TERR,LIB_TERR,periode,periode_milieu,periode_nb_annees,POPULATION_debut,POPULATION_fin,DECES,NAISSANCES,EVOL_DEMO_TOT,EVOL_DEMO_SN,EVOL_DEMO_SMA,TX_EVOL_DEMO_AN_TOT,TX_EVOL_DEMO_AN_SN,TX_EVOL_DEMO_AN_SMA,NIV_TERR
200000172,CC Faucigny-Glières,2006_2011,2008.5,5,23538,25738,664,1704,2200,1040,1160,0.0180311048491697,0.00852379501960749,0.0095073098295622,EPCI
200000172,CC Faucigny-Glières,2011_2016,2013.5,5,25738,27146,810,1850,1408,1040,368,0.0107091784735638,0.00791018864524598,0.00279898982831781,EPCI
200000172,CC Faucigny-Glières,1968_1975,1971.5,7,11677,14640,954,1565,2963,611,2352,0.0328326797235827,0.00677042433719509,0.0260622553863876,EPCI
200000172,CC Faucigny-Glières,1975_1982,1978.5,7,14640,16443,904,1755,1803,851,952,0.0167301714713091,0.00789649246926457,0.0088336790020445,EPCI
200000172,CC Faucigny-Glières,1982_1990,1986,8,16443,19270,1081,2162,2827,1081,1746,0.020029148105374,0.0076588288298229,0.0123703192755511,EPCI
200000172,CC Faucigny-Glières,1990_1999,1994.5,9,19270,21619,1167,2596,2349,1429,920,0.0128623592927837,0.00782473879497142,0.00503762049781225,EPCI
200000172,CC Faucigny-Glières,1999_2006,2002.5,7,21619,23538,966,2408,1919,1442,477,0.0122231825661412,0.00918490321020093,0.00303827935594025,EPCI
200000438,CC du Pays de Pontchâteau Saint-Gildas-des-Bois,2006_2011,2008.5,5,28867,32471,1546,2510,3604,964,2640,0.0238086683292229,0.00636835634555241,0.0174403119836705,EPCI
200000438,CC du Pays de Pontchâteau Saint-Gildas-des-Bois,2011_2016,2013.5,5,32471,35127,1637,2356,2656,719,1937,0.0158488175365361,0.00429039902438609,0.01155841851215,EPCI
200000438,CC du Pays de Pontchâteau Saint-Gildas-des-Bois,1968_1975,1971.5,7,20591,21486,2040,2671,895,631,264,0.00609672024974572,0.00429835807551905,0.00179836217422667,EPCI
200000438,CC du Pays de Pontchâteau Saint-Gildas-des-Bois,1975_1982,1978.5,7,21486,24644,1914,2618,3158,704,2454,0.0197834204355125,0.00441023685452844,0.0153731835809841,EPCI
200000438,CC du Pays de Pontchâteau Saint-Gildas-des-Bois,1982_1990,1986,8,24644,25736,2143,2696,1092,553,539,0.00543437880476327,0.00275202516395063,0.00268235364081264,EPCI
200000438,CC du Pays de Pontchâteau Saint-Gildas-des-Bois,1990_1999,1994.5,9,25736,25304,2330,2316,-432,-14,-418,-0.00187915483279444,-6.08985362479679e-05,-0.00181825629654647,EPCI
200000438,CC du Pays de Pontchâteau Saint-Gildas-des-Bois,1999_2006,2002.5,7,25304,28867,1930,2422,3563,492,3071,0.0189977157670707,0.00262331635065921,0.0163743994164114,EPCI
200000545,CC des Portes de Romilly-sur-Seine,2006_2011,2008.5,5,18137,17820,1191,1160,-317,-31,-286,-0.00352031482980086,-0.000344257917109864,-0.003176056912691,EPCI
200000545,CC des Portes de Romilly-sur-Seine,2011_2016,2013.5,5,17820,18606,1199,1134,786,-65,851,0.00866990526116207,-0.000716976898187703,0.00938688215934977,EPCI
200000545,CC des Portes de Romilly-sur-Seine,1968_1975,1971.5,7,20192,21090,1548,2430,898,882,16,0.00623543246282887,0.00612433344344662,0.000111099019382252,EPCI
200000545,CC des Portes de Romilly-sur-Seine,1975_1982,1978.5,7,21090,20003,1546,1993,-1087,447,-1534,-0.00753103176282721,0.00309693762464008,-0.0106279693874673,EPCI
200000545,CC des Portes de Romilly-sur-Seine,1982_1990,1986,8,20003,19633,1755,2221,-370,466,-836,-0.00233108359347622,0.00293590528259438,-0.0052669888760706,EPCI
200000545,CC des Portes de Romilly-sur-Seine,1990_1999,1994.5,9,19633,18670,2024,2113,-963,89,-1052,-0.00557262238706546,0.000515019099116123,-0.00608764148618159,EPCI
200000545,CC des Portes de Romilly-sur-Seine,1999_2006,2002.5,7,18670,18137,1556,1431,-533,-125,-408,-0.00412915249803048,-0.000968375351320468,-0.00316077714671001,EPCI
200000628,CC Rhône Lez Provence,2006_2011,2008.5,5,23429,24383,925,1704,954,779,175,0.00801426302556485,0.00654414140137843,0.00147012162418642,EPCI
200000628,CC Rhône Lez Provence,2011_2016,2013.5,5,24383,24103,1007,1636,-280,629,-909,-0.00230730488801445,0.00518319562343246,-0.00749050051144691,EPCI
200000628,CC Rhône Lez Provence,1968_1975,1971.5,7,17992,17667,1270,2010,-325,740,-1065,-0.00260071541134832,0.00592162893660848,-0.0085223443479568,EPCI
200000628,CC Rhône Lez Provence,1975_1982,1978.5,7,17667,20834,1275,2080,3167,805,2362,0.0238350159690479,0.00605847422010848,0.0177765417489394,EPCI
200000628,CC Rhône Lez Provence,1982_1990,1986,8,20834,22802,1419,2620,1968,1201,767,0.0113466382419722,0.00692444742307351,0.00442219081889873,EPCI
200000628,CC Rhône Lez Provence,1990_1999,1994.5,9,22802,23385,1588,2850,583,1262,-679,0.0028091092591116,0.00608078196397742,-0.00327167270486582,EPCI
200000628,CC Rhône Lez Provence,1999_2006,2002.5,7,23385,23429,1337,2067,44,730,-686,0.000268576075333815,0.00445592124985648,-0.00418734517452266,EPCI
200000800,CC Coeur de Sologne,2006_2011,2008.5,5,10427,10712,565,591,285,26,259,0.00540777201328058,0.000493340604720333,0.00491443140856024,EPCI
200000800,CC Coeur de Sologne,2011_2016,2013.5,5,10712,10609,604,501,-103,-103,0,-0.00193051633393559,-0.00193051633393559,0,EPCI
200000800,CC Coeur de Sologne,1968_1975,1971.5,7,8767,9309,853,830,542,-23,565,0.00860639553911535,-0.000365216046862829,0.00897161158597818,EPCI
200000800,CC Coeur de Sologne,1975_1982,1978.5,7,9309,9420,855,736,111,-119,230,0.00169477944009788,-0.00181692570605088,0.00351170514614876,EPCI
200000800,CC Coeur de Sologne,1982_1990,1986,8,9420,9242,961,884,-178,-77,-101,-0.00238175612463354,-0.00103031023368979,-0.00135144589094375,EPCI
200000800,CC Coeur de Sologne,1990_1999,1994.5,9,9242,9487,1080,964,245,-116,361,0.00291135511587171,-0.00137843752424946,0.00428979264012117,EPCI
200000800,CC Coeur de Sologne,1999_2006,2002.5,7,9487,10427,835,762,940,-73,1013,0.0135880837863611,-0.00105524480468549,0.0146433285910466,EPCI
200000925,CC de la Plaine Dijonnaise,2006_2011,2008.5,5,21134,21765,581,1298,631,717,-86,0.00590135619445276,0.00670566147610559,-0.000804305281652833,EPCI
200000925,CC de la Plaine Dijonnaise,2011_2016,2013.5,5,21765,22067,638,1208,302,570,-268,0.0027598222965235,0.00520893612257746,-0.00244911382605396,EPCI
200000925,CC de la Plaine Dijonnaise,1968_1975,1971.5,7,9869,11480,679,1262,1611,583,1028,0.0218361160570209,0.00790220711436571,0.0139339089426551,EPCI
200000925,CC de la Plaine Dijonnaise,1975_1982,1978.5,7,11480,14688,702,1353,3208,651,2557,0.0358304704189043,0.00727108361680383,0.0285593868021005,EPCI
200000925,CC de la Plaine Dijonnaise,1982_1990,1986,8,14688,17681,871,1867,2993,996,1997,0.0234532749478298,0.00780469824525174,0.015648576702578,EPCI
200000925,CC de la Plaine Dijonnaise,1990_1999,1994.5,9,17681,18710,1017,2031,1029,1014,15,0.00630507422191973,0.00621316351897629,9.19107029434358e-05,EPCI
200000925,CC de la Plaine Dijonnaise,1999_2006,2002.5,7,18710,21134,882,1769,2424,887,1537,0.0175558927214892,0.00642412411054492,0.0111317686109442,EPCI
200000933,CC Sauldre et Sologne,2006_2011,2008.5,5,14653,14491,1012,750,-162,-262,100,-0.0022209950508959,-0.00359197965021436,0.00137098459931846,EPCI
200000933,CC Sauldre et Sologne,2011_2016,2013.5,5,14491,13971,992,618,-520,-374,-146,-0.00728215853160286,-0.00523755248234513,-0.00204460604925773,EPCI
200000933,CC Sauldre et Sologne,1968_1975,1971.5,7,15389,15151,1541,1325,-238,-216,-22,-0.00222415604898563,-0.0020185617923567,-0.000205594256628923,EPCI
200000933,CC Sauldre et Sologne,1975_1982,1978.5,7,15151,15549,1528,1180,398,-348,746,0.00371112516345695,-0.00324490340925382,0.00695602857271077,EPCI
200000933,CC Sauldre et Sologne,1982_1990,1986,8,15549,14867,1678,1376,-682,-302,-380,-0.00559085470469745,-0.00247571571967541,-0.00311513898502204,EPCI
200000933,CC Sauldre et Sologne,1990_1999,1994.5,9,14867,14945,1744,1345,78,-399,477,0.000581591737227383,-0.00297506542504777,0.00355665716227515,EPCI
200000933,CC Sauldre et Sologne,1999_2006,2002.5,7,14945,14653,1349,1067,-292,-282,-10,-0.00281484559777523,-0.00271844677593361,-9.63988218416175e-05,EPCI
200004802,CC du Pays de Fayence,2006_2011,2008.5,5,23461,26314,1225,1362,2853,137,2716,0.0232177613648756,0.00111490827444373,0.0221028530904319,EPCI
200004802,CC du Pays de Fayence,2011_2016,2013.5,5,26314,27684,1439,1309,1370,-130,1500,0.0102023955460442,-0.000968110526266966,0.0111705060723112,EPCI
200004802,CC du Pays de Fayence,1968_1975,1971.5,7,7399,8896,836,549,1497,-287,1784,0.0266719061037051,-0.00511345160438434,0.0317853577080894,EPCI
200004802,CC du Pays de Fayence,1975_1982,1978.5,7,8896,11340,993,621,2444,-372,2816,0.0352846011010517,-0.00537065123142031,0.040655252332472,EPCI
200004802,CC du Pays de Fayence,1982_1990,1986,8,11340,14935,1325,1083,3595,-242,3837,0.0350206665209347,-0.00235744125120061,0.0373781077721353,EPCI
200004802,CC du Pays de Fayence,1990_1999,1994.5,9,14935,19799,1796,1689,4864,-107,4971,0.0318206741831828,-0.000700002495394852,0.0325206766785777,EPCI
200004802,CC du Pays de Fayence,1999_2006,2002.5,7,19799,23461,1622,1444,3662,-178,3840,0.0245402805915422,-0.0011928372324671,0.0257331178240093,EPCI
200005932,CC des Portes de Sologne,2006_2011,2008.5,5,14839,15010,537,818,171,281,-110,0.00229418675262472,0.00376997940051196,-0.00147579264788724,EPCI
200005932,CC des Portes de Sologne,2011_2016,2013.5,5,15010,15421,660,804,411,144,267,0.00541733522577448,0.00189804445866551,0.00351929076710897,EPCI
200005932,CC des Portes de Sologne,1968_1975,1971.5,7,8155,8472,787,706,317,-81,398,0.00546277716692689,-0.00139585157893085,0.00685862874585774,EPCI
200005932,CC des Portes de Sologne,1975_1982,1978.5,7,8472,11061,810,867,2589,57,2532,0.0388289968707105,0.000854867833769988,0.0379741290369405,EPCI
200005932,CC des Portes de Sologne,1982_1990,1986,8,11061,12812,911,1157,1751,246,1505,0.0185393620106509,0.00260461625049692,0.0159347457601539,EPCI
200005932,CC des Portes de Sologne,1990_1999,1994.5,9,12812,13887,958,1340,1075,382,693,0.00899251623294584,0.00319548018696308,0.00579703604598276,EPCI
200005932,CC des Portes de Sologne,1999_2006,2002.5,7,13887,14839,797,1190,952,393,559,0.0095172464325497,0.00392886328570592,0.00558838314684378,EPCI
200005957,CC de la Région de Rambervillers,2006_2011,2008.5,5,13451,13575,681,823,124,142,-18,0.00183696778061471,0.00210362439392974,-0.000266656613315038,EPCI
200005957,CC de la Région de Rambervillers,2011_2016,2013.5,5,13575,13283,780,756,-292,-24,-268,-0.00433952566356788,-0.000356673342211059,-0.00398285232135682,EPCI
200005957,CC de la Région de Rambervillers,1968_1975,1971.5,7,14254,13621,1148,1599,-633,451,-1084,-0.00646825442613463,0.00460850354847823,-0.0110767579746129,EPCI
200005957,CC de la Région de Rambervillers,1975_1982,1978.5,7,13621,13258,1155,1286,-363,131,-494,-0.00385136093277827,0.00138988507491447,-0.00524124600769274,EPCI
200005957,CC de la Région de Rambervillers,1982_1990,1986,8,13258,12868,1242,1549,-390,307,-697,-0.00372523583383066,0.00293242923329747,-0.00665766506712814,EPCI
200005957,CC de la Région de Rambervillers,1990_1999,1994.5,9,12868,13260,1285,1633,392,348,44,0.00333982877236072,0.00296495003260595,0.000374878739754775,EPCI
200005957,CC de la Région de Rambervillers,1999_2006,2002.5,7,13260,13451,1040,1205,191,165,26,0.00204515533581895,0.00176675722727815,0.000278398108540799,EPCI
200006682,"CA Beaune, Côte et Sud - Communauté Beaune-Chagny-Nolay",2006_2011,2008.5,5,51342,52650,2509,2978,1308,469,839,0.0050441004400823,0.00180862622813349,0.00323547421194882,EPCI
200006682,"CA Beaune, Côte et Sud - Communauté Beaune-Chagny-Nolay",2011_2016,2013.5,5,52650,52379,2700,2777,-271,77,-348,-0.00103156575762731,0.000293101709731744,-0.00132466746735905,EPCI
200006682,"CA Beaune, Côte et Sud - Communauté Beaune-Chagny-Nolay",1968_1975,1971.5,7,42415,44658,3687,5111,2243,1424,819,0.00738879044052854,0.00469087721235517,0.00269791322817337,EPCI
200006682,"CA Beaune, Côte et Sud - Communauté Beaune-Chagny-Nolay",1975_1982,1978.5,7,44658,47277,3454,4568,2619,1114,1505,0.00817472590042168,0.00347714572473072,0.00469758017569096,EPCI
200006682,"CA Beaune, Côte et Sud - Communauté Beaune-Chagny-Nolay",1982_1990,1986,8,47277,49492,3922,5453,2215,1531,684,0.00573980001954833,0.0039673290428571,0.00177247097669122,EPCI
200006682,"CA Beaune, Côte et Sud - Communauté Beaune-Chagny-Nolay",1990_1999,1994.5,9,49492,51116,4446,5742,1624,1296,328,0.00359383343259512,0.00286798530088871,0.000725848131706403,EPCI
200006682,"CA Beaune, Côte et Sud - Communauté Beaune-Chagny-Nolay",1999_2006,2002.5,7,51116,51342,3505,4338,226,833,-607,0.000630423049921447,0.00232363894063967,-0.00169321589071822,EPCI
200006716,CC du Nogentais,2006_2011,2008.5,5,15857,16680,917,1074,823,157,666,0.0101712498068072,0.00194032347468861,0.00823092633211856,EPCI
200006716,CC du Nogentais,2011_2016,2013.5,5,16680,16821,936,1019,141,83,58,0.00168495972787985,0.000991855726340623,0.000693104001539231,EPCI
200006716,CC du Nogentais,1968_1975,1971.5,7,11893,11913,1226,1239,20,13,7,0.000240064392576178,0.000156041855174516,8.40225374016623e-05,EPCI
200006716,CC du Nogentais,1975_1982,1978.5,7,11913,12469,1254,1076,556,-178,734,0.00653775315897298,-0.00209302169477912,0.0086307748537521,EPCI
200006716,CC du Nogentais,1982_1990,1986,8,12469,13593,1539,1468,1124,-71,1195,0.0108470813912958,-0.000685180408169038,0.0115322617994648,EPCI
200006716,CC du Nogentais,1990_1999,1994.5,9,13593,15292,1528,1841,1699,313,1386,0.0131720933858444,0.00242664227767468,0.0107454511081697,EPCI
200006716,CC du Nogentais,1999_2006,2002.5,7,15292,15857,1320,1364,565,44,521,0.00519648763086322,0.000404682222580499,0.00479180540828272,EPCI
200006930,CC du Haut-Allier,2006_2011,2008.5,5,5469,5339,421,244,-130,-177,47,-0.00479992632742643,-0.00653528430734214,0.00173535797991571,EPCI
200006930,CC du Haut-Allier,2011_2016,2013.5,5,5339,5189,435,177,-150,-258,108,-0.00568326263857599,-0.00977521173835071,0.00409194909977471,EPCI
200006930,CC du Haut-Allier,1968_1975,1971.5,7,7444,6621,750,578,-823,-172,-651,-0.0165981251892714,-0.00346886698973837,-0.013129258199533,EPCI
200006930,CC du Haut-Allier,1975_1982,1978.5,7,6621,6147,693,495,-474,-198,-276,-0.0105556451505482,-0.00440932012617836,-0.00614632502436983,EPCI
200006930,CC du Haut-Allier,1982_1990,1986,8,6147,5647,723,479,-500,-244,-256,-0.0105489315092354,-0.00514787857650688,-0.00540105293272853,EPCI
200006930,CC du Haut-Allier,1990_1999,1994.5,9,5647,5279,745,435,-368,-310,-58,-0.00745956550516314,-0.00628387311576242,-0.00117569238940071,EPCI
200006930,CC du Haut-Allier,1999_2006,2002.5,7,5279,5469,615,329,190,-286,476,0.00506407911213835,-0.00762277171616615,0.0126868508283045,EPCI
200006971,CC du Perche,2006_2011,2008.5,5,20535,20073,1099,1042,-462,-57,-405,-0.00454068357132509,-0.000560214206851797,-0.00398046936447329,EPCI
200006971,CC du Perche,2011_2016,2013.5,5,20073,18704,1189,859,-1369,-330,-1039,-0.0140283178765055,-0.00338155215430739,-0.0106467657221981,EPCI
200006971,CC du Perche,1968_1975,1971.5,7,19846,21199,1575,2559,1353,984,369,0.0094661713373192,0.00688448824532305,0.00258168309199614,EPCI
200006971,CC du Perche,1975_1982,1978.5,7,21199,20779,1557,2248,-420,691,-1111,-0.00285465334004831,0.00469658442374614,-0.00755123776379445,EPCI
200006971,CC du Perche,1982_1990,1986,8,20779,20069,1735,1973,-710,238,-948,-0.00433638627764277,0.00145360554095631,-0.00578999181859908,EPCI
200006971,CC du Perche,1990_1999,1994.5,9,20069,20145,2060,2052,76,-8,84,0.000420064056291025,-4.42172690832658e-05,0.000464281325374291,EPCI
200006971,CC du Perche,1999_2006,2002.5,7,20145,20535,1650,1587,390,-63,453,0.00274298780652238,-0.000443098030284384,0.00318608583680676,EPCI
200007052,CC de la Marche Berrichonne,2006_2011,2008.5,5,6100,5878,523,164,-222,-359,137,-0.00738702147928616,-0.0119456788786655,0.0045586573993793,EPCI
200007052,CC de la Marche Berrichonne,2011_2016,2013.5,5,5878,5727,507,169,-151,-338,187,-0.00519142465185996,-0.0116205399491965,0.0064291152973365,EPCI
200007052,CC de la Marche Berrichonne,1968_1975,1971.5,7,9872,8798,994,747,-1074,-247,-827,-0.0163193785575437,-0.00375315316919302,-0.0125662253883507,EPCI
200007052,CC de la Marche Berrichonne,1975_1982,1978.5,7,8798,8049,913,488,-749,-425,-324,-0.012630494773423,-0.00716683615314391,-0.00546365862027913,EPCI
200007052,CC de la Marche Berrichonne,1982_1990,1986,8,8049,7159,979,420,-890,-559,-331,-0.0145404458864082,-0.00913270702303618,-0.00540773886337205,EPCI
200007052,CC de la Marche Berrichonne,1990_1999,1994.5,9,7159,6209,1064,356,-950,-708,-242,-0.0156944770672037,-0.0116965155406108,-0.00399796152659295,EPCI
200007052,CC de la Marche Berrichonne,1999_2006,2002.5,7,6209,6100,834,274,-109,-560,451,-0.00252695631468547,-0.0129825278552648,0.0104555715405793,EPCI
200007177,CC Pays de Nérondes,2006_2011,2008.5,5,5034,5184,341,312,150,-29,179,0.00588968888298691,-0.00113867318404414,0.00702836206703105,EPCI
200007177,CC Pays de Nérondes,2011_2016,2013.5,5,5184,4943,349,222,-241,-127,-114,-0.00947572462906665,-0.00499343165100193,-0.00448229297806472,EPCI
200007177,CC Pays de Nérondes,1968_1975,1971.5,7,5743,5243,666,438,-500,-228,-272,-0.0129282553871993,-0.00589528445656289,-0.00703297093063643,EPCI
200007177,CC Pays de Nérondes,1975_1982,1978.5,7,5243,5065,606,313,-178,-293,115,-0.00492209173710489,-0.0081020948256839,0.003180003088579,EPCI
200007177,CC Pays de Nérondes,1982_1990,1986,8,5065,4987,611,401,-78,-210,132,-0.00193807090259679,-0.00521788319929905,0.00327981229670226,EPCI
200007177,CC Pays de Nérondes,1990_1999,1994.5,9,4987,5053,706,438,66,-268,334,0.00146191196918233,-0.0059362486021343,0.00739816057131663,EPCI
200007177,CC Pays de Nérondes,1999_2006,2002.5,7,5053,5034,549,401,-19,-148,129,-0.000538030866120587,-0.00419097727293931,0.00365294640681872,EPCI
200010650,CA du Grand Dole,2006_2011,2008.5,5,52935,53830,2458,3208,895,750,145,0.00335886574523636,0.00281469196528187,0.000544173779954495,EPCI
200010650,CA du Grand Dole,2011_2016,2013.5,5,53830,54171,2501,3068,341,567,-226,0.00126375332990536,0.0021013141878485,-0.000837560857943141,EPCI
200010650,CA du Grand Dole,1968_1975,1971.5,7,50550,52653,3239,6437,2103,3198,-1095,0.00583988194710394,0.00888061933753609,-0.00304073739043215,EPCI
200010650,CA du Grand Dole,1975_1982,1978.5,7,52653,51857,3276,5346,-796,2070,-2866,-0.00217381763286673,0.00565301821612327,-0.00782683584899,EPCI
200010650,CA du Grand Dole,1982_1990,1986,8,51857,52900,3773,5916,1043,2143,-1100,0.00249227663074803,0.00512075629884278,-0.00262847966809475,EPCI
200010650,CA du Grand Dole,1990_1999,1994.5,9,52900,52293,4230,5904,-607,1674,-2281,-0.00128149151684243,0.00353412981745341,-0.00481562133429584,EPCI
200010650,CA du Grand Dole,1999_2006,2002.5,7,52293,52935,3275,4389,642,1114,-472,0.00174469548386003,0.00302739995174466,-0.00128270446788463,EPCI
200010700,CA Caux Seine Agglo,2006_2011,2008.5,5,74590,75790,3179,4816,1200,1637,-437,0.00319708136925923,0.00436135183456446,-0.00116427046530523,EPCI
200010700,CA Caux Seine Agglo,2011_2016,2013.5,5,75790,77114,3343,4807,1324,1464,-140,0.0034697032571116,0.00383659030846781,-0.000366887051356212,EPCI
200010700,CA Caux Seine Agglo,1968_1975,1971.5,7,59464,64453,3941,8033,4989,4092,897,0.0115757996229278,0.00949452236059739,0.00208127726233037,EPCI
200010700,CA Caux Seine Agglo,1975_1982,1978.5,7,64453,68874,4154,7152,4421,2998,1423,0.00952254972776534,0.00645749922728805,0.00306505050047729,EPCI
200010700,CA Caux Seine Agglo,1982_1990,1986,8,68874,72304,4781,9134,3430,4353,-923,0.00609357881745742,0.00773333778203853,-0.00163975896458111,EPCI
200010700,CA Caux Seine Agglo,1990_1999,1994.5,9,72304,73255,5482,8753,951,3271,-2320,0.00145294920765249,0.00499747303704657,-0.00354452382939408,EPCI
200010700,CA Caux Seine Agglo,1999_2006,2002.5,7,73255,74590,4536,6713,1335,2177,-842,0.00258332318863452,0.00421265511734634,-0.00162933192871181,EPCI
200011773,CA Annemasse-les Voirons-Agglomération,2006_2011,2008.5,5,74018,82108,2460,5657,8090,3197,4893,0.0209621116122725,0.00828379120203153,0.0126783204102409,EPCI
200011773,CA Annemasse-les Voirons-Agglomération,2011_2016,2013.5,5,82108,89099,2498,6445,6991,3947,3044,0.0164768010477097,0.00930252234806323,0.00717427869964643,EPCI
200011773,CA Annemasse-les Voirons-Agglomération,1968_1975,1971.5,7,40419,53638,2546,5401,13219,2855,10364,0.0412506543776905,0.0089091926959911,0.0323414616816994,EPCI
200011773,CA Annemasse-les Voirons-Agglomération,1975_1982,1978.5,7,53638,58040,2745,5612,4402,2867,1535,0.0113315288414502,0.00738016655802763,0.00395136228342254,EPCI
200011773,CA Annemasse-les Voirons-Agglomération,1982_1990,1986,8,58040,65657,3486,6905,7617,3419,4198,0.0155333821648809,0.00697238199051171,0.00856100017436916,EPCI
200011773,CA Annemasse-les Voirons-Agglomération,1990_1999,1994.5,9,65657,68307,4220,8504,2650,4284,-1634,0.00440612624718528,0.00712296031809123,-0.00271683407090594,EPCI
200011773,CA Annemasse-les Voirons-Agglomération,1999_2006,2002.5,7,68307,74018,3279,6739,5711,3460,2251,0.0115369078727581,0.0069896167465843,0.00454729112617377,EPCI
200011781,CC Portes du Berry entre Loire et Val d'Aubois,2006_2011,2008.5,5,10230,10081,580,578,-149,-2,-147,-0.00293012196687148,-3.93304961996172e-05,-0.00289079147067186,EPCI
200011781,CC Portes du Berry entre Loire et Val d'Aubois,2011_2016,2013.5,5,10081,9896,602,447,-185,-155,-30,-0.0036975130975927,-0.00309791637906415,-0.000599596718528546,EPCI
200011781,CC Portes du Berry entre Loire et Val d'Aubois,1968_1975,1971.5,7,10717,10339,1174,923,-378,-251,-127,-0.00511659584796831,-0.00339752793079377,-0.00171906791717454,EPCI
200011781,CC Portes du Berry entre Loire et Val d'Aubois,1975_1982,1978.5,7,10339,9950,1120,735,-389,-385,-4,-0.0054636768746672,-0.00540749510731844,-5.61817673487633e-05,EPCI
200011781,CC Portes du Berry entre Loire et Val d'Aubois,1982_1990,1986,8,9950,9828,1143,752,-122,-391,269,-0.00154094858159681,-0.004938613896757,0.00339766531516019,EPCI
200011781,CC Portes du Berry entre Loire et Val d'Aubois,1990_1999,1994.5,9,9828,9862,1168,807,34,-361,395,0.000383799536980867,-0.00407504802500273,0.0044588475619836,EPCI
200011781,CC Portes du Berry entre Loire et Val d'Aubois,1999_2006,2002.5,7,9862,10230,880,762,368,-118,486,0.00524737552471155,-0.00168258236933686,0.00692995789404841,EPCI
200012060,CC Petite Montagne,2006_2011,2008.5,5,6468,6757,370,386,289,16,273,0.00878073906708043,0.000486130882606529,0.00829460818447391,EPCI
200012060,CC Petite Montagne,2011_2016,2013.5,5,6757,6655,446,281,-102,-165,63,-0.00303748801491321,-0.00491358355353608,0.00187609553862287,EPCI
200012060,CC Petite Montagne,1968_1975,1971.5,7,5864,5348,677,431,-516,-246,-270,-0.0130722779724874,-0.00623213252176727,-0.00684014545072018,EPCI
200012060,CC Petite Montagne,1975_1982,1978.5,7,5348,5204,606,358,-144,-248,104,-0.00389170740058287,-0.00670238496767049,0.00281067756708763,EPCI
200012060,CC Petite Montagne,1982_1990,1986,8,5204,5531,667,473,327,-194,521,0.00764672178123571,-0.00453658723412761,0.0121833090153633,EPCI
200012060,CC Petite Montagne,1990_1999,1994.5,9,5531,6106,674,627,575,-47,622,0.0110498550944966,-0.000903205546854507,0.0119530606413511,EPCI
200012060,CC Petite Montagne,1999_2006,2002.5,7,6106,6468,542,531,362,-11,373,0.00826180581280567,-0.000251049347902935,0.0085128551607086,EPCI
200013050,CC Sauer-Pechelbronn,2006_2011,2008.5,5,17124,17589,702,919,465,217,248,0.00537292634723396,0.00250736562870918,0.00286556071852478,EPCI
200013050,CC Sauer-Pechelbronn,2011_2016,2013.5,5,17589,17391,762,869,-198,107,-305,-0.0022616138138486,0.00122218524283737,-0.00348379905668597,EPCI
200013050,CC Sauer-Pechelbronn,1968_1975,1971.5,7,14941,15300,1275,1679,359,404,-45,0.0033977187086669,0.00382361659693991,-0.00042589788827301,EPCI
200013050,CC Sauer-Pechelbronn,1975_1982,1978.5,7,15300,15339,1228,1287,39,59,-20,0.000363748478665382,0.000550286160032245,-0.000186537681366863,EPCI
200013050,CC Sauer-Pechelbronn,1982_1990,1986,8,15339,16116,1328,1648,777,320,457,0.00619586074854484,0.00255170584238655,0.00364415490615829,EPCI
200013050,CC Sauer-Pechelbronn,1990_1999,1994.5,9,16116,16426,1338,1655,310,317,-7,0.0021192288411076,0.00216708239558422,-4.78535544766231e-05,EPCI
200013050,CC Sauer-Pechelbronn,1999_2006,2002.5,7,16426,17124,980,1256,698,276,422,0.00596278461255051,0.00235777729665321,0.0036050073158973,EPCI
200015162,CC de l'Oriente,2006_2011,2008.5,5,5770,5865,250,181,95,-69,164,0.00327141976884859,-0.00237608383211108,0.00564750360095968,EPCI
200015162,CC de l'Oriente,2011_2016,2013.5,5,5865,6089,307,269,224,-38,262,0.0075244439245139,-0.00127646816576575,0.00880091209027965,EPCI
200015162,CC de l'Oriente,1968_1975,1971.5,7,6143,7747,484,410,1604,-74,1678,0.0336970848699687,-0.00155460366607088,0.0352516885360396,EPCI
200015162,CC de l'Oriente,1975_1982,1978.5,7,7747,6790,463,347,-957,-116,-841,-0.0186600938799004,-0.00226182956120005,-0.0163982643187004,EPCI
200015162,CC de l'Oriente,1982_1990,1986,8,6790,5932,491,504,-858,13,-871,-0.0167444170824368,0.00025370328912783,-0.0169981203715646,EPCI
200015162,CC de l'Oriente,1990_1999,1994.5,9,5932,5698,600,500,-234,-100,-134,-0.00446181508422916,-0.00190675858300391,-0.00255505650122525,EPCI
200015162,CC de l'Oriente,1999_2006,2002.5,7,5698,5770,421,309,72,-112,184,0.00179544480495264,-0.00279291414103744,0.00458835894599008,EPCI
200016905,CC du Pays de Lamastre,2006_2011,2008.5,5,6681,6773,423,279,92,-144,236,0.00273903297305544,-0.00428718204478243,0.00702621501783788,EPCI
200016905,CC du Pays de Lamastre,2011_2016,2013.5,5,6773,6633,436,244,-140,-192,52,-0.00416867279817079,-0.00571703698034852,0.00154836418217772,EPCI
200016905,CC du Pays de Lamastre,1968_1975,1971.5,7,8888,7936,812,846,-952,34,-986,-0.0160544008824478,0.000573371460087422,-0.0166277723425352,EPCI
200016905,CC du Pays de Lamastre,1975_1982,1978.5,7,7936,7491,780,531,-445,-249,-196,-0.00820997965775949,-0.00459389872984745,-0.00361608092791205,EPCI
200016905,CC du Pays de Lamastre,1982_1990,1986,8,7491,6783,781,571,-708,-210,-498,-0.0123336614100157,-0.00365828940127584,-0.00867537200873985,EPCI
200016905,CC du Pays de Lamastre,1990_1999,1994.5,9,6783,6478,805,570,-305,-235,-70,-0.00509891851364075,-0.00392867492034615,-0.0011702435932946,EPCI
200016905,CC du Pays de Lamastre,1999_2006,2002.5,7,6478,6681,608,409,203,-199,402,0.00441770888821758,-0.00433066043721821,0.00874836932543579,EPCI
200017341,CC Lodévois et Larzac,2006_2011,2008.5,5,13402,14418,888,774,1016,-114,1130,0.0147220121089904,-0.00165187931144183,0.0163738914204322,EPCI
200017341,CC Lodévois et Larzac,2011_2016,2013.5,5,14418,14563,899,758,145,-141,286,0.00200333189695989,-0.0019480675687679,0.00395139946572779,EPCI
200017341,CC Lodévois et Larzac,1968_1975,1971.5,7,11494,11590,1114,1110,96,-4,100,0.00118892010096916,-4.95383375403817e-05,0.00123845843850954,EPCI
200017341,CC Lodévois et Larzac,1975_1982,1978.5,7,11590,12413,1209,1034,823,-175,998,0.00984841574514772,-0.00209413457521367,0.0119425503203614,EPCI
200017341,CC Lodévois et Larzac,1982_1990,1986,8,12413,12008,1389,1223,-405,-166,-239,-0.00413781756942044,-0.00169599436178714,-0.0024418232076333,EPCI
200017341,CC Lodévois et Larzac,1990_1999,1994.5,9,12008,11836,1439,1211,-172,-228,56,-0.00160175579472821,-0.00212325768138391,0.000521501886655697,EPCI
200017341,CC Lodévois et Larzac,1999_2006,2002.5,7,11836,13402,1117,1004,1566,-113,1679,0.017909662051526,-0.00129233193602965,0.0192019939875557,EPCI
200017846,CA Étampois Sud-Essonne (CCESE),2006_2011,2008.5,5,49190,52176,1816,3659,2986,1843,1143,0.0118561875954126,0.00731780098404068,0.00453838661137195,EPCI
200017846,CA Étampois Sud-Essonne (CCESE),2011_2016,2013.5,5,52176,53608,1892,3839,1432,1947,-515,0.00542982668752279,0.00738259257025619,-0.0019527658827334,EPCI
200017846,CA Étampois Sud-Essonne (CCESE),1968_1975,1971.5,7,31951,37218,2592,4364,5267,1772,3495,0.0220377553498576,0.00741425906207476,0.0146234962877829,EPCI
200017846,CA Étampois Sud-Essonne (CCESE),1975_1982,1978.5,7,37218,39846,2614,3910,2628,1296,1332,0.0097947300794432,0.00483027784739665,0.00496445223204656,EPCI
200017846,CA Étampois Sud-Essonne (CCESE),1982_1990,1986,8,39846,44720,3100,4962,4874,1862,3012,0.0145293908445812,0.00555062079454455,0.00897877005003661,EPCI
200017846,CA Étampois Sud-Essonne (CCESE),1990_1999,1994.5,9,44720,46966,3509,6160,2246,2651,-405,0.00545963945347294,0.00644412475118289,-0.000984485297709947,EPCI
200017846,CA Étampois Sud-Essonne (CCESE),1999_2006,2002.5,7,46966,49190,2747,4807,2224,2060,164,0.00663137874407815,0.00614237419640333,0.000489004547674829,EPCI
200018083,CC de Desvres-Samer,2006_2011,2008.5,5,20604,21984,1017,1412,1380,395,985,0.0130503591032891,0.00373542887376754,0.00931493022952158,EPCI
200018083,CC de Desvres-Samer,2011_2016,2013.5,5,21984,22852,1027,1393,868,366,502,0.00777481307489647,0.00327831979886188,0.00449649327603459,EPCI
200018083,CC de Desvres-Samer,1968_1975,1971.5,7,17942,18141,1316,2270,199,954,-755,0.00157699026085623,0.0075600437630997,-0.00598305350224347,EPCI
200018083,CC de Desvres-Samer,1975_1982,1978.5,7,18141,18091,1439,1988,-50,549,-599,-0.000394206982867407,0.00432839267188413,-0.00472259965475153,EPCI
200018083,CC de Desvres-Samer,1982_1990,1986,8,18091,18942,1603,2202,851,599,252,0.00576242699587959,0.00405604438370373,0.00170638261217586,EPCI
200018083,CC de Desvres-Samer,1990_1999,1994.5,9,18942,19717,1767,2147,775,380,395,0.00446544373234148,0.00218950789456743,0.00227593583777404,EPCI
200018083,CC de Desvres-Samer,1999_2006,2002.5,7,19717,20604,1366,1857,887,491,396,0.006306089314986,0.00349074391618729,0.00281534539879871,EPCI
200018166,CC Le Grésivaudan,2006_2011,2008.5,5,94717,98290,3024,5759,3573,2735,838,0.00743324930105604,0.00568987876809076,0.00174337053296529,EPCI
200018166,CC Le Grésivaudan,2011_2016,2013.5,5,98290,101100,3137,5494,2810,2357,453,0.00565348767314178,0.00474208912654632,0.000911398546595454,EPCI
200018166,CC Le Grésivaudan,1968_1975,1971.5,7,43843,49736,3409,4673,5893,1264,4629,0.0181795501833062,0.00389936389473936,0.0142801862885668,EPCI
200018166,CC Le Grésivaudan,1975_1982,1978.5,7,49736,58648,3467,4835,8912,1368,7544,0.023825754987723,0.00365727477818728,0.0201684802095357,EPCI
200018166,CC Le Grésivaudan,1982_1990,1986,8,58648,70887,4104,6744,12239,2640,9599,0.0239745760629118,0.00517140949473707,0.0188031665681747,EPCI
200018166,CC Le Grésivaudan,1990_1999,1994.5,9,70887,85681,4983,9068,14794,4085,10709,0.0212837849604022,0.00587699483325963,0.0154067901271426,EPCI
200018166,CC Le Grésivaudan,1999_2006,2002.5,7,85681,94717,4061,8213,9036,4152,4884,0.0144262686664058,0.00662880339784385,0.00779746526856199,EPCI
200018406,CC du Romorantinais et du Monestois,2006_2011,2008.5,5,32419,32542,1920,1740,123,-180,303,0.000757665291974519,-0.00110877847606027,0.00186644376803479,EPCI
200018406,CC du Romorantinais et du Monestois,2011_2016,2013.5,5,32542,33887,1859,1784,1345,-75,1420,0.00813287304524457,-0.000453505931890961,0.00858637897713553,EPCI
200018406,CC du Romorantinais et du Monestois,1968_1975,1971.5,7,24599,27862,2263,3001,3263,738,2525,0.0179532508312246,0.00406052685058036,0.0138927239806442,EPCI
200018406,CC du Romorantinais et du Monestois,1975_1982,1978.5,7,27862,30095,2309,2668,2233,359,1874,0.0110744862113916,0.00178044807429001,0.00929403813710161,EPCI
200018406,CC du Romorantinais et du Monestois,1982_1990,1986,8,30095,31327,2844,2861,1232,17,1215,0.00502775954160262,6.93765521162699e-05,0.00495838298948635,EPCI
200018406,CC du Romorantinais et du Monestois,1990_1999,1994.5,9,31327,32494,3065,3350,1167,285,882,0.00407217011041028,0.00099448884444467,0.00307768126596561,EPCI
200018406,CC du Romorantinais et du Monestois,1999_2006,2002.5,7,32494,32419,2526,2639,-75,113,-188,-0.000330057837932163,0.000497287142484459,-0.000827344980416621,EPCI
200018521,CC du Val de Bouzanne,2006_2011,2008.5,5,5905,6078,394,310,173,-84,257,0.00579195786991682,-0.00281228012180932,0.00860423799172614,EPCI
200018521,CC du Val de Bouzanne,2011_2016,2013.5,5,6078,6033,388,264,-45,-124,79,-0.00148515507125635,-0.00409242730746194,0.00260727223620559,EPCI
200018521,CC du Val de Bouzanne,1968_1975,1971.5,7,7055,6502,741,521,-553,-220,-333,-0.0115932406410072,-0.00461213913385458,-0.00698110150715262,EPCI
200018521,CC du Val de Bouzanne,1975_1982,1978.5,7,6502,6182,689,474,-320,-215,-105,-0.00718378354747529,-0.00482660457095996,-0.00235717897651533,EPCI
200018521,CC du Val de Bouzanne,1982_1990,1986,8,6182,5935,791,413,-247,-378,131,-0.00508388504560053,-0.00778019654751823,0.00269631150191769,EPCI
200018521,CC du Val de Bouzanne,1990_1999,1994.5,9,5935,5825,829,425,-110,-404,294,-0.00207651090754291,-0.00762645824224849,0.00554994733470558,EPCI
200018521,CC du Val de Bouzanne,1999_2006,2002.5,7,5825,5905,580,433,80,-147,227,0.0019505355669589,-0.00358410910428698,0.00553464467124588,EPCI
200018653,CA Cap Excellence,2006_2011,2008.5,5,105500,105575,3389,8448,75,5059,-4984,0.000142139681664544,0.00958779532721236,-0.00944565564554781,EPCI
200018653,CA Cap Excellence,2011_2016,2013.5,5,105575,101163,3476,7344,-4412,3868,-8280,-0.00850136199406548,0.00745314328944816,-0.0159545052835136,EPCI
200018653,CA Cap Excellence,1968_1975,1971.5,7,76831,85842,5485,31374,9011,25889,-16878,0.0159690485502502,0.0458797800374461,-0.0299107314871959,EPCI
200018653,CA Cap Excellence,1975_1982,1978.5,7,85842,91950,3633,13444,6108,9811,-3703,0.00986787724891225,0.0158503182202158,-0.00598244097130355,EPCI
200018653,CA Cap Excellence,1982_1990,1986,8,91950,103670,4225,16024,11720,11799,-79,0.0151089821290848,0.0152108259506034,-0.000101843821518574,EPCI
200018653,CA Cap Excellence,1990_1999,1994.5,9,103670,107391,5172,17294,3721,12122,-8401,0.00392586413320317,0.0127893912987608,-0.0088635271655576,EPCI
200018653,CA Cap Excellence,1999_2006,2002.5,7,107391,105500,4417,12585,-1891,8168,-10059,-0.00253470031780889,0.010948404122614,-0.0134831044404229,EPCI
200022986,CC du Grand Pic Saint-Loup,2006_2011,2008.5,5,41988,45034,1363,2077,3046,714,2332,0.0141053339132886,0.00330637177087593,0.0107989621424127,EPCI
200022986,CC du Grand Pic Saint-Loup,2011_2016,2013.5,5,45034,47600,1533,2112,2566,579,1987,0.0111446442100331,0.00251471122276274,0.0086299329872704,EPCI
200022986,CC du Grand Pic Saint-Loup,1968_1975,1971.5,7,7847,10964,726,777,3117,51,3066,0.0489437420495402,0.00080081194883752,0.0481429301007027,EPCI
200022986,CC du Grand Pic Saint-Loup,1975_1982,1978.5,7,10964,18282,817,1197,7318,380,6938,0.0757766084882072,0.0039348334552499,0.0718417750329573,EPCI
200022986,CC du Grand Pic Saint-Loup,1982_1990,1986,8,18282,29288,1216,2295,11006,1079,9927,0.0606772437678063,0.00594864128888451,0.0547286024789217,EPCI
200022986,CC du Grand Pic Saint-Loup,1990_1999,1994.5,9,29288,37445,1927,3332,8157,1405,6752,0.0276755242506495,0.00476696231116372,0.0229085619394857,EPCI
200022986,CC du Grand Pic Saint-Loup,1999_2006,2002.5,7,37445,41988,1923,2761,4543,838,3705,0.0164932032489657,0.00304232980907623,0.0134508734398895,EPCI
200023075,CC du Pays de Maîche,2006_2011,2008.5,5,17073,18219,760,1273,1146,513,633,0.013078127793499,0.00585434516410559,0.00722378262939345,EPCI
200023075,CC du Pays de Maîche,2011_2016,2013.5,5,18219,18686,726,1182,467,456,11,0.00507474809323827,0.00495521441224122,0.000119533680997047,EPCI
200023075,CC du Pays de Maîche,1968_1975,1971.5,7,16079,16566,998,2251,487,1253,-766,0.00427171636820933,0.0109906788693353,-0.00671896250112597,EPCI
200023075,CC du Pays de Maîche,1975_1982,1978.5,7,16566,16343,978,1893,-223,915,-1138,-0.0019342313966777,0.00793642030475379,-0.00987065170143149,EPCI
200023075,CC du Pays de Maîche,1982_1990,1986,8,16343,16338,1070,1806,-5,736,-741,-3.82477924399938e-05,0.00563007504716708,-0.00566832283960708,EPCI
200023075,CC du Pays de Maîche,1990_1999,1994.5,9,16338,16388,1223,1912,50,689,-639,0.000339577283866355,0.00467937497167837,-0.00433979768781201,EPCI
200023075,CC du Pays de Maîche,1999_2006,2002.5,7,16388,17073,922,1479,685,557,128,0.00586698783739115,0.00477067478164506,0.00109631305574608,EPCI
200023125,CC Les Portes Briardes entre Villes et Forêts,2006_2011,2008.5,5,44909,44927,1168,2734,18,1566,-1548,8.01492567548134e-05,0.00697298533766877,-0.00689283608091396,EPCI
200023125,CC Les Portes Briardes entre Villes et Forêts,2011_2016,2013.5,5,44927,46199,1264,2667,1272,1403,-131,0.00559945919679361,0.00617613306061434,-0.000576673863820726,EPCI
200023125,CC Les Portes Briardes entre Villes et Forêts,1968_1975,1971.5,7,13429,31460,1093,3306,18031,2213,15818,0.129318479983924,0.0158716541625214,0.113446825821403,EPCI
200023125,CC Les Portes Briardes entre Villes et Forêts,1975_1982,1978.5,7,31460,33822,1310,3396,2362,2086,276,0.0103957471369591,0.00918100276363113,0.00121474437332799,EPCI
200023125,CC Les Portes Briardes entre Villes et Forêts,1982_1990,1986,8,33822,40692,1611,4012,6870,2401,4469,0.0233842263925244,0.00817256587604818,0.0152116605164762,EPCI
200023125,CC Les Portes Briardes entre Villes et Forêts,1990_1999,1994.5,9,40692,44544,2094,4990,3852,2896,956,0.0101002165097326,0.00759351687751443,0.00250669963221816,EPCI
200023125,CC Les Portes Briardes entre Villes et Forêts,1999_2006,2002.5,7,44544,44909,1567,4058,365,2491,-2126,0.00116650203258306,0.00796097688538193,-0.00679447485279887,EPCI
200023240,CC Pays de Nemours,2006_2011,2008.5,5,29281,29879,1449,1810,598,361,237,0.00405159580930148,0.00244586302200307,0.00160573278729841,EPCI
200023240,CC Pays de Nemours,2011_2016,2013.5,5,29879,29929,1494,1762,50,268,-218,0.000334459421281297,0.00179270249806775,-0.00145824307678645,EPCI
200023240,CC Pays de Nemours,1968_1975,1971.5,7,19068,22673,1496,2637,3605,1141,2464,0.0250461207323836,0.00792721879490974,0.0171189019374738,EPCI
200023240,CC Pays de Nemours,1975_1982,1978.5,7,22673,25157,1662,2596,2484,934,1550,0.0149624618092097,0.00562598201682844,0.00933647979238124,EPCI
200023240,CC Pays de Nemours,1982_1990,1986,8,25157,27486,2029,2882,2329,853,1476,0.0111290467130845,0.00407603127791371,0.00705301543517074,EPCI
200023240,CC Pays de Nemours,1990_1999,1994.5,9,27486,29517,2399,3464,2031,1065,966,0.00795251956685128,0.00417008042279498,0.0037824391440563,EPCI
200023240,CC Pays de Nemours,1999_2006,2002.5,7,29517,29281,1901,2610,-236,709,-945,-0.00114613226474702,0.00344325328688831,-0.00458938555163533,EPCI
200023299,CC Coeur de Tarentaise,2006_2011,2008.5,5,10171,9510,406,665,-661,259,-920,-0.0133494268060388,0.00523071337785786,-0.0185801401838967,EPCI
200023299,CC Coeur de Tarentaise,2011_2016,2013.5,5,9510,9167,414,490,-343,76,-419,-0.00731983804670533,0.0016218883135557,-0.00894172636026103,EPCI
200023299,CC Coeur de Tarentaise,1968_1975,1971.5,7,8574,9260,625,1061,686,436,250,0.0110563431865656,0.00702706359962476,0.0040292795869408,EPCI
200023299,CC Coeur de Tarentaise,1975_1982,1978.5,7,9260,9196,610,946,-64,336,-400,-0.000990286736014534,0.0051990053640763,-0.00618929210009084,EPCI
200023299,CC Coeur de Tarentaise,1982_1990,1986,8,9196,9763,695,989,567,294,273,0.00750692716978141,0.00389248075470147,0.00361444641507994,EPCI
200023299,CC Coeur de Tarentaise,1990_1999,1994.5,9,9763,9687,782,1259,-76,477,-553,-0.000867950868025935,0.00544753373747857,-0.0063154846055045,EPCI
200023299,CC Coeur de Tarentaise,1999_2006,2002.5,7,9687,10171,607,921,484,314,170,0.00698942037608186,0.00453445867373906,0.0024549617023428,EPCI
200023307,CA du Grand Villeneuvois,2006_2011,2008.5,5,47509,48066,2523,2630,557,107,450,0.00233389924942729,0.000448343302852279,0.00188555594657501,EPCI
200023307,CA du Grand Villeneuvois,2011_2016,2013.5,5,48066,47909,2868,2545,-157,-323,166,-0.000654123618415214,-0.00134574476909627,0.000691621150681055,EPCI
200023307,CA du Grand Villeneuvois,1968_1975,1971.5,7,39910,41870,3261,4439,1960,1178,782,0.00687245927305469,0.00413048827737675,0.00274197099567794,EPCI
200023307,CA du Grand Villeneuvois,1975_1982,1978.5,7,41870,44329,3452,3673,2459,221,2238,0.0081861116681945,0.000735718047446516,0.00745039362074798,EPCI
200023307,CA du Grand Villeneuvois,1982_1990,1986,8,44329,45126,4048,4177,797,129,668,0.0022299184102208,0.000360927822984295,0.0018689905872365,EPCI
200023307,CA du Grand Villeneuvois,1990_1999,1994.5,9,45126,45358,4609,4277,232,-332,564,0.000569938982909468,-0.000815602337611825,0.00138554132052129,EPCI
200023307,CA du Grand Villeneuvois,1999_2006,2002.5,7,45358,47509,3478,3481,2151,3,2148,0.00664089647504573,9.26205923995221e-06,0.00663163441580578,EPCI
200023372,CC de la Vallée de Chamonix-Mont-Blanc,2006_2011,2008.5,5,13540,13264,468,867,-276,399,-675,-0.00411046264506343,0.0059422992586243,-0.0100527619036877,EPCI
200023372,CC de la Vallée de Chamonix-Mont-Blanc,2011_2016,2013.5,5,13264,13038,483,807,-226,324,-550,-0.0034311855610395,0.00491904478662299,-0.00835023034766249,EPCI
200023372,CC de la Vallée de Chamonix-Mont-Blanc,1968_1975,1971.5,7,9728,10584,661,1415,856,754,102,0.0121207396017804,0.0106764458641851,0.00144429373759533,EPCI
200023372,CC de la Vallée de Chamonix-Mont-Blanc,1975_1982,1978.5,7,10584,11250,588,1189,666,601,65,0.00875592536066416,0.00790136808071946,0.0008545572799447,EPCI
200023372,CC de la Vallée de Chamonix-Mont-Blanc,1982_1990,1986,8,11250,12596,714,1547,1346,833,513,0.0142266458635021,0.00880445468372752,0.00542219117977457,EPCI
200023372,CC de la Vallée de Chamonix-Mont-Blanc,1990_1999,1994.5,9,12596,13744,805,1907,1148,1102,46,0.00973856552679275,0.00934834426003973,0.00039022126675302,EPCI
200023372,CC de la Vallée de Chamonix-Mont-Blanc,1999_2006,2002.5,7,13744,13540,651,1329,-204,678,-882,-0.00213401941558566,0.00709247629297588,-0.00922649570856155,EPCI
200023414,Métropole Rouen Normandie,2006_2011,2008.5,5,484625,486924,20296,32302,2299,12006,-9707,0.000946979585973118,0.0049453836055647,-0.00399840401959159,EPCI
200023414,Métropole Rouen Normandie,2011_2016,2013.5,5,486924,490001,21092,31772,3077,10680,-7603,0.00126066967868055,0.00437567506282361,-0.00311500538414306,EPCI
200023414,Métropole Rouen Normandie,1968_1975,1971.5,7,442723,470139,29002,60867,27416,31865,-4449,0.00862038671076437,0.0100192815340862,-0.00139889482332181,EPCI
200023414,Métropole Rouen Normandie,1975_1982,1978.5,7,470139,468987,28960,53130,-1152,24170,-25322,-0.000350416611054394,0.00735205684825061,-0.007702473459305,EPCI
200023414,Métropole Rouen Normandie,1982_1990,1986,8,468987,477680,32895,61346,8693,28451,-19758,0.00229838759342682,0.00752230822737679,-0.00522392063394997,EPCI
200023414,Métropole Rouen Normandie,1990_1999,1994.5,9,477680,485149,36233,60958,7469,24725,-17256,0.00172537653133564,0.00571159924183609,-0.00398622271050045,EPCI
200023414,Métropole Rouen Normandie,1999_2006,2002.5,7,485149,484625,28219,44114,-524,15895,-16419,-0.000154368692485751,0.00468261520431492,-0.00483698389680067,EPCI
200023620,CC de la Gascogne Toulousaine,2006_2011,2008.5,5,15441,18501,578,1163,3060,585,2475,0.0368214085359293,0.00703938692598648,0.0297820216099428,EPCI
200023620,CC de la Gascogne Toulousaine,2011_2016,2013.5,5,18501,21384,630,1329,2883,699,2184,0.029387164074844,0.00712508764769891,0.0222620764271451,EPCI
200023620,CC de la Gascogne Toulousaine,1968_1975,1971.5,7,7433,8238,680,646,805,-34,839,0.014798145682271,-0.000625014848692191,0.0154231605309632,EPCI
200023620,CC de la Gascogne Toulousaine,1975_1982,1978.5,7,8238,9410,671,619,1172,-52,1224,0.019183884643742,-0.000851162117299133,0.0200350467610411,EPCI
200023620,CC de la Gascogne Toulousaine,1982_1990,1986,8,9410,10993,774,880,1583,106,1477,0.0196258223139481,0.00131417382519172,0.0183116484887563,EPCI
200023620,CC de la Gascogne Toulousaine,1990_1999,1994.5,9,10993,12804,898,1319,1811,421,1390,0.0170886932634535,0.00397257861066479,0.0131161146527887,EPCI
200023620,CC de la Gascogne Toulousaine,1999_2006,2002.5,7,12804,15441,749,1264,2637,515,2122,0.0271137348990986,0.00529524970536056,0.0218184851937381,EPCI
200023737,CA du Grand Cahors,2006_2011,2008.5,5,39613,41517,1899,2027,1904,128,1776,0.00943334306685006,0.000634174323821853,0.00879916874302821,EPCI
200023737,CA du Grand Cahors,2011_2016,2013.5,5,41517,40775,2223,1881,-742,-342,-400,-0.00360027011090414,-0.00165942368993156,-0.00194084642097258,EPCI
200023737,CA du Grand Cahors,1968_1975,1971.5,7,29486,31816,2459,3282,2330,823,1507,0.0109240555517924,0.00385858271207089,0.00706547283972154,EPCI
200023737,CA du Grand Cahors,1975_1982,1978.5,7,31816,34108,2528,3048,2292,520,1772,0.00998706299317798,0.00226582580997057,0.0077212371832074,EPCI
200023737,CA du Grand Cahors,1982_1990,1986,8,34108,36070,2779,3403,1962,624,1338,0.00701568718634382,0.0022312888910696,0.00478439829527423,EPCI
200023737,CA du Grand Cahors,1990_1999,1994.5,9,36070,37858,3231,3484,1788,253,1535,0.00539012174570153,0.000762696197797811,0.00462742554790372,EPCI
200023737,CA du Grand Cahors,1999_2006,2002.5,7,37858,39613,2585,2778,1755,193,1562,0.00649457445447599,0.00071421815938112,0.00578035629509487,EPCI
200023778,CC du Pays de Saint-Gilles-Croix-de-Vie,2006_2011,2008.5,5,41390,45367,2445,2263,3977,-182,4159,0.0185185122850362,-0.000847465234065021,0.0193659775191012,EPCI
200023778,CC du Pays de Saint-Gilles-Croix-de-Vie,2011_2016,2013.5,5,45367,48056,2806,1987,2689,-819,3508,0.0115829749109375,-0.00352787521459942,0.0151108501255369,EPCI
200023778,CC du Pays de Saint-Gilles-Croix-de-Vie,1968_1975,1971.5,7,22217,24604,1733,2652,2387,919,1468,0.0146855411543305,0.00565396410591946,0.00903157704841106,EPCI
200023778,CC du Pays de Saint-Gilles-Croix-de-Vie,1975_1982,1978.5,7,24604,27017,1974,2411,2413,437,1976,0.0134550389208778,0.00243673933212748,0.0110182995887504,EPCI
200023778,CC du Pays de Saint-Gilles-Croix-de-Vie,1982_1990,1986,8,27017,30171,2509,2646,3154,137,3017,0.0138975479895991,0.000603666478939466,0.0132938815106596,EPCI
200023778,CC du Pays de Saint-Gilles-Croix-de-Vie,1990_1999,1994.5,9,30171,34668,3359,3096,4497,-263,4760,0.0155570901709627,-0.000909832046911986,0.0164669222178747,EPCI
200023778,CC du Pays de Saint-Gilles-Croix-de-Vie,1999_2006,2002.5,7,34668,41390,3206,2787,6722,-419,7141,0.0256406708569863,-0.00159825068269522,0.0272389215396815,EPCI
200023794,CC de Blaye,2006_2011,2008.5,5,19351,20058,1159,1155,707,-4,711,0.00720261070587092,-4.07502727347718e-05,0.00724336097860569,EPCI
200023794,CC de Blaye,2011_2016,2013.5,5,20058,20343,1118,1077,285,-41,326,0.00282574405035407,-0.000406510547594797,0.00323225459794887,EPCI
200023794,CC de Blaye,1968_1975,1971.5,7,17251,16637,1748,1748,-614,0,-614,-0.00516390413050005,0,-0.00516390413050005,EPCI
200023794,CC de Blaye,1975_1982,1978.5,7,16637,18033,1770,1560,1396,-210,1606,0.0115771137268199,-0.00174154289586832,0.0133186566226882,EPCI
200023794,CC de Blaye,1982_1990,1986,8,18033,17812,1878,1786,-221,-92,-129,-0.00154019084500778,-0.000641165419641249,-0.000899025425366534,EPCI
200023794,CC de Blaye,1990_1999,1994.5,9,17812,18565,2068,1839,753,-229,982,0.00461123251384898,-0.00140235357990892,0.00601358609375791,EPCI
200023794,CC de Blaye,1999_2006,2002.5,7,18565,19351,1527,1489,786,-38,824,0.00594129562792922,-0.000287238211019479,0.0062285338389487,EPCI
200023919,CC Gâtinais Val de Loing,2006_2011,2008.5,5,18857,19110,1117,1160,253,43,210,0.00266906773735576,0.000453636018601967,0.00221543171875379,EPCI
200023919,CC Gâtinais Val de Loing,2011_2016,2013.5,5,19110,18857,1105,1071,-253,-34,-219,-0.00266196277838593,-0.000357734128320639,-0.00230422865006529,EPCI
200023919,CC Gâtinais Val de Loing,1968_1975,1971.5,7,14598,14933,1730,1456,335,-274,609,0.00324654379414824,-0.00265538208834811,0.00590192588249635,EPCI
200023919,CC Gâtinais Val de Loing,1975_1982,1978.5,7,14933,14935,1849,1112,2,-737,739,1.91319820057601e-05,-0.00705013536912258,0.00706926735112834,EPCI
200023919,CC Gâtinais Val de Loing,1982_1990,1986,8,14935,16826,2210,1428,1891,-782,2673,0.0150138240782898,-0.00620878393930333,0.0212226080175931,EPCI
200023919,CC Gâtinais Val de Loing,1990_1999,1994.5,9,16826,18217,2104,1935,1391,-169,1560,0.00886460605815143,-0.0010770082126726,0.00994161427082403,EPCI
200023919,CC Gâtinais Val de Loing,1999_2006,2002.5,7,18217,18857,1611,1511,640,-100,740,0.00494489637276607,-0.000772640058244699,0.00571753643101077,EPCI
200026573,CC Haut-Jura Saint-Claude,2006_2011,2008.5,5,23551,22279,956,1475,-1272,519,-1791,-0.0110433201906046,0.00450588300229858,-0.0155492031929032,EPCI
200026573,CC Haut-Jura Saint-Claude,2011_2016,2013.5,5,22279,20975,1104,1141,-1304,37,-1341,-0.0119901935027497,0.000340212545706854,-0.0123304060484565,EPCI
200026573,CC Haut-Jura Saint-Claude,1968_1975,1971.5,7,20809,21696,1770,2274,887,504,383,0.00598100468391127,0.00339845136492816,0.00258255331898311,EPCI
200026573,CC Haut-Jura Saint-Claude,1975_1982,1978.5,7,21696,21792,1821,2224,96,403,-307,0.000630915830736045,0.00264853208111069,-0.00201761625037464,EPCI
200026573,CC Haut-Jura Saint-Claude,1982_1990,1986,8,21792,22918,1890,2436,1126,546,580,0.0063173329598416,0.00306328933931929,0.00325404362052232,EPCI
200026573,CC Haut-Jura Saint-Claude,1990_1999,1994.5,9,22918,23198,1766,2798,280,1032,-752,0.00135018179308055,0.00497638432306832,-0.00362620252998777,EPCI
200026573,CC Haut-Jura Saint-Claude,1999_2006,2002.5,7,23198,23551,1353,2396,353,1043,-690,0.00215978818200102,0.00638147046409933,-0.00422168228209831,EPCI
200027027,CC Arc Sud Bretagne,2006_2011,2008.5,5,23213,25708,1165,1555,2495,390,2105,0.0206278245286387,0.00322438940527819,0.0174034351233605,EPCI
200027027,CC Arc Sud Bretagne,2011_2016,2013.5,5,25708,27221,1271,1459,1513,188,1325,0.0115029573479175,0.00142931657726933,0.0100736407706482,EPCI
200027027,CC Arc Sud Bretagne,1968_1975,1971.5,7,17369,17799,1632,2179,430,547,-117,0.00349971946343564,0.00445196871278905,-0.000952249249353417,EPCI
200027027,CC Arc Sud Bretagne,1975_1982,1978.5,7,17799,18910,1568,2036,1111,468,643,0.00868731858446004,0.00365946453422799,0.00502785405023205,EPCI
200027027,CC Arc Sud Bretagne,1982_1990,1986,8,18910,19547,1799,2087,637,288,349,0.00414995472490065,0.00187627466369135,0.00227368006120931,EPCI
200027027,CC Arc Sud Bretagne,1990_1999,1994.5,9,19547,20377,1899,2012,830,113,717,0.00463124587252151,0.000630519016379434,0.00400072685614207,EPCI
200027027,CC Arc Sud Bretagne,1999_2006,2002.5,7,20377,23213,1584,1900,2836,316,2520,0.0187894342087001,0.00209360409377617,0.0166958301149239,EPCI
200027076,CC Arnon Boischaut Cher,2006_2011,2008.5,5,8243,8351,567,421,108,-146,254,0.00260677912360685,-0.00352397918561667,0.00613075830922352,EPCI
200027076,CC Arnon Boischaut Cher,2011_2016,2013.5,5,8351,8180,512,380,-171,-132,-39,-0.00412927929523887,-0.00318751384193878,-0.000941765453300094,EPCI
200027076,CC Arnon Boischaut Cher,1968_1975,1971.5,7,9097,8959,968,773,-138,-195,57,-0.002181342439186,-0.00308233170754543,0.000900989268359433,EPCI
200027076,CC Arnon Boischaut Cher,1975_1982,1978.5,7,8959,8584,1011,539,-375,-472,97,-0.00608975443266413,-0.00766497091257992,0.00157521647991579,EPCI
200027076,CC Arnon Boischaut Cher,1982_1990,1986,8,8584,8446,1003,597,-138,-406,268,-0.00202383039002751,-0.00595416766921138,0.00393033727918387,EPCI
200027076,CC Arnon Boischaut Cher,1990_1999,1994.5,9,8446,8134,1116,664,-312,-452,140,-0.00417350539940775,-0.00604623218119328,0.00187272678178553,EPCI
200027076,CC Arnon Boischaut Cher,1999_2006,2002.5,7,8134,8243,883,580,109,-303,412,0.00190345897476218,-0.00529126669131139,0.00719472566607358,EPCI
200027100,CC Méditerranée Porte des Maures,2006_2011,2008.5,5,39108,40696,2017,1871,1588,-146,1734,0.00799232101089031,-0.000734810370018883,0.0087271313809092,EPCI
200027100,CC Méditerranée Porte des Maures,2011_2016,2013.5,5,40696,43149,2239,1891,2453,-348,2801,0.0117746689713976,-0.00167043815819256,0.0134451071295901,EPCI
200027100,CC Méditerranée Porte des Maures,1968_1975,1971.5,7,20426,21288,1638,1814,862,176,686,0.00592245947039172,0.00120922606356026,0.00471323340683146,EPCI
200027100,CC Méditerranée Porte des Maures,1975_1982,1978.5,7,21288,25183,1797,1748,3895,-49,3944,0.02429406826629,-0.000305624992310195,0.0245996932586002,EPCI
200027100,CC Méditerranée Porte des Maures,1982_1990,1986,8,25183,29948,2203,2502,4765,299,4466,0.0218979898716101,0.00137408163097826,0.0205239082406318,EPCI
200027100,CC Méditerranée Porte des Maures,1990_1999,1994.5,9,29948,34640,2917,3141,4692,224,4468,0.0163033096282943,0.000778333622493163,0.0155249760058011,EPCI
200027100,CC Méditerranée Porte des Maures,1999_2006,2002.5,7,34640,39108,2722,2598,4468,-124,4592,0.0174821935579557,-0.000485181737060542,0.0179673752950162,EPCI
200027183,CU Perpignan Méditerranée Métropole,2006_2011,2008.5,5,243869,255674,12435,14839,11805,2404,9401,0.00949923393968755,0.00193444797890799,0.00756478596077955,EPCI
200027183,CU Perpignan Méditerranée Métropole,2011_2016,2013.5,5,255674,268581,13407,15158,12907,1751,11156,0.00989853942523045,0.00134286375870291,0.00855567566652753,EPCI
200027183,CU Perpignan Méditerranée Métropole,1968_1975,1971.5,7,153795,166833,13119,16544,13038,3425,9613,0.0116925099335219,0.00307154828365643,0.00862096164986546,EPCI
200027183,CU Perpignan Méditerranée Métropole,1975_1982,1978.5,7,166833,192592,14628,15262,25759,634,25125,0.0207233283013613,0.000510058237628131,0.0202132700637331,EPCI
200027183,CU Perpignan Méditerranée Métropole,1982_1990,1986,8,192592,207203,16994,19403,14611,2409,12202,0.00918253154626902,0.00151397703750339,0.00766855450876563,EPCI
200027183,CU Perpignan Méditerranée Métropole,1990_1999,1994.5,9,207203,221648,20296,21954,14445,1658,12787,0.00751605467648675,0.000862694264701629,0.00665336041178512,EPCI
200027183,CU Perpignan Méditerranée Métropole,1999_2006,2002.5,7,221648,243869,17177,18587,22221,1410,20811,0.0137422336656392,0.00087199268568252,0.0128702409799567,EPCI
200027217,CC Sarlat-Périgord Noir,2006_2011,2008.5,5,16066,16746,894,721,680,-173,853,0.00832530137668042,-0.00211805461494958,0.01044335599163,EPCI
200027217,CC Sarlat-Périgord Noir,2011_2016,2013.5,5,16746,16152,945,667,-594,-278,-316,-0.00719708460138979,-0.00336833252388276,-0.00382875207750703,EPCI
200027217,CC Sarlat-Périgord Noir,1968_1975,1971.5,7,13256,14228,1152,1394,972,242,730,0.0101600627632532,0.00252956295134493,0.00763049981190827,EPCI
200027217,CC Sarlat-Périgord Noir,1975_1982,1978.5,7,14228,14685,1192,1228,457,36,421,0.00452660147163586,0.000356581297546807,0.00417002017408905,EPCI
200027217,CC Sarlat-Périgord Noir,1982_1990,1986,8,14685,15639,1270,1366,954,96,858,0.00789868504083868,0.000794836230524647,0.00710384881031404,EPCI
200027217,CC Sarlat-Périgord Noir,1990_1999,1994.5,9,15639,15863,1519,1446,224,-73,297,0.00158142235070047,-0.000515374248219349,0.00209679659891982,EPCI
200027217,CC Sarlat-Périgord Noir,1999_2006,2002.5,7,15863,16066,1144,1035,203,-109,312,0.00181820583899373,-0.000976278012070522,0.00279448385106425,EPCI
200027308,CC d'Auberive Vingeanne et Montsaugeonnais,2006_2011,2008.5,5,8378,8538,445,439,160,-6,166,0.00379067968346836,-0.000142150488130063,0.00393283017159842,EPCI
200027308,CC d'Auberive Vingeanne et Montsaugeonnais,2011_2016,2013.5,5,8538,8440,428,429,-98,1,-99,-0.0023062324956078,2.35329846490591e-05,-0.00232976548025686,EPCI
200027308,CC d'Auberive Vingeanne et Montsaugeonnais,1968_1975,1971.5,7,9204,8574,887,868,-630,-19,-611,-0.0100779881412736,-0.000303939324895553,-0.00977404881637803,EPCI
200027308,CC d'Auberive Vingeanne et Montsaugeonnais,1975_1982,1978.5,7,8574,8399,824,654,-175,-170,-5,-0.00294162449516622,-0.00285757808101861,-8.40464141476064e-05,EPCI
200027308,CC d'Auberive Vingeanne et Montsaugeonnais,1982_1990,1986,8,8399,8162,849,768,-237,-81,-156,-0.00357153361701612,-0.00122065072986627,-0.00235088288714985,EPCI
200027308,CC d'Auberive Vingeanne et Montsaugeonnais,1990_1999,1994.5,9,8162,8026,834,853,-136,19,-155,-0.00186525437339236,0.000260587008047461,-0.00212584138143982,EPCI
200027308,CC d'Auberive Vingeanne et Montsaugeonnais,1999_2006,2002.5,7,8026,8378,689,649,352,-40,392,0.0061506883747815,-0.000698941860770625,0.00684963023555212,EPCI
200027548,CC des Savanes,2006_2011,2008.5,5,29204,30788,447,4141,1584,3694,-2110,0.0106198581010484,0.0247662599907025,-0.0141464018896541,EPCI
200027548,CC des Savanes,2011_2016,2013.5,5,30788,31437,429,3790,649,3361,-2712,0.00418082325618063,0.0216513820709139,-0.0174705588147332,EPCI
200027548,CC des Savanes,1968_1975,1971.5,7,6333,8150,328,1446,1817,1118,699,0.036691962687101,0.0225765626220027,0.0141154000650983,EPCI
200027548,CC des Savanes,1975_1982,1978.5,7,8150,10128,317,1288,1978,971,1007,0.0315276391836308,0.0154769148874143,0.0160507242962165,EPCI
200027548,CC des Savanes,1982_1990,1986,8,10128,19005,391,2506,8877,2115,6762,0.0818524244054391,0.0195018449495892,0.0623505794558498,EPCI
200027548,CC des Savanes,1990_1999,1994.5,9,19005,23559,641,5480,4554,4839,-285,0.0241544161715053,0.0256660561822385,-0.0015116400107332,EPCI
200027548,CC des Savanes,1999_2006,2002.5,7,23559,29204,531,5547,5645,5016,629,0.0311610456285929,0.027688893688755,0.0034721519398379,EPCI
200029734,CC des 4B Sud Charente,2006_2011,2008.5,5,19283,20022,1085,924,739,-161,900,0.00754991602385324,-0.0016448396208936,0.00919475564474685,EPCI
200029734,CC des 4B Sud Charente,2011_2016,2013.5,5,20022,20071,1203,970,49,-233,282,0.000488983149314448,-0.00232516477122993,0.00281414792054437,EPCI
200029734,CC des 4B Sud Charente,1968_1975,1971.5,7,21591,20599,1865,2158,-992,293,-1285,-0.00669662418475769,0.00197793436102218,-0.00867455854577988,EPCI
200029734,CC des 4B Sud Charente,1975_1982,1978.5,7,20599,20006,1768,1737,-593,-31,-562,-0.00416420588713062,-0.000217690358349156,-0.00394651552878147,EPCI
200029734,CC des 4B Sud Charente,1982_1990,1986,8,20006,19346,1890,1731,-660,-159,-501,-0.00418453891617876,-0.00100809346617034,-0.00317644545000842,EPCI
200029734,CC des 4B Sud Charente,1990_1999,1994.5,9,19346,18988,2043,1668,-358,-375,17,-0.00207323443787033,-0.00217168411788093,9.84496800106021e-05,EPCI
200029734,CC des 4B Sud Charente,1999_2006,2002.5,7,18988,19283,1637,1266,295,-371,666,0.00220480960427261,-0.00277282834978013,0.00497763795405273,EPCI
200029999,CC Rives de l'Ain - Pays du Cerdon,2006_2011,2008.5,5,12696,13542,669,858,846,189,657,0.0129853840362835,0.00290099005065907,0.0100843939856244,EPCI
200029999,CC Rives de l'Ain - Pays du Cerdon,2011_2016,2013.5,5,13542,14449,681,884,907,203,704,0.0130502692683012,0.00292084306666499,0.0101294262016362,EPCI
200029999,CC Rives de l'Ain - Pays du Cerdon,1968_1975,1971.5,7,9293,9280,897,883,-13,-14,1,-0.0001999631157239,-0.000215344893856508,1.53817781326077e-05,EPCI
200029999,CC Rives de l'Ain - Pays du Cerdon,1975_1982,1978.5,7,9280,9404,844,768,124,-76,200,0.00189802524246874,-0.00116330579377116,0.0030613310362399,EPCI
200029999,CC Rives de l'Ain - Pays du Cerdon,1982_1990,1986,8,9404,10319,1024,1015,915,-9,924,0.0116740820472447,-0.000114827036530276,0.011788909083775,EPCI
200029999,CC Rives de l'Ain - Pays du Cerdon,1990_1999,1994.5,9,10319,11200,1211,1232,881,21,860,0.00914454958340882,0.000217974507663547,0.00892657507574528,EPCI
200029999,CC Rives de l'Ain - Pays du Cerdon,1999_2006,2002.5,7,11200,12696,915,1162,1496,247,1249,0.0180718119655092,0.00298378178842298,0.0150880301770862,EPCI
200030195,Métropole Nice Côte d'Azur,2006_2011,2008.5,5,541411,538643,27636,32655,-2768,5019,-7787,-0.00102461090032013,0.00185784758262527,-0.0028824584829454,EPCI
200030195,Métropole Nice Côte d'Azur,2011_2016,2013.5,5,538643,538769,27809,33498,126,5689,-5563,4.67798567984623e-05,0.00211214766132105,-0.00206536780452259,EPCI
200030195,Métropole Nice Côte d'Azur,1968_1975,1971.5,7,414300,461768,39056,33867,47468,-5189,52657,0.0156167220541521,-0.00170715367698229,0.0173238757311344,EPCI
200030195,Métropole Nice Côte d'Azur,1975_1982,1978.5,7,461768,477817,42869,36064,16049,-6805,22854,0.00489267502880231,-0.00207456250052961,0.00696723752933192,EPCI
200030195,Métropole Nice Côte d'Azur,1982_1990,1986,8,477817,508894,50053,46809,31077,-3244,34321,0.0079075923327887,-0.000825440986181631,0.00873303331897034,EPCI
200030195,Métropole Nice Côte d'Azur,1990_1999,1994.5,9,508894,520906,54723,53651,12012,-1072,13084,0.00259556931935179,-0.000231639219975451,0.00282720853932724,EPCI
200030195,Métropole Nice Côte d'Azur,1999_2006,2002.5,7,520906,541411,40702,42413,20505,1711,18794,0.00553082333434274,0.000461508838091218,0.00506931449625152,EPCI
200030385,CA de Blois Agglopolys,2006_2011,2008.5,5,103967,104548,4231,6724,581,2493,-1912,0.00111517234123837,0.00478506823873882,-0.00366989589750045,EPCI
200030385,CA de Blois Agglopolys,2011_2016,2013.5,5,104548,105373,4558,6548,825,1990,-1165,0.00157326432769778,0.00379490425711342,-0.00222163992941565,EPCI
200030385,CA de Blois Agglopolys,1968_1975,1971.5,7,75501,86763,5740,10633,11262,4893,6369,0.0200606147521982,0.00871573326074462,0.0113448814914536,EPCI
200030385,CA de Blois Agglopolys,1975_1982,1978.5,7,86763,90846,5703,9850,4083,4147,-64,0.00659098295007987,0.00669429495321607,-0.000103312003136202,EPCI
200030385,CA de Blois Agglopolys,1982_1990,1986,8,90846,97697,6477,10455,6851,3978,2873,0.00912955838118856,0.00530103389875465,0.00382852448243391,EPCI
200030385,CA de Blois Agglopolys,1990_1999,1994.5,9,97697,101314,7520,11466,3617,3946,-329,0.00404747484990398,0.00441563056613798,-0.000368155716234008,EPCI
200030385,CA de Blois Agglopolys,1999_2006,2002.5,7,101314,103967,6145,8844,2653,2699,-46,0.00369953158352887,0.00376367724988482,-6.41456663559472e-05,EPCI
200030435,CC d'Aire-sur-l'Adour,2006_2011,2008.5,5,12502,12850,639,543,348,-96,444,0.00550613933604116,-0.00151893498925273,0.00702507432529389,EPCI
200030435,CC d'Aire-sur-l'Adour,2011_2016,2013.5,5,12850,12868,736,534,18,-202,220,0.000279998799458392,-0.00314220874947751,0.0034222075489359,EPCI
200030435,CC d'Aire-sur-l'Adour,1968_1975,1971.5,7,11897,11753,1010,1123,-144,113,-257,-0.00173816483072098,0.00136397656855188,-0.00310214139927286,EPCI
200030435,CC d'Aire-sur-l'Adour,1975_1982,1978.5,7,11753,12074,1041,904,321,-137,458,0.00385682608867843,-0.00164605973255123,0.00550288582122967,EPCI
200030435,CC d'Aire-sur-l'Adour,1982_1990,1986,8,12074,12311,1110,1059,237,-51,288,0.00243280338676311,-0.000523514652847757,0.00295631803961086,EPCI
200030435,CC d'Aire-sur-l'Adour,1990_1999,1994.5,9,12311,12192,1223,1007,-119,-216,97,-0.00107865924190442,-0.00195790248950719,0.000879243247602765,EPCI
200030435,CC d'Aire-sur-l'Adour,1999_2006,2002.5,7,12192,12502,944,781,310,-163,473,0.00359338830417877,-0.00188942675348755,0.00548281505766632,EPCI
200030526,CC du Ried de Marckolsheim,2006_2011,2008.5,5,18125,19438,703,1112,1313,409,904,0.0140858258532872,0.00438774011728444,0.00969808573600277,EPCI
200030526,CC du Ried de Marckolsheim,2011_2016,2013.5,5,19438,20134,696,1123,696,427,269,0.007060813870162,0.00433184988873444,0.00272896398142755,EPCI
200030526,CC du Ried de Marckolsheim,1968_1975,1971.5,7,14077,13756,1143,1544,-321,401,-722,-0.00328988603720126,0.0041097953299617,-0.00739968136716296,EPCI
200030526,CC du Ried de Marckolsheim,1975_1982,1978.5,7,13756,14127,1041,1332,371,291,80,0.00380906000823633,0.00298769935956003,0.000821360648676298,EPCI
200030526,CC du Ried de Marckolsheim,1982_1990,1986,8,14127,14492,1104,1426,365,322,43,0.00319370317552803,0.00281745869183569,0.000376244483692343,EPCI
200030526,CC du Ried de Marckolsheim,1990_1999,1994.5,9,14492,15893,1160,1606,1401,446,955,0.0103063020036518,0.00328094981700835,0.00702535218664344,EPCI
200030526,CC du Ried de Marckolsheim,1999_2006,2002.5,7,15893,18125,905,1453,2232,548,1684,0.0189506758207143,0.00465276449361624,0.0142979113270981,EPCI
200030633,CA du Caudrésis et du Catésis,2006_2011,2008.5,5,63486,65381,3377,4464,1895,1087,808,0.00589979307342414,0.0033842084806396,0.00251558459278454,EPCI
200030633,CA du Caudrésis et du Catésis,2011_2016,2013.5,5,65381,64906,3442,4266,-475,824,-1299,-0.00145726256355327,0.00252796705761663,-0.0039852296211699,EPCI
200030633,CA du Caudrésis et du Catésis,1968_1975,1971.5,7,74413,71832,7284,8299,-2581,1015,-3596,-0.00503024836105803,0.00197818755771945,-0.00700843591877748,EPCI
200030633,CA du Caudrésis et du Catésis,1975_1982,1978.5,7,71832,68321,6956,7219,-3511,263,-3774,-0.00713341736582196,0.0005343459889522,-0.00766776335477416,EPCI
200030633,CA du Caudrésis et du Catésis,1982_1990,1986,8,68321,64966,6806,7564,-3355,758,-4113,-0.00627437466772152,0.00141757853893678,-0.0076919532066583,EPCI
200030633,CA du Caudrésis et du Catésis,1990_1999,1994.5,9,64966,63146,6671,7200,-1820,529,-2349,-0.00315219365916386,0.000916214530603122,-0.00406840818976698,EPCI
200030633,CA du Caudrésis et du Catésis,1999_2006,2002.5,7,63146,63486,4771,5863,340,1092,-752,0.000767423406017986,0.00246478340991659,-0.00169736000389861,EPCI
200030658,CC du Trièves,2006_2011,2008.5,5,9001,9646,433,515,645,82,563,0.0139377653331674,0.00177193295708484,0.0121658323760825,EPCI
200030658,CC du Trièves,2011_2016,2013.5,5,9646,10044,470,533,398,63,335,0.00811920736303073,0.00128520116550487,0.00683400619752587,EPCI
200030658,CC du Trièves,1968_1975,1971.5,7,6153,5734,585,479,-419,-106,-313,-0.0100246152410424,-0.00253606018031143,-0.00748855506073093,EPCI
200030658,CC du Trièves,1975_1982,1978.5,7,5734,6121,615,480,387,-135,522,0.00937396501704724,-0.00326998779664438,0.0126439528136916,EPCI
200030658,CC du Trièves,1982_1990,1986,8,6121,6992,634,680,871,46,825,0.0167691951556825,0.000885629135661764,0.0158835660200208,EPCI
200030658,CC du Trièves,1990_1999,1994.5,9,6992,7707,738,788,715,50,665,0.0108767675207486,0.000760613113339064,0.0101161544074096,EPCI
200030658,CC du Trièves,1999_2006,2002.5,7,7707,9001,596,652,1294,56,1238,0.0224200163036719,0.000970263456727685,0.0214497528469442,EPCI
200030674,CA Val de Garonne Agglomération,2006_2011,2008.5,5,56844,59308,3150,3050,2464,-100,2564,0.00852282026650864,-0.000345893679647266,0.0088687139461559,EPCI
200030674,CA Val de Garonne Agglomération,2011_2016,2013.5,5,59308,60229,3386,2923,921,-463,1384,0.00308670604466998,-0.00155173170323801,0.00463843774790799,EPCI
200030674,CA Val de Garonne Agglomération,1968_1975,1971.5,7,51637,52720,4540,5173,1083,633,450,0.00296960347742958,0.00173569621533973,0.00123390726208985,EPCI
200030674,CA Val de Garonne Agglomération,1975_1982,1978.5,7,52720,54063,4490,4687,1343,197,1146,0.00360005655129614,0.000528079777070245,0.00307197677422589,EPCI
200030674,CA Val de Garonne Agglomération,1982_1990,1986,8,54063,55441,4963,4960,1378,-3,1381,0.00315112426596831,-6.86021248033739e-06,0.00315798447844865,EPCI
200030674,CA Val de Garonne Agglomération,1990_1999,1994.5,9,55441,54534,5576,4894,-907,-682,-225,-0.0018311028010739,-0.00137686009959471,-0.000454242701479193,EPCI
200030674,CA Val de Garonne Agglomération,1999_2006,2002.5,7,54534,56844,4385,3976,2310,-409,2719,0.00594421333139938,-0.00105246028248586,0.00699667361388525,EPCI
200032514,CC Berry-Loire-Vauvise,2006_2011,2008.5,5,5850,5868,449,313,18,-136,154,0.000614628614200585,-0.00464386064062664,0.00525848925482723,EPCI
200032514,CC Berry-Loire-Vauvise,2011_2016,2013.5,5,5868,5647,412,257,-221,-155,-66,-0.00764848624249093,-0.00536432293025382,-0.00228416331223711,EPCI
200032514,CC Berry-Loire-Vauvise,1968_1975,1971.5,7,6641,6131,772,464,-510,-308,-202,-0.0113500517022889,-0.00685454102804896,-0.0044955106742399,EPCI
200032514,CC Berry-Loire-Vauvise,1975_1982,1978.5,7,6131,5771,704,327,-360,-377,17,-0.00860738438453457,-0.00901384420269314,0.000406459818158577,EPCI
200032514,CC Berry-Loire-Vauvise,1982_1990,1986,8,5771,5619,791,397,-152,-394,242,-0.00333089815907539,-0.00863403864918226,0.00530314049010687,EPCI
200032514,CC Berry-Loire-Vauvise,1990_1999,1994.5,9,5619,5635,832,388,16,-444,460,0.000315987175842025,-0.0087686441296162,0.00908463130545822,EPCI
200032514,CC Berry-Loire-Vauvise,1999_2006,2002.5,7,5635,5850,627,354,215,-273,488,0.00536354885220169,-0.00681045970535378,0.0121740085575555,EPCI
200033025,CA de Bar-le-Duc - Sud Meuse,2006_2011,2008.5,5,37204,36385,1898,1809,-819,-89,-730,-0.00444204093832212,-0.000482712629439156,-0.00395932830888297,EPCI
200033025,CA de Bar-le-Duc - Sud Meuse,2011_2016,2013.5,5,36385,35222,2016,1622,-1163,-394,-769,-0.0064760820887485,-0.00219396074201798,-0.00428212134673052,EPCI
200033025,CA de Bar-le-Duc - Sud Meuse,1968_1975,1971.5,7,40847,41393,2843,5568.20285369969,546,2725.20285369969,-2179.20285369969,0.00189871531188457,0.00947689448042329,-0.00757817916853872,EPCI
200033025,CA de Bar-le-Duc - Sud Meuse,1975_1982,1978.5,7,41393,41587,2849,4507.45362452668,194,1658.45362452668,-1464.45362452668,0.000668199434307404,0.00571225656563811,-0.00504405713133071,EPCI
200033025,CA de Bar-le-Duc - Sud Meuse,1982_1990,1986,8,41587,40726,3024,4683.65375528876,-861,1659.65375528876,-2520.65375528876,-0.00261169723160759,0.00503427772138769,-0.00764597495299528,EPCI
200033025,CA de Bar-le-Duc - Sud Meuse,1990_1999,1994.5,9,40726,39144,3423,4334,-1582,911,-2493,-0.00439249743359038,0.00252943436283239,-0.00692193179642277,EPCI
200033025,CA de Bar-le-Duc - Sud Meuse,1999_2006,2002.5,7,39144,37204,2775,2908,-1940,133,-2073,-0.00723525171149186,0.000496024988468257,-0.00773127669996012,EPCI
200033090,CC Plaines et Monts de France,2006_2011,2008.5,5,21690,23237,532,1535,1547,1003,544,0.013874268791755,0.0089954050408082,0.00487886375094682,EPCI
200033090,CC Plaines et Monts de France,2011_2016,2013.5,5,23237,24372,565,1549,1135,984,151,0.0095834492561877,0.00830847054457154,0.00127497871161616,EPCI
200033090,CC Plaines et Monts de France,1968_1975,1971.5,7,7061,9266,580,739,2205,159,2046,0.0395870698272722,0.00285457782427949,0.0367324920029927,EPCI
200033090,CC Plaines et Monts de France,1975_1982,1978.5,7,9266,11940,655,947,2674,292,2382,0.036884279662764,0.00402775230423601,0.032856527358528,EPCI
200033090,CC Plaines et Monts de France,1982_1990,1986,8,11940,16347,781,1514,4407,733,3674,0.0400499967419152,0.00666136773583478,0.0333886290060805,EPCI
200033090,CC Plaines et Monts de France,1990_1999,1994.5,9,16347,18559,866,1909,2212,1043,1169,0.0142010517167117,0.00669606552465204,0.00750498619205967,EPCI
200033090,CC Plaines et Monts de France,1999_2006,2002.5,7,18559,21690,678,1972,3131,1294,1837,0.022520773861326,0.00930753157986453,0.0132132422814615,EPCI
200033116,CC Cluses-Arve et Montagnes,2006_2011,2008.5,5,42587,43895,1348,3342,1308,1994,-686,0.00606861508228929,0.00925139027070706,-0.00318277518841778,EPCI
200033116,CC Cluses-Arve et Montagnes,2011_2016,2013.5,5,43895,45873,1443,3249,1978,1806,172,0.00885422687308934,0.00808429410151636,0.000769932771572987,EPCI
200033116,CC Cluses-Arve et Montagnes,1968_1975,1971.5,7,25560,29663,1291,3689,4103,2398,1705,0.0214951699919339,0.012562860745956,0.0089323092459779,EPCI
200033116,CC Cluses-Arve et Montagnes,1975_1982,1978.5,7,29663,32572,1505,3894,2909,2389,520,0.0134543554949174,0.0110493142926633,0.00240504120225405,EPCI
200033116,CC Cluses-Arve et Montagnes,1982_1990,1986,8,32572,36467,1637,4709,3895,3072,823,0.0142194884726281,0.0112149598428533,0.00300452862977482,EPCI
200033116,CC Cluses-Arve et Montagnes,1990_1999,1994.5,9,36467,40139,1946,5289,3672,3343,329,0.0107170975187105,0.00975687826934894,0.00096021924936159,EPCI
200033116,CC Cluses-Arve et Montagnes,1999_2006,2002.5,7,40139,42587,1678,4227,2448,2549,-101,0.00849309370707285,0.00884350321051009,-0.000350409503437238,EPCI
200033173,CC de la Haute Vallée de Chevreuse,2006_2011,2008.5,5,25283,25330,1187,1125,47,-62,109,0.000371515172610692,-0.000490083844720488,0.00086159901733118,EPCI
200033173,CC de la Haute Vallée de Chevreuse,2011_2016,2013.5,5,25330,25177,1217,1002,-153,-215,62,-0.00121098310180578,-0.00170170828031532,0.000490725178509534,EPCI
200033173,CC de la Haute Vallée de Chevreuse,1968_1975,1971.5,7,13656,17989,1098,1573,4333,475,3858,0.0401540030744041,0.00440183509354764,0.0357521679808564,EPCI
200033173,CC de la Haute Vallée de Chevreuse,1975_1982,1978.5,7,17989,21014,1109,1601,3025,492,2533,0.0224524051558166,0.00365176308649976,0.0188006420693168,EPCI
200033173,CC de la Haute Vallée de Chevreuse,1982_1990,1986,8,21014,21918,1301,1712,904,411,493,0.0052788008769229,0.00239998579691959,0.00287881508000331,EPCI
200033173,CC de la Haute Vallée de Chevreuse,1990_1999,1994.5,9,21918,24542,1742,2196,2624,454,2170,0.012643451995441,0.00218754847786975,0.0104559035175713,EPCI
200033173,CC de la Haute Vallée de Chevreuse,1999_2006,2002.5,7,24542,25283,1685,1742,741,57,684,0.00425851288669255,0.000327577914360965,0.00393093497233158,EPCI
200033181,CA Chartres Métropole,2006_2011,2008.5,5,131661,134575,4979,8819,2914,3840,-926,0.00438784394257485,0.00578219654752486,-0.00139435260495,EPCI
200033181,CA Chartres Métropole,2011_2016,2013.5,5,134575,136375,5330,8597,1800,3267,-1467,0.00266088984112534,0.00482951506164248,-0.00216862522051715,EPCI
200033181,CA Chartres Métropole,1968_1975,1971.5,7,84756,100596,6202,12715,15840,6513,9327,0.0247785751733995,0.0101883118752747,0.0145902632981248,EPCI
200033181,CA Chartres Métropole,1975_1982,1978.5,7,100596,111367,6619,12293,10771,5674,5097,0.0146373140953617,0.00771071582741458,0.00692659826794715,EPCI
200033181,CA Chartres Métropole,1982_1990,1986,8,111367,125156,7440,15189,13789,7749,6040,0.0146982099399411,0.00825994842444002,0.00643826151550106,EPCI
200033181,CA Chartres Métropole,1990_1999,1994.5,9,125156,129883,8629,16056,4727,7427,-2700,0.00412772747589085,0.00648543092097342,-0.00235770344508257,EPCI
200033181,CA Chartres Métropole,1999_2006,2002.5,7,129883,131661,6984,12527,1778,5543,-3765,0.00194422929899618,0.0060612277864656,-0.00411699848746942,EPCI
200033207,CC Vierzon-Sologne-Berry,2006_2011,2008.5,5,35826,34433,2339,1933,-1393,-406,-987,-0.0079003230858431,-0.00230260672853718,-0.00559771635730591,EPCI
200033207,CC Vierzon-Sologne-Berry,2011_2016,2013.5,5,34433,33929,2440,1898,-504,-542,38,-0.00294471598348212,-0.00316673822033196,0.000222022236849842,EPCI
200033207,CC Vierzon-Sologne-Berry,1968_1975,1971.5,7,40801,42996,3801,4468,2195,667,1528,0.00751387384926439,0.00228325916057373,0.00523061468869065,EPCI
200033207,CC Vierzon-Sologne-Berry,1975_1982,1978.5,7,42996,41909,3619,3755,-1087,136,-1223,-0.00365138700185419,0.000456843267941279,-0.00410823026979547,EPCI
200033207,CC Vierzon-Sologne-Berry,1982_1990,1986,8,41909,40050,3748,3840,-1859,92,-1951,-0.00565543839242577,0.000279881835450872,-0.00593532022787664,EPCI
200033207,CC Vierzon-Sologne-Berry,1990_1999,1994.5,9,40050,37336,4322,3604,-2714,-718,-1996,-0.00776642479838829,-0.00205464001667015,-0.00571178478171814,EPCI
200033207,CC Vierzon-Sologne-Berry,1999_2006,2002.5,7,37336,35826,3360,2689,-1510,-671,-839,-0.00588037421396714,-0.00261306695203441,-0.00326730726193274,EPCI
200033298,CC des Coëvrons,2006_2011,2008.5,5,26720,27496,1400,1685,776,285,491,0.00574206097077745,0.00210887548540151,0.00363318548537594,EPCI
200033298,CC des Coëvrons,2011_2016,2013.5,5,27496,27555,1534,1448,59,-86,145,0.000428785459748449,-0.000625009314209603,0.00105379477395805,EPCI
200033298,CC des Coëvrons,1968_1975,1971.5,7,24745,24353,1927,2723,-392,796,-1188,-0.00227860049373463,0.00462695406380807,-0.0069055545575427,EPCI
200033298,CC des Coëvrons,1975_1982,1978.5,7,24353,25011,1935,2445,658,510,148,0.00381593117818468,0.00295763662746837,0.000858294550716312,EPCI
200033298,CC des Coëvrons,1982_1990,1986,8,25011,25187,2300,2497,176,197,-21,0.000876916803991934,0.000981548922650063,-0.000104632118658129,EPCI
200033298,CC des Coëvrons,1990_1999,1994.5,9,25187,25931,2411,2641,744,230,514,0.00323981196972745,0.00100155477558779,0.00223825719413966,EPCI
200033298,CC des Coëvrons,1999_2006,2002.5,7,25931,26720,1948,2331,789,383,406,0.00429106386058065,0.00208298790697387,0.00220807595360677,EPCI
200033579,CU d'Arras,2006_2011,2008.5,5,105023,106415,4510,6923,1392,2413,-1021,0.00263690465857525,0.00457101360714229,-0.00193410894856704,EPCI
200033579,CU d'Arras,2011_2016,2013.5,5,106415,107608,4783,6641,1193,1858,-665,0.0022321776055676,0.00347643419207426,-0.00124425658650667,EPCI
200033579,CU d'Arras,1968_1975,1971.5,7,89167,98056,6327,13295,8889,6968,1921,0.013667953715752,0.0107141749905906,0.0029537787251614,EPCI
200033579,CU d'Arras,1975_1982,1978.5,7,98056,99989,6235,11870,1933,5635,-3702,0.00279266881167994,0.00814107022959984,-0.00534840141791989,EPCI
200033579,CU d'Arras,1982_1990,1986,8,99989,101467,6910,12951,1478,6041,-4563,0.00183586345355447,0.00750368817518439,-0.00566782472162992,EPCI
200033579,CU d'Arras,1990_1999,1994.5,9,101467,103002,7535,12189,1535,4654,-3119,0.00166970163001867,0.00506240481179603,-0.00339270318177735,EPCI
200033579,CU d'Arras,1999_2006,2002.5,7,103002,105023,6152,9399,2021,3247,-1226,0.00277970885648338,0.00446596469915959,-0.00168625584267621,EPCI
200033827,CC de Fium'orbu Castellu,2006_2011,2008.5,5,11327,12303,587,557,976,-30,1006,0.0166681650521294,-0.000512341138897421,0.0171805061910268,EPCI
200033827,CC de Fium'orbu Castellu,2011_2016,2013.5,5,12303,12924,615,637,621,22,599,0.00989723946885479,0.000350626841086643,0.00954661262776815,EPCI
200033827,CC de Fium'orbu Castellu,1968_1975,1971.5,7,8561,8808,664,765,247,101,146,0.00407160851817689,0.00166490874629905,0.00240669977187784,EPCI
200033827,CC de Fium'orbu Castellu,1975_1982,1978.5,7,8808,10160,714,778,1352,64,1288,0.0206092168171677,0.000975584228031605,0.019633632589136,EPCI
200033827,CC de Fium'orbu Castellu,1982_1990,1986,8,10160,10494,890,917,334,27,307,0.00405133745868702,0.000327503327498651,0.00372383413118837,EPCI
200033827,CC de Fium'orbu Castellu,1990_1999,1994.5,9,10494,10556,998,949,62,-49,111,0.000654742403244146,-0.000517457705789729,0.00117220010903388,EPCI
200033827,CC de Fium'orbu Castellu,1999_2006,2002.5,7,10556,11327,783,749,771,-34,805,0.0101215711476439,-0.000446346846977811,0.0105679179946217,EPCI
200033868,CC des Ballons des Hautes-Vosges,2006_2011,2008.5,5,16407,15851,903,766,-556,-137,-419,-0.00687138000534715,-0.00169312780707295,-0.0051782521982742,EPCI
200033868,CC des Ballons des Hautes-Vosges,2011_2016,2013.5,5,15851,15306,1026,674,-545,-352,-193,-0.00697311053513672,-0.00450373377682225,-0.00246937675831447,EPCI
200033868,CC des Ballons des Hautes-Vosges,1968_1975,1971.5,7,18169,19014,1525,2333,845,808,37,0.00651523308047763,0.00622995068523778,0.000285282395239849,EPCI
200033868,CC des Ballons des Hautes-Vosges,1975_1982,1978.5,7,19014,18562,1478,1903,-452,425,-877,-0.00343111020859077,0.00322615451028999,-0.00665726471888077,EPCI
200033868,CC des Ballons des Hautes-Vosges,1982_1990,1986,8,18562,17345,1730,1819,-1217,89,-1306,-0.00844070052488699,0.000617273908557882,-0.00905797443344487,EPCI
200033868,CC des Ballons des Hautes-Vosges,1990_1999,1994.5,9,17345,16867,1780,1860,-478,80,-558,-0.00310020996534199,0.000518863592525857,-0.00361907355786785,EPCI
200033868,CC des Ballons des Hautes-Vosges,1999_2006,2002.5,7,16867,16407,1459,1201,-460,-258,-202,-0.00394234806730598,-0.00221114304644553,-0.00173120502086045,EPCI
200034023,CC Tarn-Agout,2006_2011,2008.5,5,24300,26487,1016,1774,2187,758,1429,0.0173849281869665,0.00602550323078216,0.0113594249561843,EPCI
200034023,CC Tarn-Agout,2011_2016,2013.5,5,26487,28406,1073,1621,1919,548,1371,0.0140875764774144,0.00402292439271658,0.0100646520846979,EPCI
200034023,CC Tarn-Agout,1968_1975,1971.5,7,14682,15459,1532,1425,777,-107,884,0.00739421811908692,-0.00101825140121274,0.00841246952029966,EPCI
200034023,CC Tarn-Agout,1975_1982,1978.5,7,15459,16431,1496,1301,972,-195,1167,0.0087492581714812,-0.0017552524109453,0.0105045105824265,EPCI
200034023,CC Tarn-Agout,1982_1990,1986,8,16431,17601,1649,1504,1170,-145,1315,0.00863531156017472,-0.00107018818480798,0.0097054997449827,EPCI
200034023,CC Tarn-Agout,1990_1999,1994.5,9,17601,19104,1861,1801,1503,-60,1563,0.00914624230493399,-0.000365119453290778,0.00951136175822477,EPCI
200034023,CC Tarn-Agout,1999_2006,2002.5,7,19104,24300,1389,1861,5196,472,4724,0.034965790283807,0.00317626116511872,0.0317895291186883,EPCI
200034031,CC des Monts d'Alban et du Villefranchois,2006_2011,2008.5,5,6103,6243,307,309,140,2,138,0.00454638007183972,6.49482867405674e-05,0.00448143178509915,EPCI
200034031,CC des Monts d'Alban et du Villefranchois,2011_2016,2013.5,5,6243,6356,293,278,113,-15,128,0.00359412595526454,-0.00047709636574308,0.00407122232100762,EPCI
200034031,CC des Monts d'Alban et du Villefranchois,1968_1975,1971.5,7,7513,6710,673,494,-803,-179,-624,-0.0160183062914189,-0.00357070588563385,-0.012447600405785,EPCI
200034031,CC des Monts d'Alban et du Villefranchois,1975_1982,1978.5,7,6710,6434,625,430,-276,-195,-81,-0.00598239410015211,-0.00422669148380312,-0.00175570261634899,EPCI
200034031,CC des Monts d'Alban et du Villefranchois,1982_1990,1986,8,6434,6114,644,412,-320,-232,-88,-0.00635661138794008,-0.00460854325625656,-0.00174806813168352,EPCI
200034031,CC des Monts d'Alban et du Villefranchois,1990_1999,1994.5,9,6114,5765,674,446,-349,-228,-121,-0.00650939590843624,-0.00425255663932225,-0.002256839269114,EPCI
200034031,CC des Monts d'Alban et du Villefranchois,1999_2006,2002.5,7,5765,6103,493,341,338,-152,490,0.00817254293649028,-0.00367522640930924,0.0118477693457995,EPCI
200034049,CC Centre Tarn,2006_2011,2008.5,5,10044,10578,523,581,534,58,476,0.0104140388129161,0.0011311128298673,0.00928292598304884,EPCI
200034049,CC Centre Tarn,2011_2016,2013.5,5,10578,10995,539,627,417,88,329,0.00776282597531397,0.00163819828735643,0.00612462768795754,EPCI
200034049,CC Centre Tarn,1968_1975,1971.5,7,9251,8766,824,795,-485,-29,-456,-0.00766349195352811,-0.00045822941577797,-0.00720526253775014,EPCI
200034049,CC Centre Tarn,1975_1982,1978.5,7,8766,8955,727,639,189,-88,277,0.00305199552902646,-0.00142103495531391,0.00447303048434037,EPCI
200034049,CC Centre Tarn,1982_1990,1986,8,8955,8940,826,750,-15,-76,61,-0.000209533835625386,-0.00106163810050196,0.000852104264876571,EPCI
200034049,CC Centre Tarn,1990_1999,1994.5,9,8940,9233,936,864,293,-72,365,0.00358958647895391,-0.00088208268424806,0.00447166916320197,EPCI
200034049,CC Centre Tarn,1999_2006,2002.5,7,9233,10044,675,753,811,78,733,0.0120999648679592,0.00116374507977906,0.0109362197881801,EPCI
200034056,CC du Lautrécois et du Pays d'Agout,2006_2011,2008.5,5,12974,14087,647,743,1113,96,1017,0.0165972351229848,0.00143156744996096,0.0151656676730239,EPCI
200034056,CC du Lautrécois et du Pays d'Agout,2011_2016,2013.5,5,14087,14536,658,712,449,54,395,0.00629491921015379,0.000757072688971726,0.00553784652118207,EPCI
200034056,CC du Lautrécois et du Pays d'Agout,1968_1975,1971.5,7,11066,10223,1080,834,-843,-246,-597,-0.0112557829557151,-0.00328460570237948,-0.00797117725333557,EPCI
200034056,CC du Lautrécois et du Pays d'Agout,1975_1982,1978.5,7,10223,10479,991,772,256,-219,475,0.00353955960100572,-0.00302798262742286,0.00656754222842857,EPCI
200034056,CC du Lautrécois et du Pays d'Agout,1982_1990,1986,8,10479,11077,1043,891,598,-152,750,0.00696132214351319,-0.00176943305320068,0.00873075519671387,EPCI
200034056,CC du Lautrécois et du Pays d'Agout,1990_1999,1994.5,9,11077,11508,1026,999,431,-27,458,0.0042502913261846,-0.000266259549436158,0.00451655087562075,EPCI
200034056,CC du Lautrécois et du Pays d'Agout,1999_2006,2002.5,7,11508,12974,897,968,1466,71,1395,0.0172768199759854,0.000836735483147997,0.0164400844928374,EPCI
200034064,CC du Cordais et du Causse (4 C),2006_2011,2008.5,5,4677,4778,284,196,101,-88,189,0.00428217645922224,-0.0037310052317976,0.00801318169101984,EPCI
200034064,CC du Cordais et du Causse (4 C),2011_2016,2013.5,5,4778,4610,281,157,-168,-124,-44,-0.00713327493344307,-0.00526503626039846,-0.00186823867304461,EPCI
200034064,CC du Cordais et du Causse (4 C),1968_1975,1971.5,7,5260,4827,550,319,-433,-231,-202,-0.0121972699910679,-0.00650708860955352,-0.00569018138151433,EPCI
200034064,CC du Cordais et du Causse (4 C),1975_1982,1978.5,7,4827,4679,521,228,-148,-293,145,-0.00443879711800788,-0.00878761861875884,0.00434882150075096,EPCI
200034064,CC du Cordais et du Causse (4 C),1982_1990,1986,8,4679,4494,558,276,-185,-282,97,-0.00502996192574245,-0.00766729331383444,0.00263733138809199,EPCI
200034064,CC du Cordais et du Causse (4 C),1990_1999,1994.5,9,4494,4492,571,319,-2,-252,250,-4.94584309960189e-05,-0.00623176230549838,0.00618230387450236,EPCI
200034064,CC du Cordais et du Causse (4 C),1999_2006,2002.5,7,4492,4677,423,276,185,-147,332,0.00578220160365284,-0.00459450613911874,0.0103767077427716,EPCI
200034098,CC des Montagnes du Giffre,2006_2011,2008.5,5,11225,11521,432,641,296,209,87,0.00521917738674294,0.00368516241158538,0.00153401497515755,EPCI
200034098,CC des Montagnes du Giffre,2011_2016,2013.5,5,11521,12079,488,661,558,173,385,0.00950427154948263,0.00294666483523386,0.00655760671424877,EPCI
200034098,CC des Montagnes du Giffre,1968_1975,1971.5,7,6817,7419,566,664,602,98,504,0.0121626253846023,0.00197996227191201,0.0101826631126903,EPCI
200034098,CC des Montagnes du Giffre,1975_1982,1978.5,7,7419,8175,607,692,756,85,671,0.0139588763825653,0.00156945038692864,0.0123894259956367,EPCI
200034098,CC des Montagnes du Giffre,1982_1990,1986,8,8175,9114,711,937,939,226,713,0.0136841545747579,0.00329352389126229,0.0103906306834956,EPCI
200034098,CC des Montagnes du Giffre,1990_1999,1994.5,9,9114,10418,687,1183,1304,496,808,0.0149690851539355,0.00569376245119018,0.00927532270274529,EPCI
200034098,CC des Montagnes du Giffre,1999_2006,2002.5,7,10418,11225,604,986,807,382,425,0.0107153387329133,0.00507219256006553,0.00564314617284777,EPCI
200034130,CC Gally Mauldre,2006_2011,2008.5,5,22183,22113,584,968,-70,384,-454,-0.000631912037205695,0.0034664888898141,-0.0040984009270198,EPCI
200034130,CC Gally Mauldre,2011_2016,2013.5,5,22113,21844,518,831,-269,313,-582,-0.00244488370855145,0.00284479033745949,-0.00528967404601094,EPCI
200034130,CC Gally Mauldre,1968_1975,1971.5,7,8692,14134,622,1252,5442,630,4812,0.0719230854322865,0.00832626678102545,0.0635968186512611,EPCI
200034130,CC Gally Mauldre,1975_1982,1978.5,7,14134,18096,703,1402,3962,699,3263,0.0359315774557019,0.00633926618918112,0.0295923112665207,EPCI
200034130,CC Gally Mauldre,1982_1990,1986,8,18096,21347,864,1694,3251,830,2421,0.0208672762975808,0.00532754208766289,0.0155397342099179,EPCI
200034130,CC Gally Mauldre,1990_1999,1994.5,9,21347,21631,1022,1924,284,902,-618,0.0014695516679446,0.00466737888903532,-0.00319782722109072,EPCI
200034130,CC Gally Mauldre,1999_2006,2002.5,7,21631,22183,822,1521,552,699,-147,0.00360630982677601,0.00456668581325441,-0.000960375986478394,EPCI
200034197,CC de Montaigne Montravel et Gurson,2006_2011,2008.5,5,11609,11826,599,528,217,-71,288,0.00371083577377296,-0.00121414442367687,0.00492498019744982,EPCI
200034197,CC de Montaigne Montravel et Gurson,2011_2016,2013.5,5,11826,12033,581,553,207,-28,235,0.00347650468452843,-0.000470251841385487,0.00394675652591391,EPCI
200034197,CC de Montaigne Montravel et Gurson,1968_1975,1971.5,7,10032,9513,850,794,-519,-56,-463,-0.00755995011223953,-0.000815717160472859,-0.00674423295176667,EPCI
200034197,CC de Montaigne Montravel et Gurson,1975_1982,1978.5,7,9513,9605,888,672,92,-216,308,0.00137587593516719,-0.00323031741300123,0.00460619334816843,EPCI
200034197,CC de Montaigne Montravel et Gurson,1982_1990,1986,8,9605,10098,894,769,493,-125,618,0.00627631255026095,-0.0015913571374901,0.00786766968775106,EPCI
200034197,CC de Montaigne Montravel et Gurson,1990_1999,1994.5,9,10098,10617,1075,891,519,-184,703,0.0055843240416209,-0.00197979888951493,0.00756412293113583,EPCI
200034197,CC de Montaigne Montravel et Gurson,1999_2006,2002.5,7,10617,11609,864,830,992,-34,1026,0.0128423594328912,-0.000440161512820869,0.0132825209457121,EPCI
200034205,CC de la Costa Verde,2006_2011,2008.5,5,8646,9241,433,365,595,-68,663,0.0133996449780929,-0.00153138799749633,0.0149310329755892,EPCI
200034205,CC de la Costa Verde,2011_2016,2013.5,5,9241,10212,529,479,971,-50,1021,0.020183669164924,-0.0010393238498931,0.0212229930148171,EPCI
200034205,CC de la Costa Verde,1968_1975,1971.5,7,5937,5740,423,539,-197,116,-313,-0.00480907703229361,0.00283174079058913,-0.00764081782288274,EPCI
200034205,CC de la Costa Verde,1975_1982,1978.5,7,5740,5896,485,481,156,-4,160,0.00383805289851669,-9.84116127824791e-05,0.00393646451129917,EPCI
200034205,CC de la Costa Verde,1982_1990,1986,8,5896,6911,627,642,1015,15,1000,0.0200534458114039,0.000296356342040452,0.0197570894693634,EPCI
200034205,CC de la Costa Verde,1990_1999,1994.5,9,6911,7739,675,660,828,-15,843,0.0126525001925495,-0.000229211960009954,0.0128817121525594,EPCI
200034205,CC de la Costa Verde,1999_2006,2002.5,7,7739,8646,480,456,907,-24,931,0.0159580345314068,-0.000422263317258834,0.0163802978486656,EPCI
200034270,CC du Pays de Barr,2006_2011,2008.5,5,22448,23313,1070,1363,865,293,572,0.00759058786162559,0.00257114710226161,0.00501944075936397,EPCI
200034270,CC du Pays de Barr,2011_2016,2013.5,5,23313,24063,1050,1294,750,244,506,0.00635294411813114,0.002066824486432,0.00428611963169914,EPCI
200034270,CC du Pays de Barr,1968_1975,1971.5,7,17770,18450,1740,1785,680,45,635,0.00537909111263324,0.000355969264806611,0.00502312184782663,EPCI
200034270,CC du Pays de Barr,1975_1982,1978.5,7,18450,18393,1735,1492,-57,-243,186,-0.000441932752923147,-0.0018840291045671,0.00144209635164395,EPCI
200034270,CC du Pays de Barr,1982_1990,1986,8,18393,18766,1914,1820,373,-94,467,0.00251272216042109,-0.000633232930508264,0.00314595509092935,EPCI
200034270,CC du Pays de Barr,1990_1999,1994.5,9,18766,20713,1910,2293,1947,383,1564,0.0110286836294899,0.00216948424760896,0.00885919938188098,EPCI
200034270,CC du Pays de Barr,1999_2006,2002.5,7,20713,22448,1492,1847,1735,355,1380,0.0115577088059318,0.0023648337902627,0.00919287501566907,EPCI
200034379,CC Pays d'Uzès,2006_2011,2008.5,5,25427,27952,1299,1349,2525,50,2475,0.0191158425533478,0.000378531535709856,0.0187373110176379,EPCI
200034379,CC Pays d'Uzès,2011_2016,2013.5,5,27952,28213,1438,1248,261,-190,451,0.00186055092812731,-0.00135442404729575,0.00321497497542306,EPCI
200034379,CC Pays d'Uzès,1968_1975,1971.5,7,14989,15868,1301,1455,879,154,725,0.00817435823377166,0.00143214012286785,0.00674221811090382,EPCI
200034379,CC Pays d'Uzès,1975_1982,1978.5,7,15868,17926,1444,1364,2058,-80,2138,0.0175737280960071,-0.000683138118406496,0.0182568662144136,EPCI
200034379,CC Pays d'Uzès,1982_1990,1986,8,17926,20723,1777,1923,2797,146,2651,0.0182892391787763,0.00095467605295007,0.0173345631258263,EPCI
200034379,CC Pays d'Uzès,1990_1999,1994.5,9,20723,23140,1984,2066,2417,82,2335,0.0123330465787836,0.000418415316284758,0.0119146312624989,EPCI
200034379,CC Pays d'Uzès,1999_2006,2002.5,7,23140,25427,1759,1701,2287,-58,2345,0.0135551752023761,-0.000343769200584966,0.0138989444029611,EPCI
200034411,CC du Piémont Cévenol,2006_2011,2008.5,5,18715,20507,957,985,1792,28,1764,0.0184564430461514,0.000288381922596115,0.0181680611235552,EPCI
200034411,CC du Piémont Cévenol,2011_2016,2013.5,5,20507,21558,1141,1010,1051,-131,1182,0.0100462654872515,-0.00125219864779253,0.011298464135044,EPCI
200034411,CC du Piémont Cévenol,1968_1975,1971.5,7,13473,13155,1308,1044,-318,-264,-54,-0.00340643749379099,-0.00282798584390196,-0.000578451649889037,EPCI
200034411,CC du Piémont Cévenol,1975_1982,1978.5,7,13155,13589,1296,1009,434,-287,721,0.00464772840382843,-0.00307349781543493,0.00772122621926336,EPCI
200034411,CC du Piémont Cévenol,1982_1990,1986,8,13589,15002,1545,1204,1413,-341,1754,0.0124421276122311,-0.00300266490854267,0.0154447925207737,EPCI
200034411,CC du Piémont Cévenol,1990_1999,1994.5,9,15002,16209,1692,1453,1207,-239,1446,0.00863519425843751,-0.00170986862283891,0.0103450628812764,EPCI
200034411,CC du Piémont Cévenol,1999_2006,2002.5,7,16209,18715,1370,1246,2506,-124,2630,0.020749291206541,-0.0010267007620156,0.0217759919685566,EPCI
200034601,CC Causses Aigoual Cévennes,2006_2011,2008.5,5,5442,5628,374,208,186,-166,352,0.00674413975429156,-0.0060189634366258,0.0127631031909174,EPCI
200034601,CC Causses Aigoual Cévennes,2011_2016,2013.5,5,5628,5559,390,203,-69,-187,118,-0.00246413966737058,-0.00667817562026519,0.00421403595289461,EPCI
200034601,CC Causses Aigoual Cévennes,1968_1975,1971.5,7,5768,5173,622,372,-595,-250,-345,-0.0154329030036096,-0.0064844130267267,-0.00894848997688285,EPCI
200034601,CC Causses Aigoual Cévennes,1975_1982,1978.5,7,5173,5084,637,313,-89,-324,235,-0.0024761346933605,-0.00901424315335732,0.00653810845999682,EPCI
200034601,CC Causses Aigoual Cévennes,1982_1990,1986,8,5084,5113,637,444,29,-193,222,0.000711248163436817,-0.00473347915666572,0.00544472732010253,EPCI
200034601,CC Causses Aigoual Cévennes,1990_1999,1994.5,9,5113,5074,722,416,-39,-306,267,-0.000850399862772022,-0.00667236815405741,0.00582196829128538,EPCI
200034601,CC Causses Aigoual Cévennes,1999_2006,2002.5,7,5074,5442,522,312,368,-210,578,0.0100526459211574,-0.00573656424848656,0.015789210169644,EPCI
200034635,CC du Kochersberg,2006_2011,2008.5,5,22764,24217,649,1144,1453,495,958,0.0124517909895465,0.00424200725383725,0.00820978373570927,EPCI
200034635,CC du Kochersberg,2011_2016,2013.5,5,24217,24985,770,1164,768,394,374,0.00626369116377146,0.00321340406058067,0.00305028710319079,EPCI
200034635,CC du Kochersberg,1968_1975,1971.5,7,10460,13157,931,1168,2697,237,2460,0.0333136585566676,0.00292745164179837,0.0303862069148692,EPCI
200034635,CC du Kochersberg,1975_1982,1978.5,7,13157,15908,885,1055,2751,170,2581,0.0274952323000877,0.00169908741948924,0.0257961448805984,EPCI
200034635,CC du Kochersberg,1982_1990,1986,8,15908,17558,1027,1389,1650,362,1288,0.0124123465018278,0.00272319359615858,0.00968915290566919,EPCI
200034635,CC du Kochersberg,1990_1999,1994.5,9,17558,20480,1109,1750,2922,641,2281,0.017251462871015,0.00378445848744716,0.0134670043835678,EPCI
200034635,CC du Kochersberg,1999_2006,2002.5,7,20480,22764,887,1624,2284,737,1547,0.0152191553576664,0.00491090958782842,0.010308245769838,EPCI
200034692,CA du Gard Rhodanien,2006_2011,2008.5,5,68572,72205,3045,4019,3633,974,2659,0.0103784882396123,0.00278245184293487,0.00759603639667743,EPCI
200034692,CA du Gard Rhodanien,2011_2016,2013.5,5,72205,73922,3252,4221,1717,969,748,0.0047113009764348,0.00265885302630479,0.00205244795013001,EPCI
200034692,CA du Gard Rhodanien,1968_1975,1971.5,7,47499,49429,3259,5312,1930,2053,-123,0.00570602315814694,0.0060696712661532,-0.000363648108006256,EPCI
200034692,CA du Gard Rhodanien,1975_1982,1978.5,7,49429,54302,3248,4652,4873,1404,3469,0.0135225801367038,0.00389610147997787,0.00962647865672595,EPCI
200034692,CA du Gard Rhodanien,1982_1990,1986,8,54302,60728,4172,6331,6426,2159,4267,0.0140786611461723,0.00473013218403143,0.00934852896214086,EPCI
200034692,CA du Gard Rhodanien,1990_1999,1994.5,9,60728,64504,4749,6819,3776,2070,1706,0.00672499643520941,0.00368663734663228,0.00303835908857713,EPCI
200034692,CA du Gard Rhodanien,1999_2006,2002.5,7,64504,68572,3858,5409,4068,1551,2517,0.00877499807840243,0.00334562979832895,0.00542936828007348,EPCI
200034700,CA Durance-Lubéron-Verdon Agglomération,2006_2011,2008.5,5,56086,60320,3028,3203,4234,175,4059,0.0146619464534823,0.000606008651242183,0.0140559378022401,EPCI
200034700,CA Durance-Lubéron-Verdon Agglomération,2011_2016,2013.5,5,60320,61520,3260,3241,1200,-19,1219,0.00394749119926274,-6.25019439883268e-05,0.00400999314325107,EPCI
200034700,CA Durance-Lubéron-Verdon Agglomération,1968_1975,1971.5,7,34808,39173,2728,3719,4365,991,3374,0.0170204374142846,0.00386420469130723,0.0131562327229774,EPCI
200034700,CA Durance-Lubéron-Verdon Agglomération,1975_1982,1978.5,7,39173,42620,2972,2941,3447,-31,3478,0.0121208539873703,-0.000109006809866109,0.0122298607972364,EPCI
200034700,CA Durance-Lubéron-Verdon Agglomération,1982_1990,1986,8,42620,46633,3619,4084,4013,465,3548,0.0113116000487481,0.00131071368618686,0.0100008863625612,EPCI
200034700,CA Durance-Lubéron-Verdon Agglomération,1990_1999,1994.5,9,46633,50183,4469,4852,3550,383,3167,0.00818530446219667,0.000883090594090514,0.00730221386810616,EPCI
200034700,CA Durance-Lubéron-Verdon Agglomération,1999_2006,2002.5,7,50183,56086,3819,4161,5903,342,5561,0.0160140004309557,0.000927797416125164,0.0150862030148305,EPCI
200034718,"CC de Vitry, Champagne et Der",2006_2011,2008.5,5,26922,25419,1195,1563,-1503,368,-1871,-0.0114236232620397,0.00279700157047945,-0.0142206248325192,EPCI
200034718,"CC de Vitry, Champagne et Der",2011_2016,2013.5,5,25419,24988,1413,1370,-431,-43,-388,-0.0034144008813487,-0.000340647883754047,-0.00307375299759465,EPCI
200034718,"CC de Vitry, Champagne et Der",1968_1975,1971.5,7,28001,30374,1824,4402,2373,2578,-205,0.0116887508079275,0.0126985248979508,-0.00100977409002324,EPCI
200034718,"CC de Vitry, Champagne et Der",1975_1982,1978.5,7,30374,29783,1881,3629,-591,1748,-2339,-0.00280309516809862,0.00829071125860642,-0.011093806426705,EPCI
200034718,"CC de Vitry, Champagne et Der",1982_1990,1986,8,29783,28996,2060,3913,-787,1853,-2640,-0.00334188735898922,0.00786850988082213,-0.0112103972398113,EPCI
200034718,"CC de Vitry, Champagne et Der",1990_1999,1994.5,9,28996,28195,2240,3413,-801,1173,-1974,-0.00310774229389321,0.0045510383404953,-0.00765878063438851,EPCI
200034718,"CC de Vitry, Champagne et Der",1999_2006,2002.5,7,28195,26922,1815,2364,-1273,549,-1822,-0.00657839003319394,0.00283702759483383,-0.00941541762802777,EPCI
200034726,CC Bastides de Lomagne,2006_2011,2008.5,5,9791,10865,646,551,1074,-95,1169,0.0210347802271218,-0.00186061836273424,0.022895398589856,EPCI
200034726,CC Bastides de Lomagne,2011_2016,2013.5,5,10865,11144,730,502,279,-228,507,0.00508380345184212,-0.00415450604666668,0.00923830949850879,EPCI
200034726,CC Bastides de Lomagne,1968_1975,1971.5,7,10084,9282,950,697,-802,-253,-549,-0.0117691903396138,-0.00371272463331955,-0.00805646570629421,EPCI
200034726,CC Bastides de Lomagne,1975_1982,1978.5,7,9282,8825,897,478,-457,-419,-38,-0.00718668537878597,-0.00658910541293506,-0.000597579965850912,EPCI
200034726,CC Bastides de Lomagne,1982_1990,1986,8,8825,8417,986,535,-408,-451,43,-0.00589942124445686,-0.00652117397365207,0.000621752729195208,EPCI
200034726,CC Bastides de Lomagne,1990_1999,1994.5,9,8417,8393,1039,644,-24,-395,371,-0.000317221355634723,-0.00522093481148814,0.00490371345585342,EPCI
200034726,CC Bastides de Lomagne,1999_2006,2002.5,7,8393,9791,946,635,1398,-311,1709,0.0222533602044974,-0.00495049715565,0.0272038573601474,EPCI
200034825,CA du Grand Guéret,2006_2011,2008.5,5,29110,29160,1788,1445,50,-343,393,0.000343288786698981,-0.00235496107675501,0.00269824986345399,EPCI
200034825,CA du Grand Guéret,2011_2016,2013.5,5,29160,29213,1850,1372,53,-478,531,0.000363247666196331,-0.00327608272531786,0.00363933039151419,EPCI
200034825,CA du Grand Guéret,1968_1975,1971.5,7,27155,28139,2594,2737,984,143,841,0.00509799692749358,0.000740867439666241,0.00435712948782733,EPCI
200034825,CA du Grand Guéret,1975_1982,1978.5,7,28139,30001,2494,2507,1862,13,1849,0.00919547814456378,6.42004381736462e-05,0.00913127770639014,EPCI
200034825,CA du Grand Guéret,1982_1990,1986,8,30001,29553,2858,2568,-448,-290,-158,-0.00187891423875253,-0.00121626144919248,-0.000662652789560043,EPCI
200034825,CA du Grand Guéret,1990_1999,1994.5,9,29553,28910,3146,2533,-643,-613,-30,-0.00244120490246602,-0.00232730731759202,-0.000113897584873998,EPCI
200034825,CA du Grand Guéret,1999_2006,2002.5,7,28910,29110,2462,1907,200,-555,755,0.000985371120766132,-0.00273440486012602,0.00371977598089215,EPCI
200034833,CC des Bastides Dordogne-Périgord,2006_2011,2008.5,5,19018,19198,1302,734,180,-568,748,0.00188581748625571,-0.00595080184551803,0.00783661933177375,EPCI
200034833,CC des Bastides Dordogne-Périgord,2011_2016,2013.5,5,19198,18803,1363,635,-395,-728,333,-0.00414930282981085,-0.00764732268380329,0.00349801985399244,EPCI
200034833,CC des Bastides Dordogne-Périgord,1968_1975,1971.5,7,18849,18063,1693,1395,-786,-298,-488,-0.00606641241094252,-0.00229998842043368,-0.00376642399050884,EPCI
200034833,CC des Bastides Dordogne-Périgord,1975_1982,1978.5,7,18063,17874,1853,1109,-189,-744,555,-0.00150151505247764,-0.00591072592086437,0.00440921086838673,EPCI
200034833,CC des Bastides Dordogne-Périgord,1982_1990,1986,8,17874,18391,2102,1259,517,-843,1360,0.00357064355830272,-0.00582215187553036,0.00939279543383308,EPCI
200034833,CC des Bastides Dordogne-Périgord,1990_1999,1994.5,9,18391,18425,2352,1385,34,-967,1001,0.000205245899897788,-0.00583743485885768,0.00604268075875546,EPCI
200034833,CC des Bastides Dordogne-Périgord,1999_2006,2002.5,7,18425,19018,1846,1096,593,-750,1343,0.00453560644398054,-0.00573643310790119,0.0102720395518817,EPCI
200034874,CC Côtes de Meuse Woëvre,2006_2011,2008.5,5,5656,5937,214,377,281,163,118,0.00974457753333313,0.00565254853357046,0.00409202899976267,EPCI
200034874,CC Côtes de Meuse Woëvre,2011_2016,2013.5,5,5937,6011,241,338,74,97,-23,0.00248050512855147,0.00325147293877693,-0.000770967810225457,EPCI
200034874,CC Côtes de Meuse Woëvre,1968_1975,1971.5,7,5522,5096,575,459,-426,-116,-310,-0.0114036505361971,-0.00310521939483301,-0.00829843114136407,EPCI
200034874,CC Côtes de Meuse Woëvre,1975_1982,1978.5,7,5096,4855,576,365,-241,-211,-30,-0.00689707900724557,-0.00603852145447641,-0.000858557552769158,EPCI
200034874,CC Côtes de Meuse Woëvre,1982_1990,1986,8,4855,5107,589,521,252,-68,320,0.00634542820803064,-0.0017122584053416,0.00805768661337224,EPCI
200034874,CC Côtes de Meuse Woëvre,1990_1999,1994.5,9,5107,5218,548,554,111,6,105,0.00239197166036131,0.000129295765424936,0.00226267589493638,EPCI
200034874,CC Côtes de Meuse Woëvre,1999_2006,2002.5,7,5218,5656,363,454,438,91,347,0.0115812264944548,0.00240614523058308,0.00917508126387173,EPCI
200034882,CC Pays du Mont-Blanc,2006_2011,2008.5,5,44595,44788,1605,2864,193,1259,-1066,0.000864073352428774,0.00563662357879703,-0.00477255022636825,EPCI
200034882,CC Pays du Mont-Blanc,2011_2016,2013.5,5,44788,43907,1737,2472,-881,735,-1616,-0.00396541404402695,0.0033082625679453,-0.00727367661197225,EPCI
200034882,CC Pays du Mont-Blanc,1968_1975,1971.5,7,30334,32377,1839,3877,2043,2038,5,0.00935478480648211,0.00933189008106243,2.28947254196834e-05,EPCI
200034882,CC Pays du Mont-Blanc,1975_1982,1978.5,7,32377,34812,1967,3419,2435,1452,983,0.0104129644353355,0.00620929131831913,0.00420367311701633,EPCI
200034882,CC Pays du Mont-Blanc,1982_1990,1986,8,34812,38667,2256,4719,3855,2463,1392,0.0132145971509525,0.00844294495014165,0.00477165220081087,EPCI
200034882,CC Pays du Mont-Blanc,1990_1999,1994.5,9,38667,42078,2821,5277,3411,2456,955,0.00943742267066616,0.00679516566378074,0.00264225700688543,EPCI
200034882,CC Pays du Mont-Blanc,1999_2006,2002.5,7,42078,44595,2275,4127,2517,1852,665,0.00833406605089682,0.00613217732469643,0.00220188872620039,EPCI
200034957,CC du Frontonnais,2006_2011,2008.5,5,21016,23750,725,1555,2734,830,1904,0.0247612879059667,0.00751714299998256,0.0172441449059841,EPCI
200034957,CC du Frontonnais,2011_2016,2013.5,5,23750,25885,821,1496,2135,675,1460,0.0173652773085367,0.00549019306007599,0.0118750842484607,EPCI
200034957,CC du Frontonnais,1968_1975,1971.5,7,7336,9051,800,696,1715,-104,1819,0.0304665335031584,-0.00184753322701369,0.0323140667301721,EPCI
200034957,CC du Frontonnais,1975_1982,1978.5,7,9051,11437,892,716,2386,-176,2562,0.0339904033945759,-0.00250725523782287,0.0364976586323988,EPCI
200034957,CC du Frontonnais,1982_1990,1986,8,11437,13907,1061,973,2470,-88,2558,0.0247434868991379,-0.000881549330819486,0.0256250362299573,EPCI
200034957,CC du Frontonnais,1990_1999,1994.5,9,13907,16294,1232,1604,2387,372,2015,0.017756316377775,0.0027672181367961,0.0149890982409789,EPCI
200034957,CC du Frontonnais,1999_2006,2002.5,7,16294,21016,1079,1728,4722,649,4073,0.0370242373084233,0.00508867641108995,0.0319355608973334,EPCI
200035087,CA Terre de Provence,2006_2011,2008.5,5,52912,56420,2333,3413,3508,1080,2428,0.0129214799434367,0.00397810671006604,0.00894337323337069,EPCI
200035087,CA Terre de Provence,2011_2016,2013.5,5,56420,58855,2513,3535,2435,1022,1413,0.00848642451755133,0.0035618586681468,0.00492456584940453,EPCI
200035087,CA Terre de Provence,1968_1975,1971.5,7,34569,36420,2819,3259,1851,440,1411,0.00747936714792319,0.00177791547546526,0.00570145167245793,EPCI
200035087,CA Terre de Provence,1975_1982,1978.5,7,36420,39377,2894,3097,2957,203,2754,0.0112143886598728,0.000769875176852951,0.0104445134830198,EPCI
200035087,CA Terre de Provence,1982_1990,1986,8,39377,43807,3400,4139,4430,739,3691,0.0134156596820265,0.00223796219074889,0.0111776974912776,EPCI
200035087,CA Terre de Provence,1990_1999,1994.5,9,43807,48426,3916,5183,4619,1267,3352,0.0112003975041037,0.00307228916165824,0.00812810834244549,EPCI
200035087,CA Terre de Provence,1999_2006,2002.5,7,48426,52912,3347,4312,4486,965,3521,0.0127366136985128,0.00273981993291681,0.00999679376559594,EPCI
200035103,CC de la Vallée de la Haute-Sarthe,2006_2011,2008.5,5,7657,7888,391,501,231,110,121,0.0059621744635967,0.00283913069695081,0.00312304376664589,EPCI
200035103,CC de la Vallée de la Haute-Sarthe,2011_2016,2013.5,5,7888,7853,384,399,-35,15,-50,-0.000889003183831671,0.000381001364499288,-0.00127000454833096,EPCI
200035103,CC de la Vallée de la Haute-Sarthe,1968_1975,1971.5,7,7617,7210,609,676,-407,67,-474,-0.00781411554451028,0.00128635317317491,-0.00910046871768519,EPCI
200035103,CC de la Vallée de la Haute-Sarthe,1975_1982,1978.5,7,7210,6874,610,573,-336,-37,-299,-0.00679435228442782,-0.000748187602749492,-0.00604616468167833,EPCI
200035103,CC de la Vallée de la Haute-Sarthe,1982_1990,1986,8,6874,6704,755,600,-170,-155,-15,-0.00312533285357097,-0.00284956819002059,-0.00027576466355038,EPCI
200035103,CC de la Vallée de la Haute-Sarthe,1990_1999,1994.5,9,6704,6947,778,685,243,-93,336,0.00396400803776165,-0.00151708949593347,0.00548109753369512,EPCI
200035103,CC de la Vallée de la Haute-Sarthe,1999_2006,2002.5,7,6947,7657,599,628,710,29,681,0.0139985534919782,0.000571771903193476,0.0134267815887847,EPCI
200035111,CC des Sources de l'Orne,2006_2011,2008.5,5,11786,12231,603,711,445,108,337,0.00743980405540423,0.00180561536625541,0.00563418868914882,EPCI
200035111,CC des Sources de l'Orne,2011_2016,2013.5,5,12231,12076,696,687,-155,-9,-146,-0.00254748975872254,-0.00014791876018389,-0.00239957099853865,EPCI
200035111,CC des Sources de l'Orne,1968_1975,1971.5,7,12082,11708,1083,1316,-374,233,-607,-0.00448197908850134,0.00279224900433372,-0.00727422809283507,EPCI
200035111,CC des Sources de l'Orne,1975_1982,1978.5,7,11708,11438,1038,1011,-270,-27,-243,-0.00332748352040213,-0.000332748352040213,-0.00299473516836192,EPCI
200035111,CC des Sources de l'Orne,1982_1990,1986,8,11438,11455,1119,1150,17,31,-14,0.000185663534882918,0.000338562916551204,-0.000152899381668286,EPCI
200035111,CC des Sources de l'Orne,1990_1999,1994.5,9,11455,11554,1238,1207,99,-31,130,0.000956610755324494,-0.000299544781970296,0.00125615553729479,EPCI
200035111,CC des Sources de l'Orne,1999_2006,2002.5,7,11554,11786,899,925,232,26,206,0.00284413533705585,0.00031873930501488,0.00252539603204097,EPCI
200035129,CC de Cèze Cévennes,2006_2011,2008.5,5,18855,19534,1495,855,679,-640,1319,0.00710077304122403,-0.00669292304327449,0.0137936960844985,EPCI
200035129,CC de Cèze Cévennes,2011_2016,2013.5,5,19534,19219,1484,826,-315,-658,343,-0.00324615261126526,-0.00678085212130966,0.0035346995100444,EPCI
200035129,CC de Cèze Cévennes,1968_1975,1971.5,7,22958,20115,2382,1397,-2843,-985,-1858,-0.0187085882795127,-0.00648187107116427,-0.0122267172083484,EPCI
200035129,CC de Cèze Cévennes,1975_1982,1978.5,7,20115,19330,2248,1071,-785,-1177,392,-0.00567064828655728,-0.00850236055194639,0.00283171226538911,EPCI
200035129,CC de Cèze Cévennes,1982_1990,1986,8,19330,18603,2690,1191,-727,-1499,772,-0.00478046642160457,-0.00985683516641712,0.00507636874481255,EPCI
200035129,CC de Cèze Cévennes,1990_1999,1994.5,9,18603,17458,2766,1305,-1145,-1461,316,-0.00703346654703285,-0.00897458045870305,0.0019411139116702,EPCI
200035129,CC de Cèze Cévennes,1999_2006,2002.5,7,17458,18855,2231,1042,1397,-1189,2586,0.0110578531158259,-0.00941144406207369,0.0204692971778995,EPCI
200035137,CC Marche Occitane - Val d'Anglin,2006_2011,2008.5,5,7512,7338,521,266,-174,-255,81,-0.00467611596160622,-0.00685292856442291,0.00217681260281669,EPCI
200035137,CC Marche Occitane - Val d'Anglin,2011_2016,2013.5,5,7338,6838,544,226,-500,-318,-182,-0.0140150684926599,-0.00891358356133168,-0.0051014849313282,EPCI
200035137,CC Marche Occitane - Val d'Anglin,1968_1975,1971.5,7,10673,9664,1123,778,-1009,-345,-664,-0.0140869157429272,-0.00481663620546074,-0.00927027953746646,EPCI
200035137,CC Marche Occitane - Val d'Anglin,1975_1982,1978.5,7,9664,8750,1088,509,-914,-579,-335,-0.0140931683956503,-0.00892772921343714,-0.0051654391822132,EPCI
200035137,CC Marche Occitane - Val d'Anglin,1982_1990,1986,8,8750,8236,1199,532,-514,-667,153,-0.00753880349004388,-0.00978284421762503,0.00224404072758115,EPCI
200035137,CC Marche Occitane - Val d'Anglin,1990_1999,1994.5,9,8236,7656,1237,580,-580,-657,77,-0.00808107502246802,-0.0091539073961405,0.00107283237367248,EPCI
200035137,CC Marche Occitane - Val d'Anglin,1999_2006,2002.5,7,7656,7512,870,428,-144,-442,298,-0.00270888322846308,-0.00831476657625472,0.00560588334779165,EPCI
200035202,CC Charlieu-Belmont,2006_2011,2008.5,5,22986,23465,1159,1260,479,101,378,0.00413344206392186,0.000871560852726738,0.00326188121119512,EPCI
200035202,CC Charlieu-Belmont,2011_2016,2013.5,5,23465,23363,1276,1233,-102,-43,-59,-0.000870895525080906,-0.000367142231161558,-0.000503753293919348,EPCI
200035202,CC Charlieu-Belmont,1968_1975,1971.5,7,21180,21081,2002,2311,-99,309,-408,-0.000669087389007617,0.00208836366872074,-0.00275745105772836,EPCI
200035202,CC Charlieu-Belmont,1975_1982,1978.5,7,21081,22306,1932,2093,1225,161,1064,0.00810171984164954,0.00106479746490251,0.00703692237674703,EPCI
200035202,CC Charlieu-Belmont,1982_1990,1986,8,22306,22230,2141,2310,-76,169,-245,-0.00042653058448594,0.000948469326027946,-0.00137499991051389,EPCI
200035202,CC Charlieu-Belmont,1990_1999,1994.5,9,22230,22173,2158,2162,-57,4,-61,-0.000285225482725138,2.00158233491325e-05,-0.00030524130607427,EPCI
200035202,CC Charlieu-Belmont,1999_2006,2002.5,7,22173,22986,1708,1753,813,45,768,0.005157540626199,0.000285472728387398,0.0048720678978116,EPCI
200035319,CA Var Estérel Méditerranée (Cavem),2006_2011,2008.5,5,106373,107547,5594,5664,1174,70,1104,0.00219764649597143,0.00013103514030494,0.00206661135566649,EPCI
200035319,CA Var Estérel Méditerranée (Cavem),2011_2016,2013.5,5,107547,113022,6242,6079,5475,-163,5638,0.00998038082751207,-0.000297132799065656,0.0102775136265777,EPCI
200035319,CA Var Estérel Méditerranée (Cavem),1968_1975,1971.5,7,48565,59245,3753,5381,10680,1628,9052,0.0288039329491137,0.00439071187651283,0.0244132210726008,EPCI
200035319,CA Var Estérel Méditerranée (Cavem),1975_1982,1978.5,7,59245,67274,4536,5399,8029,863,7166,0.0183218867757107,0.0019693346976508,0.0163525520780599,EPCI
200035319,CA Var Estérel Méditerranée (Cavem),1982_1990,1986,8,67274,85830,6126,7828,18556,1702,16854,0.0309176680543422,0.00283584129276193,0.0280818267615802,EPCI
200035319,CA Var Estérel Méditerranée (Cavem),1990_1999,1994.5,9,85830,97252,7984,9743,11422,1759,9663,0.0139786843203764,0.00215273207140099,0.0118259522489754,EPCI
200035319,CA Var Estérel Méditerranée (Cavem),1999_2006,2002.5,7,97252,106373,7098,7561,9121,463,8658,0.0128889611131315,0.0006542691585769,0.0122346919545546,EPCI
200035327,CC Cazals-Salviac,2006_2011,2008.5,5,5177,5374,373,220,197,-153,350,0.00749731966669143,-0.00582279141626288,0.0133201110829543,EPCI
200035327,CC Cazals-Salviac,2011_2016,2013.5,5,5374,5332,372,171,-42,-201,159,-0.00156799099096183,-0.00750395688531734,0.00593596589435551,EPCI
200035327,CC Cazals-Salviac,1968_1975,1971.5,7,5204,4666,608,313,-538,-295,-243,-0.0154684562173877,-0.00848177431994306,-0.00698668189744462,EPCI
200035327,CC Cazals-Salviac,1975_1982,1978.5,7,4666,4432,547,223,-234,-324,90,-0.00732322840465416,-0.0101398547141365,0.00281662630948237,EPCI
200035327,CC Cazals-Salviac,1982_1990,1986,8,4432,4573,586,286,141,-300,441,0.00392248478935553,-0.00834571231777772,0.0122681971071333,EPCI
200035327,CC Cazals-Salviac,1990_1999,1994.5,9,4573,4724,680,333,151,-347,498,0.00361612843522541,-0.00830991103988885,0.0119260394751143,EPCI
200035327,CC Cazals-Salviac,1999_2006,2002.5,7,4724,5177,497,258,453,-239,692,0.0131673415538436,-0.00694700801626626,0.0201143495701098,EPCI
200035442,CC du Sud-Artois,2006_2011,2008.5,5,26466,27384,1398,1739,918,341,577,0.00684290861240777,0.00254186474600332,0.00430104386640445,EPCI
200035442,CC du Sud-Artois,2011_2016,2013.5,5,27384,27589,1539,1659,205,120,85,0.00149276132626386,0.000873811508056893,0.000618949818206966,EPCI
200035442,CC du Sud-Artois,1968_1975,1971.5,7,26227,24940,2636,3238,-1287,602,-1889,-0.00716229537637203,0.00335019566167518,-0.0105124910380472,EPCI
200035442,CC du Sud-Artois,1975_1982,1978.5,7,24940,24601,2700,2661,-339,-39,-300,-0.00195321110045243,-0.000224705701821961,-0.00172850539863047,EPCI
200035442,CC du Sud-Artois,1982_1990,1986,8,24601,24697,2883,2727,96,-156,252,0.00048695430488177,-0.000791300745432877,0.00127825505031465,EPCI
200035442,CC du Sud-Artois,1990_1999,1994.5,9,24697,25957,2806,2711,1260,-95,1355,0.00554415045340884,-0.000418011343709396,0.00596216179711823,EPCI
200035442,CC du Sud-Artois,1999_2006,2002.5,7,25957,26466,2250,2258,509,8,501,0.00277807566262189,4.36632717111496e-05,0.00273441239091074,EPCI
200035459,CA d'Agen,2006_2011,2008.5,5,92326,95126,4184,5492,2800,1308,1492,0.00599319508490304,0.00279967827537613,0.0031935168095269,EPCI
200035459,CA d'Agen,2011_2016,2013.5,5,95126,96660,4405,5420,1534,1015,519,0.00320459132066864,0.00212037822065102,0.00108421310001762,EPCI
200035459,CA d'Agen,1968_1975,1971.5,7,69061,73066,5406,7323,4005,1917,2088,0.00808579636177798,0.00387028005631171,0.00421551630546627,EPCI
200035459,CA d'Agen,1975_1982,1978.5,7,73066,76518,5494,6355,3452,861,2591,0.00661648787999858,0.00165028854712595,0.00496619933287263,EPCI
200035459,CA d'Agen,1982_1990,1986,8,76518,81675,5935,7887,5157,1952,3205,0.00818606789176468,0.00309854654347967,0.00508752134828501,EPCI
200035459,CA d'Agen,1990_1999,1994.5,9,81675,84265,6734,8345,2590,1611,979,0.00347476052541906,0.00216132787893827,0.0013134326464808,EPCI
200035459,CA d'Agen,1999_2006,2002.5,7,84265,92326,5542,6847,8061,1305,6756,0.0131368539936529,0.00212673296882733,0.0110101210248256,EPCI
200035533,CC du Grand Saint-Émilionnais,2006_2011,2008.5,5,15396,15265,580,794,-131,214,-345,-0.00170756230067892,0.00278945291866633,-0.00449701521934525,EPCI
200035533,CC du Grand Saint-Émilionnais,2011_2016,2013.5,5,15265,14738,655,722,-527,67,-594,-0.00700205732649095,0.000890204631641165,-0.00789226195813212,EPCI
200035533,CC du Grand Saint-Émilionnais,1968_1975,1971.5,7,17247,16762,1521,1556,-485,35,-520,-0.00406653710118643,0.000293461440291804,-0.00435999854147823,EPCI
200035533,CC du Grand Saint-Émilionnais,1975_1982,1978.5,7,16762,16896,1392,1430,134,38,96,0.00113814546039848,0.000322757667874195,0.000815387792524282,EPCI
200035533,CC du Grand Saint-Émilionnais,1982_1990,1986,8,16896,16474,1393,1526,-422,133,-555,-0.00315669799437124,0.000994883491117002,-0.00415158148548824,EPCI
200035533,CC du Grand Saint-Émilionnais,1990_1999,1994.5,9,16474,15503,1256,1623,-971,367,-1338,-0.00672725082133008,0.00254263754009077,-0.00926988836142085,EPCI
200035533,CC du Grand Saint-Émilionnais,1999_2006,2002.5,7,15503,15396,911,1233,-107,322,-429,-0.000988913297311877,0.00297598207228434,-0.00396489536959622,EPCI
200035541,CC des Landes d'Armagnac,2006_2011,2008.5,5,10268,10679,691,439,411,-252,663,0.00788027383367962,-0.00483170074473787,0.0127119745784175,EPCI
200035541,CC des Landes d'Armagnac,2011_2016,2013.5,5,10679,10886,739,464,207,-275,482,0.00384705375182448,-0.00511082020169919,0.00895787395352367,EPCI
200035541,CC des Landes d'Armagnac,1968_1975,1971.5,7,12333,11395,1274,977,-938,-297,-641,-0.0112369504739178,-0.00355796832702942,-0.0076789821468884,EPCI
200035541,CC des Landes d'Armagnac,1975_1982,1978.5,7,11395,10519,1255,629,-876,-626,-250,-0.0113623152868416,-0.00811964539904435,-0.00324266988779727,EPCI
200035541,CC des Landes d'Armagnac,1982_1990,1986,8,10519,10346,1299,722,-173,-577,404,-0.0020707498051995,-0.00690648923468273,0.00483573942948323,EPCI
200035541,CC des Landes d'Armagnac,1990_1999,1994.5,9,10346,10076,1423,751,-270,-672,402,-0.00293386700812459,-0.00730206899799898,0.00436820198987439,EPCI
200035541,CC des Landes d'Armagnac,1999_2006,2002.5,7,10076,10268,1006,601,192,-405,597,0.00270019677048783,-0.00569572756274776,0.00839592433323559,EPCI
200035632,CC Armagnac Adour,2006_2011,2008.5,5,6920,6852,461,229,-68,-232,164,-0.0019730887297148,-0.0067317144896152,0.0047586257599004,EPCI
200035632,CC Armagnac Adour,2011_2016,2013.5,5,6852,6821,511,216,-31,-295,264,-0.000906487249829668,-0.00862624963547588,0.00771976238564621,EPCI
200035632,CC Armagnac Adour,1968_1975,1971.5,7,8042,7491,801,591,-551,-210,-341,-0.0100881283571637,-0.00384484020871936,-0.0062432881484443,EPCI
200035632,CC Armagnac Adour,1975_1982,1978.5,7,7491,7328,716,461,-163,-255,92,-0.00313787691170875,-0.00490894854285724,0.0017710716311485,EPCI
200035632,CC Armagnac Adour,1982_1990,1986,8,7328,7020,833,512,-308,-321,13,-0.00535304727232333,-0.00557898757927204,0.000225940306948712,EPCI
200035632,CC Armagnac Adour,1990_1999,1994.5,9,7020,6796,866,483,-224,-383,159,-0.00359673998211774,-0.00614978309442452,0.00255304311230679,EPCI
200035632,CC Armagnac Adour,1999_2006,2002.5,7,6796,6920,656,418,124,-238,362,0.00258641985907793,-0.00496425747145602,0.00755067733053395,EPCI
200035665,CA Seine Eure,2006_2011,2008.5,5,71549,72262,2870,5164,713,2294,-1581,0.00198514249198167,0.00638698019159321,-0.00440183769961154,EPCI
200035665,CA Seine Eure,2011_2016,2013.5,5,72262,74192,2766,4972,1930,2206,-276,0.00528550414826645,0.00604135862750041,-0.000755854479233958,EPCI
200035665,CA Seine Eure,1968_1975,1971.5,7,40766,46348,3230,5348,5582,2118,3464,0.0185018978572393,0.00702024716259995,0.0114816506946394,EPCI
200035665,CA Seine Eure,1975_1982,1978.5,7,46348,54338,3186,5657,7990,2471,5519,0.022980891722169,0.0071071068142027,0.0158737849079663,EPCI
200035665,CA Seine Eure,1982_1990,1986,8,54338,65318,3971,7788,10980,3817,7163,0.0232721484854432,0.00809014487877384,0.0151820036066694,EPCI
200035665,CA Seine Eure,1990_1999,1994.5,9,65318,69502,4749,8985,4184,4236,-52,0.00692250385565219,0.00700853879840886,-8.60349427566718e-05,EPCI
200035665,CA Seine Eure,1999_2006,2002.5,7,69502,71549,3870,7151,2047,3281,-1234,0.00415532387761197,0.00666029196015871,-0.00250496808254674,EPCI
200035707,CC Piège Lauragais Malepère,2006_2011,2008.5,5,14591,15712,837,835,1121,-2,1123,0.0149140917746617,-2.66085491073358e-05,0.0149407003237691,EPCI
200035707,CC Piège Lauragais Malepère,2011_2016,2013.5,5,15712,15697,935,754,-15,-181,166,-0.000191009819109245,-0.00230485181725155,0.00211384199814231,EPCI
200035707,CC Piège Lauragais Malepère,1968_1975,1971.5,7,13421,12178,1309,912,-1243,-397,-846,-0.0137882870985449,-0.00440382138223838,-0.00938446571630647,EPCI
200035707,CC Piège Lauragais Malepère,1975_1982,1978.5,7,12178,12175,1303,708,-3,-595,592,-3.51959831395021e-05,-0.00698053665600125,0.00694534067286175,EPCI
200035707,CC Piège Lauragais Malepère,1982_1990,1986,8,12175,12453,1376,955,278,-421,699,0.00282609700048742,-0.00427980876692519,0.0071059057674126,EPCI
200035707,CC Piège Lauragais Malepère,1990_1999,1994.5,9,12453,13188,1619,1129,735,-490,1225,0.00639209473602631,-0.00426139649068421,0.0106534912267105,EPCI
200035707,CC Piège Lauragais Malepère,1999_2006,2002.5,7,13188,14591,1338,1035,1403,-303,1706,0.0145473076852698,-0.00314172076167979,0.0176890284469496,EPCI
200035715,CA Carcassonne Agglo,2006_2011,2008.5,5,104945,109462,5348,6206,4517,858,3659,0.00846382809450041,0.00160769637039658,0.00685613172410383,EPCI
200035715,CA Carcassonne Agglo,2011_2016,2013.5,5,109462,111452,5705,5992,1990,287,1703,0.00360980929928934,0.000520610687887457,0.00308919861140188,EPCI
200035715,CA Carcassonne Agglo,1968_1975,1971.5,7,85394,85309,7581,7774,-85,193,-278,-0.000142258711472998,0.000323010956638689,-0.000465269668111687,EPCI
200035715,CA Carcassonne Agglo,1975_1982,1978.5,7,85309,89158,7370,6943,3849,-427,4276,0.0063242164819235,-0.000701595333276522,0.00702581181520002,EPCI
200035715,CA Carcassonne Agglo,1982_1990,1986,8,89158,95065,8552,8425,5907,-127,6034,0.00805108601449223,-0.000173097667824702,0.00822418368231693,EPCI
200035715,CA Carcassonne Agglo,1990_1999,1994.5,9,95065,97721,9650,9651,2656,1,2655,0.00306642650722933,1.15452805242068e-06,0.0030652719791769,EPCI
200035715,CA Carcassonne Agglo,1999_2006,2002.5,7,97721,104945,7689,7727,7224,38,7186,0.0102406406407649,5.38682647216316e-05,0.0101867723760433,EPCI
200035723,CC Ventoux Sud,2006_2011,2008.5,5,8324,9086,402,427,762,25,737,0.0176727184191463,0.000579813596428685,0.0170929048227176,EPCI
200035723,CC Ventoux Sud,2011_2016,2013.5,5,9086,9411,478,400,325,-78,403,0.00705365073520836,-0.00169287617645001,0.00874652691165837,EPCI
200035723,CC Ventoux Sud,1968_1975,1971.5,7,5459,5023,450,455,-436,5,-441,-0.0118207590459335,0.000135559163370797,-0.0119563182093043,EPCI
200035723,CC Ventoux Sud,1975_1982,1978.5,7,5023,5626,468,414,603,-54,657,0.0163277710917853,-0.00146218845598077,0.0177899595477661,EPCI
200035723,CC Ventoux Sud,1982_1990,1986,8,5626,6110,572,609,484,37,447,0.0103694013433528,0.000792702168810032,0.00957669917454282,EPCI
200035723,CC Ventoux Sud,1990_1999,1994.5,9,6110,6873,727,688,763,-39,802,0.0131607298774079,-0.000672697857429762,0.0138334277348377,EPCI
200035723,CC Ventoux Sud,1999_2006,2002.5,7,6873,8324,566,611,1451,45,1406,0.0277409835625146,0.000860333742462549,0.0268806498200521,EPCI
200035731,CA Roannais Agglomération,2006_2011,2008.5,5,99112,100946,4959,5385,1834,426,1408,0.00367377113163969,0.000853340513674214,0.00282043061796548,EPCI
200035731,CA Roannais Agglomération,2011_2016,2013.5,5,100946,100587,5198,5594,-359,396,-755,-0.000712285351156972,0.000785696376206576,-0.00149798172736355,EPCI
200035731,CA Roannais Agglomération,1968_1975,1971.5,7,101271,108233,8258,12579,6962,4321,2641,0.00954328070016675,0.00592308473217761,0.00362019596798914,EPCI
200035731,CA Roannais Agglomération,1975_1982,1978.5,7,108233,107210,7886,10742,-1023,2856,-3879,-0.00135576337872012,0.00378500509249723,-0.00514076847121735,EPCI
200035731,CA Roannais Agglomération,1982_1990,1986,8,107210,103833,8434,10941,-3377,2507,-5884,-0.00399271889049135,0.00296409424295583,-0.00695681313344718,EPCI
200035731,CA Roannais Agglomération,1990_1999,1994.5,9,103833,100709,9135,10361,-3124,1226,-4350,-0.00338854246218467,0.00132981852069091,-0.00471836098287559,EPCI
200035731,CA Roannais Agglomération,1999_2006,2002.5,7,100709,99112,7074,7612,-1597,538,-2135,-0.0022809156491147,0.00076839863445442,-0.00304931428356912,EPCI
200035756,CC Astarac Arros en Gascogne,2006_2011,2008.5,5,7278,7386,365,271,108,-94,202,0.00295038729875641,-0.00256792968595465,0.00551831698471106,EPCI
200035756,CC Astarac Arros en Gascogne,2011_2016,2013.5,5,7386,7321,392,270,-65,-122,57,-0.00176631537883609,-0.00331523809566159,0.0015489227168255,EPCI
200035756,CC Astarac Arros en Gascogne,1968_1975,1971.5,7,7716,7060,732,544,-656,-188,-468,-0.0126127897709676,-0.00361464097094803,-0.00899814880001956,EPCI
200035756,CC Astarac Arros en Gascogne,1975_1982,1978.5,7,7060,7034,649,418,-26,-231,205,-0.000526935042849952,-0.00468161518839765,0.0041546801455477,EPCI
200035756,CC Astarac Arros en Gascogne,1982_1990,1986,8,7034,7075,737,487,41,-250,291,0.000726752641510009,-0.00443141854579274,0.00515817118730275,EPCI
200035756,CC Astarac Arros en Gascogne,1990_1999,1994.5,9,7075,6971,746,508,-104,-238,134,-0.00164406449010035,-0.00376237835234503,0.00211831386224468,EPCI
200035756,CC Astarac Arros en Gascogne,1999_2006,2002.5,7,6971,7278,602,421,307,-181,488,0.00617576512542128,-0.00364108627915717,0.00981685140457846,EPCI
200035764,CC de la Beauce Loirétaine,2006_2011,2008.5,5,15103,16137,568,1071,1034,503,531,0.0133323683617741,0.006485668555099,0.00684669980667509,EPCI
200035764,CC de la Beauce Loirétaine,2011_2016,2013.5,5,16137,16649,597,1035,512,438,74,0.00626663019979823,0.00536090630373364,0.000905723896064588,EPCI
200035764,CC de la Beauce Loirétaine,1968_1975,1971.5,7,11626,12391,810,1269,765,459,306,0.00914534160240144,0.00548720496144086,0.00365813664096057,EPCI
200035764,CC de la Beauce Loirétaine,1975_1982,1978.5,7,12391,13408,868,1268,1017,400,617,0.0113324657972003,0.00445721368621446,0.0068752521109858,EPCI
200035764,CC de la Beauce Loirétaine,1982_1990,1986,8,13408,13707,986,1390,299,404,-105,0.00276069215028762,0.00373016598232843,-0.000969473832040805,EPCI
200035764,CC de la Beauce Loirétaine,1990_1999,1994.5,9,13707,13956,981,1444,249,463,-214,0.00200232109240495,0.00372319142884936,-0.00172087033644441,EPCI
200035764,CC de la Beauce Loirétaine,1999_2006,2002.5,7,13956,15103,782,1411,1147,629,518,0.0113473086771101,0.00622271766164102,0.00512459101546907,EPCI
200035772,CC du Pays du Saintois,2006_2011,2008.5,5,13507,14390,732,925,883,193,690,0.0127456321842201,0.00278585165521458,0.00995978052900551,EPCI
200035772,CC du Pays du Saintois,2011_2016,2013.5,5,14390,14481,704,818,91,114,-23,0.00126158001283128,0.00158044089519523,-0.000318860882363949,EPCI
200035772,CC du Pays du Saintois,1968_1975,1971.5,7,11454,11078,1209,1132,-376,-77,-299,-0.00475691478086415,-0.000974155420549308,-0.00378275936031484,EPCI
200035772,CC du Pays du Saintois,1975_1982,1978.5,7,11078,11759,1140,999,681,-141,822,0.00855895522520167,-0.00177211848275101,0.0103310737079527,EPCI
200035772,CC du Pays du Saintois,1982_1990,1986,8,11759,12105,1281,1164,346,-117,463,0.00363153880967704,-0.00122800589806998,0.00485954470774702,EPCI
200035772,CC du Pays du Saintois,1990_1999,1994.5,9,12105,12549,1410,1300,444,-110,554,0.004010508511612,-0.000993594451075045,0.00500410296268704,EPCI
200035772,CC du Pays du Saintois,1999_2006,2002.5,7,12549,13507,1041,1215,958,174,784,0.0105650037186404,0.00191890464200776,0.00864609907663268,EPCI
200035814,CA Flers Agglo,2006_2011,2008.5,5,55481,54887,2825,3206,-594,381,-975,-0.00215050304653608,0.00137936306520243,-0.00352986611173851,EPCI
200035814,CA Flers Agglo,2011_2016,2013.5,5,54887,54255,2985,2802,-632,-183,-449,-0.00231359395271569,-0.000669917236308498,-0.00164367671640719,EPCI
200035814,CA Flers Agglo,1968_1975,1971.5,7,52721,56389,3925,7099,3668,3174,494,0.00965491742206215,0.00835460956860013,0.00130030785346202,EPCI
200035814,CA Flers Agglo,1975_1982,1978.5,7,56389,57379,3921,6388,990,2467,-1477,0.00248941899987565,0.00620343098251841,-0.00371401198264276,EPCI
200035814,CA Flers Agglo,1982_1990,1986,8,57379,57499,4362,6242,120,1880,-1760,0.000261180804458583,0.00409183260318446,-0.00383065179872588,EPCI
200035814,CA Flers Agglo,1990_1999,1994.5,9,57499,55822,4905,5942,-1677,1037,-2714,-0.00328343098184791,0.00203036250934781,-0.00531379349119573,EPCI
200035814,CA Flers Agglo,1999_2006,2002.5,7,55822,55481,3802,4534,-341,732,-1073,-0.000874965154647023,0.00187822432023936,-0.00275318947488638,EPCI
200035848,CC du Châtillonnais en Berry,2006_2011,2008.5,5,6509,6343,614,210,-166,-404,238,-0.00515347344388561,-0.0125421883815047,0.00738871493761914,EPCI
200035848,CC du Châtillonnais en Berry,2011_2016,2013.5,5,6343,6094,573,199,-249,-374,125,-0.00797744237815012,-0.0119821825278239,0.00400474014967376,EPCI
200035848,CC du Châtillonnais en Berry,1968_1975,1971.5,7,9011,8323,811,727,-688,-84,-604,-0.0112820585954329,-0.00137746064246564,-0.00990459795296722,EPCI
200035848,CC du Châtillonnais en Berry,1975_1982,1978.5,7,8323,7916,842,537,-407,-305,-102,-0.00713680249337123,-0.00534821808471309,-0.00178858440865815,EPCI
200035848,CC du Châtillonnais en Berry,1982_1990,1986,8,7916,7242,982,490,-674,-492,-182,-0.0110619388239669,-0.00807488709405298,-0.00298705172991391,EPCI
200035848,CC du Châtillonnais en Berry,1990_1999,1994.5,9,7242,6771,1068,509,-471,-559,88,-0.00744422291608704,-0.00883507560529226,0.00139085268920522,EPCI
200035848,CC du Châtillonnais en Berry,1999_2006,2002.5,7,6771,6509,815,346,-262,-469,207,-0.00562170331222345,-0.0100632780665374,0.00444157475431395,EPCI
200035855,CC Castelnaudary Lauragais Audois,2006_2011,2008.5,5,24937,26109,1303,1492,1172,189,983,0.00922780368715048,0.00148810144784253,0.00773970223930796,EPCI
200035855,CC Castelnaudary Lauragais Audois,2011_2016,2013.5,5,26109,26250,1232,1354,141,122,19,0.00107776168058771,0.000932531383203549,0.000145230297384159,EPCI
200035855,CC Castelnaudary Lauragais Audois,1968_1975,1971.5,7,19611,19429,1825,1623,-182,-202,20,-0.00133109017507727,-0.00147736382069015,0.000146273645612886,EPCI
200035855,CC Castelnaudary Lauragais Audois,1975_1982,1978.5,7,19429,20672,1761,1465,1243,-296,1539,0.00889840497559402,-0.00211900874720501,0.011017413722799,EPCI
200035855,CC Castelnaudary Lauragais Audois,1982_1990,1986,8,20672,21863,2065,1919,1191,-146,1337,0.0070265187882701,-0.000861353268755193,0.00788787205702529,EPCI
200035855,CC Castelnaudary Lauragais Audois,1990_1999,1994.5,9,21863,22856,2270,2216,993,-54,1047,0.00494752708540647,-0.000269049811290986,0.00521657689669745,EPCI
200035855,CC Castelnaudary Lauragais Audois,1999_2006,2002.5,7,22856,24937,1690,1783,2081,93,1988,0.0125262297894564,0.000559797871417321,0.0119664319180391,EPCI
200035863,"CC Région Lézignanaise, Corbières et Minervois",2006_2011,2008.5,5,28319,31722,1690,1558,3403,-132,3535,0.0229550000721877,-0.000890408465920885,0.0238454085381085,EPCI
200035863,"CC Région Lézignanaise, Corbières et Minervois",2011_2016,2013.5,5,31722,33209,1876,1685,1487,-191,1678,0.00920419588243448,-0.00118224708375588,0.0103864429661904,EPCI
200035863,"CC Région Lézignanaise, Corbières et Minervois",1968_1975,1971.5,7,25741,23781,2630,1819,-1960,-811,-1149,-0.011250252784802,-0.00465507908595632,-0.00659517369884564,EPCI
200035863,"CC Région Lézignanaise, Corbières et Minervois",1975_1982,1978.5,7,23781,23046,2682,1453,-735,-1229,494,-0.00447491814488599,-0.0074825502041699,0.00300763205928392,EPCI
200035863,"CC Région Lézignanaise, Corbières et Minervois",1982_1990,1986,8,23046,23905,2928,1840,859,-1088,1947,0.00458490660312716,-0.00580719253108539,0.0103920991342125,EPCI
200035863,"CC Région Lézignanaise, Corbières et Minervois",1990_1999,1994.5,9,23905,25035,2942,2080,1130,-862,1992,0.00514510233562904,-0.00392484797638251,0.00906995031201154,EPCI
200035863,"CC Région Lézignanaise, Corbières et Minervois",1999_2006,2002.5,7,25035,28319,2412,1806,3284,-606,3890,0.0177642417485946,-0.00327805435433871,0.0210422961029333,EPCI
200035970,CC Vexin Centre,2006_2011,2008.5,5,23241,23820,689,1312,579,623,-44,0.00493365129709167,0.00530857471172385,-0.000374923414632182,EPCI
200035970,CC Vexin Centre,2011_2016,2013.5,5,23820,24918,775,1370,1098,595,503,0.00905371314163039,0.00490615602847913,0.00414755711315126,EPCI
200035970,CC Vexin Centre,1968_1975,1971.5,7,14338,15604,1210,1568,1266,358,908,0.0121610567342996,0.00343890861838803,0.00872214811591154,EPCI
200035970,CC Vexin Centre,1975_1982,1978.5,7,15604,17576,1119,1401,1972,282,1690,0.017146345782886,0.00245196222655875,0.0146943835563272,EPCI
200035970,CC Vexin Centre,1982_1990,1986,8,17576,20147,1349,1776,2571,427,2144,0.0172115735544445,0.00285855383420762,0.0143530197202369,EPCI
200035970,CC Vexin Centre,1990_1999,1994.5,9,20147,22227,1252,2367,2080,1115,965,0.0109767373625143,0.00588416449961702,0.00509257286289724,EPCI
200035970,CC Vexin Centre,1999_2006,2002.5,7,22227,23241,996,1863,1014,867,147,0.00639323492530353,0.0054664050100968,0.000926829915206724,EPCI
200036069,CC du Pays de Mortagne-au-Perche,2006_2011,2008.5,5,14675,14718,801,760,43,-41,84,0.000585345005614579,-0.000558119656516227,0.00114346466213081,EPCI
200036069,CC du Pays de Mortagne-au-Perche,2011_2016,2013.5,5,14718,13918,856,616,-800,-240,-560,-0.0111154157530974,-0.00333462472592921,-0.00778079102716817,EPCI
200036069,CC du Pays de Mortagne-au-Perche,1968_1975,1971.5,7,14589,14637,1189,1622,48,433,-385,0.000469360030972199,0.00423401861272838,-0.00376465858175618,EPCI
200036069,CC du Pays de Mortagne-au-Perche,1975_1982,1978.5,7,14637,14819,1125,1388,182,263,-81,0.00176692656498201,0.0025533059702762,-0.00078637940529419,EPCI
200036069,CC du Pays de Mortagne-au-Perche,1982_1990,1986,8,14819,14733,1240,1451,-86,211,-297,-0.000727268597254582,0.00178434504675252,-0.0025116136440071,EPCI
200036069,CC du Pays de Mortagne-au-Perche,1990_1999,1994.5,9,14733,14736,1365,1470,3,105,-102,2.26228989754773e-05,0.000791801464141706,-0.000769178565166229,EPCI
200036069,CC du Pays de Mortagne-au-Perche,1999_2006,2002.5,7,14736,14675,1087,1130,-61,43,-104,-0.000592412140136056,0.000417602000423777,-0.00101001414055983,EPCI
200036077,CC du Golfe de Saint-Tropez,2006_2011,2008.5,5,55219,54990,2801,2938,-229,137,-366,-0.000830803978635109,0.000497031201192183,-0.00132783517982729,EPCI
200036077,CC du Golfe de Saint-Tropez,2011_2016,2013.5,5,54990,57448,3083,2828,2458,-255,2713,0.00878412402303508,-0.000911290327857586,0.00969541435089266,EPCI
200036077,CC du Golfe de Saint-Tropez,1968_1975,1971.5,7,25653,29865,2127,2618,4212,491,3721,0.0219556549033817,0.00255940801461548,0.0193962468887662,EPCI
200036077,CC du Golfe de Saint-Tropez,1975_1982,1978.5,7,29865,35943,2391,2577,6078,186,5892,0.0268171526961054,0.000820663113108853,0.0259964895829966,EPCI
200036077,CC du Golfe de Saint-Tropez,1982_1990,1986,8,35943,43399,3158,3917,7456,759,6697,0.0238425511268414,0.00242710519115781,0.0214154459356836,EPCI
200036077,CC du Golfe de Saint-Tropez,1990_1999,1994.5,9,43399,48396,4294,5076,4997,782,4215,0.0121825844764503,0.00190650011218413,0.0102760843642661,EPCI
200036077,CC du Golfe de Saint-Tropez,1999_2006,2002.5,7,48396,55219,3814,4076,6823,262,6561,0.0190200383362089,0.000730360551676203,0.0182896777845327,EPCI
200036135,CC Coeur de France,2006_2011,2008.5,5,20857,19825,1406,886,-1032,-520,-512,-0.0100978421169563,-0.00508805998141209,-0.00500978213554421,EPCI
200036135,CC Coeur de France,2011_2016,2013.5,5,19825,18673,1303,745,-1152,-558,-594,-0.0119016359716801,-0.00576485492378257,-0.00613678104789758,EPCI
200036135,CC Coeur de France,1968_1975,1971.5,7,20674,21383,2048,2295,709,247,462,0.00482866943991311,0.00168220218851698,0.00314646725139613,EPCI
200036135,CC Coeur de France,1975_1982,1978.5,7,21383,21428,2135,1759,45,-376,421,0.000300368560349984,-0.00250974619314653,0.00281011475349652,EPCI
200036135,CC Coeur de France,1982_1990,1986,8,21428,21287,2215,1860,-141,-355,214,-0.000824899616613473,-0.00207687492126087,0.0012519753046474,EPCI
200036135,CC Coeur de France,1990_1999,1994.5,9,21287,20758,2411,1924,-529,-487,-42,-0.00279218826058503,-0.00257050223611514,-0.000221686024469889,EPCI
200036135,CC Coeur de France,1999_2006,2002.5,7,20758,20857,1974,1492,99,-482,581,0.000679932302299235,-0.00331037747180032,0.00399030977409955,EPCI
200036150,CC des Hauts du Val de Saône,2006_2011,2008.5,5,9055,9068,567,430,13,-137,150,0.000286969429832196,-0.00302421629900083,0.00331118572883303,EPCI
200036150,CC des Hauts du Val de Saône,2011_2016,2013.5,5,9068,8694,600,391,-374,-209,-165,-0.00838833990004562,-0.00468760170884902,-0.0037007381911966,EPCI
200036150,CC des Hauts du Val de Saône,1968_1975,1971.5,7,11714,10698,1202,1093,-1016,-109,-907,-0.0128774948012635,-0.00138154225722217,-0.0114959525440414,EPCI
200036150,CC des Hauts du Val de Saône,1975_1982,1978.5,7,10698,9998,1130,734,-700,-396,-304,-0.00962081172930429,-0.005442630635435,-0.00417818109386929,EPCI
200036150,CC des Hauts du Val de Saône,1982_1990,1986,8,9998,9276,1146,836,-722,-310,-412,-0.00932557627118191,-0.00400405629372077,-0.00532151997746115,EPCI
200036150,CC des Hauts du Val de Saône,1990_1999,1994.5,9,9276,9189,1152,813,-87,-339,252,-0.00104648570424826,-0.00407768567517424,0.00303119997092598,EPCI
200036150,CC des Hauts du Val de Saône,1999_2006,2002.5,7,9189,9055,851,672,-134,-179,45,-0.00209637455717782,-0.00280038093831962,0.000704006381141804,EPCI
200036465,CC de Thann-Cernay,2006_2011,2008.5,5,36818,37694,1544,2220,876,676,200,0.00471389050341342,0.00363765979487154,0.00107623070854188,EPCI
200036465,CC de Thann-Cernay,2011_2016,2013.5,5,37694,37806,1767,2015,112,248,-136,0.000593554002211061,0.00131429814775306,-0.000720744145542003,EPCI
200036465,CC de Thann-Cernay,1968_1975,1971.5,7,30779,32352,2501,3687,1573,1186,387,0.00714586838969122,0.00538779396705263,0.00175807442263859,EPCI
200036465,CC de Thann-Cernay,1975_1982,1978.5,7,32352,32961,2494,3336,609,842,-233,0.0026677237088486,0.00368837990615849,-0.00102065619730989,EPCI
200036465,CC de Thann-Cernay,1982_1990,1986,8,32961,34000,2529,3818,1039,1289,-250,0.00388696977710579,0.00482223680720824,-0.000935267030102452,EPCI
200036465,CC de Thann-Cernay,1990_1999,1994.5,9,34000,35495,2811,3991,1495,1180,315,0.00479270588060854,0.00378287153118266,0.00100983434942588,EPCI
200036465,CC de Thann-Cernay,1999_2006,2002.5,7,35495,36818,2242,3039,1323,797,526,0.00524154831951051,0.00315760696194246,0.00208394135756805,EPCI
200036473,CA de Saintes,2006_2011,2008.5,5,57677,58909,2990,2864,1232,-126,1358,0.00423602666710265,-0.00043323000004459,0.00466925666714725,EPCI
200036473,CA de Saintes,2011_2016,2013.5,5,58909,59716,3159,2759,807,-400,1207,0.00272492805550018,-0.00135064587633218,0.00407557393183236,EPCI
200036473,CA de Saintes,1968_1975,1971.5,7,45946,47640,3753,4763,1694,1010,684,0.00518567798457492,0.00309181509115742,0.0020938628934175,EPCI
200036473,CA de Saintes,1975_1982,1978.5,7,47640,49452,3722,4534,1812,812,1000,0.00534706733096146,0.0023961471703867,0.00295092016057476,EPCI
200036473,CA de Saintes,1982_1990,1986,8,49452,52210,4095,4907,2758,812,1946,0.00680700622546526,0.00200409320343647,0.00480291302202879,EPCI
200036473,CA de Saintes,1990_1999,1994.5,9,52210,53354,4644,4995,1144,351,793,0.0024112250145687,0.000739807674924486,0.00167141733964421,EPCI
200036473,CA de Saintes,1999_2006,2002.5,7,53354,57677,3903,3940,4323,37,4286,0.0111921008467752,9.57917490933805e-05,0.0110963090976819,EPCI
200036499,CC de Marana-Golo,2006_2011,2008.5,5,17990,21197,588,1205,3207,617,2590,0.0333528635495557,0.00641681222640345,0.0269360513231522,EPCI
200036499,CC de Marana-Golo,2011_2016,2013.5,5,21197,23720,645,1355,2523,710,1813,0.0227466295865351,0.00640115220231466,0.0163454773842204,EPCI
200036499,CC de Marana-Golo,1968_1975,1971.5,7,5351,7913,320,526,2562,206,2356,0.0574803750562838,0.00462176317782766,0.0528586118784561,EPCI
200036499,CC de Marana-Golo,1975_1982,1978.5,7,7913,9920,364,695,2007,331,1676,0.0328193313666967,0.00541265504851849,0.0274066763181782,EPCI
200036499,CC de Marana-Golo,1982_1990,1986,8,9920,11903,554,1138,1983,584,1399,0.0230411320933968,0.00678568892715265,0.0162554431662441,EPCI
200036499,CC de Marana-Golo,1990_1999,1994.5,9,11903,14925,801,1529,3022,728,2294,0.0254572151319721,0.0061326448100846,0.0193245703218875,EPCI
200036499,CC de Marana-Golo,1999_2006,2002.5,7,14925,17990,743,1507,3065,764,2301,0.0270417956510831,0.00674059767615905,0.0203011979749241,EPCI
200036523,CC des Bastides en Haut-Agenais Périgord,2006_2011,2008.5,5,16806,17276,1119,713,470,-406,876,0.00553170158993588,-0.00477844860747652,0.0103101501974124,EPCI
200036523,CC des Bastides en Haut-Agenais Périgord,2011_2016,2013.5,5,17276,17110,1184,687,-166,-497,331,-0.00192917019332228,-0.00577588907277816,0.00384671887945588,EPCI
200036523,CC des Bastides en Haut-Agenais Périgord,1968_1975,1971.5,7,17038,15695,1601,1256,-1343,-345,-998,-0.0116606180196069,-0.00299546777123186,-0.00866515024837507,EPCI
200036523,CC des Bastides en Haut-Agenais Périgord,1975_1982,1978.5,7,15695,15711,1510,1049,16,-461,477,0.000145569690173986,-0.00419422669813796,0.00433979638831195,EPCI
200036523,CC des Bastides en Haut-Agenais Périgord,1982_1990,1986,8,15711,16059,1785,1225,348,-560,908,0.00274229524576386,-0.0044128889012292,0.00715518414699306,EPCI
200036523,CC des Bastides en Haut-Agenais Périgord,1990_1999,1994.5,9,16059,15939,1908,1277,-120,-631,511,-0.000833042154502417,-0.00438041332909188,0.00354737117458946,EPCI
200036523,CC des Bastides en Haut-Agenais Périgord,1999_2006,2002.5,7,15939,16806,1511,1026,867,-485,1352,0.00759541843808553,-0.00424887882638003,0.0118442972644656,EPCI
200036549,CC Val de Gray,2006_2011,2008.5,5,21502,21365,1234,1151,-137,-83,-54,-0.00127756021762715,-0.000773996336226667,-0.000503563881400482,EPCI
200036549,CC Val de Gray,2011_2016,2013.5,5,21365,20535,1287,1022,-830,-265,-565,-0.00789334696621691,-0.00252016499523793,-0.00537318197097898,EPCI
200036549,CC Val de Gray,1968_1975,1971.5,7,21653,22844,1802,3016,1191,1214,-23,0.00767854250865274,0.00782682670487358,-0.000148284196220835,EPCI
200036549,CC Val de Gray,1975_1982,1978.5,7,22844,22322,1763,2473,-522,710,-1232,-0.00329680521655573,0.00448416035202025,-0.00778096556857598,EPCI
200036549,CC Val de Gray,1982_1990,1986,8,22322,21721,1933,2363,-601,430,-1031,-0.0034058375217223,0.00243678890905256,-0.00584262643077486,EPCI
200036549,CC Val de Gray,1990_1999,1994.5,9,21721,21649,2118,2481,-72,363,-435,-0.000368850904024609,0.00185962330779074,-0.00222847421181535,EPCI
200036549,CC Val de Gray,1999_2006,2002.5,7,21649,21502,1667,1833,-147,166,-313,-0.000972856459761307,0.00109859981170324,-0.00207145627146455,EPCI
200036572,CC Porte d'Aquitaine en Pays de Serres,2006_2011,2008.5,5,4941,5168,216,258,227,42,185,0.00902407901474156,0.00166965338598743,0.00735442562875413,EPCI
200036572,CC Porte d'Aquitaine en Pays de Serres,2011_2016,2013.5,5,5168,5316,265,275,148,10,138,0.0056630496575667,0.000382638490376128,0.00528041116719057,EPCI
200036572,CC Porte d'Aquitaine en Pays de Serres,1968_1975,1971.5,7,4201,3788,406,270,-413,-136,-277,-0.0146747488707722,-0.00483236282427367,-0.00984238604649858,EPCI
200036572,CC Porte d'Aquitaine en Pays de Serres,1975_1982,1978.5,7,3788,4011,406,307,223,-99,322,0.008205253138869,-0.00364269085537233,0.0118479439942413,EPCI
200036572,CC Porte d'Aquitaine en Pays de Serres,1982_1990,1986,8,4011,4431,409,452,420,43,377,0.0125258881133286,0.00128241235445983,0.0112434757588687,EPCI
200036572,CC Porte d'Aquitaine en Pays de Serres,1990_1999,1994.5,9,4431,4593,445,438,162,-7,169,0.00399776015663944,-0.000172742722817754,0.00417050287945719,EPCI
200036572,CC Porte d'Aquitaine en Pays de Serres,1999_2006,2002.5,7,4593,4941,353,343,348,-10,358,0.0104880948628192,-0.000301382036287908,0.0107894768991071,EPCI
200037059,CC de la Haute-Somme,2006_2011,2008.5,5,28071,27904,1599,1699,-167,100,-267,-0.0011926816362885,0.000714180620532033,-0.00190686225682053,EPCI
200037059,CC de la Haute-Somme,2011_2016,2013.5,5,27904,27655,1706,1615,-249,-91,-158,-0.0017910949275991,-0.000654576861090435,-0.00113651806650867,EPCI
200037059,CC de la Haute-Somme,1968_1975,1971.5,7,29165,29078,2512,3571,-87,1059,-1146,-0.000426692611713353,0.00519387903223495,-0.0056205716439483,EPCI
200037059,CC de la Haute-Somme,1975_1982,1978.5,7,29078,29486,2533,3107,408,574,-166,0.00199251097687858,0.00280318946256938,-0.000810678485690795,EPCI
200037059,CC de la Haute-Somme,1982_1990,1986,8,29486,28563,2696,3412,-923,716,-1639,-0.00396753351567747,0.0030777399753251,-0.00704527349100257,EPCI
200037059,CC de la Haute-Somme,1990_1999,1994.5,9,28563,28263,2745,3292,-300,547,-847,-0.00117249489420879,0.00213784902377402,-0.00331034391798281,EPCI
200037059,CC de la Haute-Somme,1999_2006,2002.5,7,28263,28071,2290,2545,-192,255,-447,-0.000973313704461076,0.00129268226373737,-0.00226599596819844,EPCI
200037133,CC du Provinois,2006_2011,2008.5,5,32917,34299,1494,2209,1382,715,667,0.00825931299158333,0.00427308884875693,0.0039862241428264,EPCI
200037133,CC du Provinois,2011_2016,2013.5,5,34299,34655,1603,2132,356,529,-173,0.00206729714669152,0.00307191064775228,-0.00100461350106076,EPCI
200037133,CC du Provinois,1968_1975,1971.5,7,26678,26928,2197,3190,250,993,-743,0.00133337125427757,0.00529615062199051,-0.00396277936771294,EPCI
200037133,CC du Provinois,1975_1982,1978.5,7,26928,27959,2072,2575,1031,503,528,0.00538193283192112,0.00262571504796928,0.00275621778395184,EPCI
200037133,CC du Provinois,1982_1990,1986,8,27959,29707,2500,3307,1748,807,941,0.00760924892329684,0.00351296560703693,0.00409628331625991,EPCI
200037133,CC du Provinois,1990_1999,1994.5,9,29707,31426,2607,3763,1719,1156,563,0.00626989261182831,0.00421640247776238,0.00205349013406593,EPCI
200037133,CC du Provinois,1999_2006,2002.5,7,31426,32917,2000,2894,1491,894,597,0.00664392586988383,0.00398368190991022,0.0026602439599736,EPCI
200038958,CC de la Pieve de l'Ornano,2006_2011,2008.5,5,10548,11166,627,396,618,-231,849,0.011452519335807,-0.00428079606241331,0.0157333153982204,EPCI
200038958,CC de la Pieve de l'Ornano,2011_2016,2013.5,5,11166,12199,679,422,1033,-257,1290,0.0178536106509193,-0.0044417985840138,0.0222954092349331,EPCI
200038958,CC de la Pieve de l'Ornano,1968_1975,1971.5,7,6808,6775,725,381,-33,-344,311,-0.000693905494052904,-0.00723343908952119,0.00653953359546828,EPCI
200038958,CC de la Pieve de l'Ornano,1975_1982,1978.5,7,6775,7413,800,454,638,-346,984,0.0129395506007686,-0.00701737383678045,0.019956924437549,EPCI
200038958,CC de la Pieve de l'Ornano,1982_1990,1986,8,7413,7787,961,634,374,-327,701,0.00617152347386551,-0.00539595768971664,0.0115674811635822,EPCI
200038958,CC de la Pieve de l'Ornano,1990_1999,1994.5,9,7787,8877,1017,717,1090,-300,1390,0.0146629037833665,-0.00403566159175226,0.0186985653751188,EPCI
200038958,CC de la Pieve de l'Ornano,1999_2006,2002.5,7,8877,10548,848,561,1671,-287,1958,0.0249449909374437,-0.00428438803054839,0.0292293789679921,EPCI
200038990,CC de Saint-Méen Montauban,2006_2011,2008.5,5,22399,25038,1044,1882,2639,838,1801,0.0225256264525373,0.00715288933960828,0.015372737112929,EPCI
200038990,CC de Saint-Méen Montauban,2011_2016,2013.5,5,25038,26303,1173,1751,1265,578,687,0.009906412891447,0.00452640841996551,0.00538000447148149,EPCI
200038990,CC de Saint-Méen Montauban,1968_1975,1971.5,7,18089,17945,1639,1939,-144,300,-444,-0.00114113328594057,0.00237736101237618,-0.00351849429831674,EPCI
200038990,CC de Saint-Méen Montauban,1975_1982,1978.5,7,17945,18586,1653,1767,641,114,527,0.00502645969518079,0.000893941349844945,0.00413251834533584,EPCI
200038990,CC de Saint-Méen Montauban,1982_1990,1986,8,18586,18996,1798,2016,410,218,192,0.00273120064523758,0.00145219936746778,0.00127900127776979,EPCI
200038990,CC de Saint-Méen Montauban,1990_1999,1994.5,9,18996,19274,1874,1900,278,26,252,0.00161559330494643,0.00015109865441945,0.00146449465052698,EPCI
200038990,CC de Saint-Méen Montauban,1999_2006,2002.5,7,19274,22399,1403,2027,3125,624,2501,0.0216976546569976,0.00433258768190928,0.0173650669750883,EPCI
200039022,CA Vitré Communauté,2006_2011,2008.5,5,72165,77036,2820,5585,4871,2765,2106,0.0131492370165625,0.0074641018991573,0.00568513511740516,EPCI
200039022,CA Vitré Communauté,2011_2016,2013.5,5,77036,80368,2964,5314,3332,2350,982,0.00850460883235105,0.00599814848620197,0.00250646034614908,EPCI
200039022,CA Vitré Communauté,1968_1975,1971.5,7,50813,51766,3807,6556,953,2749,-1796,0.0026580027773313,0.00766720843114769,-0.00500920565381639,EPCI
200039022,CA Vitré Communauté,1975_1982,1978.5,7,51766,55360,3866,6246,3594,2380,1214,0.00963522967957631,0.00638059171880679,0.00325463796076952,EPCI
200039022,CA Vitré Communauté,1982_1990,1986,8,55360,59690,4096,7052,4330,2956,1374,0.00945784424919149,0.00645667150129563,0.00300117274789587,EPCI
200039022,CA Vitré Communauté,1990_1999,1994.5,9,59690,64989,4555,7947,5299,3392,1907,0.00949518735346566,0.00607806671125788,0.00341712064220778,EPCI
200039022,CA Vitré Communauté,1999_2006,2002.5,7,64989,72165,3743,7563,7176,3820,3356,0.0150749462427402,0.00802484596533829,0.00705010027740191,EPCI
200039055,CC Ouche et Montagne,2006_2011,2008.5,5,9940,10488,457,640,548,183,365,0.0107907498341753,0.0036034803278359,0.00718726950633937,EPCI
200039055,CC Ouche et Montagne,2011_2016,2013.5,5,10488,10666,408,577,178,169,9,0.00337154405514917,0.00320107272651803,0.000170471328631138,EPCI
200039055,CC Ouche et Montagne,1968_1975,1971.5,7,6098,6054,646,523,-44,-123,79,-0.00103398477847194,-0.0028904574489102,0.00185647267043826,EPCI
200039055,CC Ouche et Montagne,1975_1982,1978.5,7,6054,7401,635,539,1347,-96,1443,0.0291152129443859,-0.00207502631229476,0.0311902392566807,EPCI
200039055,CC Ouche et Montagne,1982_1990,1986,8,7401,8510,699,749,1109,50,1059,0.0176065517802035,0.000793803055915399,0.0168127487242881,EPCI
200039055,CC Ouche et Montagne,1990_1999,1994.5,9,8510,9432,878,879,922,1,921,0.0114951472863112,1.2467621785587e-05,0.0114826796645256,EPCI
200039055,CC Ouche et Montagne,1999_2006,2002.5,7,9432,9940,674,747,508,73,435,0.00752227370538372,0.0010809566545138,0.00644131705086992,EPCI
200039063,"CC Forêts, Seine et Suzon",2006_2011,2008.5,5,6372,6652,390,352,280,-38,318,0.00863792729666368,-0.00117229013311864,0.00981021742978233,EPCI
200039063,"CC Forêts, Seine et Suzon",2011_2016,2013.5,5,6652,6902,445,324,250,-121,371,0.0074060225973287,-0.00358451493710709,0.0109905375344358,EPCI
200039063,"CC Forêts, Seine et Suzon",1968_1975,1971.5,7,4463,4734,366,477,271,111,160,0.00845689137287331,0.00346389277634294,0.00499299859653037,EPCI
200039063,"CC Forêts, Seine et Suzon",1975_1982,1978.5,7,4734,5195,305,395,461,90,371,0.0133636652004316,0.00260895849899967,0.010754706701432,EPCI
200039063,"CC Forêts, Seine et Suzon",1982_1990,1986,8,5195,5558,357,534,363,177,186,0.00847845356112109,0.0041341219843483,0.00434433157677279,EPCI
200039063,"CC Forêts, Seine et Suzon",1990_1999,1994.5,9,5558,5892,400,601,334,201,133,0.00650519717689524,0.00391480428908965,0.00259039288780559,EPCI
200039063,"CC Forêts, Seine et Suzon",1999_2006,2002.5,7,5892,6372,355,493,480,138,342,0.0112510932649115,0.00323468931366205,0.00801640395124942,EPCI
200039204,CC de Lacq-Orthez,2006_2011,2008.5,5,51429,53228,2394,2677,1799,283,1516,0.00690016881503186,0.00108546290975765,0.00581470590527421,EPCI
200039204,CC de Lacq-Orthez,2011_2016,2013.5,5,53228,53388,2522,2522,160,0,160,0.000600465793531013,0,0.000600465793531013,EPCI
200039204,CC de Lacq-Orthez,1968_1975,1971.5,7,51573,50674,3358,5312,-899,1954,-2853,-0.00250903583473094,0.00545345497337516,-0.0079624908081061,EPCI
200039204,CC de Lacq-Orthez,1975_1982,1978.5,7,50674,50779,3391,4076,105,685,-580,0.000295747259354773,0.00192939878721923,-0.00163365152786446,EPCI
200039204,CC de Lacq-Orthez,1982_1990,1986,8,50779,49270,3949,4560,-1509,611,-2120,-0.00376383728249063,0.00152399243181032,-0.00528782971430096,EPCI
200039204,CC de Lacq-Orthez,1990_1999,1994.5,9,49270,49656,4373,4595,386,222,164,0.000867470763698863,0.000498908055806082,0.000368562707892781,EPCI
200039204,CC de Lacq-Orthez,1999_2006,2002.5,7,49656,51429,3421,3738,1773,317,1456,0.00502443558060906,0.000898333941936306,0.00412610163867275,EPCI
200039519,CC du Quercy Blanc,2006_2011,2008.5,5,7834,7966,411,321,132,-90,222,0.00334744010902521,-0.00228234552888083,0.00562978563790604,EPCI
200039519,CC du Quercy Blanc,2011_2016,2013.5,5,7966,7742,467,290,-224,-177,-47,-0.00568824683193547,-0.00449473075559187,-0.0011935160763436,EPCI
200039519,CC du Quercy Blanc,1968_1975,1971.5,7,7638,7079,666,566,-559,-100,-459,-0.0107988596873335,-0.00193181747537272,-0.0088670422119608,EPCI
200039519,CC du Quercy Blanc,1975_1982,1978.5,7,7079,6988,718,407,-91,-311,220,-0.0018466161197378,-0.00631096278284017,0.00446434666310237,EPCI
200039519,CC du Quercy Blanc,1982_1990,1986,8,6988,7158,771,555,170,-216,386,0.00300904562558113,-0.00382325797132661,0.00683230359690774,EPCI
200039519,CC du Quercy Blanc,1990_1999,1994.5,9,7158,7389,806,552,231,-254,485,0.00353532294910774,-0.00388732480118341,0.00742264775029115,EPCI
200039519,CC du Quercy Blanc,1999_2006,2002.5,7,7389,7834,619,488,445,-131,576,0.0083893993394204,-0.00246968834486308,0.0108590876842835,EPCI
200039642,CC Le Tonnerrois en Bourgogne,2006_2011,2008.5,5,17950,17684,1383,913,-266,-470,204,-0.0029815142260643,-0.00526808904605346,0.00228657481998916,EPCI
200039642,CC Le Tonnerrois en Bourgogne,2011_2016,2013.5,5,17684,16475,1326,744,-1209,-582,-627,-0.0140634122900911,-0.00676998010987016,-0.00729343218022095,EPCI
200039642,CC Le Tonnerrois en Bourgogne,1968_1975,1971.5,7,20359,20209,2194,2144,-150,-50,-100,-0.00105587429010423,-0.00035195809670141,-0.00070391619340282,EPCI
200039642,CC Le Tonnerrois en Bourgogne,1975_1982,1978.5,7,20209,19394,2266,1865,-815,-401,-414,-0.00586335871671362,-0.00288491637472658,-0.00297844234198704,EPCI
200039642,CC Le Tonnerrois en Bourgogne,1982_1990,1986,8,19394,18907,2252,1847,-487,-405,-82,-0.00317389202385066,-0.00263947899314069,-0.000534413030709967,EPCI
200039642,CC Le Tonnerrois en Bourgogne,1990_1999,1994.5,9,18907,18825,2496,1953,-82,-543,461,-0.00048282231264607,-0.00319722580203434,0.00271440348938827,EPCI
200039642,CC Le Tonnerrois en Bourgogne,1999_2006,2002.5,7,18825,17950,1903,1403,-875,-500,-375,-0.00677631634074793,-0.00387218076614168,-0.00290413557460626,EPCI
200039709,CC du Serein,2006_2011,2008.5,5,7840,7858,615,356,18,-259,277,0.000458762554157666,-0.00660108341815752,0.00705984597231519,EPCI
200039709,CC du Serein,2011_2016,2013.5,5,7858,7497,619,277,-361,-342,-19,-0.00936173960964004,-0.00886901647229056,-0.000492723137349476,EPCI
200039709,CC du Serein,1968_1975,1971.5,7,8105,7460,1090,583,-645,-507,-138,-0.0117766405081151,-0.00925698719009978,-0.00251965331801533,EPCI
200039709,CC du Serein,1975_1982,1978.5,7,7460,6965,1035,441,-495,-594,99,-0.00976031405404287,-0.0117123768648514,0.00195206281080857,EPCI
200039709,CC du Serein,1982_1990,1986,8,6965,6887,970,531,-78,-439,361,-0.00140676341303359,-0.00791755305540697,0.00651078964237339,EPCI
200039709,CC du Serein,1990_1999,1994.5,9,6887,7645,1063,591,758,-472,1230,0.0116693689700123,-0.00726641445098388,0.0189357834209961,EPCI
200039709,CC du Serein,1999_2006,2002.5,7,7645,7840,824,518,195,-306,501,0.00360462322457122,-0.005656485675481,0.00926110890005222,EPCI
200039758,"CC Avallon, Vézelay, Morvan",2006_2011,2008.5,5,20370,20219,1200,930,-151,-270,119,-0.00148698810669523,-0.00265885290601134,0.00117186479931611,EPCI
200039758,"CC Avallon, Vézelay, Morvan",2011_2016,2013.5,5,20219,19217,1236,913,-1002,-323,-679,-0.0101139965233986,-0.00326030027650474,-0.00685369624689387,EPCI
200039758,"CC Avallon, Vézelay, Morvan",1968_1975,1971.5,7,20152,21049,2174,2108,897,-66,963,0.00624075199505803,-0.000459185765522664,0.00669993776058069,EPCI
200039758,"CC Avallon, Vézelay, Morvan",1975_1982,1978.5,7,21049,21247,2178,1833,198,-345,543,0.00133841714923766,-0.00233209048730804,0.0036705076365457,EPCI
200039758,"CC Avallon, Vézelay, Morvan",1982_1990,1986,8,21247,21012,2339,2187,-235,-152,-83,-0.00138928477936673,-0.00089860121899465,-0.000490683560372079,EPCI
200039758,"CC Avallon, Vézelay, Morvan",1990_1999,1994.5,9,21012,20847,2296,2141,-165,-155,-10,-0.000875577579322773,-0.000822512271485029,-5.30653078377438e-05,EPCI
200039758,"CC Avallon, Vézelay, Morvan",1999_2006,2002.5,7,20847,20370,1738,1537,-477,-201,-276,-0.00330122789099907,-0.00139108345092414,-0.00191014444007493,EPCI
200039808,CC des Gorges de l'Ardèche,2006_2011,2008.5,5,13435,14365,775,640,930,-135,1065,0.0134762875829393,-0.00195623529429764,0.0154325228772369,EPCI
200039808,CC des Gorges de l'Ardèche,2011_2016,2013.5,5,14365,15020,914,635,655,-279,934,0.00895747095047916,-0.00381547235905906,0.0127729433095382,EPCI
200039808,CC des Gorges de l'Ardèche,1968_1975,1971.5,7,8599,8714,1030,686,115,-344,459,0.00189966068299618,-0.00568246326044076,0.00758212394343695,EPCI
200039808,CC des Gorges de l'Ardèche,1975_1982,1978.5,7,8714,9538,1007,541,824,-466,1290,0.0129912180972167,-0.00734697528313469,0.0203381933803514,EPCI
200039808,CC des Gorges de l'Ardèche,1982_1990,1986,8,9538,10063,1136,781,525,-355,880,0.00672016856186275,-0.00454411397992624,0.011264282541789,EPCI
200039808,CC des Gorges de l'Ardèche,1990_1999,1994.5,9,10063,11458,1221,928,1395,-293,1688,0.0145292994628174,-0.00305167365061327,0.0175809731134307,EPCI
200039808,CC des Gorges de l'Ardèche,1999_2006,2002.5,7,11458,13435,1044,794,1977,-250,2227,0.0229998037732215,-0.00290842232842963,0.0259082261016512,EPCI
200039824,CC Ardèche des Sources et Volcans,2006_2011,2008.5,5,9158,9604,621,407,446,-214,660,0.00955574012638416,-0.00458504122656101,0.0141407813529452,EPCI
200039824,CC Ardèche des Sources et Volcans,2011_2016,2013.5,5,9604,9627,617,377,23,-240,263,0.000478508936257116,-0.00499313672616121,0.00547164566241833,EPCI
200039824,CC Ardèche des Sources et Volcans,1968_1975,1971.5,7,9077,8652,1074,527,-425,-547,122,-0.00682705099673653,-0.00878681622403501,0.00195976522729849,EPCI
200039824,CC Ardèche des Sources et Volcans,1975_1982,1978.5,7,8652,8372,1072,450,-280,-622,342,-0.00468864575135986,-0.010415491633378,0.00572684588201811,EPCI
200039824,CC Ardèche des Sources et Volcans,1982_1990,1986,8,8372,8151,1057,514,-221,-543,322,-0.00333843816561319,-0.00820258789107675,0.00486414972546356,EPCI
200039824,CC Ardèche des Sources et Volcans,1990_1999,1994.5,9,8151,8206,1157,598,55,-559,614,0.00074749867217383,-0.00759730468627583,0.00834480335844966,EPCI
200039824,CC Ardèche des Sources et Volcans,1999_2006,2002.5,7,8206,9158,796,507,952,-289,1241,0.0158038984330906,-0.00479761202433108,0.0206015104574217,EPCI
200039832,CC Pays des Vans en Cévennes,2006_2011,2008.5,5,8426,8815,569,310,389,-259,648,0.00906739243942867,-0.00603715846224171,0.0151045509016704,EPCI
200039832,CC Pays des Vans en Cévennes,2011_2016,2013.5,5,8815,9193,624,310,378,-314,692,0.00843285972808894,-0.00700507395402097,0.0154379336821099,EPCI
200039832,CC Pays des Vans en Cévennes,1968_1975,1971.5,7,7746,7341,897,435,-405,-462,57,-0.00764229204126055,-0.00871787388410462,0.00107558184284408,EPCI
200039832,CC Pays des Vans en Cévennes,1975_1982,1978.5,7,7341,7477,885,412,136,-473,609,0.00262580839601934,-0.00913240714203784,0.0117582155380572,EPCI
200039832,CC Pays des Vans en Cévennes,1982_1990,1986,8,7477,7568,876,523,91,-353,444,0.00151329258984134,-0.00587024488147246,0.0073835374713138,EPCI
200039832,CC Pays des Vans en Cévennes,1990_1999,1994.5,9,7568,7734,1049,540,166,-509,675,0.00241372629554881,-0.00740112460502618,0.00981485090057499,EPCI
200039832,CC Pays des Vans en Cévennes,1999_2006,2002.5,7,7734,8426,780,471,692,-309,1001,0.0123175249466665,-0.0055001664863005,0.017817691432967,EPCI
200039857,CA du Pays de Grasse,2006_2011,2008.5,5,95556,101301,4096,6036,5745,1940,3805,0.0117452034951782,0.00396617837783214,0.00777902511734602,EPCI
200039857,CA du Pays de Grasse,2011_2016,2013.5,5,101301,101795,4505,5701,494,1196,-702,0.000973414284944241,0.00235668721618079,-0.00138327293123655,EPCI
200039857,CA du Pays de Grasse,1968_1975,1971.5,7,44136,51871,3981,4171,7735,190,7545,0.0233373068942404,0.000573249943103514,0.0227640569511369,EPCI
200039857,CA du Pays de Grasse,1975_1982,1978.5,7,51871,61792,4716,4517,9921,-199,10120,0.02531717688414,-0.000507823626644881,0.0258250005107849,EPCI
200039857,CA du Pays de Grasse,1982_1990,1986,8,61792,76039,6171,6743,14247,572,13675,0.0262732712572182,0.00105484039861928,0.025218430858599,EPCI
200039857,CA du Pays de Grasse,1990_1999,1994.5,9,76039,85528,7511,9525,9489,2014,7475,0.013152120546311,0.00279148179789971,0.0103606387484113,EPCI
200039857,CA du Pays de Grasse,1999_2006,2002.5,7,85528,95556,5667,7680,10028,2013,8015,0.0159644712838212,0.00320467497949063,0.0127597963043305,EPCI
200039865,Metz Métropole,2006_2011,2008.5,5,227105,223114,8752,13692,-3991,4940,-8931,-0.00353964344060476,0.00438131761377787,-0.00792096105438263,EPCI
200039865,Metz Métropole,2011_2016,2013.5,5,223114,222146,9005,13127,-968,4122,-5090,-0.000869227648754745,0.00370140120678415,-0.00457062885553889,EPCI
200039865,Metz Métropole,1968_1975,1971.5,7,182463,201632,11752,26724,19169,14972,4197,0.0143732938242169,0.0112263005444299,0.00314699327978707,EPCI
200039865,Metz Métropole,1975_1982,1978.5,7,201632,208807,12298,24943,7175,12645,-5470,0.00500765755687338,0.00882534213333295,-0.00381768457645957,EPCI
200039865,Metz Métropole,1982_1990,1986,8,208807,216909,13359,28575,8102,15216,-7114,0.00476978066020672,0.00895790946997106,-0.00418812880976433,EPCI
200039865,Metz Métropole,1990_1999,1994.5,9,216909,225297,14527,28224,8388,13697,-5309,0.0042246343832526,0.00689852374194217,-0.00267388935868956,EPCI
200039865,Metz Métropole,1999_2006,2002.5,7,225297,227105,11983,20146,1808,8163,-6355,0.00114249984649217,0.00515831097727633,-0.00401581113078416,EPCI
200039907,CC du Sud Messin,2006_2011,2008.5,5,14680,15324,512,863,644,351,293,0.00862381339763685,0.00470024612200394,0.00392356727563291,EPCI
200039907,CC du Sud Messin,2011_2016,2013.5,5,15324,16065,489,861,741,372,369,0.00948929367846607,0.00476385593574815,0.00472543774271792,EPCI
200039907,CC du Sud Messin,1968_1975,1971.5,7,7617,9363,676,884,1746,208,1538,0.0299222445381349,0.00356462019698285,0.026357624341152,EPCI
200039907,CC du Sud Messin,1975_1982,1978.5,7,9363,11191,677,886,1828,209,1619,0.0258050645435983,0.00295036022407661,0.0228547043195217,EPCI
200039907,CC du Sud Messin,1982_1990,1986,8,11191,12395,779,1356,1204,577,627,0.012854832246691,0.00616049684912021,0.00669433539757083,EPCI
200039907,CC du Sud Messin,1990_1999,1994.5,9,12395,13286,750,1258,891,508,383,0.00774289836818443,0.00441458178567642,0.00332831658250801,EPCI
200039907,CC du Sud Messin,1999_2006,2002.5,7,13286,14680,650,1047,1394,397,997,0.0143556631444526,0.00408837752392229,0.0102672856205303,EPCI
200039915,CA Cannes Pays de Lérins,2006_2011,2008.5,5,154851,157419,9716,8947,2568,-769,3337,0.00329495165856564,-0.000986689184360193,0.00428164084292583,EPCI
200039915,CA Cannes Pays de Lérins,2011_2016,2013.5,5,157419,158455,9946,8790,1036,-1156,2192,0.00131278115852362,-0.00146484075217501,0.00277762191069863,EPCI
200039915,CA Cannes Pays de Lérins,1968_1975,1971.5,7,103586,123244,10085,9105,19658,-980,20638,0.0251340870435832,-0.00125299650537753,0.0263870835489608,EPCI
200039915,CA Cannes Pays de Lérins,1975_1982,1978.5,7,123244,135160,12021,9171,11916,-2850,14766,0.0132720349481541,-0.00317432860038932,0.0164463635485434,EPCI
200039915,CA Cannes Pays de Lérins,1982_1990,1986,8,135160,141241,15399,11637,6081,-3762,9843,0.00551620721848556,-0.0034125919348697,0.00892879915335526,EPCI
200039915,CA Cannes Pays de Lérins,1990_1999,1994.5,9,141241,144679,17415,14597,3438,-2818,6256,0.0026757784187752,-0.00219323548112522,0.00486901389990042,EPCI
200039915,CA Cannes Pays de Lérins,1999_2006,2002.5,7,144679,154851,14041,11640,10172,-2401,12573,0.00975381408920839,-0.0023022913515719,0.0120561054407803,EPCI
200039931,CC Alpes d'Azur,2006_2011,2008.5,5,9180,9585,585,429,405,-156,561,0.00867181862132771,-0.00334025606154845,0.0120120746828762,EPCI
200039931,CC Alpes d'Azur,2011_2016,2013.5,5,9585,9662,616,411,77,-205,282,0.00160153902290805,-0.00426383765839156,0.00586537668129961,EPCI
200039931,CC Alpes d'Azur,1968_1975,1971.5,7,6265,5933,780,428,-332,-352,20,-0.00774819833301266,-0.00821495726873631,0.000466758935723654,EPCI
200039931,CC Alpes d'Azur,1975_1982,1978.5,7,5933,6374,703,318,441,-385,826,0.010295094797256,-0.00898778117220761,0.0192828759694636,EPCI
200039931,CC Alpes d'Azur,1982_1990,1986,8,6374,7385,776,484,1011,-292,1303,0.0185733405617985,-0.00536440696740372,0.0239377475292022,EPCI
200039931,CC Alpes d'Azur,1990_1999,1994.5,9,7385,7796,827,594,411,-233,644,0.00603590596158443,-0.0034218153018228,0.00945772126340723,EPCI
200039931,CC Alpes d'Azur,1999_2006,2002.5,7,7796,9180,793,524,1384,-269,1653,0.0236198354928947,-0.00459084952860453,0.0282106850214992,EPCI
200039949,CC Rives de Moselle,2006_2011,2008.5,5,48321,50520,1945,2906,2199,961,1238,0.00894033794895721,0.00390707811230008,0.00503325983665713,EPCI
200039949,CC Rives de Moselle,2011_2016,2013.5,5,50520,51388,2109,2978,868,869,-1,0.00341288762131819,0.00341681951949944,-3.93189818124204e-06,EPCI
200039949,CC Rives de Moselle,1968_1975,1971.5,7,46303,49079,2431,6047,2776,3616,-840,0.00835247329853561,0.0108798787635104,-0.00252740546497475,EPCI
200039949,CC Rives de Moselle,1975_1982,1978.5,7,49079,46468,2531,4652,-2611,2121,-4732,-0.00777920430188495,0.006319300009306,-0.0140985043111909,EPCI
200039949,CC Rives de Moselle,1982_1990,1986,8,46468,44783,2804,4759,-1685,1955,-3640,-0.00460627100887234,0.00534436784708928,-0.00995063885596162,EPCI
200039949,CC Rives de Moselle,1990_1999,1994.5,9,44783,47107,3174,5122,2324,1948,376,0.00563727517346435,0.00472522032612244,0.000912054847341909,EPCI
200039949,CC Rives de Moselle,1999_2006,2002.5,7,47107,48321,2676,3914,1214,1238,-24,0.00364156284256301,0.00371355420024135,-7.19913576783466e-05,EPCI
200040038,CC Saône Doubs Bresse,2006_2011,2008.5,5,10986,11785,535,649,799,114,685,0.0141402003877731,0.00201750043079616,0.0121226999569769,EPCI
200040038,CC Saône Doubs Bresse,2011_2016,2013.5,5,11785,12179,534,627,394,93,301,0.00659880092193688,0.00155758498918815,0.00504121593274873,EPCI
200040038,CC Saône Doubs Bresse,1968_1975,1971.5,7,9230,8572,881,761,-658,-120,-538,-0.010509806366676,-0.00191668201215975,-0.00859312435451622,EPCI
200040038,CC Saône Doubs Bresse,1975_1982,1978.5,7,8572,9083,905,590,511,-315,826,0.00830622929513236,-0.00512027833261584,0.0134265076277482,EPCI
200040038,CC Saône Doubs Bresse,1982_1990,1986,8,9083,9374,958,810,291,-148,439,0.00394970021046581,-0.00200878223762522,0.00595848244809104,EPCI
200040038,CC Saône Doubs Bresse,1990_1999,1994.5,9,9374,9847,986,868,473,-118,591,0.00548464598587573,-0.0013682626349542,0.00685290862082992,EPCI
200040038,CC Saône Doubs Bresse,1999_2006,2002.5,7,9847,10986,761,772,1139,11,1128,0.0157593019117752,0.00015219694559221,0.015607104966183,EPCI
200040095,CC Isle Vern Salembre en Périgord,2006_2011,2008.5,5,17983,18681,1053,892,698,-161,859,0.00764509511807887,-0.0017634101919924,0.00940850531007128,EPCI
200040095,CC Isle Vern Salembre en Périgord,2011_2016,2013.5,5,18681,19085,1160,863,404,-297,701,0.00428831293911469,-0.00315254688840857,0.00744085982752326,EPCI
200040095,CC Isle Vern Salembre en Périgord,1968_1975,1971.5,7,14255,14666,1255,1198,411,-57,468,0.00406885071692975,-0.000564293165121644,0.0046331438820514,EPCI
200040095,CC Isle Vern Salembre en Périgord,1975_1982,1978.5,7,14666,15201,1455,941,535,-514,1049,0.00513159684182862,-0.0049301696760746,0.0100617665179032,EPCI
200040095,CC Isle Vern Salembre en Périgord,1982_1990,1986,8,15201,15825,1624,1201,624,-423,1047,0.00504138433754098,-0.00341747688265999,0.00845886122020097,EPCI
200040095,CC Isle Vern Salembre en Périgord,1990_1999,1994.5,9,15825,16852,1928,1323,1027,-605,1632,0.00701094866239882,-0.00413011094523007,0.0111410596076289,EPCI
200040095,CC Isle Vern Salembre en Périgord,1999_2006,2002.5,7,16852,17983,1454,1135,1131,-319,1450,0.00932283555944924,-0.00262951772189594,0.0119523532813452,EPCI
200040111,CC Coeur de Chartreuse,2006_2011,2008.5,5,15792,16674,796,1008,882,212,670,0.0109287142960561,0.00262685649746474,0.00830185779859139,EPCI
200040111,CC Coeur de Chartreuse,2011_2016,2013.5,5,16674,16980,791,907,306,116,190,0.00364373449772848,0.00138128497299511,0.00226244952473337,EPCI
200040111,CC Coeur de Chartreuse,1968_1975,1971.5,7,12015,11763,1071,1126,-252,55,-307,-0.00302354232001745,0.000659900109527617,-0.00368344242954506,EPCI
200040111,CC Coeur de Chartreuse,1975_1982,1978.5,7,11763,12749,1042,1012,986,-30,1016,0.0115654868896129,-0.000351891081834064,0.011917377971447,EPCI
200040111,CC Coeur de Chartreuse,1982_1990,1986,8,12749,13609,1150,1243,860,93,767,0.00819319468444224,0.000886008262387358,0.00730718642205488,EPCI
200040111,CC Coeur de Chartreuse,1990_1999,1994.5,9,13609,14604,1293,1480,995,187,808,0.00787127523771103,0.0014793250949266,0.00639195014278443,EPCI
200040111,CC Coeur de Chartreuse,1999_2006,2002.5,7,14604,15792,1050,1335,1188,285,903,0.0112352204239865,0.00269531803100686,0.00853990239297964,EPCI
200040137,CC des Lacs de Champagne,2006_2011,2008.5,5,9932,9842,584,491,-90,-93,3,-0.00181892878075507,-0.00187955974011357,6.06309593585023e-05,EPCI
200040137,CC des Lacs de Champagne,2011_2016,2013.5,5,9842,9529,603,424,-313,-179,-134,-0.00644298678919342,-0.00368464739701477,-0.00275833939217865,EPCI
200040137,CC des Lacs de Champagne,1968_1975,1971.5,7,11888,11231,916,1246,-657,330,-987,-0.00808877635889782,0.00406285570538247,-0.0121516320642803,EPCI
200040137,CC des Lacs de Champagne,1975_1982,1978.5,7,11231,10874,986,966,-357,-20,-337,-0.0046041103327652,-0.000257933351975641,-0.00434617698078956,EPCI
200040137,CC des Lacs de Champagne,1982_1990,1986,8,10874,10379,1068,973,-495,-95,-400,-0.00580683537093796,-0.00111444315199819,-0.00469239221893976,EPCI
200040137,CC des Lacs de Champagne,1990_1999,1994.5,9,10379,9827,1079,1005,-552,-74,-478,-0.00605391571225045,-0.000811575657077053,-0.00524234005517339,EPCI
200040137,CC des Lacs de Champagne,1999_2006,2002.5,7,9827,9932,875,769,105,-106,211,0.00151946296805727,-0.00153393404394353,0.0030533970120008,EPCI
200040178,CC de l'Outre-Forêt,2006_2011,2008.5,5,15286,15845,597,855,559,258,301,0.00720918521883873,0.00332731625484865,0.00388186896399009,EPCI
200040178,CC de l'Outre-Forêt,2011_2016,2013.5,5,15845,16157,691,827,312,136,176,0.00390749425693926,0.00170326672738378,0.00220422752955548,EPCI
200040178,CC de l'Outre-Forêt,1968_1975,1971.5,7,12301,12450,1006,1427,149,421,-272,0.00172148906737712,0.00486407313668302,-0.00314258406930589,EPCI
200040178,CC de l'Outre-Forêt,1975_1982,1978.5,7,12450,12993,997,1266,543,269,274,0.00611722397272563,0.00303044797175542,0.00308677600097021,EPCI
200040178,CC de l'Outre-Forêt,1982_1990,1986,8,12993,13394,1089,1381,401,292,109,0.00380673911895491,0.00277198958287988,0.00103474953607502,EPCI
200040178,CC de l'Outre-Forêt,1990_1999,1994.5,9,13394,14386,1109,1446,992,337,655,0.00797033601734065,0.00270766455427802,0.00526267146306263,EPCI
200040178,CC de l'Outre-Forêt,1999_2006,2002.5,7,14386,15286,806,1128,900,322,578,0.00870652109725545,0.00311499977035139,0.00559152132690405,EPCI
200040202,CC Provence Verdon,2006_2011,2008.5,5,18885,20987,1107,1125,2102,18,2084,0.0213313777269286,0.000182666412504622,0.021148711314424,EPCI
200040202,CC Provence Verdon,2011_2016,2013.5,5,20987,22109,1158,1004,1122,-154,1276,0.0104707520505183,-0.00143716204614957,0.0119079140966679,EPCI
200040202,CC Provence Verdon,1968_1975,1971.5,7,8470,8465,830,702,-5,-128,123,-8.43525962431757e-05,-0.0021594264638253,0.00207507386758212,EPCI
200040202,CC Provence Verdon,1975_1982,1978.5,7,8465,9323,899,538,858,-361,1219,0.0138876135337918,-0.00584315674323872,0.0197307702770305,EPCI
200040202,CC Provence Verdon,1982_1990,1986,8,9323,12204,1197,895,2881,-302,3183,0.0342328174577411,-0.00358844528713565,0.0378212627448767,EPCI
200040202,CC Provence Verdon,1990_1999,1994.5,9,12204,14997,1701,1192,2793,-509,3302,0.0231626735152275,-0.00422119614008263,0.0273838696553101,EPCI
200040202,CC Provence Verdon,1999_2006,2002.5,7,14997,18885,1380,1232,3888,-148,4036,0.0334793411449075,-0.00127441936456952,0.034753760509477,EPCI
200040210,CC Lacs et Gorges du Verdon,2006_2011,2008.5,5,7214,8315,427,329,1101,-98,1199,0.028814847266732,-0.00256480929349658,0.0313796565602286,EPCI
200040210,CC Lacs et Gorges du Verdon,2011_2016,2013.5,5,8315,9067,474,310,752,-164,916,0.0174668594141196,-0.00380926189350481,0.0212761213076244,EPCI
200040210,CC Lacs et Gorges du Verdon,1968_1975,1971.5,7,3666,3803,445,248,137,-197,334,0.00525505670195892,-0.00755654138894822,0.0128115980909071,EPCI
200040210,CC Lacs et Gorges du Verdon,1975_1982,1978.5,7,3803,4484,429,233,681,-196,877,0.0238112488411626,-0.00685316413049614,0.0306644129716587,EPCI
200040210,CC Lacs et Gorges du Verdon,1982_1990,1986,8,4484,5445,486,404,961,-82,1043,0.0245697633463706,-0.00209648344890988,0.0266662467952805,EPCI
200040210,CC Lacs et Gorges du Verdon,1990_1999,1994.5,9,5445,6184,622,457,739,-165,904,0.0142412940489876,-0.00317972059280507,0.0174210146417926,EPCI
200040210,CC Lacs et Gorges du Verdon,1999_2006,2002.5,7,6184,7214,566,382,1030,-184,1214,0.0222522941298797,-0.00397516710669696,0.0262274612365767,EPCI
200040244,CA du Bocage Bressuirais,2006_2011,2008.5,5,69732,72023,3066,4352,2291,1286,1005,0.00648618267754131,0.00364086901934444,0.00284531365819686,EPCI
200040244,CA du Bocage Bressuirais,2011_2016,2013.5,5,72023,73449,3329,4230,1426,901,525,0.00392885286154487,0.00248239581223838,0.00144645704930649,EPCI
200040244,CA du Bocage Bressuirais,1968_1975,1971.5,7,63139,66435,4534,8186,3296,3652,-356,0.00729582591488542,0.00808384594695436,-0.000788020032068936,EPCI
200040244,CA du Bocage Bressuirais,1975_1982,1978.5,7,66435,68596,4391,7851,2161,3460,-1299,0.00458335701777646,0.00733846149074805,-0.0027551044729716,EPCI
200040244,CA du Bocage Bressuirais,1982_1990,1986,8,68596,69696,5040,7464,1100,2424,-1324,0.00199056646681228,0.0043864846505027,-0.00239591818369042,EPCI
200040244,CA du Bocage Bressuirais,1990_1999,1994.5,9,69696,68013,5612,7124,-1683,1512,-3195,-0.00271232209359795,0.00243673856537142,-0.00514906065896938,EPCI
200040244,CA du Bocage Bressuirais,1999_2006,2002.5,7,68013,69732,4291,5882,1719,1591,128,0.00357214488580104,0.00330615620320504,0.000265988682596006,EPCI
200040251,CC Bassée-Montois,2006_2011,2008.5,5,22094,23316,1031,1323,1222,292,930,0.0108249183614813,0.00258664170339814,0.00823827665808311,EPCI
200040251,CC Bassée-Montois,2011_2016,2013.5,5,23316,23467,1194,1243,151,49,102,0.00129190554335445,0.000419227626651446,0.000872677916703009,EPCI
200040251,CC Bassée-Montois,1968_1975,1971.5,7,15069,15072,1514,1388,3,-126,129,2.84381754986907e-05,-0.00119440337094501,0.0012228415464437,EPCI
200040251,CC Bassée-Montois,1975_1982,1978.5,7,15072,16429,1513,1169,1357,-344,1701,0.0123917707065455,-0.00314131843997911,0.0155330891465246,EPCI
200040251,CC Bassée-Montois,1982_1990,1986,8,16429,19056,1749,1718,2627,-31,2658,0.0187147088325028,-0.00022084353780266,0.0189355523703055,EPCI
200040251,CC Bassée-Montois,1990_1999,1994.5,9,19056,21240,1793,2198,2184,405,1779,0.0121289871667269,0.00224919404877491,0.00987979311795203,EPCI
200040251,CC Bassée-Montois,1999_2006,2002.5,7,21240,22094,1572,1690,854,118,736,0.00564729793079,0.000780305803083395,0.0048669921277066,EPCI
200040277,CA du Pays de Dreux,2006_2011,2008.5,5,112038,112757,4749,8229,719,3480,-2761,0.00128021102097309,0.00619629256326335,-0.00491608154229026,EPCI
200040277,CA du Pays de Dreux,2011_2016,2013.5,5,112757,115092,4701,8107,2335,3406,-1071,0.0041077633907618,0.00599188098883713,-0.00188411759807533,EPCI
200040277,CA du Pays de Dreux,1968_1975,1971.5,7,71384,83616,5416,10893,12232,5477,6755,0.0228516357096991,0.0102320478075557,0.0126195879021433,EPCI
200040277,CA du Pays de Dreux,1975_1982,1978.5,7,83616,93453,5614,10802,9837,5188,4649,0.0160160097726674,0.00844678852298448,0.00756922124968289,EPCI
200040277,CA du Pays de Dreux,1982_1990,1986,8,93453,107223,6654,13485,13770,6831,6939,0.0173299689812745,0.00859702382796558,0.0087329451533089,EPCI
200040277,CA du Pays de Dreux,1990_1999,1994.5,9,107223,107341,7870,13733,118,5863,-5745,0.000122219138634971,0.00607263398149862,-0.00595041484286365,EPCI
200040277,CA du Pays de Dreux,1999_2006,2002.5,7,107341,112038,6332,10463,4697,4131,566,0.00613695679526982,0.00539743847589092,0.000739518319378905,EPCI
200040293,CC du Clunisois,2006_2011,2008.5,5,13308,13727,1010,591,419,-419,838,0.00621912658235591,-0.00621912658235591,0.0124382531647118,EPCI
200040293,CC du Clunisois,2011_2016,2013.5,5,13727,13815,1022,529,88,-493,581,0.00127886947821065,-0.00716457559952105,0.0084434450777317,EPCI
200040293,CC du Clunisois,1968_1975,1971.5,7,13256,13200,1409,1213,-56,-196,140,-0.000604595805674735,-0.00211608531986157,0.00151148951418684,EPCI
200040293,CC du Clunisois,1975_1982,1978.5,7,13200,12841,1348,955,-359,-393,34,-0.0039313451979851,-0.00430367315545444,0.000372327957469341,EPCI
200040293,CC du Clunisois,1982_1990,1986,8,12841,12546,1497,1020,-295,-477,182,-0.00290094500051219,-0.00469068056015022,0.00178973555963803,EPCI
200040293,CC du Clunisois,1990_1999,1994.5,9,12546,12745,1541,1144,199,-397,596,0.0017501016605419,-0.00349140884037757,0.00524151050091947,EPCI
200040293,CC du Clunisois,1999_2006,2002.5,7,12745,13308,1410,819,563,-591,1154,0.00619429440257102,-0.0065023587778321,0.0126966531804031,EPCI
200040350,CC Bugey Sud,2006_2011,2008.5,5,30230,32538,1601,1975,2308,374,1934,0.0148235607999949,0.00240208480901131,0.0124214759909836,EPCI
200040350,CC Bugey Sud,2011_2016,2013.5,5,32538,33837,1625,1812,1299,187,1112,0.00785997695371821,0.00113149783706336,0.00672847911665485,EPCI
200040350,CC Bugey Sud,1968_1975,1971.5,7,23532,23698,2320,2368,166,48,118,0.00100471287078219,0.00029051938432256,0.000714193486459627,EPCI
200040350,CC Bugey Sud,1975_1982,1978.5,7,23698,25362,2181,2134,1664,-47,1711,0.00974162000245915,-0.000275153930357921,0.0100167739328171,EPCI
200040350,CC Bugey Sud,1982_1990,1986,8,25362,25941,2509,2504,579,-5,584,0.00282557666717098,-2.44004893538081e-05,0.00284997715652479,EPCI
200040350,CC Bugey Sud,1990_1999,1994.5,9,25941,27531,2856,2697,1590,-159,1749,0.00663166093308343,-0.000663166093308343,0.00729482702639177,EPCI
200040350,CC Bugey Sud,1999_2006,2002.5,7,27531,30230,2235,2258,2699,23,2676,0.0134499571996223,0.000114616159907859,0.0133353410397144,EPCI
200040384,CC Isle Double Landais,2006_2011,2008.5,5,11422,11819,885,584,397,-301,698,0.0068568182252291,-0.00519874631182357,0.0120555645370527,EPCI
200040384,CC Isle Double Landais,2011_2016,2013.5,5,11819,11947,876,508,128,-368,496,0.00215668125965185,-0.00620045862149907,0.00835713988115092,EPCI
200040384,CC Isle Double Landais,1968_1975,1971.5,7,10509,10726,1233,879,217,-354,571,0.0029240764641647,-0.00477015238854519,0.00769422885270989,EPCI
200040384,CC Isle Double Landais,1975_1982,1978.5,7,10726,10845,1093,645,119,-448,567,0.00157744911142621,-0.00593863194889867,0.00751608106032488,EPCI
200040384,CC Isle Double Landais,1982_1990,1986,8,10845,10732,1291,773,-113,-518,405,-0.00130841973594131,-0.00599788870104071,0.0046894689650994,EPCI
200040384,CC Isle Double Landais,1990_1999,1994.5,9,10732,10596,1397,797,-136,-600,464,-0.00141603660087908,-0.00624722029799593,0.00483118369711686,EPCI
200040384,CC Isle Double Landais,1999_2006,2002.5,7,10596,11422,1180,703,826,-477,1303,0.010781238731131,-0.00622596958202118,0.0170072083131522,EPCI
200040392,CA Le Grand Périgueux,2006_2011,2008.5,5,97643,102202,5022,5131,4559,109,4450,0.00916843028774017,0.000219205725238798,0.00894922456250137,EPCI
200040392,CA Le Grand Périgueux,2011_2016,2013.5,5,102202,103565,5332,4978,1363,-354,1717,0.00265315096356433,-0.000689079560602916,0.00334223052416725,EPCI
200040392,CA Le Grand Périgueux,1968_1975,1971.5,7,81110,83597,7025,8180,2487,1155,1332,0.00432380309264002,0.00200803883071943,0.00231576426192059,EPCI
200040392,CA Le Grand Périgueux,1975_1982,1978.5,7,83597,87347,6933,7539,3750,606,3144,0.00628841200759811,0.00101620738042785,0.00527220462717026,EPCI
200040392,CA Le Grand Périgueux,1982_1990,1986,8,87347,91682,7530,8340,4335,810,3525,0.00607303861813135,0.0011347546206889,0.00493828399744245,EPCI
200040392,CA Le Grand Périgueux,1990_1999,1994.5,9,91682,93905,8350,8311,2223,-39,2262,0.0026654978276579,-4.6763119783472e-05,0.00271226094744138,EPCI
200040392,CA Le Grand Périgueux,1999_2006,2002.5,7,93905,97643,6934,6747,3738,-187,3925,0.00559191058033548,-0.000279745125340485,0.00587165570567597,EPCI
200040400,CC du Pays Ribéracois,2006_2011,2008.5,5,19683,19879,1416,798,196,-618,814,0.0019836807208522,-0.00625466676268704,0.00823834748353924,EPCI
200040400,CC du Pays Ribéracois,2011_2016,2013.5,5,19879,19769,1445,693,-110,-752,642,-0.00110915322206862,-0.00758257475450544,0.00647342153243683,EPCI
200040400,CC du Pays Ribéracois,1968_1975,1971.5,7,20269,19290,2116,1461,-979,-655,-324,-0.00704730734779524,-0.00471500134096617,-0.00233230600682907,EPCI
200040400,CC du Pays Ribéracois,1975_1982,1978.5,7,19290,18772,2088,1200,-518,-888,370,-0.0038810817708077,-0.00665328303567035,0.00277220126486265,EPCI
200040400,CC du Pays Ribéracois,1982_1990,1986,8,18772,19067,2284,1422,295,-862,1157,0.00195098747306166,-0.00570085153145475,0.00765183900451641,EPCI
200040400,CC du Pays Ribéracois,1990_1999,1994.5,9,19067,18985,2508,1423,-82,-1085,1003,-0.000478762956261036,-0.00633485131150274,0.0058560883552417,EPCI
200040400,CC du Pays Ribéracois,1999_2006,2002.5,7,18985,19683,1967,1154,698,-813,1511,0.00517134338225178,-0.00602335554408409,0.0111946989263359,EPCI
200040418,CC du Pays de Serres en Quercy,2006_2011,2008.5,5,8722,8809,563,329,87,-234,321,0.00198704289987761,-0.00534446021346392,0.00733150311334153,EPCI
200040418,CC du Pays de Serres en Quercy,2011_2016,2013.5,5,8809,8578,507,322,-231,-185,-46,-0.00530053035681477,-0.00424501348922395,-0.00105551686759082,EPCI
200040418,CC du Pays de Serres en Quercy,1968_1975,1971.5,7,10684,9633,971,785,-1051,-186,-865,-0.0146843451331208,-0.00259875185039055,-0.0120855932827302,EPCI
200040418,CC du Pays de Serres en Quercy,1975_1982,1978.5,7,9633,9201,944,564,-432,-380,-52,-0.00653321229793968,-0.00574680711392843,-0.000786405184011258,EPCI
200040418,CC du Pays de Serres en Quercy,1982_1990,1986,8,9201,9227,1038,718,26,-320,346,0.000352786564072449,-0.00434198848089168,0.00469477504496413,EPCI
200040418,CC du Pays de Serres en Quercy,1990_1999,1994.5,9,9227,8835,1102,675,-392,-427,35,-0.00481203630171179,-0.00524168240007891,0.000429646098367124,EPCI
200040418,CC du Pays de Serres en Quercy,1999_2006,2002.5,7,8835,8722,803,530,-113,-273,160,-0.00183724396171625,-0.00443865134113749,0.00260140737942124,EPCI
200040426,CC du Val de l'Oise,2006_2011,2008.5,5,16518,16476,839,981,-42,142,-184,-0.000509054150885646,0.00172108784347052,-0.00223014199435616,EPCI
200040426,CC du Val de l'Oise,2011_2016,2013.5,5,16476,16158,786,880,-318,94,-412,-0.00389031175703025,0.00114996636843033,-0.00504027812546058,EPCI
200040426,CC du Val de l'Oise,1968_1975,1971.5,7,17584,16685,1457,1911,-899,454,-1353,-0.00746900806735162,0.00377189061465811,-0.0112408986820097,EPCI
200040426,CC du Val de l'Oise,1975_1982,1978.5,7,16685,16786,1388,1519,101,131,-30,0.00086252797168096,0.00111872439891293,-0.000256196427231968,EPCI
200040426,CC du Val de l'Oise,1982_1990,1986,8,16786,17044,1613,1809,258,196,62,0.00190844751944264,0.00144982834810371,0.000458619171338928,EPCI
200040426,CC du Val de l'Oise,1990_1999,1994.5,9,17044,16506,1506,1688,-538,182,-720,-0.00355746655369238,0.00120345522820077,-0.00476092178189315,EPCI
200040426,CC du Val de l'Oise,1999_2006,2002.5,7,16506,16518,1113,1383,12,270,-258,0.000103825992121331,0.00233608482272996,-0.00223225883060862,EPCI
200040442,CA Luberon Monts de Vaucluse,2006_2011,2008.5,5,52504,53322,2511,3209,818,698,120,0.00309671430648462,0.00264242858915191,0.000454285717332706,EPCI
200040442,CA Luberon Monts de Vaucluse,2011_2016,2013.5,5,53322,55092,2707,3300,1770,593,1177,0.00655247636913137,0.00219526468186153,0.00435721168726984,EPCI
200040442,CA Luberon Monts de Vaucluse,1968_1975,1971.5,7,31581,35990,2536,3213,4409,677,3732,0.0188447116436872,0.00289359713830261,0.0159511145053846,EPCI
200040442,CA Luberon Monts de Vaucluse,1975_1982,1978.5,7,35990,38370,2856,3093,2380,237,2143,0.00918979526261809,0.000915118267748104,0.00827467699486999,EPCI
200040442,CA Luberon Monts de Vaucluse,1982_1990,1986,8,38370,44742,3494,4155,6372,661,5711,0.0193901885949588,0.00201144297885558,0.0173787456161032,EPCI
200040442,CA Luberon Monts de Vaucluse,1990_1999,1994.5,9,44742,49326,4338,5123,4584,785,3799,0.01089656957367,0.00186601376861496,0.00903055580505507,EPCI
200040442,CA Luberon Monts de Vaucluse,1999_2006,2002.5,7,49326,52504,3626,4175,3178,549,2629,0.00895961805847434,0.00154777542923298,0.00741184262924136,EPCI
200040459,CA Montélimar Agglomération,2006_2011,2008.5,5,56738,59868,2345,3725,3130,1380,1750,0.0107974681007641,0.00476054504123145,0.00603692305953264,EPCI
200040459,CA Montélimar Agglomération,2011_2016,2013.5,5,59868,64813,2538,3833,4945,1295,3650,0.0159994546261539,0.00418994817813333,0.0118095064480206,EPCI
200040459,CA Montélimar Agglomération,1968_1975,1971.5,7,39384,41439,2767,4648,2055,1881,174,0.00729257999140676,0.00667510606512706,0.000617473926279696,EPCI
200040459,CA Montélimar Agglomération,1975_1982,1978.5,7,41439,45064,2918,3874,3625,956,2669,0.0120522262074789,0.0031784629667172,0.00887376324076172,EPCI
200040459,CA Montélimar Agglomération,1982_1990,1986,8,45064,48340,3367,5253,3276,1886,1390,0.00881054558807981,0.00507224938312531,0.0037382962049545,EPCI
200040459,CA Montélimar Agglomération,1990_1999,1994.5,9,48340,51690,3957,5794,3350,1837,1513,0.00747277888020825,0.00409775964266942,0.00337501923753883,EPCI
200040459,CA Montélimar Agglomération,1999_2006,2002.5,7,51690,56738,3333,4865,5048,1532,3516,0.0134003970548116,0.00406683999365517,0.00933355706115638,EPCI
200040475,CC Loué - Brûlon - Noyen,2006_2011,2008.5,5,17106,18365,775,1360,1259,585,674,0.0143048287111951,0.00664680285627413,0.00765802585492097,EPCI
200040475,CC Loué - Brûlon - Noyen,2011_2016,2013.5,5,18365,18565,909,1222,200,313,-113,0.0021686297548531,0.0033939055663451,-0.001225275811492,EPCI
200040475,CC Loué - Brûlon - Noyen,1968_1975,1971.5,7,15916,14747,1292,1577,-1169,285,-1454,-0.0108387217519179,0.00264245996518101,-0.0134811817170989,EPCI
200040475,CC Loué - Brûlon - Noyen,1975_1982,1978.5,7,14747,13939,1159,1240,-808,81,-889,-0.00801754458929116,0.000803738999669039,-0.0088212835889602,EPCI
200040475,CC Loué - Brûlon - Noyen,1982_1990,1986,8,13939,14208,1360,1455,269,95,174,0.0023921716254165,0.000844818975518836,0.00154735264989766,EPCI
200040475,CC Loué - Brûlon - Noyen,1990_1999,1994.5,9,14208,15305,1545,1778,1097,233,864,0.00829806030090352,0.00176248682781269,0.00653557347309083,EPCI
200040475,CC Loué - Brûlon - Noyen,1999_2006,2002.5,7,15305,17106,1157,1630,1801,473,1328,0.0160197777453339,0.00420730420518764,0.0118124735401463,EPCI
200040491,CC Porte de Drômardèche,2006_2011,2008.5,5,40861,44745,1755,2974,3884,1219,2665,0.0183266376007583,0.00575184635307011,0.0125747912476881,EPCI
200040491,CC Porte de Drômardèche,2011_2016,2013.5,5,44745,46656,1990,2803,1911,813,1098,0.00839944499559597,0.00357339025715307,0.0048260547384429,EPCI
200040491,CC Porte de Drômardèche,1968_1975,1971.5,7,33267,33887,2626,3632,620,1006,-386,0.0026414174655085,0.00428591285532508,-0.00164449538981658,EPCI
200040491,CC Porte de Drômardèche,1975_1982,1978.5,7,33887,33606,2624,2865,-281,241,-522,-0.00118884099041572,0.00101961095619284,-0.00220845194660856,EPCI
200040491,CC Porte de Drômardèche,1982_1990,1986,8,33606,35213,2770,3448,1607,678,929,0.00585591801250462,0.00247063622431745,0.00338528178818718,EPCI
200040491,CC Porte de Drômardèche,1990_1999,1994.5,9,35213,36768,3140,3890,1555,750,805,0.00481294173713875,0.00232135453559747,0.00249158720154128,EPCI
200040491,CC Porte de Drômardèche,1999_2006,2002.5,7,36768,40861,2560,3406,4093,846,3247,0.0151925599615348,0.00314021640055178,0.012052343560983,EPCI
200040509,CC du Crestois et de Pays de Saillans Coeur de Drôme,2006_2011,2008.5,5,13755,14414,832,765,659,-67,726,0.00940344963152229,-0.000956041161323207,0.0103594907928455,EPCI
200040509,CC du Crestois et de Pays de Saillans Coeur de Drôme,2011_2016,2013.5,5,14414,15134,848,792,720,-56,776,0.00979645652848604,-0.000761946618882248,0.0105584031473683,EPCI
200040509,CC du Crestois et de Pays de Saillans Coeur de Drôme,1968_1975,1971.5,7,11414,11965,1145,1251,551,106,445,0.00675773819785808,0.0013000367494972,0.00545770144836088,EPCI
200040509,CC du Crestois et de Pays de Saillans Coeur de Drôme,1975_1982,1978.5,7,11965,12242,1135,1098,277,-37,314,0.00327491386098822,-0.000437443367713227,0.00371235722870144,EPCI
200040509,CC du Crestois et de Pays de Saillans Coeur de Drôme,1982_1990,1986,8,12242,12594,1194,1288,352,94,258,0.00354976650539762,0.000947949009964138,0.00260181749543348,EPCI
200040509,CC du Crestois et de Pays de Saillans Coeur de Drôme,1990_1999,1994.5,9,12594,13146,1414,1316,552,-98,650,0.00477771257615567,-0.000848217087795753,0.00562592966395142,EPCI
200040509,CC du Crestois et de Pays de Saillans Coeur de Drôme,1999_2006,2002.5,7,13146,13755,1173,1042,609,-131,740,0.00649023726352271,-0.00139609372992032,0.00788633099344304,EPCI
200040558,CC Écueillé-Valençay,2006_2011,2008.5,5,12199,11944,976,412,-255,-564,309,-0.00421607149666503,-0.0093249581338003,0.00510888663713527,EPCI
200040558,CC Écueillé-Valençay,2011_2016,2013.5,5,11944,11306,944,402,-638,-542,-96,-0.0109190500412135,-0.00927605818548233,-0.00164299185573119,EPCI
200040558,CC Écueillé-Valençay,1968_1975,1971.5,7,15254,14843,1502,1278,-411,-224,-187,-0.00389431030072152,-0.00212244648993095,-0.00177186381079057,EPCI
200040558,CC Écueillé-Valençay,1975_1982,1978.5,7,14843,14589,1650,998,-254,-652,398,-0.00246275579342425,-0.00632171959571895,0.0038589638022947,EPCI
200040558,CC Écueillé-Valençay,1982_1990,1986,8,14589,13525,1796,889,-1064,-907,-157,-0.00942133788027433,-0.00803115926448197,-0.00139017861579236,EPCI
200040558,CC Écueillé-Valençay,1990_1999,1994.5,9,13525,12524,1826,935,-1001,-891,-110,-0.00850727560777598,-0.00757241015637202,-0.000934865451403954,EPCI
200040558,CC Écueillé-Valençay,1999_2006,2002.5,7,12524,12199,1483,683,-325,-800,475,-0.00374907208571029,-0.0092284851340561,0.00547941304834581,EPCI
200040566,CA de l'Ouest Rhodanien,2006_2011,2008.5,5,48952,50162,2513,3166,1210,653,557,0.0048954521170681,0.0026419258119384,0.0022535263051297,EPCI
200040566,CA de l'Ouest Rhodanien,2011_2016,2013.5,5,50162,50606,2626,2971,444,345,99,0.00176402975328038,0.00137069879477868,0.000393330958501707,EPCI
200040566,CA de l'Ouest Rhodanien,1968_1975,1971.5,7,49940,48170,4644,5393,-1770,749,-2519,-0.00514185861332384,0.0021758486448472,-0.00731770725817104,EPCI
200040566,CA de l'Ouest Rhodanien,1975_1982,1978.5,7,48170,46735,4426,4562,-1435,136,-1571,-0.00431111918878047,0.000408579937055152,-0.00471969912583562,EPCI
200040566,CA de l'Ouest Rhodanien,1982_1990,1986,8,46735,46456,4701,4892,-279,191,-470,-0.000748185040487459,0.000512198361050554,-0.00126038340153801,EPCI
200040566,CA de l'Ouest Rhodanien,1990_1999,1994.5,9,46456,46634,4953,5134,178,181,-3,0.000425008152277639,0.000432171211023892,-7.16305874625236e-06,EPCI
200040566,CA de l'Ouest Rhodanien,1999_2006,2002.5,7,46634,48952,3716,4094,2318,378,1940,0.00695411654060485,0.00113401900446447,0.00582009753614038,EPCI
200040574,CC Beaujolais Pierres Dorées,2006_2011,2008.5,5,44923,48935,1774,2876,4012,1102,2910,0.0172557849835355,0.00473974951442078,0.0125160354691148,EPCI
200040574,CC Beaujolais Pierres Dorées,2011_2016,2013.5,5,48935,51870,1878,2949,2935,1071,1864,0.0117176604575266,0.00427584816014005,0.0074418122973866,EPCI
200040574,CC Beaujolais Pierres Dorées,1968_1975,1971.5,7,22402,26415,2333,2576,4013,243,3770,0.0238195145068447,0.00144234787569481,0.0223771666311499,EPCI
200040574,CC Beaujolais Pierres Dorées,1975_1982,1978.5,7,26415,31367,2391,2569,4952,178,4774,0.0248500777886127,0.00089323785266015,0.0239568399359526,EPCI
200040574,CC Beaujolais Pierres Dorées,1982_1990,1986,8,31367,35869,2649,3211,4502,562,3940,0.0169059434580545,0.00211042652674959,0.0147955169313049,EPCI
200040574,CC Beaujolais Pierres Dorées,1990_1999,1994.5,9,35869,41486,2797,4047,5617,1250,4367,0.0162960903877014,0.00362651112419918,0.0126695792635022,EPCI
200040574,CC Beaujolais Pierres Dorées,1999_2006,2002.5,7,41486,44923,2472,3780,3437,1308,2129,0.0114354465018744,0.00435192435974739,0.00708352214212706,EPCI
200040590,CA Villefranche Beaujolais Saône,2006_2011,2008.5,5,67210,69825,2379,5375,2615,2996,-381,0.00766322653951246,0.00877974252863454,-0.00111651598912208,EPCI
200040590,CA Villefranche Beaujolais Saône,2011_2016,2013.5,5,69825,73257,2566,5447,3432,2881,551,0.0096425314298072,0.00809444436167673,0.00154808706813047,EPCI
200040590,CA Villefranche Beaujolais Saône,1968_1975,1971.5,7,42520,49810,3342,5824,7290,2482,4808,0.0228633370343843,0.00778419787645291,0.0150791391579313,EPCI
200040590,CA Villefranche Beaujolais Saône,1975_1982,1978.5,7,49810,53255,3338,6069,3445,2731,714,0.0095994865718374,0.00760992680048997,0.00198955977134743,EPCI
200040590,CA Villefranche Beaujolais Saône,1982_1990,1986,8,53255,58141,3967,7815,4886,3848,1038,0.0110328425706239,0.00868898448869436,0.00234385808192951,EPCI
200040590,CA Villefranche Beaujolais Saône,1990_1999,1994.5,9,58141,61850,4390,8377,3709,3987,-278,0.0068948836786995,0.00741167463655296,-0.000516790957853454,EPCI
200040590,CA Villefranche Beaujolais Saône,1999_2006,2002.5,7,61850,67210,3364,6850,5360,3486,1874,0.011943611642387,0.0077678041390599,0.0041758075033271,EPCI
200040624,CC Pays d'Apt-Luberon,2006_2011,2008.5,5,29188,30444,1470,1563,1256,93,1163,0.00846185369283115,0.000626554453370459,0.00783529923946069,EPCI
200040624,CC Pays d'Apt-Luberon,2011_2016,2013.5,5,30444,29951,1564,1496,-493,-68,-425,-0.00325991837388917,-0.000449643913639886,-0.00281027446024928,EPCI
200040624,CC Pays d'Apt-Luberon,1968_1975,1971.5,7,19737,22931,1714,2335,3194,621,2573,0.0216590326699755,0.00421110184347363,0.0174479308265019,EPCI
200040624,CC Pays d'Apt-Luberon,1975_1982,1978.5,7,22931,25448,1844,2023,2517,179,2338,0.0149894382668032,0.00106599501380921,0.013923443252994,EPCI
200040624,CC Pays d'Apt-Luberon,1982_1990,1986,8,25448,27913,2094,2816,2465,722,1743,0.0116239611894424,0.00340466530579206,0.00821929588365036,EPCI
200040624,CC Pays d'Apt-Luberon,1990_1999,1994.5,9,27913,27984,2661,2767,71,106,-35,0.000282305190506316,0.000421469721037598,-0.000139164530531282,EPCI
200040624,CC Pays d'Apt-Luberon,1999_2006,2002.5,7,27984,29188,2069,2112,1204,43,1161,0.00603596455136635,0.000215570162548798,0.00582039438881755,EPCI
200040657,CC de la Matheysine,2006_2011,2008.5,5,18492,19218,948,1108,726,160,566,0.00773156210326698,0.00170392553240044,0.00602763657086654,EPCI
200040657,CC de la Matheysine,2011_2016,2013.5,5,19218,19088,1005,895,-130,-110,-20,-0.00135657392049027,-0.00114787024041484,-0.000208703680075426,EPCI
200040657,CC de la Matheysine,1968_1975,1971.5,7,18996,15698,1652,1299,-3298,-353,-2945,-0.0268744383989926,-0.00287649386138399,-0.0239979445376086,EPCI
200040657,CC de la Matheysine,1975_1982,1978.5,7,15698,16673,1691,1240,975,-451,1426,0.00864534684691898,-0.00399902710560047,0.0126443739525195,EPCI
200040657,CC de la Matheysine,1982_1990,1986,8,16673,17202,1763,1631,529,-132,661,0.00391200845108886,-0.000976153337511775,0.00488816178860063,EPCI
200040657,CC de la Matheysine,1990_1999,1994.5,9,17202,17476,1838,1647,274,-191,465,0.0017574152205686,-0.0012250595150679,0.0029824747356365,EPCI
200040657,CC de la Matheysine,1999_2006,2002.5,7,17476,18492,1404,1389,1016,-15,1031,0.00810548659809718,-0.000119667617097891,0.00822515421519507,EPCI
200040681,CC Enclave des Papes-Pays de Grignan,2006_2011,2008.5,5,22440,22808,1116,1138,368,22,346,0.00325855176581902,0.000194804725130485,0.00306374704068853,EPCI
200040681,CC Enclave des Papes-Pays de Grignan,2011_2016,2013.5,5,22808,22967,1242,1156,159,-86,245,0.00139037596244007,-0.000752027250124819,0.00214240321256489,EPCI
200040681,CC Enclave des Papes-Pays de Grignan,1968_1975,1971.5,7,15943,16709,1348,1640,766,292,474,0.00672646961377943,0.00256413724180626,0.00416233237197317,EPCI
200040681,CC Enclave des Papes-Pays de Grignan,1975_1982,1978.5,7,16709,18376,1528,1498,1667,-30,1697,0.013678125333102,-0.000246157024590917,0.0139242823576929,EPCI
200040681,CC Enclave des Papes-Pays de Grignan,1982_1990,1986,8,18376,20181,1718,2008,1805,290,1515,0.0117808669567991,0.0018927708684054,0.00988809608839374,EPCI
200040681,CC Enclave des Papes-Pays de Grignan,1990_1999,1994.5,9,20181,21239,1940,2180,1058,240,818,0.00569365275230793,0.00129156584173337,0.00440208691057456,EPCI
200040681,CC Enclave des Papes-Pays de Grignan,1999_2006,2002.5,7,21239,22440,1485,1786,1201,301,900,0.00788895026821135,0.00197716405556338,0.00591178621264797,EPCI
200040715,Métropole Grenoble-Alpes-Métropole,2006_2011,2008.5,5,430812,437236,13754,29508,6424,15754,-9330,0.00296464490191561,0.00727039473611124,-0.00430574983419562,EPCI
200040715,Métropole Grenoble-Alpes-Métropole,2011_2016,2013.5,5,437236,443123,14658,29296,5887,14638,-8751,0.00267843838127413,0.00665992543317321,-0.00398148705189908,EPCI
200040715,Métropole Grenoble-Alpes-Métropole,1968_1975,1971.5,7,338231,393673,18456,49309,55442,30853,24589,0.0219213205609725,0.0121990278717883,0.00972229268918425,EPCI
200040715,Métropole Grenoble-Alpes-Métropole,1975_1982,1978.5,7,393673,398638,18545,42982,4965,24437,-19472,0.00179204972558078,0.00882020526566315,-0.00702815554008237,EPCI
200040715,Métropole Grenoble-Alpes-Métropole,1982_1990,1986,8,398638,409547,21645,47934,10909,26289,-15380,0.00338044259198034,0.00814634295541031,-0.00476590036342997,EPCI
200040715,Métropole Grenoble-Alpes-Métropole,1990_1999,1994.5,9,409547,422357,24925,50853,12810,25928,-13118,0.00342800188806769,0.00693842567945504,-0.00351042379138735,EPCI
200040715,Métropole Grenoble-Alpes-Métropole,1999_2006,2002.5,7,422357,430812,19235,39373,8455,20138,-11683,0.00283556578731758,0.00675371068302797,-0.00391814489571039,EPCI
200040764,CC du Sud Corse,2006_2011,2008.5,5,16652,19073,874,1369,2421,495,1926,0.0275205617384533,0.00562688065284361,0.0218936810856097,EPCI
200040764,CC du Sud Corse,2011_2016,2013.5,5,19073,20848,961,1400,1775,439,1336,0.0179561673594477,0.00444099012439298,0.0135151772350547,EPCI
200040764,CC du Sud Corse,1968_1975,1971.5,7,9977,13445,873,1027,3468,154,3314,0.043539014666617,0.00193339338484978,0.0416056212817673,EPCI
200040764,CC du Sud Corse,1975_1982,1978.5,7,13445,14567,968,1085,1122,117,1005,0.0115160054330656,0.00120086687671005,0.0103151385563556,EPCI
200040764,CC du Sud Corse,1982_1990,1986,8,14567,15440,1245,1605,873,360,513,0.00730188571745716,0.00301108689379677,0.00429079882366039,EPCI
200040764,CC du Sud Corse,1990_1999,1994.5,9,15440,16628,1473,2084,1188,611,577,0.00827028662558416,0.00425348916517838,0.00401679746040577,EPCI
200040764,CC du Sud Corse,1999_2006,2002.5,7,16628,16652,1110,1709,24,599,-575,0.000206065220283769,0.00514304445624906,-0.00493697923596529,EPCI
200040772,CC du Perche et Haut Vendômois,2006_2011,2008.5,5,9081,9337,624,479,256,-145,401,0.00557562280667634,-0.00315806760534402,0.00873369041202036,EPCI
200040772,CC du Perche et Haut Vendômois,2011_2016,2013.5,5,9337,9213,612,475,-124,-137,13,-0.00267032260383471,-0.00295027578004318,0.000279953176208477,EPCI
200040772,CC du Perche et Haut Vendômois,1968_1975,1971.5,7,9363,8888,908,777,-475,-131,-344,-0.00741008034318491,-0.00204362215780468,-0.00536645818538023,EPCI
200040772,CC du Perche et Haut Vendômois,1975_1982,1978.5,7,8888,8796,887,619,-92,-268,176,-0.00148532148008151,-0.00432680605067224,0.00284148457059072,EPCI
200040772,CC du Perche et Haut Vendômois,1982_1990,1986,8,8796,8512,994,671,-284,-323,39,-0.00409411368289936,-0.00465633351963554,0.00056221983673618,EPCI
200040772,CC du Perche et Haut Vendômois,1990_1999,1994.5,9,8512,8535,1113,674,23,-439,462,0.000299869801642094,-0.00572360186612519,0.00602347166776728,EPCI
200040772,CC du Perche et Haut Vendômois,1999_2006,2002.5,7,8535,9081,837,672,546,-165,711,0.00889777515252321,-0.00268888809554273,0.0115866632480659,EPCI
200040798,CC Val Vanoise,2006_2011,2008.5,5,9332,9544,289,556,212,267,-55,0.00450277328210746,0.00567094559586176,-0.00116817231375429,EPCI
200040798,CC Val Vanoise,2011_2016,2013.5,5,9544,9199,292,523,-345,231,-576,-0.00733653572426618,0.00491228913711736,-0.0122488248613835,EPCI
200040798,CC Val Vanoise,1968_1975,1971.5,7,6627,6758,457,809,131,352,-221,0.00280031001881942,0.00752449714980485,-0.00472418713098543,EPCI
200040798,CC Val Vanoise,1975_1982,1978.5,7,6758,7306,444,651,548,207,341,0.0112006831680778,0.00423091499232134,0.00696976817575642,EPCI
200040798,CC Val Vanoise,1982_1990,1986,8,7306,8055,446,833,749,387,362,0.0122743551310873,0.0063420232786793,0.00593233185240803,EPCI
200040798,CC Val Vanoise,1990_1999,1994.5,9,8055,9010,552,1040,955,488,467,0.0125269300461137,0.00640119566754292,0.00612573437857079,EPCI
200040798,CC Val Vanoise,1999_2006,2002.5,7,9010,9332,439,845,322,406,-84,0.00502892890513262,0.00634082340212374,-0.00131189449699112,EPCI
200040814,CC Briance Sud Haute Vienne,2006_2011,2008.5,5,8557,9141,638,465,584,-173,757,0.0132915835398395,-0.00393740402806889,0.0172289875679084,EPCI
200040814,CC Briance Sud Haute Vienne,2011_2016,2013.5,5,9141,9147,644,459,6,-185,191,0.00013124221201477,-0.00404663487045542,0.00417787708247019,EPCI
200040814,CC Briance Sud Haute Vienne,1968_1975,1971.5,7,10139,9300,1049,554,-839,-495,-344,-0.0122634651951561,-0.00723529829749972,-0.00502816689765637,EPCI
200040814,CC Briance Sud Haute Vienne,1975_1982,1978.5,7,9300,8404,1068,412,-896,-656,-240,-0.0143681524623537,-0.0105195401956518,-0.00384861226670188,EPCI
200040814,CC Briance Sud Haute Vienne,1982_1990,1986,8,8404,7998,1213,467,-406,-746,340,-0.00617041836320531,-0.0113377637905201,0.00516734542731479,EPCI
200040814,CC Briance Sud Haute Vienne,1990_1999,1994.5,9,7998,7915,1213,630,-83,-583,500,-0.0011584193016968,-0.00813684882999078,0.00697842952829398,EPCI
200040814,CC Briance Sud Haute Vienne,1999_2006,2002.5,7,7915,8557,823,592,642,-231,873,0.0112037208226632,-0.00403124534273395,0.0152349661653971,EPCI
200040830,CC du Pays de Fénelon,2006_2011,2008.5,5,9151,9527,618,420,376,-198,574,0.00808585734385847,-0.00425797806937228,0.0123438354132308,EPCI
200040830,CC du Pays de Fénelon,2011_2016,2013.5,5,9527,9686,586,365,159,-221,380,0.00331581945865977,-0.00460878050543277,0.00792459996409254,EPCI
200040830,CC du Pays de Fénelon,1968_1975,1971.5,7,7512,7247,845,552,-265,-293,28,-0.00511745409833664,-0.00565816622948164,0.000540712131145003,EPCI
200040830,CC du Pays de Fénelon,1975_1982,1978.5,7,7247,7628,856,478,381,-378,759,0.00734658292386126,-0.00728873581422455,0.0146353187380858,EPCI
200040830,CC du Pays de Fénelon,1982_1990,1986,8,7628,7965,976,633,337,-343,680,0.00541853439473328,-0.00551500681719144,0.0109335412119247,EPCI
200040830,CC du Pays de Fénelon,1990_1999,1994.5,9,7965,8284,1020,671,319,-349,668,0.00437275495482847,-0.00478398582832331,0.00915674078315179,EPCI
200040830,CC du Pays de Fénelon,1999_2006,2002.5,7,8284,9151,840,605,867,-235,1102,0.0143211822249931,-0.00388175066075361,0.0182029328857467,EPCI
200040889,CC de Portes Sud Périgord,2006_2011,2008.5,5,7793,8099,554,323,306,-231,537,0.0077326844500718,-0.00583741865348558,0.0135701031035574,EPCI
200040889,CC de Portes Sud Périgord,2011_2016,2013.5,5,8099,8345,637,314,246,-323,569,0.0060023342163007,-0.00788111362546799,0.0138834478417687,EPCI
200040889,CC de Portes Sud Périgord,1968_1975,1971.5,7,8450,7866,820,686,-584,-134,-450,-0.0101788084533618,-0.00233554851498371,-0.00784325993837812,EPCI
200040889,CC de Portes Sud Périgord,1975_1982,1978.5,7,7866,7715,780,552,-151,-228,77,-0.00276519666612485,-0.00417526384024149,0.00141006717411664,EPCI
200040889,CC de Portes Sud Périgord,1982_1990,1986,8,7715,7649,866,584,-66,-282,216,-0.00107336921114332,-0.0045862139021578,0.00351284469101449,EPCI
200040889,CC de Portes Sud Périgord,1990_1999,1994.5,9,7649,7546,949,533,-103,-416,313,-0.00150523253248014,-0.00607938576224988,0.00457415322976974,EPCI
200040889,CC de Portes Sud Périgord,1999_2006,2002.5,7,7546,7793,723,432,247,-291,538,0.00461178359407577,-0.00543331589423502,0.0100450994883108,EPCI
200040905,CC Carmausin-Ségala,2006_2011,2008.5,5,29076,29543,1845,1323,467,-522,989,0.00319183058486217,-0.00356774210984593,0.0067595726947081,EPCI
200040905,CC Carmausin-Ségala,2011_2016,2013.5,5,29543,29452,1817,1416,-91,-401,310,-0.000616811623599167,-0.00271803803366226,0.0021012264100631,EPCI
200040905,CC Carmausin-Ségala,1968_1975,1971.5,7,39609,35614,3128,2516,-3995,-612,-3383,-0.0150734615880388,-0.00230912603050807,-0.0127643355575307,EPCI
200040905,CC Carmausin-Ségala,1975_1982,1978.5,7,35614,32917,3113,1924,-2697,-1189,-1508,-0.0111868956835267,-0.0049318572368236,-0.00625503844670311,EPCI
200040905,CC Carmausin-Ségala,1982_1990,1986,8,32917,30374,3418,2160,-2543,-1258,-1285,-0.00999994746911814,-0.00494688710819922,-0.00505306036091892,EPCI
200040905,CC Carmausin-Ségala,1990_1999,1994.5,9,30374,28532,3637,1971,-1842,-1666,-176,-0.00692708690060928,-0.0062652154052199,-0.000661871495389378,EPCI
200040905,CC Carmausin-Ségala,1999_2006,2002.5,7,28532,29076,2616,1593,544,-1023,1567,0.00270176136906186,-0.00508070198630567,0.00778246335536753,EPCI
200040947,CC de Flandre Intérieure,2006_2011,2008.5,5,97256,100763,4462,6136,3507,1674,1833,0.00711006685022464,0.00339385569069748,0.00371621115952716,EPCI
200040947,CC de Flandre Intérieure,2011_2016,2013.5,5,100763,102169,4696,6119,1406,1423,-17,0.00277525996076933,0.00280881573554392,-3.35557747745937e-05,EPCI
200040947,CC de Flandre Intérieure,1968_1975,1971.5,7,83013,85035,6861,10157,2022,3296,-1274,0.00344387576100313,0.0056137559388063,-0.00216988017780316,EPCI
200040947,CC de Flandre Intérieure,1975_1982,1978.5,7,85035,87730,7024,9443,2695,2419,276,0.00446723127428506,0.00400973374860688,0.000457497525678172,EPCI
200040947,CC de Flandre Intérieure,1982_1990,1986,8,87730,91563,7480,10980,3833,3500,333,0.00535973021281389,0.00489409228929001,0.000465637923523878,EPCI
200040947,CC de Flandre Intérieure,1990_1999,1994.5,9,91563,95443,7870,11033,3880,3163,717,0.00462197639059014,0.00376786374315377,0.000854112647436375,EPCI
200040947,CC de Flandre Intérieure,1999_2006,2002.5,7,95443,97256,6314,8673,1813,2359,-546,0.00269182598887974,0.00350249173070452,-0.000810665741824786,EPCI
200040954,CC des Hauts de Flandre,2006_2011,2008.5,5,50922,52482,2323,3333,1560,1010,550,0.00605328823786322,0.00391911610271914,0.00213417213514408,EPCI
200040954,CC des Hauts de Flandre,2011_2016,2013.5,5,52482,53422,2331,3133,940,802,138,0.00355678891020883,0.00303462202764626,0.000522166882562573,EPCI
200040954,CC des Hauts de Flandre,1968_1975,1971.5,7,37809,41355,3340,4675,3546,1335,2211,0.0128889504276608,0.00485243903579447,0.00803651139186634,EPCI
200040954,CC des Hauts de Flandre,1975_1982,1978.5,7,41355,47335,3554,5114,5980,1560,4420,0.0194811349402548,0.00508203520180561,0.0143990997384492,EPCI
200040954,CC des Hauts de Flandre,1982_1990,1986,8,47335,49076,3732,5604,1741,1872,-131,0.00452522521591381,0.00486572177150526,-0.000340496555591447,EPCI
200040954,CC des Hauts de Flandre,1990_1999,1994.5,9,49076,49320,3934,5338,244,1404,-1160,0.00055121423689819,0.00317174093690598,-0.00262052670000779,EPCI
200040954,CC des Hauts de Flandre,1999_2006,2002.5,7,49320,50922,3252,4448,1602,1196,406,0.00457692396910514,0.00341697944260284,0.0011599445265023,EPCI
200041010,CC Coeur de Savoie,2006_2011,2008.5,5,32506,34763,1335,2096,2257,761,1496,0.0135163135370389,0.00455733921208975,0.00895897432494911,EPCI
200041010,CC Coeur de Savoie,2011_2016,2013.5,5,34763,36460,1377,2002,1697,625,1072,0.00957801164705319,0.00352755290477799,0.0060504587422752,EPCI
200041010,CC Coeur de Savoie,1968_1975,1971.5,7,20513,21897,2009,2143,1384,134,1250,0.00937089295310511,0.000907297439101218,0.0084635955140039,EPCI
200041010,CC Coeur de Savoie,1975_1982,1978.5,7,21897,24134,1976,2067,2237,91,2146,0.0139929972432518,0.00056922787176393,0.0134237693714878,EPCI
200041010,CC Coeur de Savoie,1982_1990,1986,8,24134,26219,2187,2490,2085,303,1782,0.0104116661076512,0.00151306226888169,0.00889860383876952,EPCI
200041010,CC Coeur de Savoie,1990_1999,1994.5,9,26219,28866,2324,2964,2647,640,2007,0.0107439835076155,0.00259771418393424,0.00814626932368128,EPCI
200041010,CC Coeur de Savoie,1999_2006,2002.5,7,28866,32506,1805,2677,3640,872,2768,0.0171104865279248,0.00409899567372264,0.0130114908542022,EPCI
200041051,CC Vallée de la Dordogne et Forêt Bessède,2006_2011,2008.5,5,8760,9072,542,335,312,-207,519,0.00702392123781048,-0.00466010159047042,0.0116840228282809,EPCI
200041051,CC Vallée de la Dordogne et Forêt Bessède,2011_2016,2013.5,5,9072,9106,649,319,34,-330,364,0.000748437925433221,-0.0072642504527342,0.00801268837816742,EPCI
200041051,CC Vallée de la Dordogne et Forêt Bessède,1968_1975,1971.5,7,8607,8134,943,577,-473,-366,-107,-0.00804220392664146,-0.00622293157959994,-0.00181927234704151,EPCI
200041051,CC Vallée de la Dordogne et Forêt Bessède,1975_1982,1978.5,7,8134,8257,917,511,123,-406,529,0.00214637416315555,-0.00708477975805816,0.00923115392121371,EPCI
200041051,CC Vallée de la Dordogne et Forêt Bessède,1982_1990,1986,8,8257,8128,1008,544,-129,-464,335,-0.00196636848425413,-0.00707282927669704,0.0051064607924429,EPCI
200041051,CC Vallée de la Dordogne et Forêt Bessède,1990_1999,1994.5,9,8128,8234,1101,593,106,-508,614,0.00144070710182276,-0.00690452082760341,0.00834522792942616,EPCI
200041051,CC Vallée de la Dordogne et Forêt Bessède,1999_2006,2002.5,7,8234,8760,800,504,526,-296,822,0.00888552708382839,-0.00500022056428366,0.0138857476481121,EPCI
200041150,CC du Terrassonnais en Périgord Noir Thenon Hautefort,2006_2011,2008.5,5,22373,22980,1342,1163,607,-179,786,0.00536823717059209,-0.00158305511290937,0.00695129228350146,EPCI
200041150,CC du Terrassonnais en Périgord Noir Thenon Hautefort,2011_2016,2013.5,5,22980,22489,1424,1000,-491,-424,-67,-0.00431027829991837,-0.00372211405125334,-0.000588164248665032,EPCI
200041150,CC du Terrassonnais en Périgord Noir Thenon Hautefort,1968_1975,1971.5,7,20923,21789,2060,2074,866,14,852,0.00581056234129895,9.3935187965572e-05,0.00571662715333338,EPCI
200041150,CC du Terrassonnais en Périgord Noir Thenon Hautefort,1975_1982,1978.5,7,21789,21995,1933,1787,206,-146,352,0.00134517529610623,-0.000953376666172374,0.0022985519622786,EPCI
200041150,CC du Terrassonnais en Périgord Noir Thenon Hautefort,1982_1990,1986,8,21995,21614,2276,1654,-381,-622,241,-0.00218185402855797,-0.00356197691801328,0.00138012288945531,EPCI
200041150,CC du Terrassonnais en Périgord Noir Thenon Hautefort,1990_1999,1994.5,9,21614,21384,2393,1906,-230,-487,257,-0.00118799089547783,-0.00251544159172915,0.00132745069625132,EPCI
200041150,CC du Terrassonnais en Périgord Noir Thenon Hautefort,1999_2006,2002.5,7,21384,22373,1989,1521,989,-468,1457,0.00647974556607989,-0.0030662496713098,0.00954599523738968,EPCI
200041168,CC de la Vallée de l'Homme,2006_2011,2008.5,5,15532,15846,1056,607,314,-449,763,0.00401096059247674,-0.00573541817204477,0.00974637876452151,EPCI
200041168,CC de la Vallée de l'Homme,2011_2016,2013.5,5,15846,15725,1125,551,-121,-574,453,-0.00153188545512883,-0.00726696075408224,0.0057350752989534,EPCI
200041168,CC de la Vallée de l'Homme,1968_1975,1971.5,7,14226,13789,1661,1122,-437,-539,102,-0.00444723925027191,-0.00548526763363057,0.00103802838335866,EPCI
200041168,CC de la Vallée de l'Homme,1975_1982,1978.5,7,13789,14149,1569,864,360,-705,1065,0.00368861158125289,-0.0072235310132869,0.0109121425945398,EPCI
200041168,CC de la Vallée de l'Homme,1982_1990,1986,8,14149,14467,1656,1090,318,-566,884,0.00278214342694505,-0.00495186534481415,0.0077340087717592,EPCI
200041168,CC de la Vallée de l'Homme,1990_1999,1994.5,9,14467,15053,1915,1234,586,-681,1267,0.00442164823604463,-0.00513846834257064,0.00956011657861526,EPCI
200041168,CC de la Vallée de l'Homme,1999_2006,2002.5,7,15053,15532,1478,887,479,-591,1070,0.00448504283099482,-0.0055337376056742,0.010018780436669,EPCI
200041283,CC de la Plaine du Rhin,2006_2011,2008.5,5,17900,18281,691,802,381,111,270,0.00422119550873812,0.00122979711671898,0.00299139839201914,EPCI
200041283,CC de la Plaine du Rhin,2011_2016,2013.5,5,18281,18414,707,729,133,22,111,0.00145084660920003,0.000239989664679704,0.00121085694452033,EPCI
200041283,CC de la Plaine du Rhin,1968_1975,1971.5,7,13343,14298,1059,1693,955,634,321,0.00992431756403334,0.0065884998278504,0.00333581773618293,EPCI
200041283,CC de la Plaine du Rhin,1975_1982,1978.5,7,14298,14631,1029,1335,333,306,27,0.00329440008311277,0.00302728656286038,0.000267113520252387,EPCI
200041283,CC de la Plaine du Rhin,1982_1990,1986,8,14631,15164,1133,1666,533,533,0,0.00448272150242945,0.00448272150242945,0,EPCI
200041283,CC de la Plaine du Rhin,1990_1999,1994.5,9,15164,17002,1119,1638,1838,519,1319,0.0127930043749889,0.00361238806888968,0.00918061630609919,EPCI
200041283,CC de la Plaine du Rhin,1999_2006,2002.5,7,17002,17900,928,1144,898,216,682,0.00737991672353444,0.00177512473528223,0.00560479198825222,EPCI
200041317,CA du Niortais,2006_2011,2008.5,5,113774,117811,4893,6490,4037,1597,2440,0.00699789581460597,0.00276830310030363,0.00422959271430235,EPCI
200041317,CA du Niortais,2011_2016,2013.5,5,117811,120806,5253,6189,2995,936,2059,0.00503348718210384,0.00157306978378938,0.00346041739831446,EPCI
200041317,CA du Niortais,1968_1975,1971.5,7,87429,96980,6057,12151,9551,6094,3457,0.0149213331268678,0.00952053230814915,0.00540080081871868,EPCI
200041317,CA du Niortais,1975_1982,1978.5,7,96980,101229,5935,10029,4249,4094,155,0.00614458748503166,0.00592043802393966,0.000224149461092,EPCI
200041317,CA du Niortais,1982_1990,1986,8,101229,105229,6872,10374,4000,3502,498,0.00485595846726294,0.00425139163808871,0.000604566829174237,EPCI
200041317,CA du Niortais,1990_1999,1994.5,9,105229,107126,8061,10998,1897,2937,-1040,0.00198717003830828,0.00307660432393855,-0.00108943428563027,EPCI
200041317,CA du Niortais,1999_2006,2002.5,7,107126,113774,6570,8835,6648,2265,4383,0.00863828404150713,0.00294309767659652,0.00569518636491061,EPCI
200041325,CC du Pays Rhénan,2006_2011,2008.5,5,33678,35503,1149,1792,1825,643,1182,0.0106103739403907,0.0037383399691349,0.00687203397125576,EPCI
200041325,CC du Pays Rhénan,2011_2016,2013.5,5,35503,36463,1327,1785,960,458,502,0.00535043228403831,0.00255260206884328,0.00279783021519503,EPCI
200041325,CC du Pays Rhénan,1968_1975,1971.5,7,24052,27006,1828,2840,2954,1012,1942,0.0166863897124663,0.00571652890623422,0.0109698608062321,EPCI
200041325,CC du Pays Rhénan,1975_1982,1978.5,7,27006,28271,1942,2355,1265,413,852,0.00656107024002361,0.00214207273448992,0.00441899750553369,EPCI
200041325,CC du Pays Rhénan,1982_1990,1986,8,28271,28012,1995,2552,-259,557,-816,-0.00114978280186273,0.00247269892138047,-0.0036224817232432,EPCI
200041325,CC du Pays Rhénan,1990_1999,1994.5,9,28012,30898,2198,2901,2886,703,2183,0.0109549560952291,0.00266851494627376,0.00828644114895536,EPCI
200041325,CC du Pays Rhénan,1999_2006,2002.5,7,30898,33678,1609,2421,2780,812,1968,0.0123836716348684,0.00361710121133567,0.00876657042353275,EPCI
200041333,CC de Parthenay-Gâtine,2006_2011,2008.5,5,37217,37956,2023,1901,739,-122,861,0.00394013158338424,-0.000650468272223109,0.00459059985560735,EPCI
200041333,CC de Parthenay-Gâtine,2011_2016,2013.5,5,37956,37782,2206,1622,-174,-584,410,-0.000918536961790783,-0.00308290566486102,0.00216436870307024,EPCI
200041333,CC de Parthenay-Gâtine,1968_1975,1971.5,7,37161,38673,2983,4503,1512,1520,-8,0.00571366936771023,0.00574390042256584,-3.023105485561e-05,EPCI
200041333,CC de Parthenay-Gâtine,1975_1982,1978.5,7,38673,38980,2854,3684,307,830,-523,0.00113021134377522,0.00305562024538578,-0.00192540890161056,EPCI
200041333,CC de Parthenay-Gâtine,1982_1990,1986,8,38980,37507,3220,3365,-1473,145,-1618,-0.00480356478492094,0.000472856003946732,-0.00527642078886768,EPCI
200041333,CC de Parthenay-Gâtine,1990_1999,1994.5,9,37507,36479,3634,3262,-1028,-372,-656,-0.00308310739656437,-0.00111567699564391,-0.00196743040092045,EPCI
200041333,CC de Parthenay-Gâtine,1999_2006,2002.5,7,36479,37217,2914,2770,738,-144,882,0.00286536785411218,-0.000559096166656035,0.00342446402076821,EPCI
200041366,CC Rhône Crussol,2006_2011,2008.5,5,31317,32474,1242,1785,1157,543,614,0.00728212425787467,0.00341762616424023,0.00386449809363444,EPCI
200041366,CC Rhône Crussol,2011_2016,2013.5,5,32474,33854,1352,1788,1380,436,944,0.0083582147752288,0.00264071133478243,0.00571750344044637,EPCI
200041366,CC Rhône Crussol,1968_1975,1971.5,7,17846,20493,1150,2202,2647,1052,1595,0.0199541855237839,0.00793041298489637,0.0120237725388876,EPCI
200041366,CC Rhône Crussol,1975_1982,1978.5,7,20493,23725,1265,1986,3232,721,2511,0.0211412294986162,0.00471622106079897,0.0164250084378172,EPCI
200041366,CC Rhône Crussol,1982_1990,1986,8,23725,27334,1539,2574,3609,1035,2574,0.0178578282889146,0.00512132232724483,0.0127365059616697,EPCI
200041366,CC Rhône Crussol,1990_1999,1994.5,9,27334,29100,1998,2928,1766,930,836,0.00698056531210534,0.00367606214057642,0.00330450317152891,EPCI
200041366,CC Rhône Crussol,1999_2006,2002.5,7,29100,31317,1741,2425,2217,684,1533,0.0105441889598528,0.00325314625554321,0.00729104270430956,EPCI
200041416,CC Airvaudais-Val du Thouet,2006_2011,2008.5,5,7100,7046,472,365,-54,-107,53,-0.00152577564463186,-0.00302329618473349,0.00149752054010164,EPCI
200041416,CC Airvaudais-Val du Thouet,2011_2016,2013.5,5,7046,6918,518,310,-128,-208,80,-0.00365995984071166,-0.00594743474115644,0.00228747490044479,EPCI
200041416,CC Airvaudais-Val du Thouet,1968_1975,1971.5,7,8410,8205,716,905,-205,189,-394,-0.00351918587648892,0.00324451771051905,-0.00676370358700797,EPCI
200041416,CC Airvaudais-Val du Thouet,1975_1982,1978.5,7,8205,8012,755,740,-193,-15,-178,-0.00339469733280018,-0.000263836580269444,-0.00313086075253073,EPCI
200041416,CC Airvaudais-Val du Thouet,1982_1990,1986,8,8012,7591,809,673,-421,-136,-285,-0.00672442453477351,-0.00217226065731401,-0.0045521638774595,EPCI
200041416,CC Airvaudais-Val du Thouet,1990_1999,1994.5,9,7591,7138,873,618,-453,-255,-198,-0.00681342817556452,-0.00383537347631115,-0.00297805469925337,EPCI
200041416,CC Airvaudais-Val du Thouet,1999_2006,2002.5,7,7138,7100,690,523,-38,-167,129,-0.000762258050856723,-0.00334992353929139,0.00258766548843467,EPCI
200041440,CC de Domme - Villefranche du Périgord,2006_2011,2008.5,5,8860,8968,553,326,108,-227,335,0.00242612251433649,-0.00509935009957763,0.00752547261391412,EPCI
200041440,CC de Domme - Villefranche du Périgord,2011_2016,2013.5,5,8968,8705,562,269,-263,-293,30,-0.00593533838018157,-0.0066123731764,0.00067703479621843,EPCI
200041440,CC de Domme - Villefranche du Périgord,1968_1975,1971.5,7,8793,8439,911,646,-354,-265,-89,-0.00585310803109884,-0.00438156392158529,-0.00147154410951355,EPCI
200041440,CC de Domme - Villefranche du Périgord,1975_1982,1978.5,7,8439,8307,977,521,-132,-456,324,-0.00224964935436134,-0.00777151595143008,0.00552186659706874,EPCI
200041440,CC de Domme - Villefranche du Périgord,1982_1990,1986,8,8307,8412,978,535,105,-443,548,0.00157132386056924,-0.00662949019268737,0.00820081405325661,EPCI
200041440,CC de Domme - Villefranche du Périgord,1990_1999,1994.5,9,8412,8431,1046,639,19,-407,426,0.000250712656508778,-0.00537052901047751,0.00562124166698629,EPCI
200041440,CC de Domme - Villefranche du Périgord,1999_2006,2002.5,7,8431,8860,883,534,429,-349,778,0.007115391479116,-0.00578851194921091,0.0129039034283269,EPCI
200041465,CC Val Eyrieux,2006_2011,2008.5,5,13779,13524,931,637,-255,-294,39,-0.00372899181043029,-0.00429930820496669,0.000570316394536398,EPCI
200041465,CC Val Eyrieux,2011_2016,2013.5,5,13524,12743,958,473,-781,-485,-296,-0.0118262701104254,-0.00734409859610282,-0.00448217151432254,EPCI
200041465,CC Val Eyrieux,1968_1975,1971.5,7,17236,16242,1765,1646,-994,-119,-875,-0.00844977539141756,-0.00101159282854999,-0.00743818256286757,EPCI
200041465,CC Val Eyrieux,1975_1982,1978.5,7,16242,15479,1752,1313,-763,-439,-324,-0.00685017460515736,-0.00394131933376681,-0.00290885527139054,EPCI
200041465,CC Val Eyrieux,1982_1990,1986,8,15479,14547,1806,1307,-932,-499,-433,-0.00773238508040242,-0.00413997870721116,-0.00359240637319125,EPCI
200041465,CC Val Eyrieux,1990_1999,1994.5,9,14547,13984,1786,1314,-563,-472,-91,-0.00437606012077185,-0.00366873956839132,-0.00070732055238053,EPCI
200041465,CC Val Eyrieux,1999_2006,2002.5,7,13984,13779,1313,941,-205,-372,167,-0.00210750820817962,-0.00382435635825765,0.00171684815007803,EPCI
200041499,CC Aunis Atlantique,2006_2011,2008.5,5,23288,26651,1284,1950,3363,666,2697,0.0273448859193444,0.00541531193050352,0.0219295739888408,EPCI
200041499,CC Aunis Atlantique,2011_2016,2013.5,5,26651,29560,1374,2006,2909,632,2277,0.0209352148695379,0.00454831756533102,0.0163868973042069,EPCI
200041499,CC Aunis Atlantique,1968_1975,1971.5,7,15152,15755,1392,1521,603,129,474,0.00559060353192664,0.00119599976056142,0.00439460377136522,EPCI
200041499,CC Aunis Atlantique,1975_1982,1978.5,7,15755,16882,1425,1422,1127,-3,1130,0.00991889655991152,-2.6403451357351e-05,0.00994530001126887,EPCI
200041499,CC Aunis Atlantique,1982_1990,1986,8,16882,17427,1728,1616,545,-112,657,0.00397949250050877,-0.000817803963407308,0.00479729646391608,EPCI
200041499,CC Aunis Atlantique,1990_1999,1994.5,9,17427,18765,2103,1722,1338,-381,1719,0.00825305970354684,-0.00235008650751222,0.0106031462110591,EPCI
200041499,CC Aunis Atlantique,1999_2006,2002.5,7,18765,23288,1767,1867,4523,100,4423,0.0313300226815896,0.000692682349802997,0.0306373403317866,EPCI
200041507,CA La Riviera du Levant,2006_2011,2008.5,5,65462,67592,2108,5101,2130,2993,-863,0.00642451145521639,0.00902749426547542,-0.00260298281025903,EPCI
200041507,CA La Riviera du Levant,2011_2016,2013.5,5,67592,65471,2308,4553,-2121,2245,-4366,-0.00635618074284128,0.00672778206868396,-0.0130839628115252,EPCI
200041507,CA La Riviera du Levant,1968_1975,1971.5,7,33808,34966,1763,5208,1158,3445,-2287,0.00482283545612483,0.0143477272420985,-0.00952489178597365,EPCI
200041507,CA La Riviera du Levant,1975_1982,1978.5,7,34966,37781,1707,4943,2815,3236,-421,0.0111228569209534,0.0127863463574441,-0.00166348943649072,EPCI
200041507,CA La Riviera du Levant,1982_1990,1986,8,37781,47219,2139,6389,9438,4250,5188,0.0282658606452215,0.0127283224986429,0.0155375381465786,EPCI
200041507,CA La Riviera du Levant,1990_1999,1994.5,9,47219,58049,2635,8447,10830,5812,5018,0.0232086842715742,0.0124551129257977,0.0107535713457765,EPCI
200041507,CA La Riviera du Levant,1999_2006,2002.5,7,58049,65462,2396,7299,7413,4903,2510,0.0173171385140678,0.0114536530600937,0.00586348545397412,EPCI
200041515,CC du Bassin de Pont-à-Mousson,2006_2011,2008.5,5,39287,40263,1566,2619,976,1053,-77,0.00491991477724141,0.00530806379142951,-0.000388149014188103,EPCI
200041515,CC du Bassin de Pont-à-Mousson,2011_2016,2013.5,5,40263,40401,1603,2454,138,851,-713,0.000684555011352783,0.00422142257000883,-0.00353686755865605,EPCI
200041515,CC du Bassin de Pont-à-Mousson,1968_1975,1971.5,7,35856,37685,2494,4847,1829,2353,-524,0.00713263409834308,0.00917610061968358,-0.0020434665213405,EPCI
200041515,CC du Bassin de Pont-à-Mousson,1975_1982,1978.5,7,37685,38890,2549,4356,1205,1807,-602,0.00450655423496671,0.00675796141293348,-0.00225140717796677,EPCI
200041515,CC du Bassin de Pont-à-Mousson,1982_1990,1986,8,38890,39699,2657,4762,809,2105,-1296,0.00257692085393346,0.0067050907262422,-0.00412816987230874,EPCI
200041515,CC du Bassin de Pont-à-Mousson,1990_1999,1994.5,9,39699,39715,2934,4656,16,1722,-1706,4.47734051960413e-05,0.00481873773422395,-0.00477396432902791,EPCI
200041515,CC du Bassin de Pont-à-Mousson,1999_2006,2002.5,7,39715,39287,2321,3394,-428,1073,-1501,-0.00154669901721261,0.003877588891283,-0.00542428790849561,EPCI
200041523,CC de la Haute-Saintonge,2006_2011,2008.5,5,64336,67167,3830,3060,2831,-770,3601,0.00864973570134464,-0.00235263033911529,0.0110023660404599,EPCI
200041523,CC de la Haute-Saintonge,2011_2016,2013.5,5,67167,67989,4168,3000,822,-1168,1990,0.00243573597662361,-0.00346099710547004,0.00589673308209365,EPCI
200041523,CC de la Haute-Saintonge,1968_1975,1971.5,7,68190,65525,6095,6448,-2665,353,-3018,-0.00567898146195178,0.000752225311845771,-0.00643120677379755,EPCI
200041523,CC de la Haute-Saintonge,1975_1982,1978.5,7,65525,64116,6058,5337,-1409,-721,-688,-0.00310058415068493,-0.00158660125808647,-0.00151398289259846,EPCI
200041523,CC de la Haute-Saintonge,1982_1990,1986,8,64116,62487,6548,5248,-1629,-1300,-329,-0.00321175719472244,-0.0025630965949289,-0.000648660599793544,EPCI
200041523,CC de la Haute-Saintonge,1990_1999,1994.5,9,62487,61974,6871,5053,-513,-1818,1305,-0.00091553540312983,-0.00324452897249519,0.00232899356936536,EPCI
200041523,CC de la Haute-Saintonge,1999_2006,2002.5,7,61974,64336,5510,4339,2362,-1171,3533,0.00535778873165382,-0.00265621109431271,0.00801399982596654,EPCI
200041556,CC Portes de la Creuse en Marche,2006_2011,2008.5,5,6981,6768,612,225,-213,-387,174,-0.00617814641867354,-0.0112250829297026,0.00504693651102909,EPCI
200041556,CC Portes de la Creuse en Marche,2011_2016,2013.5,5,6768,6655,621,227,-113,-394,281,-0.00336177064406829,-0.0117215719802027,0.00835980133613441,EPCI
200041556,CC Portes de la Creuse en Marche,1968_1975,1971.5,7,10335,8906,1268,666,-1429,-602,-827,-0.0210343386720964,-0.00886121195283556,-0.0121731267192608,EPCI
200041556,CC Portes de la Creuse en Marche,1975_1982,1978.5,7,8906,8062,1192,441,-844,-751,-93,-0.0141226890156841,-0.0125665159369417,-0.00155617307874245,EPCI
200041556,CC Portes de la Creuse en Marche,1982_1990,1986,8,8062,7526,1222,427,-536,-795,259,-0.00856287451743076,-0.0127005321667117,0.00413765764928091,EPCI
200041556,CC Portes de la Creuse en Marche,1990_1999,1994.5,9,7526,7068,1204,445,-458,-759,301,-0.00695196006666854,-0.0115208246519682,0.00456886458529963,EPCI
200041556,CC Portes de la Creuse en Marche,1999_2006,2002.5,7,7068,6981,868,313,-87,-555,468,-0.00176777585025867,-0.0112771907688915,0.00950941491863284,EPCI
200041572,CC Dronne et Belle,2006_2011,2008.5,5,11350,11461,858,473,111,-385,496,0.00194834027061264,-0.00675775679446725,0.00870609706507989,EPCI
200041572,CC Dronne et Belle,2011_2016,2013.5,5,11461,11337,886,432,-124,-454,330,-0.00217328588286825,-0.00795703057114665,0.0057837446882784,EPCI
200041572,CC Dronne et Belle,1968_1975,1971.5,7,11560,11156,1224,850,-404,-374,-30,-0.00506902227882577,-0.00469260973336842,-0.000376412545457359,EPCI
200041572,CC Dronne et Belle,1975_1982,1978.5,7,11156,11077,1322,725,-79,-597,518,-0.00101471100803607,-0.00766813255439919,0.00665342154636311,EPCI
200041572,CC Dronne et Belle,1982_1990,1986,8,11077,11045,1509,859,-32,-650,618,-0.00036156582715563,-0.00734430586409873,0.0069827400369431,EPCI
200041572,CC Dronne et Belle,1990_1999,1994.5,9,11045,10885,1644,807,-160,-837,677,-0.00162003545529843,-0.00847481047552991,0.00685477502023148,EPCI
200041572,CC Dronne et Belle,1999_2006,2002.5,7,10885,11350,1148,654,465,-494,959,0.00599389898750835,-0.00636771204264328,0.0123616110301516,EPCI
200041614,CC Aunis Sud,2006_2011,2008.5,5,26968,30058,1207,1881,3090,674,2416,0.0219326343661923,0.00478401150900117,0.0171486228571911,EPCI
200041614,CC Aunis Sud,2011_2016,2013.5,5,30058,31496,1336,1783,1438,447,991,0.00939015446325575,0.00291891449587992,0.00647123996737583,EPCI
200041614,CC Aunis Sud,1968_1975,1971.5,7,20568,21235,1550,2284,667,734,-67,0.00456959372463972,0.00502860838663501,-0.000459014661995294,EPCI
200041614,CC Aunis Sud,1975_1982,1978.5,7,21235,22578,1542,1947,1343,405,938,0.00879923293674589,0.00265352891986753,0.00614570401687837,EPCI
200041614,CC Aunis Sud,1982_1990,1986,8,22578,22954,1768,2225,376,457,-81,0.0020666616598517,0.00251187334721337,-0.000445211687361669,EPCI
200041614,CC Aunis Sud,1990_1999,1994.5,9,22954,24051,2068,2265,1097,197,900,0.00520062794693255,0.000933932274882144,0.0042666956720504,EPCI
200041614,CC Aunis Sud,1999_2006,2002.5,7,24051,26968,1697,2193,2917,496,2421,0.0164879361913541,0.00280357091220831,0.0136843652791458,EPCI
200041622,CC Ardennes Thiérache,2006_2011,2008.5,5,9787,10055,510,587,268,77,191,0.00541763233685288,0.00155655854454355,0.00386107379230933,EPCI
200041622,CC Ardennes Thiérache,2011_2016,2013.5,5,10055,9956,486,509,-99,23,-122,-0.00197697095733884,0.000459296283018115,-0.00243626724035696,EPCI
200041622,CC Ardennes Thiérache,1968_1975,1971.5,7,11379,10420,976,1178,-959,202,-1161,-0.0124987359429923,0.00263268473460318,-0.0151314206775955,EPCI
200041622,CC Ardennes Thiérache,1975_1982,1978.5,7,10420,10093,899,855,-327,-44,-283,-0.00454463063831267,-0.000611509932983968,-0.00393312070532871,EPCI
200041622,CC Ardennes Thiérache,1982_1990,1986,8,10093,9377,983,917,-716,-66,-650,-0.00915560879804689,-0.000843952766300412,-0.00831165603174648,EPCI
200041622,CC Ardennes Thiérache,1990_1999,1994.5,9,9377,9271,944,872,-106,-72,-34,-0.00126238405676504,-0.000857468415915878,-0.000404915640849165,EPCI
200041622,CC Ardennes Thiérache,1999_2006,2002.5,7,9271,9787,724,826,516,102,414,0.00776768828586061,0.00153547326580966,0.00623221502005095,EPCI
200041630,CA Ardenne Métropole,2006_2011,2008.5,5,132585,128903,6122,8166,-3682,2044,-5726,-0.00561691892030403,0.00311813749948436,-0.00873505641978839,EPCI
200041630,CA Ardenne Métropole,2011_2016,2013.5,5,128903,123082,6475,7270,-5821,795,-6616,-0.00919930183843343,0.00125638978896316,-0.0104556916273966,EPCI
200041630,CA Ardenne Métropole,1968_1975,1971.5,7,134121,141026,9608,19200,6905,9592,-2687,0.00719747721557007,0.0099982913036565,-0.00280081408808643,EPCI
200041630,CA Ardenne Métropole,1975_1982,1978.5,7,141026,140364,9335,16881,-662,7546,-8208,-0.000671948724937366,0.00765940344165765,-0.00833135216659501,EPCI
200041630,CA Ardenne Métropole,1982_1990,1986,8,140364,138770,10154,18333,-1594,8179,-9773,-0.00142662665850446,0.00732018785439647,-0.00874681451290093,EPCI
200041630,CA Ardenne Métropole,1990_1999,1994.5,9,138770,136423,10978,17406,-2347,6428,-8775,-0.00189348658678934,0.00518591043028627,-0.00707939701707561,EPCI
200041630,CA Ardenne Métropole,1999_2006,2002.5,7,136423,132585,8781,12233,-3838,3452,-7290,-0.00406833092962799,0.00365916580747156,-0.00772749673709955,EPCI
200041689,CC des Vals de Saintonge,2006_2011,2008.5,5,51222,53000,3336,2485,1778,-851,2629,0.00684789761572802,-0.00327759329076746,0.0101254909064955,EPCI
200041689,CC des Vals de Saintonge,2011_2016,2013.5,5,53000,52563,3504,2280,-437,-1224,787,-0.00165452244195985,-0.00463417727450539,0.00297965483254554,EPCI
200041689,CC des Vals de Saintonge,1968_1975,1971.5,7,56368,53667,4840,5577,-2701,737,-3438,-0.00699021600265704,0.00190736364085829,-0.00889757964351532,EPCI
200041689,CC des Vals de Saintonge,1975_1982,1978.5,7,53667,52343,4810,4253,-1324,-557,-767,-0.00356222224681424,-0.00149860860383348,-0.00206361364298076,EPCI
200041689,CC des Vals de Saintonge,1982_1990,1986,8,52343,50722,5169,4290,-1621,-879,-742,-0.00392458753131786,-0.00212813845775965,-0.00179644907355821,EPCI
200041689,CC des Vals de Saintonge,1990_1999,1994.5,9,50722,49878,5929,4285,-844,-1644,800,-0.00186267614501756,-0.00362824595072141,0.00176556980570385,EPCI
200041689,CC des Vals de Saintonge,1999_2006,2002.5,7,49878,51222,4578,3414,1344,-1164,2508,0.00380566658291093,-0.00329597909412821,0.00710164567703914,EPCI
200041721,CC de la Haute Comté,2006_2011,2008.5,5,19456,18835,960,1050,-621,90,-711,-0.00646673302713641,0.000937207685092233,-0.00740394071222864,EPCI
200041721,CC de la Haute Comté,2011_2016,2013.5,5,18835,18120,971,879,-715,-92,-623,-0.00771023060381593,-0.000992085616155336,-0.00671814498766059,EPCI
200041721,CC de la Haute Comté,1968_1975,1971.5,7,21128,21885,1882,2549,757,667,90,0.00504156551611157,0.0044421719937205,0.000599393522391072,EPCI
200041721,CC de la Haute Comté,1975_1982,1978.5,7,21885,22186,1811,2292,301,481,-180,0.00195333222608185,0.00312143787623046,-0.00116810565014861,EPCI
200041721,CC de la Haute Comté,1982_1990,1986,8,22186,21424,1903,2616,-762,713,-1475,-0.00435917986910361,0.00407886515311139,-0.008438045022215,EPCI
200041721,CC de la Haute Comté,1990_1999,1994.5,9,21424,20526,1816,2162,-898,346,-1244,-0.00474641264917952,0.00182879596505135,-0.00657520861423087,EPCI
200041721,CC de la Haute Comté,1999_2006,2002.5,7,20526,19456,1378,1538,-1070,160,-1230,-0.00761895172271521,0.00113928250059293,-0.00875823422330814,EPCI
200041762,CA Rochefort Océan,2006_2011,2008.5,5,60694,63167,3294,3452,2473,158,2315,0.0080194179456472,0.000512360709831079,0.00750705723581612,EPCI
200041762,CA Rochefort Océan,2011_2016,2013.5,5,63167,63288,3502,3068,121,-434,555,0.000382818222959047,-0.001373083543506,0.00175590176646505,EPCI
200041762,CA Rochefort Océan,1968_1975,1971.5,7,52555,52445,4077,6337,-110,2260,-2370,-0.000299275045679503,0.00614874184759707,-0.00644801689327658,EPCI
200041762,CA Rochefort Océan,1975_1982,1978.5,7,52445,53197,4108,5249,752,1141,-389,0.00203592717197743,0.00308908630748171,-0.00105315913550428,EPCI
200041762,CA Rochefort Océan,1982_1990,1986,8,53197,54301,4788,5837,1104,1049,55,0.00257087895575259,0.00244280074690622,0.00012807820884637,EPCI
200041762,CA Rochefort Océan,1990_1999,1994.5,9,54301,55993,5178,5636,1692,458,1234,0.00341515617415511,0.000924433527046714,0.0024907226471084,EPCI
200041762,CA Rochefort Océan,1999_2006,2002.5,7,55993,60694,4211,4493,4701,282,4419,0.0115834550956966,0.000694859463302794,0.0108885956323938,EPCI
200041788,CA du Pays Nord Martinique,2006_2011,2008.5,5,110873,107501,4188,6737,-3372,2549,-5921,-0.00615801170222508,0.00465503316398924,-0.0108130448662143,EPCI
200041788,CA du Pays Nord Martinique,2011_2016,2013.5,5,107501,101863,4493,5564,-5638,1071,-6709,-0.0107164407182097,0.00203570557098307,-0.0127521462891927,EPCI
200041788,CA du Pays Nord Martinique,1968_1975,1971.5,7,100743,100439,5177,18521,-304,13344,-13648,-0.000431641310040254,0.0189467817143985,-0.0193784230244388,EPCI
200041788,CA du Pays Nord Martinique,1975_1982,1978.5,7,100439,94666,5375,13140,-5773,7765,-13538,-0.00842086858101332,0.0113265277206943,-0.0197473963017077,EPCI
200041788,CA du Pays Nord Martinique,1982_1990,1986,8,94666,102258,5139,13577,7592,8438,-846,0.00968965921434917,0.010769407857044,-0.00107974864269486,EPCI
200041788,CA du Pays Nord Martinique,1990_1999,1994.5,9,102258,108470,6309,14925,6212,8616,-2404,0.00657425008539558,0.00911843830260276,-0.00254418821720718,EPCI
200041788,CA du Pays Nord Martinique,1999_2006,2002.5,7,108470,110873,5427,10543,2403,5116,-2713,0.00313515651001217,0.00667476517071255,-0.00353960866070038,EPCI
200041853,CC du Pays de Montbozon et du Chanois,2006_2011,2008.5,5,6074,6442,368,444,368,76,292,0.0118338088312124,0.00244393878035909,0.00938987005085334,EPCI
200041853,CC du Pays de Montbozon et du Chanois,2011_2016,2013.5,5,6442,6559,422,372,117,-50,167,0.00360630741538182,-0.00154115701512043,0.00514746443050225,EPCI
200041853,CC du Pays de Montbozon et du Chanois,1968_1975,1971.5,7,5031,4796,450,499,-235,49,-284,-0.00681049337314832,0.00142006032035859,-0.0082305536935069,EPCI
200041853,CC du Pays de Montbozon et du Chanois,1975_1982,1978.5,7,4796,5364,433,474,568,41,527,0.0161181944039539,0.00116346121577836,0.0149547331881755,EPCI
200041853,CC du Pays de Montbozon et du Chanois,1982_1990,1986,8,5364,5398,674,522,34,-152,186,0.000790130635927921,-0.00353234872532483,0.00432247936125275,EPCI
200041853,CC du Pays de Montbozon et du Chanois,1990_1999,1994.5,9,5398,5488,814,516,90,-298,388,0.00183895278443202,-0.00608897699734159,0.00792792978177362,EPCI
200041853,CC du Pays de Montbozon et du Chanois,1999_2006,2002.5,7,5488,6074,640,516,586,-124,710,0.0145988916438551,-0.00308918526252224,0.0176880769063773,EPCI
200041861,CC du Triangle Vert,2006_2011,2008.5,5,10527,11119,448,754,592,306,286,0.0110024812518679,0.00568709334978305,0.00531538790208481,EPCI
200041861,CC du Triangle Vert,2011_2016,2013.5,5,11119,11048,455,630,-71,175,-246,-0.00128036775170848,0.00315583600773216,-0.00443620375944064,EPCI
200041861,CC du Triangle Vert,1968_1975,1971.5,7,7894,7532,846,803,-362,-43,-319,-0.00668361695931685,-0.000793910301797306,-0.00588970665751955,EPCI
200041861,CC du Triangle Vert,1975_1982,1978.5,7,7532,8310,753,685,778,-68,846,0.0141417760756812,-0.00123604212486674,0.015377818200548,EPCI
200041861,CC du Triangle Vert,1982_1990,1986,8,8310,9070,823,975,760,152,608,0.0109991324300593,0.00219982648601187,0.00879930594404748,EPCI
200041861,CC du Triangle Vert,1990_1999,1994.5,9,9070,9537,737,908,467,171,296,0.00559411187444336,0.00204837929449639,0.00354573257994697,EPCI
200041861,CC du Triangle Vert,1999_2006,2002.5,7,9537,10527,599,905,990,306,684,0.0142092066626502,0.00439193660481917,0.00981727005783108,EPCI
200041879,CC Terres de Saône,2006_2011,2008.5,5,13163,13479,618,811,316,193,123,0.00475588455202924,0.00290470164095457,0.00185118291107467,EPCI
200041879,CC Terres de Saône,2011_2016,2013.5,5,13479,13343,573,771,-136,198,-334,-0.00202614778489529,0.00294983280447991,-0.00497598058937521,EPCI
200041879,CC Terres de Saône,1968_1975,1971.5,7,13098,13291,1150,1219,193,69,124,0.00209183736589535,0.000747858954646526,0.00134397841124883,EPCI
200041879,CC Terres de Saône,1975_1982,1978.5,7,13291,13965,1172,1207,674,35,639,0.00709175465488432,0.000368266191277376,0.00672348846360694,EPCI
200041879,CC Terres de Saône,1982_1990,1986,8,13965,13688,1223,1335,-277,112,-389,-0.00250119962548412,0.0010113153720369,-0.00351251499752102,EPCI
200041879,CC Terres de Saône,1990_1999,1994.5,9,13688,13012,1471,1260,-676,-211,-465,-0.00561169837409714,-0.00175158040966641,-0.00386011796443073,EPCI
200041879,CC Terres de Saône,1999_2006,2002.5,7,13012,13163,842,1049,151,207,-56,0.00164962411137504,0.0022614052387724,-0.000611781127397364,EPCI
200041887,CC du Val Marnaysien,2006_2011,2008.5,5,12693,13498,467,934,805,467,338,0.0123741066766629,0.00717851902857341,0.00519558764808954,EPCI
200041887,CC du Val Marnaysien,2011_2016,2013.5,5,13498,14190,486,909,692,423,269,0.0100493519438594,0.00614288420845739,0.00390646773540198,EPCI
200041887,CC du Val Marnaysien,1968_1975,1971.5,7,7465,7648,788,758,183,-30,213,0.00346581276779845,-0.000568166027507942,0.00403397879530639,EPCI
200041887,CC du Val Marnaysien,1975_1982,1978.5,7,7648,9058,681,689,1410,8,1402,0.024466535767353,0.000138817224211932,0.0243277185431411,EPCI
200041887,CC du Val Marnaysien,1982_1990,1986,8,9058,10033,776,956,975,180,795,0.0128609135919953,0.00237432250929143,0.0104865910827038,EPCI
200041887,CC du Val Marnaysien,1990_1999,1994.5,9,10033,11121,901,1052,1088,151,937,0.0115051872395537,0.00159676771431306,0.00990841952524067,EPCI
200041887,CC du Val Marnaysien,1999_2006,2002.5,7,11121,12693,691,1169,1572,478,1094,0.0190674262413861,0.00579785607085405,0.0132695701705321,EPCI
200041960,CC Pévèle-Carembault,2006_2011,2008.5,5,87644,90854,3213,5074,3210,1861,1349,0.00722007345553277,0.00418584320895529,0.00303423024657748,EPCI
200041960,CC Pévèle-Carembault,2011_2016,2013.5,5,90854,94663,3363,5104,3809,1741,2068,0.00824770522568374,0.00376982273507887,0.00447788249060488,EPCI
200041960,CC Pévèle-Carembault,1968_1975,1971.5,7,63993,68489,5320,7573,4496,2253,2243,0.00974711757524127,0.00488439855360734,0.00486271902163394,EPCI
200041960,CC Pévèle-Carembault,1975_1982,1978.5,7,68489,73043,5376,7118,4554,1742,2812,0.00923886877491742,0.00353406003643086,0.00570480873848656,EPCI
200041960,CC Pévèle-Carembault,1982_1990,1986,8,73043,79003,5604,8382,5960,2778,3182,0.00985291314674619,0.00459251555732566,0.00526039758942053,EPCI
200041960,CC Pévèle-Carembault,1990_1999,1994.5,9,79003,84135,5903,8841,5132,2938,2194,0.00701748856097506,0.0040174164832706,0.00300007207770446,EPCI
200041960,CC Pévèle-Carembault,1999_2006,2002.5,7,84135,87644,4537,7368,3509,2831,678,0.00585428449472381,0.00472313462654976,0.00113114986817405,EPCI
200041994,CC Haut Val de Sèvre,2006_2011,2008.5,5,29090,30084,1244,1801,994,557,437,0.00674242780061807,0.00377820149390771,0.00296422630671036,EPCI
200041994,CC Haut Val de Sèvre,2011_2016,2013.5,5,30084,30203,1293,1599,119,306,-187,0.000789869428958756,0.00203109281732252,-0.00124122338836376,EPCI
200041994,CC Haut Val de Sèvre,1968_1975,1971.5,7,22974,22707,1944,2459,-267,515,-782,-0.0016685913121669,0.00321844391672642,-0.00488703522889332,EPCI
200041994,CC Haut Val de Sèvre,1975_1982,1978.5,7,22707,24166,1715,2085,1459,370,1089,0.00893589450219579,0.00226612814654725,0.00666976635564853,EPCI
200041994,CC Haut Val de Sèvre,1982_1990,1986,8,24166,24879,1913,2546,713,633,80,0.00364128687715293,0.00323272733974446,0.000408559537408463,EPCI
200041994,CC Haut Val de Sèvre,1990_1999,1994.5,9,24879,25490,2147,2547,611,400,211,0.0026994307251651,0.00176722142400334,0.00093220930116176,EPCI
200041994,CC Haut Val de Sèvre,1999_2006,2002.5,7,25490,29090,1740,2371,3600,631,2969,0.0190518210246626,0.00333936085182281,0.0157124601728398,EPCI
200042000,CC Bruyères-Vallons des Vosges,2006_2011,2008.5,5,15337,15474,888,969,137,81,56,0.00178017993404245,0.00105251514348495,0.000727664790557497,EPCI
200042000,CC Bruyères-Vallons des Vosges,2011_2016,2013.5,5,15474,15321,880,815,-153,-65,-88,-0.00198537848237246,-0.000843461446759541,-0.00114191703561292,EPCI
200042000,CC Bruyères-Vallons des Vosges,1968_1975,1971.5,7,15130,14990,1394,1567,-140,173,-313,-0.00132714936956957,0.00163997743525382,-0.00296712680482339,EPCI
200042000,CC Bruyères-Vallons des Vosges,1975_1982,1978.5,7,14990,15121,1388,1462,131,74,57,0.0012438005957307,0.000702604916672306,0.000541195679058398,EPCI
200042000,CC Bruyères-Vallons des Vosges,1982_1990,1986,8,15121,14933,1532,1571,-188,39,-227,-0.00156264992111277,0.000324166738954245,-0.00188681666006701,EPCI
200042000,CC Bruyères-Vallons des Vosges,1990_1999,1994.5,9,14933,14929,1632,1595,-4,-37,33,-2.97661129446958e-05,-0.000275336544738436,0.00024557043179374,EPCI
200042000,CC Bruyères-Vallons des Vosges,1999_2006,2002.5,7,14929,15337,1293,1340,408,47,361,0.00385922478931366,0.000444567561514074,0.00341465722779959,EPCI
200042174,CA Lorient Agglomération,2006_2011,2008.5,5,197413,198810,9965,10695,1397,730,667,0.00141131773435466,0.000737481708002075,0.000673836026352581,EPCI
200042174,CA Lorient Agglomération,2011_2016,2013.5,5,198810,202494,10484,10123,3684,-361,4045,0.00367888288034668,-0.000360498566722354,0.00403938144706903,EPCI
200042174,CA Lorient Agglomération,1968_1975,1971.5,7,163359,174516,13116,22004,11157,8888,2269,0.00948270649595706,0.00755420770243492,0.00192849879352214,EPCI
200042174,CA Lorient Agglomération,1975_1982,1978.5,7,174516,182060,13168,19612,7544,6444,1100,0.00606400854922029,0.0051798079389151,0.000884200610305186,EPCI
200042174,CA Lorient Agglomération,1982_1990,1986,8,182060,191544,14941,21792,9484,6851,2633,0.00636784458101602,0.00459996870777528,0.00176787587324074,EPCI
200042174,CA Lorient Agglomération,1990_1999,1994.5,9,191544,192683,16552,20777,1139,4225,-3086,0.000658973055822631,0.00244439083481178,-0.00178541777898915,EPCI
200042174,CA Lorient Agglomération,1999_2006,2002.5,7,192683,197413,13764,15227,4730,1463,3267,0.00347052687563765,0.00107344203362746,0.00239708484201019,EPCI
200042182,CC du Mont des Avaloirs,2006_2011,2008.5,5,17108,16920,1014,792,-188,-222,34,-0.00220752705762539,-0.00260676067442998,0.000399233616804592,EPCI
200042182,CC du Mont des Avaloirs,2011_2016,2013.5,5,16920,16411,1060,776,-509,-284,-225,-0.00609028108934551,-0.00339811361370162,-0.00269216747564389,EPCI
200042182,CC du Mont des Avaloirs,1968_1975,1971.5,7,17962,17321,1665,1811,-641,146,-787,-0.00517780259384104,0.00117934349251294,-0.00635714608635398,EPCI
200042182,CC du Mont des Avaloirs,1975_1982,1978.5,7,17321,17251,1537,1495,-70,-42,-28,-0.000578336324260187,-0.000347001794556112,-0.000231334529704075,EPCI
200042182,CC du Mont des Avaloirs,1982_1990,1986,8,17251,16845,1627,1588,-406,-39,-367,-0.00297260253598319,-0.000285545563801341,-0.00268705697218185,EPCI
200042182,CC du Mont des Avaloirs,1990_1999,1994.5,9,16845,16758,1689,1627,-87,-62,-25,-0.000575181260626168,-0.000409899289181867,-0.000165281971444301,EPCI
200042182,CC du Mont des Avaloirs,1999_2006,2002.5,7,16758,17108,1382,1405,350,23,327,0.00295728332807155,0.000194335761558987,0.00276294756651256,EPCI
200042190,CA de la Porte du Hainaut,2006_2011,2008.5,5,156909,158104,7787,11217,1195,3430,-2235,0.00151855681497137,0.00435870282456218,-0.00284014600959081,EPCI
200042190,CA de la Porte du Hainaut,2011_2016,2013.5,5,158104,158789,7946,11425,685,3479,-2794,0.000865020425403928,0.00439329351821937,-0.00352827309281544,EPCI
200042190,CA de la Porte du Hainaut,1968_1975,1971.5,7,176888,173329,14588,22142,-3559,7554,-11113,-0.0028993945184288,0.0061539831953389,-0.0090533777137677,EPCI
200042190,CA de la Porte du Hainaut,1975_1982,1978.5,7,173329,162347,13804,18139,-10982,4335,-15317,-0.00930720346536051,0.00367389610474757,-0.0129810995701081,EPCI
200042190,CA de la Porte du Hainaut,1982_1990,1986,8,162347,157408,14386,19756,-4939,5370,-10309,-0.00385441001491427,0.00419076367282641,-0.00804517368774067,EPCI
200042190,CA de la Porte du Hainaut,1990_1999,1994.5,9,157408,157175,14703,18732,-233,4029,-4262,-0.000164578271488414,0.00284586204217519,-0.0030104403136636,EPCI
200042190,CA de la Porte du Hainaut,1999_2006,2002.5,7,157175,156909,11378,15157,-266,3779,-4045,-0.000241944269415706,0.00343724584256373,-0.00367919011197944,EPCI
200042372,CC des Coteaux Arrats Gimone,2006_2011,2008.5,5,9738,10321,601,519,583,-82,665,0.0116968588129052,-0.00164518425841891,0.0133420430713241,EPCI
200042372,CC des Coteaux Arrats Gimone,2011_2016,2013.5,5,10321,10553,612,527,232,-85,317,0.00445580271939905,-0.00163251392736603,0.00608831664676508,EPCI
200042372,CC des Coteaux Arrats Gimone,1968_1975,1971.5,7,10178,9399,1039,713,-779,-326,-453,-0.011310581430992,-0.00473331135623026,-0.00657727007476169,EPCI
200042372,CC des Coteaux Arrats Gimone,1975_1982,1978.5,7,9399,9241,969,549,-158,-420,262,-0.00241895470705156,-0.00643013276558009,0.00401117805852853,EPCI
200042372,CC des Coteaux Arrats Gimone,1982_1990,1986,8,9241,9151,1055,674,-90,-381,291,-0.00122261973732229,-0.00517575688799771,0.00395313715067542,EPCI
200042372,CC des Coteaux Arrats Gimone,1990_1999,1994.5,9,9151,9097,1169,727,-54,-442,388,-0.000657392055686046,-0.00538087571505986,0.00472348365937381,EPCI
200042372,CC des Coteaux Arrats Gimone,1999_2006,2002.5,7,9097,9738,936,634,641,-302,943,0.0097747594732116,-0.0046052688937752,0.0143800283669868,EPCI
200042414,CC Bresse Revermont 71,2006_2011,2008.5,5,8908,9694,574,455,786,-119,905,0.0170552861710354,-0.00258216164675981,0.0196374478177952,EPCI
200042414,CC Bresse Revermont 71,2011_2016,2013.5,5,9694,9865,560,432,171,-128,299,0.0035033227505703,-0.00262237024604093,0.00612569299661123,EPCI
200042414,CC Bresse Revermont 71,1968_1975,1971.5,7,10462,9429,1003,735,-1033,-268,-765,-0.0147416335192636,-0.00382454770877313,-0.0109170858104905,EPCI
200042414,CC Bresse Revermont 71,1975_1982,1978.5,7,9429,8829,1048,502,-600,-546,-54,-0.00934863984666578,-0.00850726226046587,-0.000841377586199921,EPCI
200042414,CC Bresse Revermont 71,1982_1990,1986,8,8829,8357,1117,565,-472,-552,80,-0.00684425155106228,-0.00800429418683554,0.00116004263577327,EPCI
200042414,CC Bresse Revermont 71,1990_1999,1994.5,9,8357,8011,1108,559,-346,-549,203,-0.00468719330572276,-0.00743719400243293,0.00275000069671017,EPCI
200042414,CC Bresse Revermont 71,1999_2006,2002.5,7,8011,8908,762,623,897,-139,1036,0.0152775483227632,-0.00236742387610266,0.0176449721988658,EPCI
200042463,CC de la Montagne Noire,2006_2011,2008.5,5,5748,5832,419,265,84,-154,238,0.00290581902911069,-0.00532733488670293,0.00823315391581362,EPCI
200042463,CC de la Montagne Noire,2011_2016,2013.5,5,5832,5867,423,251,35,-172,207,0.00119740336312479,-0.00588438224164184,0.00708178560476664,EPCI
200042463,CC de la Montagne Noire,1968_1975,1971.5,7,5636,5053,538,365,-583,-173,-410,-0.0154778908923454,-0.00459292474163938,-0.010884966150706,EPCI
200042463,CC de la Montagne Noire,1975_1982,1978.5,7,5053,4822,474,285,-231,-189,-42,-0.00666247046236279,-0.00545111219647865,-0.00121135826588414,EPCI
200042463,CC de la Montagne Noire,1982_1990,1986,8,4822,4905,547,378,83,-169,252,0.0021355662375433,-0.00434832161620261,0.00648388785374591,EPCI
200042463,CC de la Montagne Noire,1990_1999,1994.5,9,4905,5208,638,417,303,-221,524,0.00668231792949059,-0.0048739018561631,0.0115562197856537,EPCI
200042463,CC de la Montagne Noire,1999_2006,2002.5,7,5208,5748,501,314,540,-187,727,0.0141935080771771,-0.004915159278578,0.0191086673557551,EPCI
200042497,CC Dombes Saône Vallée,2006_2011,2008.5,5,33399,35020,994,1923,1621,929,692,0.00952373838676923,0.0054580832580559,0.00406565512871333,EPCI
200042497,CC Dombes Saône Vallée,2011_2016,2013.5,5,35020,37603,1131,2007,2583,876,1707,0.0143346715149155,0.00486146815604568,0.00947320335886984,EPCI
200042497,CC Dombes Saône Vallée,1968_1975,1971.5,7,13529,15489,1171,1592,1960,421,1539,0.0195157860191126,0.00419191118063593,0.0153238748384767,EPCI
200042497,CC Dombes Saône Vallée,1975_1982,1978.5,7,15489,20588,1108,1735,5099,627,4472,0.0414917298075719,0.00510204247682831,0.0363896873307436,EPCI
200042497,CC Dombes Saône Vallée,1982_1990,1986,8,20588,25867,1364,2485,5279,1121,4158,0.0289434050682453,0.00614615591617788,0.0227972491520675,EPCI
200042497,CC Dombes Saône Vallée,1990_1999,1994.5,9,25867,30009,1580,3097,4142,1517,2625,0.0166401878235858,0.0060944386596764,0.0105457491639094,EPCI
200042497,CC Dombes Saône Vallée,1999_2006,2002.5,7,30009,33399,1322,2679,3390,1357,2033,0.0154072903117455,0.00616746104809399,0.00923982926365149,EPCI
200042604,"CC de Granville, Terre et Mer",2006_2011,2008.5,5,42173,43868,2657,2049,1695,-608,2303,0.00791212050480161,-0.00283809396278429,0.0107502144675859,EPCI
200042604,"CC de Granville, Terre et Mer",2011_2016,2013.5,5,43868,44464,2786,1786,596,-1000,1596,0.00270259506384885,-0.00453455547625645,0.0072371505401053,EPCI
200042604,"CC de Granville, Terre et Mer",1968_1975,1971.5,7,33842,35108,3088,3799,1266,711,555,0.00526041480536832,0.0029543087887969,0.00230610601657142,EPCI
200042604,"CC de Granville, Terre et Mer",1975_1982,1978.5,7,35108,36646,3103,3397,1538,294,1244,0.00614383312668076,0.00117443884216134,0.00496939428451942,EPCI
200042604,"CC de Granville, Terre et Mer",1982_1990,1986,8,36646,36812,3509,3531,166,22,144,0.000565109253932716,7.48939975091552e-05,0.000490215256423561,EPCI
200042604,"CC de Granville, Terre et Mer",1990_1999,1994.5,9,36812,39515,4028,3930,2703,-98,2801,0.00790401394421725,-0.000286568023134773,0.00819058196735202,EPCI
200042604,"CC de Granville, Terre et Mer",1999_2006,2002.5,7,39515,42173,3343,3152,2658,-191,2849,0.00934335906845951,-0.000671400143745586,0.0100147592122051,EPCI
200042620,CC de la Région de Suippes,2006_2011,2008.5,5,7248,7727,326,574,479,248,231,0.0128812821167668,0.00666922330888968,0.00621205880787708,EPCI
200042620,CC de la Région de Suippes,2011_2016,2013.5,5,7727,7703,356,553,-24,197,-221,-0.000621971611540428,0.00510535031139435,-0.00572732192293478,EPCI
200042620,CC de la Région de Suippes,1968_1975,1971.5,7,6800,6520,481,814,-280,333,-613,-0.00598888559282984,0.00712249608004406,-0.0131113816728739,EPCI
200042620,CC de la Région de Suippes,1975_1982,1978.5,7,6520,6370,452,621,-150,169,-319,-0.00331946497554703,0.00373993053911632,-0.00705939551466334,EPCI
200042620,CC de la Région de Suippes,1982_1990,1986,8,6370,6532,472,742,162,270,-108,0.00314414568027455,0.00524024280045758,-0.00209609712018303,EPCI
200042620,CC de la Région de Suippes,1990_1999,1994.5,9,6532,6840,628,807,308,179,129,0.00513252166337708,0.00298286161605356,0.00214966004732352,EPCI
200042620,CC de la Région de Suippes,1999_2006,2002.5,7,6840,7248,469,743,408,274,134,0.00831118155976185,0.00558152879258516,0.00272965276717669,EPCI
200042646,CC Grand Orb,2006_2011,2008.5,5,20132,20779,1432,908,647,-524,1171,0.00634650876240239,-0.00513998545826716,0.0114864942206696,EPCI
200042646,CC Grand Orb,2011_2016,2013.5,5,20779,20337,1486,790,-442,-696,254,-0.00429096224106196,-0.00675680932076725,0.00246584707970529,EPCI
200042646,CC Grand Orb,1968_1975,1971.5,7,20839,19193,2108,1483,-1646,-625,-1021,-0.0116855589488142,-0.00443710470413661,-0.00724845424467757,EPCI
200042646,CC Grand Orb,1975_1982,1978.5,7,19193,19016,2127,1275,-177,-852,675,-0.00132268150840253,-0.00636680590485288,0.00504412439645034,EPCI
200042646,CC Grand Orb,1982_1990,1986,8,19016,18728,2432,1472,-288,-960,672,-0.00190580662355477,-0.00635268874518258,0.0044468821216278,EPCI
200042646,CC Grand Orb,1990_1999,1994.5,9,18728,18586,2512,1515,-142,-997,855,-0.000845322630401379,-0.00593511734162095,0.00508979471121957,EPCI
200042646,CC Grand Orb,1999_2006,2002.5,7,18586,20132,2100,1121,1546,-979,2525,0.0114799633081573,-0.00726965334973218,0.0187496166578894,EPCI
200042653,CC Sud-Hérault,2006_2011,2008.5,5,15968,17090,1197,786,1122,-411,1533,0.0136740010627165,-0.00500892552297371,0.0186829265856903,EPCI
200042653,CC Sud-Hérault,2011_2016,2013.5,5,17090,17616,1156,758,526,-398,924,0.00608123264189198,-0.00460138895717302,0.010682621599065,EPCI
200042653,CC Sud-Hérault,1968_1975,1971.5,7,15378,13496,1613,947,-1882,-666,-1216,-0.0184764036861633,-0.00653840853081019,-0.0119379951553531,EPCI
200042653,CC Sud-Hérault,1975_1982,1978.5,7,13496,13666,1540,685,170,-855,1025,0.00178983572082236,-0.00900182083119483,0.0107916565520172,EPCI
200042653,CC Sud-Hérault,1982_1990,1986,8,13666,14344,1746,897,678,-849,1527,0.00607094644194706,-0.00760211434987176,0.0136730607918188,EPCI
200042653,CC Sud-Hérault,1990_1999,1994.5,9,14344,14863,1805,1117,519,-688,1207,0.00395704928982665,-0.00524556823005923,0.00920261751988588,EPCI
200042653,CC Sud-Hérault,1999_2006,2002.5,7,14863,15968,1534,964,1105,-570,1675,0.0102972002087782,-0.00531167793574985,0.0156088781445281,EPCI
200042703,CC de l'Argonne Champenoise,2006_2011,2008.5,5,12631,12425,874,679,-206,-195,-11,-0.00328330568646751,-0.00310798353816099,-0.000175322148306518,EPCI
200042703,CC de l'Argonne Champenoise,2011_2016,2013.5,5,12425,12048,854,587,-377,-267,-110,-0.0061434316629041,-0.00435091844561113,-0.00179251321729297,EPCI
200042703,CC de l'Argonne Champenoise,1968_1975,1971.5,7,14848,14236,1279,1588,-612,309,-921,-0.00599498768797058,0.00302688103853416,-0.00902186872650474,EPCI
200042703,CC de l'Argonne Champenoise,1975_1982,1978.5,7,14236,13839,1244,1285,-397,41,-438,-0.00403231606471266,0.000416435664113902,-0.00444875172882656,EPCI
200042703,CC de l'Argonne Champenoise,1982_1990,1986,8,13839,13283,1339,1305,-556,-34,-522,-0.00511259485668358,-0.000312640692674895,-0.00479995416400869,EPCI
200042703,CC de l'Argonne Champenoise,1990_1999,1994.5,9,13283,12849,1340,1285,-434,-55,-379,-0.0036842004903318,-0.000466891767207947,-0.00321730872312385,EPCI
200042703,CC de l'Argonne Champenoise,1999_2006,2002.5,7,12849,12631,1136,1023,-218,-113,-105,-0.00244156844119603,-0.00126558364153739,-0.00117598479965864,EPCI
200042729,CC de la Baie du Cotentin,2006_2011,2008.5,5,23267,23383,1392,1226,116,-166,282,0.000995137814605362,-0.00142407652779733,0.00241921434240269,EPCI
200042729,CC de la Baie du Cotentin,2011_2016,2013.5,5,23383,23192,1509,1145,-191,-364,173,-0.00163902951998407,-0.00312359552499582,0.00148456600501175,EPCI
200042729,CC de la Baie du Cotentin,1968_1975,1971.5,7,23649,23402,1584,2599,-247,1015,-1262,-0.00149878169592055,0.00615896122007836,-0.00765774291599891,EPCI
200042729,CC de la Baie du Cotentin,1975_1982,1978.5,7,23402,23339,1811,2158,-63,347,-410,-0.000385026966326141,0.00212070408436779,-0.00250573105069393,EPCI
200042729,CC de la Baie du Cotentin,1982_1990,1986,8,23339,22765,2190,2440,-574,250,-824,-0.0031078496375172,0.00135359304769913,-0.00446144268521633,EPCI
200042729,CC de la Baie du Cotentin,1990_1999,1994.5,9,22765,22927,2398,2556,162,158,4,0.000788197859669548,0.000768736184122152,1.94616755473963e-05,EPCI
200042729,CC de la Baie du Cotentin,1999_2006,2002.5,7,22927,23267,1979,1853,340,-126,466,0.00210518312220986,-0.000780156098230714,0.00288533922044058,EPCI
200042901,CC Drôme Sud Provence,2006_2011,2008.5,5,37583,40197,1368,2393,2614,1025,1589,0.0135389416334648,0.00530888109192863,0.00823006054153618,EPCI
200042901,CC Drôme Sud Provence,2011_2016,2013.5,5,40197,41965,1514,2597,1768,1083,685,0.00864587585425025,0.00529608798085578,0.00334978787339447,EPCI
200042901,CC Drôme Sud Provence,1968_1975,1971.5,7,23676,24421,1482,2716,745,1234,-489,0.00443574335033992,0.00734725811318048,-0.00291151476284056,EPCI
200042901,CC Drôme Sud Provence,1975_1982,1978.5,7,24421,30363,1536,2684,5942,1148,4794,0.0316006453123394,0.00610527445617059,0.0254953708561688,EPCI
200042901,CC Drôme Sud Provence,1982_1990,1986,8,30363,32594,1868,3820,2231,1952,279,0.00890232463708318,0.0077890352718899,0.00111328936519328,EPCI
200042901,CC Drôme Sud Provence,1990_1999,1994.5,9,32594,34497,2320,3830,1903,1510,393,0.00632482234669785,0.00501864516211968,0.00130617718457817,EPCI
200042901,CC Drôme Sud Provence,1999_2006,2002.5,7,34497,37583,1830,2994,3086,1164,1922,0.0123151368041374,0.00464511316915618,0.00767002363498125,EPCI
200042935,CA Haut - Bugey Agglomération,2006_2011,2008.5,5,64720,64028,2344,4668,-692,2324,-3016,-0.0021476475109844,0.00721261967561812,-0.00936026718660251,EPCI
200042935,CA Haut - Bugey Agglomération,2011_2016,2013.5,5,64028,63403,2353,3811,-625,1458,-2083,-0.00195993855687726,0.00457214466548327,-0.00653208322236054,EPCI
200042935,CA Haut - Bugey Agglomération,1968_1975,1971.5,7,43596,48148,3253,5549,4552,2296,2256,0.0142888661902396,0.00720721370228255,0.00708165248795707,EPCI
200042935,CA Haut - Bugey Agglomération,1975_1982,1978.5,7,48148,52927,3304,5868,4779,2564,2215,0.0136109404144145,0.00730245892918156,0.0063084814852329,EPCI
200042935,CA Haut - Bugey Agglomération,1982_1990,1986,8,52927,59148,3551,7442,6221,3891,2330,0.0139880767645075,0.00874901248845825,0.00523906427604928,EPCI
200042935,CA Haut - Bugey Agglomération,1990_1999,1994.5,9,59148,62714,3854,8312,3566,4458,-892,0.00652586020365087,0.00815824026580919,-0.00163238006215832,EPCI
200042935,CA Haut - Bugey Agglomération,1999_2006,2002.5,7,62714,64720,3224,6492,2006,3268,-1262,0.00450806869866671,0.00734415179822673,-0.00283608309956002,EPCI
200042943,CC du Cap Corse,2006_2011,2008.5,5,6287,6533,359,218,246,-141,387,0.00770598876611617,-0.00441684721960317,0.0121228359857193,EPCI
200042943,CC du Cap Corse,2011_2016,2013.5,5,6533,6804,425,224,271,-201,472,0.00816201281703233,-0.00605374382370294,0.0142157566407353,EPCI
200042943,CC du Cap Corse,1968_1975,1971.5,7,5869,5172,601,322,-697,-279,-418,-0.0178985690705207,-0.00716456351603338,-0.0107340055544873,EPCI
200042943,CC du Cap Corse,1975_1982,1978.5,7,5172,5022,587,274,-150,-313,163,-0.0041956308120521,-0.00875488296114871,0.00455925214909661,EPCI
200042943,CC du Cap Corse,1982_1990,1986,8,5022,5230,620,387,208,-233,441,0.00508576599432065,-0.00569703594556111,0.0107828019398818,EPCI
200042943,CC du Cap Corse,1990_1999,1994.5,9,5230,5779,687,404,549,-283,832,0.0111527757667294,-0.00574906291800438,0.0169018386847337,EPCI
200042943,CC du Cap Corse,1999_2006,2002.5,7,5779,6287,554,343,508,-211,719,0.0121089196153363,-0.005029492202433,0.0171384118177693,EPCI
200042992,CC Perthois-Bocage et Der,2006_2011,2008.5,5,5550,5694,309,305,144,-4,148,0.00513615728445749,-0.000142671035679375,0.00527882832013686,EPCI
200042992,CC Perthois-Bocage et Der,2011_2016,2013.5,5,5694,5681,368,324,-13,-44,31,-0.000457038582204694,-0.00154689981669281,0.00108986123448812,EPCI
200042992,CC Perthois-Bocage et Der,1968_1975,1971.5,7,5083,4783,505,477,-300,-28,-272,-0.00865287136798998,-0.000807601327679065,-0.00784527004031091,EPCI
200042992,CC Perthois-Bocage et Der,1975_1982,1978.5,7,4783,5215,471,391,432,-80,512,0.0124296313470968,-0.00230178358279571,0.0147314149298926,EPCI
200042992,CC Perthois-Bocage et Der,1982_1990,1986,8,5215,5382,533,520,167,-13,180,0.0039478929610175,-0.000307321008941482,0.00425521396995898,EPCI
200042992,CC Perthois-Bocage et Der,1990_1999,1994.5,9,5382,5298,592,445,-84,-147,63,-0.00174632467027791,-0.00305606817298634,0.00130974350270843,EPCI
200042992,CC Perthois-Bocage et Der,1999_2006,2002.5,7,5298,5550,394,398,252,4,248,0.00666044518069731,0.00010572135207456,0.00655472382862275,EPCI
200043016,CC Val de Charente,2006_2011,2008.5,5,14257,14352,977,611,95,-366,461,0.00132914075458213,-0.00512068964396903,0.00644983039855116,EPCI
200043016,CC Val de Charente,2011_2016,2013.5,5,14352,14076,978,534,-276,-444,168,-0.0038760856832134,-0.00623544218603895,0.00235935650282555,EPCI
200043016,CC Val de Charente,1968_1975,1971.5,7,15980,15194,1527,1462,-786,-65,-721,-0.00717943629150708,-0.000593719286193334,-0.00658571700531375,EPCI
200043016,CC Val de Charente,1975_1982,1978.5,7,15194,15009,1482,1177,-185,-305,120,-0.00174855405310936,-0.00288275127674787,0.00113419722363851,EPCI
200043016,CC Val de Charente,1982_1990,1986,8,15009,14580,1805,1274,-429,-531,102,-0.00361834976270092,-0.00447865669928716,0.000860306936586234,EPCI
200043016,CC Val de Charente,1990_1999,1994.5,9,14580,14113,1856,1216,-467,-640,173,-0.00361061800270834,-0.00494817028208424,0.0013375522793759,EPCI
200043016,CC Val de Charente,1999_2006,2002.5,7,14113,14257,1365,924,144,-441,585,0.00145128863581911,-0.00444457144719604,0.00589586008301515,EPCI
200043065,CC du Val d'Amboise,2006_2011,2008.5,5,26576,27775,1294,1547,1199,253,946,0.00886461657931892,0.0018705154249939,0.00699410115432502,EPCI
200043065,CC du Val d'Amboise,2011_2016,2013.5,5,27775,27961,1382,1493,186,111,75,0.0013357606504989,0.000797147484975148,0.000538613165523748,EPCI
200043065,CC du Val d'Amboise,1968_1975,1971.5,7,17520,20514,1749,2220,2994,471,2523,0.0227936796024855,0.00358577925610242,0.019207900346383,EPCI
200043065,CC du Val d'Amboise,1975_1982,1978.5,7,20514,22055,1783,2181,1541,398,1143,0.0104011127819439,0.00268633542324054,0.00771477735870335,EPCI
200043065,CC du Val d'Amboise,1982_1990,1986,8,22055,23490,1923,2192,1435,269,1166,0.00791055756644687,0.00148288500722941,0.00642767255921746,EPCI
200043065,CC du Val d'Amboise,1990_1999,1994.5,9,23490,24797,2278,2592,1307,314,993,0.00603456612151199,0.00144977334518345,0.00458479277632854,EPCI
200043065,CC du Val d'Amboise,1999_2006,2002.5,7,24797,26576,1762,2261,1779,499,1280,0.00994712915170459,0.00279011660860067,0.00715701254310392,EPCI
200043081,"CC Chinon, Vienne et Loire",2006_2011,2008.5,5,23550,23505,1207,1180,-45,-27,-18,-0.000382458041536582,-0.000229474824921949,-0.000152983216614633,EPCI
200043081,"CC Chinon, Vienne et Loire",2011_2016,2013.5,5,23505,23524,1296,1146,19,-150,169,0.000161615482698441,-0.001275911705514,0.00143752718821245,EPCI
200043081,"CC Chinon, Vienne et Loire",1968_1975,1971.5,7,20171,20939,1645,2646,768,1001,-233,0.00535249073822808,0.00697635837104988,-0.0016238676328218,EPCI
200043081,"CC Chinon, Vienne et Loire",1975_1982,1978.5,7,20939,22923,1747,1918,1984,171,1813,0.0130164610447547,0.00112188247915981,0.0118945785655949,EPCI
200043081,"CC Chinon, Vienne et Loire",1982_1990,1986,8,22923,23313,2022,2545,390,523,-133,0.0021110215202349,0.00283093398739193,-0.000719912467157031,EPCI
200043081,"CC Chinon, Vienne et Loire",1990_1999,1994.5,9,23313,23473,2234,2568,160,334,-174,0.00076025324072182,0.0015870286400068,-0.000826775399284979,EPCI
200043081,"CC Chinon, Vienne et Loire",1999_2006,2002.5,7,23473,23550,1623,1835,77,212,-135,0.000467966035625045,0.00128842596821441,-0.000820459932589364,EPCI
200043123,CC Auray Quiberon Terre Atlantique,2006_2011,2008.5,5,77293,82715,4210,4479,5422,269,5153,0.013651860896869,0.000677305529556945,0.012974555367312,EPCI
200043123,CC Auray Quiberon Terre Atlantique,2011_2016,2013.5,5,82715,86301,4614,4192,3586,-422,4008,0.00852416987721227,-0.00100312317015716,0.00952729304736943,EPCI
200043123,CC Auray Quiberon Terre Atlantique,1968_1975,1971.5,7,55127,57412,5425,6425,2285,1000,1285,0.00581882489147856,0.00254653168117224,0.00327229321030632,EPCI
200043123,CC Auray Quiberon Terre Atlantique,1975_1982,1978.5,7,57412,60225,5304,5579,2813,275,2538,0.00685685960552007,0.000670329325104166,0.00618653028041591,EPCI
200043123,CC Auray Quiberon Terre Atlantique,1982_1990,1986,8,60225,64182,6154,6263,3957,109,3848,0.00798612646954466,0.000219986804442853,0.00776613966510181,EPCI
200043123,CC Auray Quiberon Terre Atlantique,1990_1999,1994.5,9,64182,68038,6596,6652,3856,56,3800,0.00650367710800603,9.44517422324528e-05,0.00640922536577358,EPCI
200043123,CC Auray Quiberon Terre Atlantique,1999_2006,2002.5,7,68038,77293,5292,5795,9255,503,8752,0.0183865637219505,0.0009992913616576,0.0173872723602929,EPCI
200043156,CC du Pays Rethélois,2006_2011,2008.5,5,28061,29293,1380,1958,1232,578,654,0.00863060428696083,0.00404909843982416,0.00458150584713667,EPCI
200043156,CC du Pays Rethélois,2011_2016,2013.5,5,29293,29876,1552,1938,583,386,197,0.00394915802795426,0.00261470840272786,0.0013344496252264,EPCI
200043156,CC du Pays Rethélois,1968_1975,1971.5,7,27246,27020,2223,3312,-226,1089,-1315,-0.00118920502201503,0.00573028437599277,-0.00691948939800779,EPCI
200043156,CC du Pays Rethélois,1975_1982,1978.5,7,27020,27246,2184,2774,226,590,-364,0.00119062091438571,0.00310825813932552,-0.00191763722493982,EPCI
200043156,CC du Pays Rethélois,1982_1990,1986,8,27246,27513,2438,2935,267,497,-230,0.00121973062970637,0.00227043491746842,-0.00105070428776204,EPCI
200043156,CC du Pays Rethélois,1990_1999,1994.5,9,27513,27238,2505,2983,-275,478,-753,-0.00111555098743144,0.00193903044360809,-0.00305458143103953,EPCI
200043156,CC du Pays Rethélois,1999_2006,2002.5,7,27238,28061,2001,2490,823,489,334,0.00426157691877016,0.00253209126765323,0.00172948565111693,EPCI
200043172,CA du Bassin de Brive,2006_2011,2008.5,5,104846,107550,5404,5646,2704,242,2462,0.00510563934817365,0.000456939616219683,0.00464869973195397,EPCI
200043172,CA du Bassin de Brive,2011_2016,2013.5,5,107550,107831,5604,5271,281,-333,614,0.000522002394703236,-0.000618600702619849,0.00114060309732309,EPCI
200043172,CA du Bassin de Brive,1968_1975,1971.5,7,83575,91424,7062,9087,7849,2025,5824,0.0129059425234468,0.00332966411134918,0.0095762784120976,EPCI
200043172,CA du Bassin de Brive,1975_1982,1978.5,7,91424,96076,7072,8168,4652,1096,3556,0.00711541208281585,0.00167637395588267,0.00543903812693319,EPCI
200043172,CA du Bassin de Brive,1982_1990,1986,8,96076,98048,8243,8534,1972,291,1681,0.00254292899137876,0.000375249663535101,0.00216767932784366,EPCI
200043172,CA du Bassin de Brive,1990_1999,1994.5,9,98048,99572,9243,8761,1524,-482,2006,0.00171522998165008,-0.000542480873461508,0.00225771085511159,EPCI
200043172,CA du Bassin de Brive,1999_2006,2002.5,7,99572,104846,7382,7562,5274,180,5094,0.00740033474568236,0.000252571151729773,0.00714776359395258,EPCI
200043263,CC Coeur de l'Avesnois,2006_2011,2008.5,5,30787,31085,1511,2012,298,501,-203,0.00192842998681186,0.00324209202480786,-0.001313662037996,EPCI
200043263,CC Coeur de l'Avesnois,2011_2016,2013.5,5,31085,30446,1584,1877,-639,293,-932,-0.00414553645883342,0.00190084848581877,-0.00604638494465219,EPCI
200043263,CC Coeur de l'Avesnois,1968_1975,1971.5,7,35529,34767,2953,4690,-762,1737,-2499,-0.00309243758942235,0.00704929670974622,-0.0101417342991686,EPCI
200043263,CC Coeur de l'Avesnois,1975_1982,1978.5,7,34767,33859,2871,3699,-908,828,-1736,-0.00377340818146332,0.00344094931084981,-0.00721435749231314,EPCI
200043263,CC Coeur de l'Avesnois,1982_1990,1986,8,33859,31665,2891,3845,-2194,954,-3148,-0.00833914393305191,0.00362604526532886,-0.0119651891983808,EPCI
200043263,CC Coeur de l'Avesnois,1990_1999,1994.5,9,31665,30925,2690,3573,-740,883,-1623,-0.00262400146162889,0.00313107201434907,-0.00575507347597795,EPCI
200043263,CC Coeur de l'Avesnois,1999_2006,2002.5,7,30925,30787,2214,2717,-138,503,-641,-0.000638709555450645,0.00232805004631648,-0.00296675960176713,EPCI
200043321,CC du Pays de Mormal,2006_2011,2008.5,5,47123,48286,2345,2993,1163,648,515,0.004887999285907,0.00272349401312789,0.00216450527277911,EPCI
200043321,CC du Pays de Mormal,2011_2016,2013.5,5,48286,48473,2388,2765,187,377,-190,0.000773354549942873,0.00155911585737146,-0.000785761307428587,EPCI
200043321,CC du Pays de Mormal,1968_1975,1971.5,7,45595,44748,4446,5598,-847,1152,-1999,-0.00267517395634942,0.00363848925350004,-0.00631366320984946,EPCI
200043321,CC du Pays de Mormal,1975_1982,1978.5,7,44748,45113,4153,4436,365,283,82,0.00116120257787866,0.000900329669971675,0.000260872907906987,EPCI
200043321,CC du Pays de Mormal,1982_1990,1986,8,45113,46255,4419,5337,1142,918,224,0.00312977666983394,0.00251588002005916,0.000613896649774783,EPCI
200043321,CC du Pays de Mormal,1990_1999,1994.5,9,46255,46361,4529,4905,106,376,-270,0.000254368161081597,0.000902287061949817,-0.00064791890086822,EPCI
200043321,CC du Pays de Mormal,1999_2006,2002.5,7,46361,47123,3335,4099,762,764,-2,0.00233165924090928,0.0023377790814366,-6.1198405273211e-06,EPCI
200043354,CC de Villedieu Intercom,2006_2011,2008.5,5,15307,15678,898,896,371,-2,373,0.0048011318069503,-2.5882112166848e-05,0.00482701391911715,EPCI
200043354,CC de Villedieu Intercom,2011_2016,2013.5,5,15678,15736,950,875,58,-75,133,0.00073879784082731,-0.000955342035552556,0.00169413987637987,EPCI
200043354,CC de Villedieu Intercom,1968_1975,1971.5,7,17122,16089,1317,1662,-1033,345,-1378,-0.00885037107657571,0.00295583545151851,-0.0118062065280942,EPCI
200043354,CC de Villedieu Intercom,1975_1982,1978.5,7,16089,15968,1334,1493,-121,159,-280,-0.00107785999113919,0.00141636147595976,-0.00249422146709894,EPCI
200043354,CC de Villedieu Intercom,1982_1990,1986,8,15968,15353,1541,1520,-615,-21,-594,-0.00489744632186839,-0.000167229874405262,-0.00473021644746313,EPCI
200043354,CC de Villedieu Intercom,1990_1999,1994.5,9,15353,15052,1597,1422,-301,-175,-126,-0.00219758420672922,-0.00127766523647048,-0.000919918970258743,EPCI
200043354,CC de Villedieu Intercom,1999_2006,2002.5,7,15052,15307,1190,1129,255,-61,316,0.00240279171371061,-0.000574785468769988,0.00297757718248059,EPCI
200043396,CA Maubeuge Val de Sambre,2006_2011,2008.5,5,129827,126644,5965,8808,-3183,2843,-6026,-0.00495225580466874,0.00442326837972768,-0.00937552418439642,EPCI
200043396,CA Maubeuge Val de Sambre,2011_2016,2013.5,5,126644,125671,6063,8599,-973,2536,-3509,-0.00154133486679264,0.00401729210913273,-0.00555862697592537,EPCI
200043396,CA Maubeuge Val de Sambre,1968_1975,1971.5,7,134794,141529,10464,19134,6735,8670,-1935,0.00698959340276573,0.00899773939153361,-0.00200814598876788,EPCI
200043396,CA Maubeuge Val de Sambre,1975_1982,1978.5,7,141529,142145,10413,17468,616,7055,-6439,0.000620623976777424,0.00710795804572195,-0.00648733406894453,EPCI
200043396,CA Maubeuge Val de Sambre,1982_1990,1986,8,142145,139024,10708,19785,-3121,9077,-12198,-0.00277128828003237,0.00805991147640302,-0.0108311997564354,EPCI
200043396,CA Maubeuge Val de Sambre,1990_1999,1994.5,9,139024,133743,10838,17305,-5281,6467,-11748,-0.00429370359879311,0.00525797787793884,-0.00955168147673195,EPCI
200043396,CA Maubeuge Val de Sambre,1999_2006,2002.5,7,133743,129827,8374,12547,-3916,4173,-8089,-0.00423632321583367,0.00451434544935493,-0.0087506686651886,EPCI
200043404,CC du Sud Avesnois,2006_2011,2008.5,5,26919,26665,1400,1900,-254,500,-754,-0.00189430611939201,0.00372894905392128,-0.00562325517331329,EPCI
200043404,CC du Sud Avesnois,2011_2016,2013.5,5,26665,25782,1498,1717,-883,219,-1102,-0.00671242436255515,0.0016648028713472,-0.00837722723390235,EPCI
200043404,CC du Sud Avesnois,1968_1975,1971.5,7,30744,30702,2596,4100,-42,1504,-1546,-0.000195274390264233,0.00699268292755729,-0.00718795731782153,EPCI
200043404,CC du Sud Avesnois,1975_1982,1978.5,7,30702,29515,2488,3431,-1187,943,-2130,-0.00561690733530695,0.00446229453849575,-0.0100792018738027,EPCI
200043404,CC du Sud Avesnois,1982_1990,1986,8,29515,28516,2539,3677,-999,1138,-2137,-0.00429490981083081,0.00489249986459005,-0.00918740967542085,EPCI
200043404,CC du Sud Avesnois,1990_1999,1994.5,9,28516,27437,2697,3626,-1079,929,-2008,-0.00427670272914038,0.00368216574177147,-0.00795886847091185,EPCI
200043404,CC du Sud Avesnois,1999_2006,2002.5,7,27437,26919,2042,2683,-518,641,-1159,-0.00271916926534477,0.00336484073182625,-0.00608400999717101,EPCI
200043438,CC de la Moivre à la Coole,2006_2011,2008.5,5,9171,9557,355,526,386,171,215,0.00827959556646674,0.00366790373540366,0.00461169183106308,EPCI
200043438,CC de la Moivre à la Coole,2011_2016,2013.5,5,9557,9600,414,490,43,76,-33,0.000898248822001069,0.00158760256911817,-0.000689353747117099,EPCI
200043438,CC de la Moivre à la Coole,1968_1975,1971.5,7,6485,6992,495,792,507,297,210,0.0108115729842533,0.00633340665941464,0.00447816632483864,EPCI
200043438,CC de la Moivre à la Coole,1975_1982,1978.5,7,6992,8191,505,750,1199,245,954,0.0228674487441296,0.00467266467248687,0.0181947840716427,EPCI
200043438,CC de la Moivre à la Coole,1982_1990,1986,8,8191,8625,602,872,434,270,164,0.00647449103397046,0.00402790916859914,0.00244658186537133,EPCI
200043438,CC de la Moivre à la Coole,1990_1999,1994.5,9,8625,8589,695,787,-36,92,-128,-0.000464630707187941,0.00118738958503585,-0.00165202029222379,EPCI
200043438,CC de la Moivre à la Coole,1999_2006,2002.5,7,8589,9171,545,696,582,151,431,0.00941028905763841,0.00244150111289244,0.00696878794474597,EPCI
200043495,CA du Pays de Laon,2006_2011,2008.5,5,43329,43559,1862,3013,230,1151,-921,0.00105939760021734,0.00530159407760937,-0.00424219647739204,EPCI
200043495,CA du Pays de Laon,2011_2016,2013.5,5,43559,43259,1979,2884,-300,905,-1205,-0.00138125254036925,0.00416677849678057,-0.00554803103714982,EPCI
200043495,CA du Pays de Laon,1968_1975,1971.5,7,38743,40860,2626,5611,2117,2985,-868,0.00762916851270035,0.0107572357158293,-0.00312806720312891,EPCI
200043495,CA du Pays de Laon,1975_1982,1978.5,7,40860,41099,2572,4917,239,2345,-2106,0.000833518743333706,0.00817824875781397,-0.00734473001448027,EPCI
200043495,CA du Pays de Laon,1982_1990,1986,8,41099,42094,3075,5541,995,2466,-1471,0.00299465284229905,0.00742192352674317,-0.00442727068444412,EPCI
200043495,CA du Pays de Laon,1990_1999,1994.5,9,42094,42349,3342,5470,255,2128,-1873,0.000671291365421212,0.00560199225731897,-0.00493070089189776,EPCI
200043495,CA du Pays de Laon,1999_2006,2002.5,7,42349,43329,2563,4125,980,1562,-582,0.00327353903851391,0.00521762038587625,-0.00194408134736234,EPCI
200043602,"CC des Albères, de la Côte Vermeille et de l'Illibéris",2006_2011,2008.5,5,51133,53300,3449,2353,2167,-1096,3263,0.00833580088115471,-0.00421598420200534,0.01255178508316,EPCI
200043602,"CC des Albères, de la Côte Vermeille et de l'Illibéris",2011_2016,2013.5,5,53300,55283,3720,2341,1983,-1379,3362,0.00733257583466895,-0.00509915384569263,0.0124317296803616,EPCI
200043602,"CC des Albères, de la Côte Vermeille et de l'Illibéris",1968_1975,1971.5,7,34038,34794,3201,2531,756,-670,1426,0.00314313081651441,-0.00278557889823367,0.00592870971474807,EPCI
200043602,"CC des Albères, de la Côte Vermeille et de l'Illibéris",1975_1982,1978.5,7,34794,37789,3534,2374,2995,-1160,4155,0.0118660057308038,-0.00459584863029461,0.0164618543610984,EPCI
200043602,"CC des Albères, de la Côte Vermeille et de l'Illibéris",1982_1990,1986,8,37789,42912,4293,3048,5123,-1245,6368,0.01601862584654,-0.00389287315614724,0.0199114990026873,EPCI
200043602,"CC des Albères, de la Côte Vermeille et de l'Illibéris",1990_1999,1994.5,9,42912,48119,5531,3633,5207,-1898,7105,0.0128063751168317,-0.00466804301358682,0.0174744181304185,EPCI
200043602,"CC des Albères, de la Côte Vermeille et de l'Illibéris",1999_2006,2002.5,7,48119,51133,4701,3011,3014,-1690,4704,0.00871676765538632,-0.00488763680743294,0.0136044044628193,EPCI
200043628,CC des Vallées du Clain,2006_2011,2008.5,5,22040,24569,797,1447,2529,650,1879,0.021963012950557,0.0056449024981661,0.0163181104523909,EPCI
200043628,CC des Vallées du Clain,2011_2016,2013.5,5,24569,26284,966,1495,1715,529,1186,0.0135864489169264,0.00419080552597905,0.00939564339094735,EPCI
200043628,CC des Vallées du Clain,1968_1975,1971.5,7,11415,13585,986,1342,2170,356,1814,0.0251742171801437,0.0041299637401526,0.0210442534399911,EPCI
200043628,CC des Vallées du Clain,1975_1982,1978.5,7,13585,16674,957,1466,3089,509,2580,0.0297017495127025,0.00489420216962305,0.0248075473430795,EPCI
200043628,CC des Vallées du Clain,1982_1990,1986,8,16674,19195,1110,1841,2521,731,1790,0.0177556919426711,0.00514851678305934,0.0126071751596118,EPCI
200043628,CC des Vallées du Clain,1990_1999,1994.5,9,19195,20671,1354,1988,1476,634,842,0.00826529531582132,0.00355026912617257,0.00471502618964875,EPCI
200043628,CC des Vallées du Clain,1999_2006,2002.5,7,20671,22040,1091,1808,1369,717,652,0.00920312390763756,0.00482004371203516,0.0043830801956024,EPCI
200043693,CC Terre Lorraine du Longuyonnais,2006_2011,2008.5,5,15630,15816,760,865,186,105,81,0.00236878944600738,0.00133721984855255,0.00103156959745483,EPCI
200043693,CC Terre Lorraine du Longuyonnais,2011_2016,2013.5,5,15816,15567,765,726,-249,-39,-210,-0.00316872831252901,-0.00049630684413105,-0.00267242146839796,EPCI
200043693,CC Terre Lorraine du Longuyonnais,1968_1975,1971.5,7,17076,17632,1190,2227,556,1037,-481,0.00458784408893576,0.00855682431695392,-0.00396898022801816,EPCI
200043693,CC Terre Lorraine du Longuyonnais,1975_1982,1978.5,7,17632,16707,1144,1646,-925,502,-1427,-0.00766867872728771,0.00416181267145777,-0.0118304913987455,EPCI
200043693,CC Terre Lorraine du Longuyonnais,1982_1990,1986,8,16707,15051,1348,1516,-1656,168,-1824,-0.0129631648077735,0.00131510367615093,-0.0142782684839244,EPCI
200043693,CC Terre Lorraine du Longuyonnais,1990_1999,1994.5,9,15051,15165,1375,1435,114,60,54,0.000838763451081359,0.000441454447937557,0.000397309003143802,EPCI
200043693,CC Terre Lorraine du Longuyonnais,1999_2006,2002.5,7,15165,15630,1089,1155,465,66,399,0.0043238930651055,0.000613713854402071,0.00371017921070343,EPCI
200043776,CC Pyrénées Audoises,2006_2011,2008.5,5,15347,15044,1142,545,-303,-597,294,-0.00398021278880656,-0.00784220143537134,0.00386198864656478,EPCI
200043776,CC Pyrénées Audoises,2011_2016,2013.5,5,15044,14080,1189,462,-964,-727,-237,-0.0131574518672869,-0.00992268413642902,-0.00323476773085788,EPCI
200043776,CC Pyrénées Audoises,1968_1975,1971.5,7,19644,18063,1883,1328,-1581,-555,-1026,-0.0119150611488135,-0.00418270647538993,-0.00773235467342354,EPCI
200043776,CC Pyrénées Audoises,1975_1982,1978.5,7,18063,17344,1896,976,-719,-920,201,-0.00578591416583196,-0.00740339503833853,0.00161748087250657,EPCI
200043776,CC Pyrénées Audoises,1982_1990,1986,8,17344,15860,2154,1140,-1484,-1014,-470,-0.0111185282772285,-0.00759716150479089,-0.00352136677243759,EPCI
200043776,CC Pyrénées Audoises,1990_1999,1994.5,9,15860,15174,2272,1115,-686,-1157,471,-0.00490092655283858,-0.00826584842803825,0.00336492187519967,EPCI
200043776,CC Pyrénées Audoises,1999_2006,2002.5,7,15174,15347,1617,793,173,-824,997,0.00162082329890789,-0.00771999074161909,0.00934081404052698,EPCI
200043974,CC du Sud Gironde,2006_2011,2008.5,5,33073,36531,1650,2247,3458,597,2861,0.0200878949777428,0.00346803739205102,0.0166198575856918,EPCI
200043974,CC du Sud Gironde,2011_2016,2013.5,5,36531,38135,1830,2082,1604,252,1352,0.00863129272823682,0.00135603850842623,0.00727525421981058,EPCI
200043974,CC du Sud Gironde,1968_1975,1971.5,7,24310,24084,2628,2011,-226,-617,391,-0.00133340575576335,-0.00364031571374331,0.00230690995797996,EPCI
200043974,CC du Sud Gironde,1975_1982,1978.5,7,24084,25467,2576,1735,1383,-841,2224,0.00800843689126807,-0.00486991715513843,0.0128783540464065,EPCI
200043974,CC du Sud Gironde,1982_1990,1986,8,25467,26900,2821,2327,1433,-494,1927,0.00686631455638009,-0.00236703376891261,0.0092333483252927,EPCI
200043974,CC du Sud Gironde,1990_1999,1994.5,9,26900,28752,2922,2726,1852,-196,2048,0.00742532573519772,-0.000785833609124597,0.00821115934432232,EPCI
200043974,CC du Sud Gironde,1999_2006,2002.5,7,28752,33073,2406,2513,4321,107,4214,0.0202027842684622,0.000500277231364374,0.0197025070370979,EPCI
200043982,CC du Bazadais,2006_2011,2008.5,5,14513,15370,834,660,857,-174,1031,0.0115406368039064,-0.00234313979449208,0.0138837765983985,EPCI
200043982,CC du Bazadais,2011_2016,2013.5,5,15370,15660,959,663,290,-296,586,0.00374542323524385,-0.00382291475045579,0.00756833798569964,EPCI
200043982,CC du Bazadais,1968_1975,1971.5,7,14857,14296,1401,1172,-561,-229,-332,-0.00548367471963862,-0.00223843406559224,-0.00324524065404638,EPCI
200043982,CC du Bazadais,1975_1982,1978.5,7,14296,13895,1388,921,-401,-467,66,-0.00405613936356486,-0.00472373337352815,0.000667594009963293,EPCI
200043982,CC du Bazadais,1982_1990,1986,8,13895,13472,1507,967,-423,-540,117,-0.00385699333147904,-0.00492382127422856,0.00106682794274952,EPCI
200043982,CC du Bazadais,1990_1999,1994.5,9,13472,13494,1591,1110,22,-481,503,0.000181314736114935,-0.00396419945778562,0.00414551419390055,EPCI
200043982,CC du Bazadais,1999_2006,2002.5,7,13494,14513,1289,894,1019,-395,1414,0.0104542184943821,-0.00405242031921583,0.0145066388135979,EPCI
200043990,CC Vallons de Haute-Bretagne Communauté,2006_2011,2008.5,5,35566,40186,1267,3006,4620,1739,2881,0.0247264615434115,0.0093072113904746,0.0154192501529369,EPCI
200043990,CC Vallons de Haute-Bretagne Communauté,2011_2016,2013.5,5,40186,43278,1393,2944,3092,1551,1541,0.0149355868997028,0.00749194543384184,0.00744364146586092,EPCI
200043990,CC Vallons de Haute-Bretagne Communauté,1968_1975,1971.5,7,21925,23427,2269,2453,1502,184,1318,0.00951089598097621,0.00116511641844183,0.00834577956253438,EPCI
200043990,CC Vallons de Haute-Bretagne Communauté,1975_1982,1978.5,7,23427,25293,2431,2374,1866,-57,1923,0.0110085060108636,-0.000336272691650173,0.0113447787025137,EPCI
200043990,CC Vallons de Haute-Bretagne Communauté,1982_1990,1986,8,25293,27553,2596,2790,2260,194,2066,0.0107553959884197,0.000923250806085583,0.0098321451823341,EPCI
200043990,CC Vallons de Haute-Bretagne Communauté,1990_1999,1994.5,9,27553,30120,2669,3343,2567,674,1893,0.00994669614966792,0.00261163739964012,0.00733505875002781,EPCI
200043990,CC Vallons de Haute-Bretagne Communauté,1999_2006,2002.5,7,30120,35566,1823,3482,5446,1659,3787,0.0240270684912174,0.00731929978459964,0.0167077687066177,EPCI
200044014,CC Creuse Grand Sud,2006_2011,2008.5,5,13019,12497,994,462,-522,-532,10,-0.00815084294746948,-0.00830698936408767,0.000156146416618189,EPCI
200044014,CC Creuse Grand Sud,2011_2016,2013.5,5,12497,12128,950,458,-369,-492,123,-0.00597642700567647,-0.00796856934090195,0.00199214233522549,EPCI
200044014,CC Creuse Grand Sud,1968_1975,1971.5,7,16601,16094,1869,1535,-507,-334,-173,-0.00442111266417988,-0.00291252786949917,-0.00150858479468071,EPCI
200044014,CC Creuse Grand Sud,1975_1982,1978.5,7,16094,15208,1782,1142,-886,-640,-246,-0.00805664507691184,-0.00581969847542165,-0.00223694660149019,EPCI
200044014,CC Creuse Grand Sud,1982_1990,1986,8,15208,14432,1793,1211,-776,-582,-194,-0.00652532224667657,-0.00489399168500743,-0.00163133056166914,EPCI
200044014,CC Creuse Grand Sud,1990_1999,1994.5,9,14432,13554,1887,1142,-878,-745,-133,-0.0069497664092697,-0.00589701136094069,-0.00105275504832901,EPCI
200044014,CC Creuse Grand Sud,1999_2006,2002.5,7,13554,13019,1332,800,-535,-532,-3,-0.00573660786487285,-0.00570443997030346,-3.21678945693809e-05,EPCI
200044030,CC des Sept Vallées,2006_2011,2008.5,5,29214,29458,1833,1733,244,-100,344,0.00166487910262814,-0.000682327501077105,0.00234720660370524,EPCI
200044030,CC des Sept Vallées,2011_2016,2013.5,5,29458,29764,1963,1714,306,-249,555,0.00206895523387929,-0.00168356161188217,0.00375251684576145,EPCI
200044030,CC des Sept Vallées,1968_1975,1971.5,7,28718,29242,2406,3449,524,1043,-519,0.0025864717505415,0.00514826342712745,-0.00256179167658595,EPCI
200044030,CC des Sept Vallées,1975_1982,1978.5,7,29242,29476,2551,2950,234,399,-165,0.00113926860392821,0.00194259902977503,-0.000803330425846816,EPCI
200044030,CC des Sept Vallées,1982_1990,1986,8,29476,29264,2685,3124,-212,439,-651,-0.000901878220178287,0.00186756857857674,-0.00276944679875502,EPCI
200044030,CC des Sept Vallées,1990_1999,1994.5,9,29264,29150,3185,2964,-114,-221,107,-0.000433592510698411,-0.000840560919862708,0.000406968409164298,EPCI
200044030,CC des Sept Vallées,1999_2006,2002.5,7,29150,29214,2496,2438,64,-58,122,0.000313353889664469,-0.000283976962508425,0.000597330852172895,EPCI
200044048,CC Osartis Marquion,2006_2011,2008.5,5,40057,41198,1772,2536,1141,764,377,0.00563306070001768,0.0037718303022029,0.00186123039781478,EPCI
200044048,CC Osartis Marquion,2011_2016,2013.5,5,41198,41920,1708,2449,722,741,-19,0.00348070935372169,0.00357230696829331,-9.15976145716233e-05,EPCI
200044048,CC Osartis Marquion,1968_1975,1971.5,7,35284,37326,3022,4292,2042,1270,772,0.0080696039131225,0.00501880360904289,0.00305080030407962,EPCI
200044048,CC Osartis Marquion,1975_1982,1978.5,7,37326,37848,3015,3663,522,648,-126,0.00198596994094813,0.00246534199565975,-0.000479372054711617,EPCI
200044048,CC Osartis Marquion,1982_1990,1986,8,37848,39414,3083,4315,1566,1232,334,0.00508073146550303,0.00399710163825015,0.00108362982725288,EPCI
200044048,CC Osartis Marquion,1990_1999,1994.5,9,39414,39321,3232,4351,-93,1119,-1212,-0.000262449535523901,0.00315786054033597,-0.00342031007585987,EPCI
200044048,CC Osartis Marquion,1999_2006,2002.5,7,39321,40057,2435,3543,736,1108,-372,0.00265275698664191,0.00399355263749897,-0.00134079565085705,EPCI
200044253,CC du Bassin de Joinville en Champagne,2006_2011,2008.5,5,13878,13480,830,754,-398,-76,-322,-0.00580264862189928,-0.00110804345543805,-0.00469460516646122,EPCI
200044253,CC du Bassin de Joinville en Champagne,2011_2016,2013.5,5,13480,12866,813,715,-614,-98,-516,-0.0092804547782076,-0.00148124522518623,-0.00779920955302137,EPCI
200044253,CC du Bassin de Joinville en Champagne,1968_1975,1971.5,7,16903,16108,1467,2127,-795,660,-1455,-0.00685852620958627,0.00569387081550558,-0.0125523970250919,EPCI
200044253,CC du Bassin de Joinville en Champagne,1975_1982,1978.5,7,16108,15892,1453,1737,-216,284,-500,-0.00192674216417876,0.0025333091417906,-0.00446005130596936,EPCI
200044253,CC du Bassin de Joinville en Champagne,1982_1990,1986,8,15892,15290,1551,1818,-602,267,-869,-0.00481547051673359,0.00213576516273732,-0.00695123567947091,EPCI
200044253,CC du Bassin de Joinville en Champagne,1990_1999,1994.5,9,15290,14547,1606,1578,-743,-28,-715,-0.00551962537506512,-0.000208007416556963,-0.00531161795850816,EPCI
200044253,CC du Bassin de Joinville en Champagne,1999_2006,2002.5,7,14547,13878,1186,1182,-669,-4,-665,-0.00670313796996613,-4.00785528847003e-05,-0.00666305941708143,EPCI
200044394,CC du Réolais en Sud Gironde,2006_2011,2008.5,5,21703,22789,1313,1260,1086,-53,1139,0.0098133307301127,-0.000478919455521154,0.0102922501856339,EPCI
200044394,CC du Réolais en Sud Gironde,2011_2016,2013.5,5,22789,23660,1325,1210,871,-115,986,0.00752978636295709,-0.000994173859632681,0.00852396022258977,EPCI
200044394,CC du Réolais en Sud Gironde,1968_1975,1971.5,7,21600,20693,1972,1887,-907,-85,-822,-0.00610952276630672,-0.00057255726034848,-0.00553696550595824,EPCI
200044394,CC du Réolais en Sud Gironde,1975_1982,1978.5,7,20693,19935,1958,1517,-758,-441,-317,-0.00531702829832625,-0.00309341619994971,-0.00222361209837655,EPCI
200044394,CC du Réolais en Sud Gironde,1982_1990,1986,8,19935,20302,2153,1700,367,-453,820,0.00228290468388792,-0.00281786327466275,0.00510076795855067,EPCI
200044394,CC du Réolais en Sud Gironde,1990_1999,1994.5,9,20302,20265,2234,1802,-37,-432,395,-0.000202662048157443,-0.00236621634605447,0.00216355429789702,EPCI
200044394,CC du Réolais en Sud Gironde,1999_2006,2002.5,7,20265,21703,1691,1539,1438,-152,1590,0.00984171997845085,-0.00104029307143569,0.0108820130498865,EPCI
200044469,CC du Pays de Mirepoix,2006_2011,2008.5,5,9753,10271,560,446,518,-114,632,0.0104036374310008,-0.00228960360450597,0.0126932410355068,EPCI
200044469,CC du Pays de Mirepoix,2011_2016,2013.5,5,10271,10519,555,440,248,-115,363,0.00478315404915142,-0.00221799482117908,0.0070011488703305,EPCI
200044469,CC du Pays de Mirepoix,1968_1975,1971.5,7,8840,8495,891,677,-345,-214,-131,-0.0056708768891196,-0.00351758740368578,-0.00215328948543382,EPCI
200044469,CC du Pays de Mirepoix,1975_1982,1978.5,7,8495,8790,867,571,295,-296,591,0.00488861857620604,-0.00490519016459996,0.009793808740806,EPCI
200044469,CC du Pays de Mirepoix,1982_1990,1986,8,8790,8982,1064,726,192,-338,530,0.00270463381159503,-0.00476128243916208,0.0074659162507571,EPCI
200044469,CC du Pays de Mirepoix,1990_1999,1994.5,9,8982,9361,1016,759,379,-257,636,0.00460273214957163,-0.00312111388506572,0.00772384603463736,EPCI
200044469,CC du Pays de Mirepoix,1999_2006,2002.5,7,9361,9753,876,615,392,-261,653,0.00587760683063032,-0.00391340658876152,0.00979101341939184,EPCI
200044618,CA du Douaisis (C.A.D.),2006_2011,2008.5,5,152576,151933,7533,10523,-643,2990,-3633,-0.000844283065603912,0.00392598190692955,-0.00477026497253346,EPCI
200044618,CA du Douaisis (C.A.D.),2011_2016,2013.5,5,151933,148910,7583,10153,-3023,2570,-5593,-0.00401144011112276,0.00341032123241332,-0.00742176134353608,EPCI
200044618,CA du Douaisis (C.A.D.),1968_1975,1971.5,7,159057,159872,11668,21342,815,9674,-8859,0.000730390393708369,0.00866968916409173,-0.00793929877038336,EPCI
200044618,CA du Douaisis (C.A.D.),1975_1982,1978.5,7,159872,156535,11778,18742,-3337,6964,-10301,-0.00300887394023652,0.00627923228043367,-0.00928810622067019,EPCI
200044618,CA du Douaisis (C.A.D.),1982_1990,1986,8,156535,155687,12520,19871,-848,7351,-8199,-0.00067877523940485,0.00588405281234086,-0.00656282805174571,EPCI
200044618,CA du Douaisis (C.A.D.),1990_1999,1994.5,9,155687,153972,13695,18783,-1715,5088,-6803,-0.00123000001298212,0.00364911957204259,-0.00487911958502472,EPCI
200044618,CA du Douaisis (C.A.D.),1999_2006,2002.5,7,153972,152576,10562,14653,-1396,4091,-5487,-0.00130028748385302,0.00381051296306785,-0.00511080044692088,EPCI
200044691,CA du Nord Grande Terre,2006_2011,2008.5,5,56142,57773,2212,3730,1631,1518,113,0.00574390190514773,0.00534594916739071,0.000397952737757016,EPCI
200044691,CA du Nord Grande Terre,2011_2016,2013.5,5,57773,58267,2337,3247,494,910,-416,0.00170432207847004,0.00313954067086587,-0.00143521859239583,EPCI
200044691,CA du Nord Grande Terre,1968_1975,1971.5,7,48838,49186,2604,7707,348,5103,-4755,0.0010148477236438,0.0148815170510181,-0.0138666693273743,EPCI
200044691,CA du Nord Grande Terre,1975_1982,1978.5,7,49186,46014,2287,6095,-3172,3808,-6980,-0.0094781298361396,0.0113785367011411,-0.0208566665372807,EPCI
200044691,CA du Nord Grande Terre,1982_1990,1986,8,46014,51127,2657,7002,5113,4345,768,0.0132579975101035,0.0112665752359475,0.00199142227415597,EPCI
200044691,CA du Nord Grande Terre,1990_1999,1994.5,9,51127,56336,3111,8162,5209,5051,158,0.0108384291253556,0.0105096766197295,0.000328752505626067,EPCI
200044691,CA du Nord Grande Terre,1999_2006,2002.5,7,56336,56142,2892,5907,-194,3015,-3209,-0.000492673866477777,0.00765676137850773,-0.0081494352449855,EPCI
200046977,Métropole de Lyon,2006_2011,2008.5,5,1259353,1310082,43060,99086,50729,56026,-5297,0.00792960079719118,0.00875759061411487,-0.000827989816923686,EPCI
200046977,Métropole de Lyon,2011_2016,2013.5,5,1310082,1381249,44634,104293,71167,59659,11508,0.0106358490936951,0.0089159880433453,0.00171986105034978,EPCI
200046977,Métropole de Lyon,1968_1975,1971.5,7,1077794,1153402,69956,140130,75608,70174,5434,0.00973269712498226,0.00903320135499557,0.000699495769986689,EPCI
200046977,Métropole de Lyon,1975_1982,1978.5,7,1153402,1138718,67515,127282,-14684,59767,-74451,-0.00182872127535894,0.00744328415039346,-0.00927200542575239,EPCI
200046977,Métropole de Lyon,1982_1990,1986,8,1138718,1166797,73226,141863,28079,68637,-40558,0.00304955542030938,0.00745440846838473,-0.00440485304807535,EPCI
200046977,Métropole de Lyon,1990_1999,1994.5,9,1166797,1199589,79974,158511,32792,78537,-45745,0.00308437027323349,0.00738708185377345,-0.00430271158053995,EPCI
200046977,Métropole de Lyon,1999_2006,2002.5,7,1199589,1259353,61179,127606,59764,66427,-6663,0.00696976207605893,0.00774681054525076,-0.000777048469191832,EPCI
200048551,CC du Pays de Craon,2006_2011,2008.5,5,27741,28505,1453,1918,764,465,299,0.00544839827322274,0.00331610627885939,0.00213229199436335,EPCI
200048551,CC du Pays de Craon,2011_2016,2013.5,5,28505,28720,1553,1756,215,203,12,0.00150397657937784,0.00142003370052885,8.39428788489958e-05,EPCI
200048551,CC du Pays de Craon,1968_1975,1971.5,7,29025,27615,2305,3264,-1410,959,-2369,-0.00708881557562069,0.00482140009717748,-0.0119102156727982,EPCI
200048551,CC du Pays de Craon,1975_1982,1978.5,7,27615,27548,2302,2974,-67,672,-739,-0.000346963461494432,0.00347999173319788,-0.00382695519469231,EPCI
200048551,CC du Pays de Craon,1982_1990,1986,8,27548,27112,2382,2938,-436,556,-992,-0.0019922008505624,0.00254051301126765,-0.00453271386183004,EPCI
200048551,CC du Pays de Craon,1990_1999,1994.5,9,27112,26729,2569,2902,-383,333,-716,-0.00157956406258508,0.0013733546549369,-0.00295291871752198,EPCI
200048551,CC du Pays de Craon,1999_2006,2002.5,7,26729,27741,2060,2476,1012,416,596,0.00532302363798953,0.00218812038873878,0.00313490324925075,EPCI
200049187,CA du Grand Verdun,2006_2011,2008.5,5,29875,28842,1381,1849,-1033,468,-1501,-0.00701316260975837,0.00317730890742199,-0.0101904715171804,EPCI
200049187,CA du Grand Verdun,2011_2016,2013.5,5,28842,28434,1406,1630,-408,224,-632,-0.00284535347196535,0.00156215484735353,-0.00440750831931888,EPCI
200049187,CA du Grand Verdun,1968_1975,1971.5,7,30921,32286,2135,4670,1365,2535,-1170,0.00619024299590998,0.0114961655638328,-0.00530592256792284,EPCI
200049187,CA du Grand Verdun,1975_1982,1978.5,7,32286,30733,2207,3875,-1553,1668,-3221,-0.00701764677643268,0.00753730510179634,-0.014554951878229,EPCI
200049187,CA du Grand Verdun,1982_1990,1986,8,30733,30544,2274,4108,-189,1834,-2023,-0.000770793893804966,0.00747955556210745,-0.00825034945591242,EPCI
200049187,CA du Grand Verdun,1990_1999,1994.5,9,30544,29380,2531,3950,-1164,1419,-2583,-0.00430781642947653,0.00525153910088247,-0.009559355530359,EPCI
200049187,CA du Grand Verdun,1999_2006,2002.5,7,29380,29875,1958,2796,495,838,-343,0.00238968497156322,0.00404556768923228,-0.00165588271766906,EPCI
200049211,CC Conflent-Canigó,2006_2011,2008.5,5,19566,20030,1379,884,464,-495,959,0.00469856050943673,-0.00501247295726548,0.00971103346670221,EPCI
200049211,CC Conflent-Canigó,2011_2016,2013.5,5,20030,20850,1348,913,820,-435,1255,0.0080568427874228,-0.00427405684454746,0.0123308996319703,EPCI
200049211,CC Conflent-Canigó,1968_1975,1971.5,7,17766,17518,2016,1176,-248,-840,592,-0.00200621266067358,-0.00679523643131373,0.00478902377064016,EPCI
200049211,CC Conflent-Canigó,1975_1982,1978.5,7,17518,17280,2036,991,-238,-1045,807,-0.00195225762764772,-0.00857188748273896,0.00661962985509123,EPCI
200049211,CC Conflent-Canigó,1982_1990,1986,8,17280,17800,2391,1248,520,-1143,1663,0.00371296277149469,-0.00816137778426621,0.0118743405557609,EPCI
200049211,CC Conflent-Canigó,1990_1999,1994.5,9,17800,17818,2478,1378,18,-1100,1118,0.000112309084016715,-0.00686333291213259,0.00697564199614931,EPCI
200049211,CC Conflent-Canigó,1999_2006,2002.5,7,17818,19566,1955,1166,1748,-789,2537,0.0134589360368909,-0.00607500030498106,0.0195339363418719,EPCI
200049484,CC Berry Grand Sud,2006_2011,2008.5,5,12692,12569,968,522,-123,-446,323,-0.00194578625434994,-0.00705545259707375,0.00510966634272381,EPCI
200049484,CC Berry Grand Sud,2011_2016,2013.5,5,12569,12039,994,457,-530,-537,7,-0.00857940206534424,-0.00869271492281106,0.00011331285746681,EPCI
200049484,CC Berry Grand Sud,1968_1975,1971.5,7,17849,15666,1947,1271,-2183,-676,-1507,-0.0184638056007643,-0.00571760539904566,-0.0127462002017187,EPCI
200049484,CC Berry Grand Sud,1975_1982,1978.5,7,15666,14138,1989,881,-1528,-1108,-420,-0.0145539876563021,-0.0105535460230254,-0.00400044163327676,EPCI
200049484,CC Berry Grand Sud,1982_1990,1986,8,14138,13069,2098,916,-1069,-1182,113,-0.00977976328565577,-0.0108135455600048,0.00103378227434902,EPCI
200049484,CC Berry Grand Sud,1990_1999,1994.5,9,13069,12577,1986,911,-492,-1075,583,-0.00425461941365124,-0.00929617046681927,0.00504155105316803,EPCI
200049484,CC Berry Grand Sud,1999_2006,2002.5,7,12577,12692,1474,743,115,-731,846,0.00130114928344316,-0.00827078370606043,0.00957193298950359,EPCI
200054781,Métropole du Grand Paris,2006_2011,2008.5,5,6742223,6932820,206603,546754,190597,340151,-149554,0.00559096429495676,0.00997797497281613,-0.00438701067785937,EPCI
200054781,Métropole du Grand Paris,2011_2016,2013.5,5,6932820,7026765,209453,540983,93945,331530,-237585,0.00269558103847811,0.00951265082427642,-0.00681706978579831,EPCI
200054781,Métropole du Grand Paris,1968_1975,1971.5,7,6627331,6506587,437585,751384,-120744,313799,-434543,-0.00262328325672467,0.00681759476807912,-0.0094408780248038,EPCI
200054781,Métropole du Grand Paris,1975_1982,1978.5,7,6506587,6296648,415278,672902,-209939,257624,-467563,-0.00467441505372468,0.00573614956630625,-0.0104105646200309,EPCI
200054781,Métropole du Grand Paris,1982_1990,1986,8,6296648,6355983,439095,787567,59335,348472,-289137,0.00117308073699873,0.00688945463189386,-0.00571637389489513,EPCI
200054781,Métropole du Grand Paris,1990_1999,1994.5,9,6355983,6383877,443461,885024,27894,441563,-413669,0.000486676056365543,0.00770409907065814,-0.0072174230142926,EPCI
200054781,Métropole du Grand Paris,1999_2006,2002.5,7,6383877,6742223,310760,734627,358346,423867,-65521,0.00783252922916655,0.00926465111032114,-0.00143212188115459,EPCI
200054807,Métropole d'Aix-Marseille-Provence,2006_2011,2008.5,5,1800669,1834013,75296,119535,33344,44239,-10895,0.00367638129676751,0.00487762212655043,-0.00120124082978293,EPCI
200054807,Métropole d'Aix-Marseille-Provence,2011_2016,2013.5,5,1834013,1873707,78338,123139,39694,44801,-5107,0.00429165476615667,0.00484381582049139,-0.000552161054334714,EPCI
200054807,Métropole d'Aix-Marseille-Provence,1968_1975,1971.5,7,1365063,1520528,102012,150039,155465,48027,107438,0.0155274692511453,0.00479682092898567,0.0107306483221597,EPCI
200054807,Métropole d'Aix-Marseille-Provence,1975_1982,1978.5,7,1520528,1603840,107025,143368,83312,36343,46969,0.00764955389402977,0.00333694710450744,0.00431260678952233,EPCI
200054807,Métropole d'Aix-Marseille-Provence,1982_1990,1986,8,1603840,1633096,123532,173491,29256,49959,-20703,0.00226216057331952,0.00386297785351619,-0.00160081728019668,EPCI
200054807,Métropole d'Aix-Marseille-Provence,1990_1999,1994.5,9,1633096,1705626,141779,190891,72530,49112,23418,0.00483996374736173,0.00327726871033268,0.00156269503702905,EPCI
200054807,Métropole d'Aix-Marseille-Provence,1999_2006,2002.5,7,1705626,1800669,107087,156919,95043,49832,45211,0.0077766629179532,0.00407738251662347,0.00369928040132974,EPCI
200055481,CC Beauce Val de Loire,2006_2011,2008.5,5,18641,19720,959,1287,1079,328,751,0.0113175429017098,0.00344036521942616,0.00787717768228367,EPCI
200055481,CC Beauce Val de Loire,2011_2016,2013.5,5,19720,19940,979,1139,220,160,60,0.00222134661465123,0.00161552481065544,0.00060582180399579,EPCI
200055481,CC Beauce Val de Loire,1968_1975,1971.5,7,16784,16494,1471,1707,-290,236,-526,-0.00248681320735966,0.00202375143771338,-0.00451056464507304,EPCI
200055481,CC Beauce Val de Loire,1975_1982,1978.5,7,16494,17007,1433,1375,513,-58,571,0.00438506432290953,-0.000495777252882559,0.00488084157579209,EPCI
200055481,CC Beauce Val de Loire,1982_1990,1986,8,17007,17418,1658,1691,411,33,378,0.00298935050618021,0.000240020843561915,0.0027493296626183,EPCI
200055481,CC Beauce Val de Loire,1990_1999,1994.5,9,17418,17706,1754,1834,288,80,208,0.00182381790514308,0.000506616084761966,0.00131720182038111,EPCI
200055481,CC Beauce Val de Loire,1999_2006,2002.5,7,17706,18641,1399,1564,935,165,770,0.00737850093073389,0.00130208839954127,0.00607641253119261,EPCI
200055655,CA Roissy Pays de France,2006_2011,2008.5,5,331946,339599,8881,29840,7653,20959,-13306,0.00456904735205077,0.0125130881290516,-0.00794404077700086,EPCI
200055655,CA Roissy Pays de France,2011_2016,2013.5,5,339599,350406,9110,31045,10807,21935,-11128,0.0062850631220559,0.0127568112873412,-0.00647174816528528,EPCI
200055655,CA Roissy Pays de France,1968_1975,1971.5,7,206698,257737,10578,29282,51039,18704,32335,0.0320280449748502,0.0117371530243461,0.0202908919505042,EPCI
200055655,CA Roissy Pays de France,1975_1982,1978.5,7,257737,275132,11466,30662,17395,19196,-1801,0.00937384720004197,0.0103443731446971,-0.000970525944655108,EPCI
200055655,CA Roissy Pays de France,1982_1990,1986,8,275132,301221,13826,39139,26089,25313,776,0.0113885149604822,0.0110497711370572,0.000338743823424977,EPCI
200055655,CA Roissy Pays de France,1990_1999,1994.5,9,301221,318403,16284,45625,17182,29341,-12159,0.00618277509346288,0.0105580726351586,-0.00437529754169568,EPCI
200055655,CA Roissy Pays de France,1999_2006,2002.5,7,318403,331946,12365,39136,13543,26771,-13228,0.00596837290711338,0.0117979259467129,-0.00582955303959949,EPCI
200055887,CC Mayenne Communauté,2006_2011,2008.5,5,36326,37009,1641,2439,683,798,-115,0.0037324258137319,0.00436087232702497,-0.000628446513293073,EPCI
200055887,CC Mayenne Communauté,2011_2016,2013.5,5,37009,36792,1753,2089,-217,336,-553,-0.00117544783355505,0.00182004825840783,-0.00299549609196288,EPCI
200055887,CC Mayenne Communauté,1968_1975,1971.5,7,30141,30426,2552,3631,285,1079,-794,0.00134535201696684,0.00509345553090252,-0.00374810351393568,EPCI
200055887,CC Mayenne Communauté,1975_1982,1978.5,7,30426,32316,2546,3529,1890,983,907,0.00864644608403342,0.00449706693153696,0.00414937915249646,EPCI
200055887,CC Mayenne Communauté,1982_1990,1986,8,32316,33038,2698,3692,722,994,-272,0.002765811633473,0.00380777945106948,-0.00104196781759648,EPCI
200055887,CC Mayenne Communauté,1990_1999,1994.5,9,33038,34549,2920,3768,1511,848,663,0.00498127574053564,0.00279558029647533,0.00218569544406031,EPCI
200055887,CC Mayenne Communauté,1999_2006,2002.5,7,34549,36326,2393,3296,1777,903,874,0.00719074903372285,0.00365404973407526,0.00353669929964759,EPCI
200056232,CA Communauté Paris-Saclay,2006_2011,2008.5,5,287689,293784,7842,20947,6095,13105,-7010,0.00420175630601061,0.00903429309110238,-0.00483253678509177,EPCI
200056232,CA Communauté Paris-Saclay,2011_2016,2013.5,5,293784,312888,8398,21709,19104,13311,5793,0.0126798148230887,0.00883485213097431,0.00384496269211435,EPCI
200056232,CA Communauté Paris-Saclay,1968_1975,1971.5,7,165965,228258,8070,25118,62293,17048,45245,0.0465808534810659,0.012747987577179,0.0338328659038869,EPCI
200056232,CA Communauté Paris-Saclay,1975_1982,1978.5,7,228258,249704,9383,26805,21446,17422,4024,0.012911159652101,0.0104885863778282,0.0024225732742728,EPCI
200056232,CA Communauté Paris-Saclay,1982_1990,1986,8,249704,265903,11203,30790,16199,19587,-3388,0.00788786712555956,0.0095376043822665,-0.00164973725670694,EPCI
200056232,CA Communauté Paris-Saclay,1990_1999,1994.5,9,265903,275108,13312,35617,9205,22305,-13100,0.00378851024433557,0.00918008919064693,-0.00539157894631136,EPCI
200056232,CA Communauté Paris-Saclay,1999_2006,2002.5,7,275108,287689,10689,28368,12581,17679,-5098,0.00640848815203987,0.00900529862808305,-0.00259681047604318,EPCI
200056380,CA Plaine Vallée,2006_2011,2008.5,5,177223,178359,5839,13117,1136,7278,-6142,0.00127872617751468,0.00819240239432379,-0.00691367621680911,EPCI
200056380,CA Plaine Vallée,2011_2016,2013.5,5,178359,182034,6125,12998,3675,6873,-3198,0.00408735247513992,0.007644183282078,-0.00355683080693808,EPCI
200056380,CA Plaine Vallée,1968_1975,1971.5,7,117507,137515,7484,14939,20008,7455,12553,0.0227163303087272,0.00846412647198928,0.0142522038367379,EPCI
200056380,CA Plaine Vallée,1975_1982,1978.5,7,137515,143789,7899,13791,6274,5892,382,0.0063937742009661,0.00600448160537014,0.00038929259559596,EPCI
200056380,CA Plaine Vallée,1982_1990,1986,8,143789,158994,9858,17374,15205,7516,7689,0.0126442103217477,0.0062501732836735,0.00639403703807418,EPCI
200056380,CA Plaine Vallée,1990_1999,1994.5,9,158994,166699,11017,20822,7705,9805,-2100,0.00527199557105562,0.00670887950346533,-0.00143688393240971,EPCI
200056380,CA Plaine Vallée,1999_2006,2002.5,7,166699,177223,8571,16757,10524,8186,2338,0.00878393080424655,0.00683250261911462,0.00195142818513193,EPCI
200057859,CA Coeur d'Essonne Agglomération,2006_2011,2008.5,5,184582,188962,5208,13660,4380,8452,-4072,0.00470144275509221,0.00907228177306835,-0.00437083901797614,EPCI
200057859,CA Coeur d'Essonne Agglomération,2011_2016,2013.5,5,188962,196960,5627,13852,7998,8225,-227,0.00832541022779232,0.00856170281615302,-0.000236292588360698,EPCI
200057859,CA Coeur d'Essonne Agglomération,1968_1975,1971.5,7,99375,147012,5336,17509,47637,12173,35464,0.0575393124709893,0.014703403881633,0.0428359085893563,EPCI
200057859,CA Coeur d'Essonne Agglomération,1975_1982,1978.5,7,147012,151630,5964,15718,4618,9754,-5136,0.00442822240130281,0.00935315749292065,-0.00492493509161785,EPCI
200057859,CA Coeur d'Essonne Agglomération,1982_1990,1986,8,151630,165570,7280,18340,13940,11060,2880,0.0110544947477551,0.00877063930489035,0.00228385544286476,EPCI
200057859,CA Coeur d'Essonne Agglomération,1990_1999,1994.5,9,165570,173942,8624,22470,8372,13846,-5474,0.00549591903220348,0.0090894045532596,-0.00359348552105612,EPCI
200057859,CA Coeur d'Essonne Agglomération,1999_2006,2002.5,7,173942,184582,7227,18046,10640,10819,-179,0.00851777136594523,0.00866106845941367,-0.00014329709346844,EPCI
200057958,CA Paris - Vallée de la Marne,2006_2011,2008.5,5,212079,221929,5251,17611,9850,12360,-2510,0.00912107864194756,0.0114453331994388,-0.0023242545574912,EPCI
200057958,CA Paris - Vallée de la Marne,2011_2016,2013.5,5,221929,227440,5658,18004,5511,12346,-6835,0.00491784438472509,0.0110171850433344,-0.00609934065860933,EPCI
200057958,CA Paris - Vallée de la Marne,1968_1975,1971.5,7,69607,97504,4548,9940,27897,5392,22505,0.0493247846890736,0.00953361433284887,0.0397911703562248,EPCI
200057958,CA Paris - Vallée de la Marne,1975_1982,1978.5,7,97504,142784,5584,14843,45280,9259,36021,0.0560033639715445,0.0114517479463898,0.0445516160251547,EPCI
200057958,CA Paris - Vallée de la Marne,1982_1990,1986,8,142784,190975,7147,23947,48191,16800,31391,0.0370199749691103,0.012905637556412,0.0241143374126982,EPCI
200057958,CA Paris - Vallée de la Marne,1990_1999,1994.5,9,190975,205194,8729,28121,14219,19392,-5173,0.00801117954729369,0.0109257186708713,-0.00291453912357763,EPCI
200057958,CA Paris - Vallée de la Marne,1999_2006,2002.5,7,205194,212079,7438,21875,6885,14437,-7552,0.00472584225863071,0.00990951121101693,-0.00518366895238622,EPCI
200058360,CC Entre Beauce et Perche,2006_2011,2008.5,5,19342,20681,1034,1351,1339,317,1022,0.0134773125549923,0.00319067070943432,0.010286641845558,EPCI
200058360,CC Entre Beauce et Perche,2011_2016,2013.5,5,20681,21236,1096,1242,555,146,409,0.00531054127010266,0.00139700725303602,0.00391353401706665,EPCI
200058360,CC Entre Beauce et Perche,1968_1975,1971.5,7,14156,15107,1422,1427,951,5,946,0.00933179362948722,4.90630579888918e-05,0.00928273057149833,EPCI
200058360,CC Entre Beauce et Perche,1975_1982,1978.5,7,15107,15569,1422,1177,462,-245,707,0.00431263635797152,-0.00228700412922732,0.00659964048719884,EPCI
200058360,CC Entre Beauce et Perche,1982_1990,1986,8,15569,16845,1548,1470,1276,-78,1354,0.00989515132368846,-0.000604876021353997,0.0105000273450425,EPCI
200058360,CC Entre Beauce et Perche,1990_1999,1994.5,9,16845,17873,1791,1714,1028,-77,1105,0.00660363261441455,-0.000494630069367627,0.00709826268378217,EPCI
200058360,CC Entre Beauce et Perche,1999_2006,2002.5,7,17873,19342,1404,1674,1469,270,1199,0.0113478615702667,0.00208571996185977,0.00926214160840691,EPCI
200058477,CA Val d'Yerres Val de Seine,2006_2011,2008.5,5,169049,170070,5864,12104,1021,6240,-5219,0.00120502611674267,0.00736470418067998,-0.00615967806393731,EPCI
200058477,CA Val d'Yerres Val de Seine,2011_2016,2013.5,5,170070,177491,6138,12597,7421,6459,962,0.00857854389672186,0.00746648902155053,0.00111205487517133,EPCI
200058477,CA Val d'Yerres Val de Seine,1968_1975,1971.5,7,118233,158447,6897,18943,40214,12046,28168,0.0427101855936081,0.0127937259576417,0.0299164596359664,EPCI
200058477,CA Val d'Yerres Val de Seine,1975_1982,1978.5,7,158447,157844,7546,17237,-603,9691,-10294,-0.000544558678122975,0.00875177139252032,-0.00929633007064329,EPCI
200058477,CA Val d'Yerres Val de Seine,1982_1990,1986,8,157844,160694,8987,18483,2850,9496,-6646,0.00223934508158763,0.00746134066482671,-0.00522199558323908,EPCI
200058477,CA Val d'Yerres Val de Seine,1990_1999,1994.5,9,160694,161451,10698,20576,757,9878,-9121,0.000522331440792279,0.00681583880072144,-0.00629350735992916,EPCI
200058477,CA Val d'Yerres Val de Seine,1999_2006,2002.5,7,161451,169049,8238,16109,7598,7871,-273,0.00659118727753971,0.00682801198493223,-0.000236824707392516,EPCI
200058485,CA Val Parisis,2006_2011,2008.5,5,256116,260872,8083,18907,4756,10824,-6068,0.00368665881458119,0.00839032695732271,-0.00470366814274152,EPCI
200058485,CA Val Parisis,2011_2016,2013.5,5,260872,272890,8495,19406,12018,10911,1107,0.00904847577562951,0.00821500409285185,0.000833471682777656,EPCI
200058485,CA Val Parisis,1968_1975,1971.5,7,160739,187864,9704,19790,27125,10086,17039,0.0225266003489042,0.00837615819793724,0.0141504421509669,EPCI
200058485,CA Val Parisis,1975_1982,1978.5,7,187864,212822,10293,21964,24958,11671,13287,0.017979409252054,0.0084076322373877,0.00957177701466629,EPCI
200058485,CA Val Parisis,1982_1990,1986,8,212822,239424,12052,28524,26602,16472,10130,0.0148313975350389,0.00918362454691982,0.0056477729881191,EPCI
200058485,CA Val Parisis,1990_1999,1994.5,9,239424,246721,13809,31117,7297,17308,-10011,0.00334135936150548,0.00792548277770822,-0.00458412341620274,EPCI
200058485,CA Val Parisis,1999_2006,2002.5,7,246721,256116,11079,24246,9395,13167,-3772,0.00535318067080426,0.00750243000452152,-0.00214924933371726,EPCI
200058519,CA Saint-Germain Boucles de Seine,2006_2011,2008.5,5,329957,333624,10627,23637,3667,13010,-9343,0.00221289833394578,0.00785105190200016,-0.00563815356805438,EPCI
200058519,CA Saint-Germain Boucles de Seine,2011_2016,2013.5,5,333624,334123,10955,22483,499,11528,-11029,0.000298960342639099,0.00690664294577861,-0.00660768260313952,EPCI
200058519,CA Saint-Germain Boucles de Seine,1968_1975,1971.5,7,272744,296249,15255,33727,23505,18472,5033,0.0118795350118033,0.00933583368381324,0.00254370132799004,EPCI
200058519,CA Saint-Germain Boucles de Seine,1975_1982,1978.5,7,296249,302741,15356,30770,6492,15414,-8922,0.00310156243351134,0.00736406089805049,-0.00426249846453915,EPCI
200058519,CA Saint-Germain Boucles de Seine,1982_1990,1986,8,302741,313963,17407,35956,11222,18549,-7327,0.00456005179616525,0.00753737308564153,-0.00297732128947628,EPCI
200058519,CA Saint-Germain Boucles de Seine,1990_1999,1994.5,9,313963,315133,19887,41066,1170,21179,-20009,0.00041337734652136,0.00748283659997938,-0.00706945925345802,EPCI
200058519,CA Saint-Germain Boucles de Seine,1999_2006,2002.5,7,315133,329957,14920,33183,14824,18263,-3439,0.00658840453550624,0.00811683972152931,-0.00152843518602307,EPCI
200058782,CA de Saint-Quentin-en-Yvelines,2006_2011,2008.5,5,228154,226463,4536,18715,-1691,14179,-15870,-0.00148674637078838,0.0124663375466638,-0.0139530839174522,EPCI
200058782,CA de Saint-Quentin-en-Yvelines,2011_2016,2013.5,5,226463,229369,4916,17833,2906,12917,-10011,0.0025533511141782,0.0113494963323606,-0.00879614521818238,EPCI
200058782,CA de Saint-Quentin-en-Yvelines,1968_1975,1971.5,7,51393,109484,2740,12339,58091,9599,48492,0.11409174214002,0.0188526042382134,0.0952391379018069,EPCI
200058782,CA de Saint-Quentin-en-Yvelines,1975_1982,1978.5,7,109484,163605,3482,20541,54121,17059,37062,0.0590606824166302,0.0186159934470038,0.0404446889696264,EPCI
200058782,CA de Saint-Quentin-en-Yvelines,1982_1990,1986,8,163605,204010,5234,28803,40405,23569,16836,0.0279733610021973,0.0163173900621405,0.0116559709400568,EPCI
200058782,CA de Saint-Quentin-en-Yvelines,1990_1999,1994.5,9,204010,224259,6946,34022,20249,27076,-6827,0.0105702098354183,0.0141339819992981,-0.00356377216387975,EPCI
200058782,CA de Saint-Quentin-en-Yvelines,1999_2006,2002.5,7,224259,228154,6012,25891,3895,19879,-15984,0.0024629145220556,0.0125700328071742,-0.0101071182851186,EPCI
200059228,CA Grand Paris Sud Seine Essonne Sénart,2006_2011,2008.5,5,312384,326924,7127,29709,14540,22582,-8042,0.00914042642054702,0.0141959497543874,-0.00505552333384038,EPCI
200059228,CA Grand Paris Sud Seine Essonne Sénart,2011_2016,2013.5,5,326924,351608,7771,30461,24684,22690,1994,0.0146643195509162,0.0134797200863024,0.00118459946461379,EPCI
200059228,CA Grand Paris Sud Seine Essonne Sénart,1968_1975,1971.5,7,93150,159073,5558,16883,65923,11325,54598,0.0794485433886953,0.0136485711189869,0.0657999722697084,EPCI
200059228,CA Grand Paris Sud Seine Essonne Sénart,1975_1982,1978.5,7,159073,204544,6793,22617,45471,15824,29647,0.036569940145821,0.0127264131615199,0.0238435269843011,EPCI
200059228,CA Grand Paris Sud Seine Essonne Sénart,1982_1990,1986,8,204544,271251,8925,34787,66707,25862,40845,0.035912504368012,0.01392311433531,0.0219893900327019,EPCI
200059228,CA Grand Paris Sud Seine Essonne Sénart,1990_1999,1994.5,9,271251,290802,11188,45106,19551,33918,-14367,0.00776309239175155,0.0134677800492777,-0.00570468765752619,EPCI
200059228,CA Grand Paris Sud Seine Essonne Sénart,1999_2006,2002.5,7,290802,312384,9567,37106,21582,27539,-5957,0.0102797021062599,0.0131170751693213,-0.00283737306306137,EPCI
200059392,CC Bièvre Isère,2006_2011,2008.5,5,47030,51653,2079,3135,4623,1056,3567,0.0189294489146581,0.00432392343800107,0.014605525476657,EPCI
200059392,CC Bièvre Isère,2011_2016,2013.5,5,51653,54249,2229,3206,2596,977,1619,0.00985550512707078,0.0037091018910432,0.00614640323602758,EPCI
200059392,CC Bièvre Isère,1968_1975,1971.5,7,30374,31844,2824,3044,1470,220,1250,0.00677455876808342,0.00101387954352269,0.00576067922456073,EPCI
200059392,CC Bièvre Isère,1975_1982,1978.5,7,31844,35949,2874,3087,4105,213,3892,0.0174726467407249,0.000906619672539441,0.0165660270681855,EPCI
200059392,CC Bièvre Isère,1982_1990,1986,8,35949,38495,3279,3597,2546,318,2228,0.00859007165240211,0.0010729154695459,0.00751715618285621,EPCI
200059392,CC Bièvre Isère,1990_1999,1994.5,9,38495,41195,3688,3828,2700,140,2560,0.00756049586511365,0.000392025711524411,0.00716847015358924,EPCI
200059392,CC Bièvre Isère,1999_2006,2002.5,7,41195,47030,2932,3984,5835,1052,4783,0.0191043111255851,0.00344434195443282,0.0156599691711523,EPCI
200059400,CC Porte Océane du Limousin,2006_2011,2008.5,5,25180,25650,1495,1266,470,-229,699,0.00370555726390376,-0.00180547364560417,0.00551103090950793,EPCI
200059400,CC Porte Océane du Limousin,2011_2016,2013.5,5,25650,25637,1560,1094,-13,-466,453,-0.000101385078201122,-0.00363426511090175,0.00353288003270062,EPCI
200059400,CC Porte Océane du Limousin,1968_1975,1971.5,7,24948,24413,2311,2010,-535,-301,-234,-0.00309204993086254,-0.00173963930689649,-0.00135241062396605,EPCI
200059400,CC Porte Océane du Limousin,1975_1982,1978.5,7,24413,23994,2372,1740,-419,-632,213,-0.00247008405391769,-0.00372575924123145,0.00125567518731376,EPCI
200059400,CC Porte Océane du Limousin,1982_1990,1986,8,23994,24009,2588,1737,15,-851,866,7.81231714912511e-05,-0.00443218792927032,0.00451031110076157,EPCI
200059400,CC Porte Océane du Limousin,1990_1999,1994.5,9,24009,23655,2851,1785,-354,-1066,712,-0.00164911104955523,-0.00496596717182451,0.00331685612226928,EPCI
200059400,CC Porte Océane du Limousin,1999_2006,2002.5,7,23655,25180,2229,1626,1525,-603,2128,0.00896502144947564,-0.00354485766166152,0.0125098791111372,EPCI
200059889,CU Grand Paris Seine et Oise,2006_2011,2008.5,5,390424,399855,11851,31626,9431,19775,-10344,0.00478514307087208,0.0100335281758557,-0.00524838510498365,EPCI
200059889,CU Grand Paris Seine et Oise,2011_2016,2013.5,5,399855,410596,12111,33019,10741,20908,-10167,0.00531563437848437,0.0103472007806863,-0.0050315664022019,EPCI
200059889,CU Grand Paris Seine et Oise,1968_1975,1971.5,7,234847,310745,13220,37888,75898,24668,51230,0.040816484077596,0.013265975773092,0.027550508304504,EPCI
200059889,CU Grand Paris Seine et Oise,1975_1982,1978.5,7,310745,333553,14875,41035,22808,26160,-3352,0.0101698121753502,0.0116644285560839,-0.00149461638073368,EPCI
200059889,CU Grand Paris Seine et Oise,1982_1990,1986,8,333553,366365,17279,47987,32812,30708,2104,0.0117975903942551,0.0110410948990243,0.000756495495230792,EPCI
200059889,CU Grand Paris Seine et Oise,1990_1999,1994.5,9,366365,383452,20838,53634,17087,32796,-15709,0.00507777573632007,0.00974604863629384,-0.00466827289997378,EPCI
200059889,CU Grand Paris Seine et Oise,1999_2006,2002.5,7,383452,390424,16958,41362,6972,24404,-17432,0.00257744134232696,0.00902178406743361,-0.00644434272510665,EPCI
200060010,CA Mauges Communauté,2006_2011,2008.5,5,109993,116900,4734,8998,6907,4264,2643,0.0122549117370949,0.00756550508860182,0.0046894066484931,EPCI
200060010,CA Mauges Communauté,2011_2016,2013.5,5,116900,121088,5053,8187,4188,3134,1054,0.00706457429974128,0.00528662269708433,0.00177795160265695,EPCI
200060010,CA Mauges Communauté,1968_1975,1971.5,7,88085,91344,6496,12157,3259,5661,-2402,0.00520354046878713,0.00903873660441974,-0.00383519613563261,EPCI
200060010,CA Mauges Communauté,1975_1982,1978.5,7,91344,97146,6396,11836,5802,5440,362,0.00883629765612759,0.00828498091163979,0.000551316744487796,EPCI
200060010,CA Mauges Communauté,1982_1990,1986,8,97146,100096,7218,12110,2950,4892,-1942,0.00374634054990741,0.0062125755831007,-0.00246623503319329,EPCI
200060010,CA Mauges Communauté,1990_1999,1994.5,9,100096,101125,8177,11196,1029,3019,-1990,0.00113705149743026,0.00333601406291736,-0.0021989625654871,EPCI
200060010,CA Mauges Communauté,1999_2006,2002.5,7,101125,109993,6862,10401,8868,3539,5329,0.0120808701224628,0.00482117719478981,0.00725969292767303,EPCI
200065563,CC Normandie-Cabourg-Pays d'Auge,2006_2011,2008.5,5,29858,30792,1440,1655,934,215,719,0.00617943548944622,0.00142246106020443,0.00475697442924179,EPCI
200065563,CC Normandie-Cabourg-Pays d'Auge,2011_2016,2013.5,5,30792,31268,1619,1442,476,-177,653,0.00307277018491869,-0.00114260572002229,0.00421537590494098,EPCI
200065563,CC Normandie-Cabourg-Pays d'Auge,1968_1975,1971.5,7,22574,23367,1600,2562,793,962,-169,0.00494446501840717,0.00599820346495296,-0.00105373844654579,EPCI
200065563,CC Normandie-Cabourg-Pays d'Auge,1975_1982,1978.5,7,23367,24017,1686,2077,650,391,259,0.00392728340668791,0.00236241201848457,0.00156487138820334,EPCI
200065563,CC Normandie-Cabourg-Pays d'Auge,1982_1990,1986,8,24017,26063,1843,2637,2046,794,1252,0.0102717422389289,0.00398619908978961,0.00628554314913929,EPCI
200065563,CC Normandie-Cabourg-Pays d'Auge,1990_1999,1994.5,9,26063,28169,2142,2915,2106,773,1333,0.00867131306572366,0.00318277540351586,0.00548853766220781,EPCI
200065563,CC Normandie-Cabourg-Pays d'Auge,1999_2006,2002.5,7,28169,29858,1734,2403,1689,669,1020,0.00835337177026796,0.00330870675802798,0.00504466501223998,EPCI
200065589,CC Val ès Dunes,2006_2011,2008.5,5,15191,16565,501,1043,1374,542,832,0.0174685997941577,0.00689081593044649,0.0105777838637112,EPCI
200065589,CC Val ès Dunes,2011_2016,2013.5,5,16565,17901,599,1136,1336,537,799,0.0156338580713289,0.00628396840142486,0.00934988966990403,EPCI
200065589,CC Val ès Dunes,1968_1975,1971.5,7,8248,9046,558,1062,798,504,294,0.0132805454110059,0.0083877128911616,0.00489283251984427,EPCI
200065589,CC Val ès Dunes,1975_1982,1978.5,7,9046,11276,566,1065,2230,499,1731,0.031979836801205,0.0071560262617943,0.0248238105394107,EPCI
200065589,CC Val ès Dunes,1982_1990,1986,8,11276,13536,708,1481,2260,773,1487,0.0230972323123375,0.00790007105196323,0.0151971612603743,EPCI
200065589,CC Val ès Dunes,1990_1999,1994.5,9,13536,14031,881,1497,495,616,-121,0.00399868064693831,0.0049761359161899,-0.000977455269251588,EPCI
200065589,CC Val ès Dunes,1999_2006,2002.5,7,14031,15191,667,1272,1160,605,555,0.0114123409133124,0.00595212607978796,0.00546021483352449,EPCI
200065597,CU Caen la Mer,2006_2011,2008.5,5,261162,260827,9354,15936,-335,6582,-6917,-0.000256677478391199,0.00504313779931603,-0.00529981527770722,EPCI
200065597,CU Caen la Mer,2011_2016,2013.5,5,260827,265466,10100,14731,4639,4631,8,0.00353210722425978,0.00352601607146951,6.09115279027366e-06,EPCI
200065597,CU Caen la Mer,1968_1975,1971.5,7,182789,216842,9911,30286,34053,20375,13678,0.0247054584187938,0.0147820666397358,0.00992339177905798,EPCI
200065597,CU Caen la Mer,1975_1982,1978.5,7,216842,227044,10231,27867,10202,17636,-7434,0.00658945175530734,0.0113910577491276,-0.00480160599382031,EPCI
200065597,CU Caen la Mer,1982_1990,1986,8,227044,240779,12318,30020,13735,17702,-3967,0.00736897688909277,0.00949731553627377,-0.002128338647181,EPCI
200065597,CU Caen la Mer,1990_1999,1994.5,9,240779,256981,14698,30420,16202,15722,480,0.00726209222835128,0.00704694568659047,0.000215146541760808,EPCI
200065597,CU Caen la Mer,1999_2006,2002.5,7,256981,261162,12437,23184,4181,10747,-6566,0.00230819582453634,0.00593307355328679,-0.00362487772875045,EPCI
200065647,CA Pays de Montbéliard Agglomération,2006_2011,2008.5,5,142399,142674,5781,9582,275,3801,-3526,0.000385940652038563,0.00533440152144938,-0.00494846086941082,EPCI
200065647,CA Pays de Montbéliard Agglomération,2011_2016,2013.5,5,142674,139989,6224,8743,-2685,2519,-5204,-0.00379248217885875,0.00355801214470957,-0.00735049432356831,EPCI
200065647,CA Pays de Montbéliard Agglomération,1968_1975,1971.5,7,140400,160628,7573,20817,20228,13244,6984,0.0194139962337461,0.0127110424223716,0.00670295381137446,EPCI
200065647,CA Pays de Montbéliard Agglomération,1975_1982,1978.5,7,160628,158245,7628,19882,-2383,12254,-14637,-0.00213296022470244,0.0109682310505681,-0.0131011912752705,EPCI
200065647,CA Pays de Montbéliard Agglomération,1982_1990,1986,8,158245,148914,8632,18062,-9331,9430,-18761,-0.00756815455505655,0.00764845112572964,-0.0152166056807862,EPCI
200065647,CA Pays de Montbéliard Agglomération,1990_1999,1994.5,9,148914,144504,9885,16577,-4410,6692,-11102,-0.00333462433524256,0.00506016010236808,-0.00839478443761065,EPCI
200065647,CA Pays de Montbéliard Agglomération,1999_2006,2002.5,7,144504,142399,8086,12631,-2105,4545,-6650,-0.00209412031394618,0.00452150918141824,-0.00661562949536442,EPCI
200065787,CC de Pont-Audemer / Val de Risle,2006_2011,2008.5,5,30255,32101,1582,1926,1846,344,1502,0.0119155759842127,0.00222045402956076,0.00969512195465191,EPCI
200065787,CC de Pont-Audemer / Val de Risle,2011_2016,2013.5,5,32101,33226,1721,2042,1125,321,804,0.00691288839612492,0.00197247748902764,0.00494041090709727,EPCI
200065787,CC de Pont-Audemer / Val de Risle,1968_1975,1971.5,7,25668,26877,1793,3473,1209,1680,-471,0.00659678102408923,0.00916674286225798,-0.00256996183816876,EPCI
200065787,CC de Pont-Audemer / Val de Risle,1975_1982,1978.5,7,26877,27984,1781,2978,1107,1197,-90,0.00578265767212405,0.00625279244221543,-0.000470134770091386,EPCI
200065787,CC de Pont-Audemer / Val de Risle,1982_1990,1986,8,27984,28529,2200,3262,545,1062,-517,0.00241393329562434,0.00470384799991385,-0.00228991470428951,EPCI
200065787,CC de Pont-Audemer / Val de Risle,1990_1999,1994.5,9,28529,28863,2563,3177,334,614,-280,0.00129410154545284,0.00237897709253906,-0.00108487554708621,EPCI
200065787,CC de Pont-Audemer / Val de Risle,1999_2006,2002.5,7,28863,30255,2243,2545,1392,302,1090,0.00675139748230347,0.00146474284458021,0.00528665463772326,EPCI
200065886,CA Loire Forez Agglomération,2006_2011,2008.5,5,99340,104112,4604,6045,4772,1441,3331,0.00942795237957461,0.00284695712048764,0.00658099525908697,EPCI
200065886,CA Loire Forez Agglomération,2011_2016,2013.5,5,104112,109047,4872,5911,4935,1039,3896,0.00930537612885596,0.0019591257949101,0.00734625033394586,EPCI
200065886,CA Loire Forez Agglomération,1968_1975,1971.5,7,71158,73504,7179,7478,2346,299,2047,0.00464462007668343,0.000591961382322397,0.00405265869436103,EPCI
200065886,CA Loire Forez Agglomération,1975_1982,1978.5,7,73504,79185,7117,6930,5681,-187,5868,0.0106920501174006,-0.000351947433894369,0.011043997551295,EPCI
200065886,CA Loire Forez Agglomération,1982_1990,1986,8,79185,86083,7651,8177,6898,526,6372,0.01049532610364,0.000800310456728711,0.0096950156469113,EPCI
200065886,CA Loire Forez Agglomération,1990_1999,1994.5,9,86083,90159,8373,8596,4076,223,3853,0.00515354865743234,0.00028195322635118,0.00487159543108116,EPCI
200065886,CA Loire Forez Agglomération,1999_2006,2002.5,7,90159,99340,6564,7808,9181,1244,7937,0.0139497640947859,0.00189015428971938,0.0120596098050665,EPCI
200065894,CC de Forez-Est,2006_2011,2008.5,5,57740,60981,2632,3573,3241,941,2300,0.0109823007434249,0.00318862850958433,0.00779367223384055,EPCI
200065894,CC de Forez-Est,2011_2016,2013.5,5,60981,63437,2592,3355,2456,763,1693,0.007928252899988,0.00246305250923894,0.00546520039074906,EPCI
200065894,CC de Forez-Est,1968_1975,1971.5,7,43408,44760,3830,4910,1352,1080,272,0.00439120284588834,0.00350776558695223,0.000883437258936116,EPCI
200065894,CC de Forez-Est,1975_1982,1978.5,7,44760,47856,3484,4345,3096,861,2235,0.00960030703529857,0.00266985282861501,0.00693045420668356,EPCI
200065894,CC de Forez-Est,1982_1990,1986,8,47856,51488,4076,4935,3632,859,2773,0.0091859680097246,0.00217256236793872,0.00701340564178588,EPCI
200065894,CC de Forez-Est,1990_1999,1994.5,9,51488,54444,4804,5318,2956,514,2442,0.00622192958359324,0.00108189167996175,0.0051400379036315,EPCI
200065894,CC de Forez-Est,1999_2006,2002.5,7,54444,57740,3691,4732,3296,1041,2255,0.00843214102119405,0.00266318531646329,0.00576895570473076,EPCI
200065928,CA Lannion-Trégor Communauté,2006_2011,2008.5,5,98171,100730,6224,5020,2559,-1204,3763,0.00515982908121382,-0.00242768042742534,0.00758750950863916,EPCI
200065928,CA Lannion-Trégor Communauté,2011_2016,2013.5,5,100730,99903,6548,4183,-827,-2365,1538,-0.0016474324351351,-0.00471121851160158,0.00306378607646648,EPCI
200065928,CA Lannion-Trégor Communauté,1968_1975,1971.5,7,82255,88338,8120,9131,6083,1011,5072,0.0102444311139447,0.00170263354532272,0.00854179756862197,EPCI
200065928,CA Lannion-Trégor Communauté,1975_1982,1978.5,7,88338,91295,8498,8102,2957,-396,3353,0.00471474466549293,-0.000631396309616233,0.00534614097510916,EPCI
200065928,CA Lannion-Trégor Communauté,1982_1990,1986,8,91295,91357,9680,8170,62,-1510,1572,8.48644322832826e-05,-0.00206685956044769,0.00215172399273097,EPCI
200065928,CA Lannion-Trégor Communauté,1990_1999,1994.5,9,91357,93105,10638,8218,1748,-2420,4168,0.00210810563595598,-0.0029185444159116,0.00502665005186758,EPCI
200065928,CA Lannion-Trégor Communauté,1999_2006,2002.5,7,93105,98171,8559,7062,5066,-1497,6563,0.00759771261470332,-0.0022451195784072,0.00984283219311052,EPCI
200066009,CA Mulhouse Alsace Agglomération,2006_2011,2008.5,5,267609,270116,10469,18483,2507,8014,-5507,0.00186664729868902,0.00596701693326437,-0.00410036963457536,EPCI
200066009,CA Mulhouse Alsace Agglomération,2011_2016,2013.5,5,270116,272712,11375,18241,2596,6866,-4270,0.00191479025811847,0.00506431044385263,-0.00314952018573416,EPCI
200066009,CA Mulhouse Alsace Agglomération,1968_1975,1971.5,7,220406,243743,17203,28462,23337,11259,12078,0.0144814390795402,0.00698661021538945,0.0074948288641508,EPCI
200066009,CA Mulhouse Alsace Agglomération,1975_1982,1978.5,7,243743,248488,16810,27612,4745,10802,-6057,0.00275810561042822,0.00627883178163237,-0.00352072617120416,EPCI
200066009,CA Mulhouse Alsace Agglomération,1982_1990,1986,8,248488,253338,18269,32023,4850,13754,-8904,0.00241917284572568,0.0068604749113631,-0.00444130206563742,EPCI
200066009,CA Mulhouse Alsace Agglomération,1990_1999,1994.5,9,253338,261570,19508,32615,8232,13107,-4875,0.00355936048927896,0.00566721792188768,-0.00210785743260871,EPCI
200066009,CA Mulhouse Alsace Agglomération,1999_2006,2002.5,7,261570,267609,14928,25251,6039,10323,-4284,0.00326603990483232,0.0055829325944004,-0.00231689268956808,EPCI
200066017,CC Lieuvin Pays d'Auge,2006_2011,2008.5,5,17430,19305,701,1234,1875,533,1342,0.0206444627840259,0.00586853262073909,0.0147759301632868,EPCI
200066017,CC Lieuvin Pays d'Auge,2011_2016,2013.5,5,19305,20503,748,1177,1198,429,769,0.0121142071743512,0.00433805916343628,0.00777614801091491,EPCI
200066017,CC Lieuvin Pays d'Auge,1968_1975,1971.5,7,15574,15074,1163,1745,-500,582,-1082,-0.00465078740090408,0.00541351653465235,-0.0100643039355564,EPCI
200066017,CC Lieuvin Pays d'Auge,1975_1982,1978.5,7,15074,15366,1075,1328,292,253,39,0.00274459825014883,0.0023780251961906,0.000366573053958234,EPCI
200066017,CC Lieuvin Pays d'Auge,1982_1990,1986,8,15366,15715,1209,1470,349,261,88,0.00281124337992544,0.00210239118097576,0.000708852198949682,EPCI
200066017,CC Lieuvin Pays d'Auge,1990_1999,1994.5,9,15715,16244,1237,1591,529,354,175,0.00368543452681935,0.00246624541114187,0.00121918911567748,EPCI
200066017,CC Lieuvin Pays d'Auge,1999_2006,2002.5,7,16244,17430,1003,1376,1186,373,813,0.0101178787459548,0.00318209845888798,0.00693578028706684,EPCI
200066025,CC Pays Rhin - Brisach,2006_2011,2008.5,5,30858,32495,936,1811,1637,875,762,0.0103916612142752,0.00555449209681781,0.00483716911745734,EPCI
200066025,CC Pays Rhin - Brisach,2011_2016,2013.5,5,32495,33064,1025,1665,569,640,-71,0.00347780274358578,0.00391176407011406,-0.000433961326528278,EPCI
200066025,CC Pays Rhin - Brisach,1968_1975,1971.5,7,16471,20416,1275,2403,3945,1128,2817,0.0311492426186009,0.00890655150159234,0.0222426911170085,EPCI
200066025,CC Pays Rhin - Brisach,1975_1982,1978.5,7,20416,23147,1223,2311,2731,1088,1643,0.0180969834356159,0.00720963675501653,0.0108873466805994,EPCI
200066025,CC Pays Rhin - Brisach,1982_1990,1986,8,23147,25131,1377,2785,1984,1408,576,0.0103326369710957,0.00733283914077756,0.00299979783031809,EPCI
200066025,CC Pays Rhin - Brisach,1990_1999,1994.5,9,25131,28136,1478,2818,3005,1340,1665,0.0126288287215746,0.00563149101061894,0.00699733771095562,EPCI
200066025,CC Pays Rhin - Brisach,1999_2006,2002.5,7,28136,30858,1200,2466,2722,1266,1456,0.013279708225671,0.00617638156271107,0.00710332666295997,EPCI
200066033,CC Sud Alsace Largue,2006_2011,2008.5,5,20670,21710,734,1181,1040,447,593,0.00986627595131462,0.00424060129830542,0.0056256746530092,EPCI
200066033,CC Sud Alsace Largue,2011_2016,2013.5,5,21710,22272,885,1142,562,257,305,0.00512454585063993,0.00234343110963427,0.00278111474100565,EPCI
200066033,CC Sud Alsace Largue,1968_1975,1971.5,7,14508,15354,1211,1556,846,345,501,0.00812940921768357,0.00331518461004826,0.00481422460763531,EPCI
200066033,CC Sud Alsace Largue,1975_1982,1978.5,7,15354,16234,1215,1374,880,159,721,0.00799346161322734,0.00144427317784448,0.00654918843538285,EPCI
200066033,CC Sud Alsace Largue,1982_1990,1986,8,16234,17217,1322,1699,983,377,606,0.00737575026233417,0.00282874654008136,0.0045470037222528,EPCI
200066033,CC Sud Alsace Largue,1990_1999,1994.5,9,17217,18697,1308,1916,1480,608,872,0.00920497596547931,0.00378150363987258,0.00542347232560673,EPCI
200066033,CC Sud Alsace Largue,1999_2006,2002.5,7,18697,20670,1003,1626,1973,623,1350,0.0144346579455157,0.00455792797772746,0.00987672996778823,EPCI
200066041,CC Sundgau,2006_2011,2008.5,5,46151,47662,1676,2567,1511,891,620,0.00646396291792173,0.00381164193240785,0.00265232098551388,EPCI
200066041,CC Sundgau,2011_2016,2013.5,5,47662,47521,1910,2251,-141,341,-482,-0.00059236770036708,0.00143260557322819,-0.00202497327359527,EPCI
200066041,CC Sundgau,1968_1975,1971.5,7,34841,36252,2980,3803,1411,823,588,0.0056874981781081,0.00331737136823739,0.0023701268098707,EPCI
200066041,CC Sundgau,1975_1982,1978.5,7,36252,38076,3023,3241,1824,218,1606,0.00703744873057466,0.000841098587316489,0.00619635014325817,EPCI
200066041,CC Sundgau,1982_1990,1986,8,38076,39895,3151,4004,1819,853,966,0.00585040219318045,0.00274348162220062,0.00310692057097983,EPCI
200066041,CC Sundgau,1990_1999,1994.5,9,39895,43144,3281,4452,3249,1171,2078,0.00873709815392232,0.00314901260025948,0.00558808555366284,EPCI
200066041,CC Sundgau,1999_2006,2002.5,7,43144,46151,2414,3537,3007,1123,1884,0.00967150839235709,0.00361194011460493,0.00605956827775216,EPCI
200066058,CA Saint-Louis Agglomération,2006_2011,2008.5,5,70019,74537,2390,3917,4518,1527,2991,0.012584327065033,0.00425326857642881,0.00833105848860417,EPCI
200066058,CA Saint-Louis Agglomération,2011_2016,2013.5,5,74537,78300,2643,4059,3763,1416,2347,0.00989906611581293,0.00372497412170904,0.00617409199410389,EPCI
200066058,CA Saint-Louis Agglomération,1968_1975,1971.5,7,46558,54601,3515,4840,8043,1325,6718,0.0230258590837744,0.00379326908939464,0.0192325899943798,EPCI
200066058,CA Saint-Louis Agglomération,1975_1982,1978.5,7,54601,57851,3710,5248,3250,1538,1712,0.00829399790387164,0.00392497500804756,0.00436902289582408,EPCI
200066058,CA Saint-Louis Agglomération,1982_1990,1986,8,57851,61123,4099,6102,3272,2003,1269,0.00690088812808987,0.00422447399772739,0.00267641413036248,EPCI
200066058,CA Saint-Louis Agglomération,1990_1999,1994.5,9,61123,65923,4424,6969,4800,2545,2255,0.00843528563881768,0.00447245873974812,0.00396282689906956,EPCI
200066058,CA Saint-Louis Agglomération,1999_2006,2002.5,7,65923,70019,3340,5441,4096,2101,1995,0.0086485040043891,0.00443615891436072,0.00421234509002838,EPCI
200066108,CC des Portes de Meuse,2006_2011,2008.5,5,17829,17484,832,936,-345,104,-449,-0.00390040718497353,0.00117577491952825,-0.00507618210450178,EPCI
200066108,CC des Portes de Meuse,2011_2016,2013.5,5,17484,16919,829,805,-565,-24,-541,-0.00654825138920889,-0.000278155811223033,-0.00627009557798586,EPCI
200066108,CC des Portes de Meuse,1968_1975,1971.5,7,18937,18418,1588,2052,-519,464,-983,-0.00396202082820263,0.00354215349573414,-0.00750417432393677,EPCI
200066108,CC des Portes de Meuse,1975_1982,1978.5,7,18418,18690,1595,1785,272,190,82,0.00209650519569671,0.00146447054111167,0.000632034654585037,EPCI
200066108,CC des Portes de Meuse,1982_1990,1986,8,18690,18667,1559,2025,-23,466,-489,-0.00015390845700447,0.00311831917235144,-0.00327222762935591,EPCI
200066108,CC des Portes de Meuse,1990_1999,1994.5,9,18667,17570,1609,1671,-1097,62,-1159,-0.006706781457127,0.000379052370411918,-0.00708583382753892,EPCI
200066108,CC des Portes de Meuse,1999_2006,2002.5,7,17570,17829,1169,1372,259,203,56,0.00209267843771643,0.00164020742415612,0.00045247101356031,EPCI
200066116,CC Argonne-Meuse,2006_2011,2008.5,5,7480,7531,462,439,51,-23,74,0.00135993249725797,-0.000613302890920259,0.00197323538817822,EPCI
200066116,CC Argonne-Meuse,2011_2016,2013.5,5,7531,7252,536,333,-279,-203,-76,-0.00752167797260017,-0.00547276210909618,-0.00204891586350399,EPCI
200066116,CC Argonne-Meuse,1968_1975,1971.5,7,8856,8119,949,794,-737,-155,-582,-0.0123358816496251,-0.0025943848788221,-0.00974149677080297,EPCI
200066116,CC Argonne-Meuse,1975_1982,1978.5,7,8119,7766,906,647,-353,-259,-94,-0.0063301315589499,-0.00464448746109922,-0.00168564409785068,EPCI
200066116,CC Argonne-Meuse,1982_1990,1986,8,7766,7652,913,785,-114,-128,14,-0.00184681500103723,-0.00207361684326987,0.000226801842232642,EPCI
200066116,CC Argonne-Meuse,1990_1999,1994.5,9,7652,7507,987,766,-145,-221,76,-0.00212342378218966,-0.00323639073009596,0.0011129669479063,EPCI
200066116,CC Argonne-Meuse,1999_2006,2002.5,7,7507,7480,731,610,-27,-121,94,-0.000514599920087844,-0.00230617001224552,0.00179157009215768,EPCI
200066124,CA Gaillac-Graulhet,2006_2011,2008.5,5,63309,67886,3376,3906,4577,530,4047,0.0140583680785942,0.0016279080361929,0.0124304600424013,EPCI
200066124,CA Gaillac-Graulhet,2011_2016,2013.5,5,67886,73228,3727,4001,5342,274,5068,0.0152649437430465,0.000782964168025974,0.0144819795750206,EPCI
200066124,CA Gaillac-Graulhet,1968_1975,1971.5,7,54355,55826,4991,5246,1471,255,1216,0.00382201463086918,0.00066255182248242,0.00315946280838676,EPCI
200066124,CA Gaillac-Graulhet,1975_1982,1978.5,7,55826,55536,4728,4161,-290,-567,277,-0.00074375921214187,-0.00145417749408428,0.000710418281942407,EPCI
200066124,CA Gaillac-Graulhet,1982_1990,1986,8,55536,56808,5399,4709,1272,-690,1962,0.0028347229703598,-0.00153770349807254,0.00437242646843234,EPCI
200066124,CA Gaillac-Graulhet,1990_1999,1994.5,9,56808,58329,6050,5257,1521,-793,2314,0.00294011768199565,-0.00153288186839089,0.00447299955038654,EPCI
200066124,CA Gaillac-Graulhet,1999_2006,2002.5,7,58329,63309,4862,4713,4980,-149,5129,0.0117727745955629,-0.000352237633481702,0.0121250122290446,EPCI
200066132,CC du Pays de Stenay et du Val Dunois,2006_2011,2008.5,5,10201,10289,697,579,88,-118,206,0.00171939821157552,-0.00230555669279444,0.00402495490436996,EPCI
200066132,CC du Pays de Stenay et du Val Dunois,2011_2016,2013.5,5,10289,9966,700,537,-323,-163,-160,-0.00635890872692302,-0.00320898489934505,-0.00314992382757797,EPCI
200066132,CC du Pays de Stenay et du Val Dunois,1968_1975,1971.5,7,13367,12361,1180,1459,-1006,279,-1285,-0.0111152819385263,0.00308266765491932,-0.0141979495934456,EPCI
200066132,CC du Pays de Stenay et du Val Dunois,1975_1982,1978.5,7,12361,11685,1178,1074,-676,-104,-572,-0.00800215193391485,-0.00123110029752536,-0.00677105163638949,EPCI
200066132,CC du Pays de Stenay et du Val Dunois,1982_1990,1986,8,11685,10928,1178,1040,-757,-138,-619,-0.0083372588130558,-0.00151987016671295,-0.00681738864634286,EPCI
200066132,CC du Pays de Stenay et du Val Dunois,1990_1999,1994.5,9,10928,10368,1397,1078,-560,-319,-241,-0.00582785878651182,-0.0033197981301737,-0.00250806065633812,EPCI
200066132,CC du Pays de Stenay et du Val Dunois,1999_2006,2002.5,7,10368,10201,1090,722,-167,-368,201,-0.00231708068741932,-0.00510590235311562,0.0027888216656963,EPCI
200066140,CC de l'Aire à l'Argonne,2006_2011,2008.5,5,6416,6584,305,347,168,42,126,0.00518290357794937,0.00129572589448734,0.00388717768346203,EPCI
200066140,CC de l'Aire à l'Argonne,2011_2016,2013.5,5,6584,6579,316,362,-5,46,-51,-0.000151929511724158,0.00139775150786226,-0.00154968101958641,EPCI
200066140,CC de l'Aire à l'Argonne,1968_1975,1971.5,7,7682,6710,748,585,-972,-163,-809,-0.0191403070232693,-0.00320974284443714,-0.0159305641788322,EPCI
200066140,CC de l'Aire à l'Argonne,1975_1982,1978.5,7,6710,6448,663,511,-262,-152,-110,-0.00567369286123287,-0.00329160807216564,-0.00238208478906724,EPCI
200066140,CC de l'Aire à l'Argonne,1982_1990,1986,8,6448,6556,708,662,108,-46,154,0.00207848902953311,-0.000885282364430771,0.00296377139396389,EPCI
200066140,CC de l'Aire à l'Argonne,1990_1999,1994.5,9,6556,6428,698,646,-128,-52,-76,-0.00218840339119997,-0.000889038877674986,-0.00129936451352498,EPCI
200066140,CC de l'Aire à l'Argonne,1999_2006,2002.5,7,6428,6416,458,518,-12,60,-72,-0.000266903990655432,0.00133451995327716,-0.00160142394393259,EPCI
200066157,CC de Commercy - Void - Vaucouleurs,2006_2011,2008.5,5,23467,23534,1216,1538,67,322,-255,0.000570363615760128,0.0027411505115636,-0.00217078689580347,EPCI
200066157,CC de Commercy - Void - Vaucouleurs,2011_2016,2013.5,5,23534,22749,1257,1352,-785,95,-880,-0.00676203299545408,0.000818335203271513,-0.0075803681987256,EPCI
200066157,CC de Commercy - Void - Vaucouleurs,1968_1975,1971.5,7,25246,23294,2190,2678,-1952,488,-2440,-0.0114301608623313,0.00285754021558282,-0.0142877010779141,EPCI
200066157,CC de Commercy - Void - Vaucouleurs,1975_1982,1978.5,7,23294,22845,2051,2310,-449,259,-708,-0.00277664392579169,0.00160167210864153,-0.00437831603443322,EPCI
200066157,CC de Commercy - Void - Vaucouleurs,1982_1990,1986,8,22845,22544,2035,2635,-301,600,-901,-0.0016565414005183,0.00330207588143182,-0.00495861728195012,EPCI
200066157,CC de Commercy - Void - Vaucouleurs,1990_1999,1994.5,9,22544,22414,2266,2388,-130,122,-252,-0.000642370427994643,0.00060283994011805,-0.00124521036811269,EPCI
200066157,CC de Commercy - Void - Vaucouleurs,1999_2006,2002.5,7,22414,23467,1757,2059,1053,302,751,0.00658004187802819,0.00188715351107741,0.00469288836695078,EPCI
200066165,CC Val de Meuse - Voie Sacrée,2006_2011,2008.5,5,8516,8768,378,511,252,133,119,0.00584943817503669,0.00308720348126937,0.00276223469376733,EPCI
200066165,CC Val de Meuse - Voie Sacrée,2011_2016,2013.5,5,8768,9145,365,546,377,181,196,0.00845525577919948,0.00405941988338224,0.00439583589581724,EPCI
200066165,CC Val de Meuse - Voie Sacrée,1968_1975,1971.5,7,8007,7671,645,817,-336,172,-508,-0.00610545323833334,0.00312541058628968,-0.00923086382462302,EPCI
200066165,CC Val de Meuse - Voie Sacrée,1975_1982,1978.5,7,7671,8225,623,781,554,158,396,0.0100113980156167,0.00285523625716144,0.00715616175845524,EPCI
200066165,CC Val de Meuse - Voie Sacrée,1982_1990,1986,8,8225,8445,636,893,220,257,-37,0.00330498114765643,0.00386081888612592,-0.00055583773846949,EPCI
200066165,CC Val de Meuse - Voie Sacrée,1990_1999,1994.5,9,8445,8387,729,904,-58,175,-233,-0.000765447146584886,0.00230953880435095,-0.00307498595093583,EPCI
200066165,CC Val de Meuse - Voie Sacrée,1999_2006,2002.5,7,8387,8516,556,729,129,173,-44,0.002182930420773,0.0029274958356103,-0.000744565414837302,EPCI
200066173,CC de Damvillers Spincourt,2006_2011,2008.5,5,7890,8384,366,549,494,183,311,0.0122198582898423,0.00452678960939502,0.00769306868044727,EPCI
200066173,CC de Damvillers Spincourt,2011_2016,2013.5,5,8384,8347,354,449,-37,95,-132,-0.000884195810326838,0.00227023248597431,-0.00315442829630115,EPCI
200066173,CC de Damvillers Spincourt,1968_1975,1971.5,7,9396,8514,833,874,-882,41,-923,-0.0139830587875925,0.000650006134117114,-0.0146330649217097,EPCI
200066173,CC de Damvillers Spincourt,1975_1982,1978.5,7,8514,7897,816,666,-617,-150,-467,-0.0106894469844827,-0.00259873103350471,-0.008090715950978,EPCI
200066173,CC de Damvillers Spincourt,1982_1990,1986,8,7897,7190,733,690,-707,-43,-664,-0.011655513142863,-0.000708892595676247,-0.0109466205471867,EPCI
200066173,CC de Damvillers Spincourt,1990_1999,1994.5,9,7190,7138,682,669,-52,-13,-39,-0.000806180047106198,-0.000201545011776549,-0.000604635035329648,EPCI
200066173,CC de Damvillers Spincourt,1999_2006,2002.5,7,7138,7890,490,649,752,159,593,0.0144119376575522,0.00304720490365798,0.0113647327538942,EPCI
200066223,CC Arize Lèze,2006_2011,2008.5,5,10191,10804,747,586,613,-161,774,0.0117507960886423,-0.00308626128918663,0.0148370573778289,EPCI
200066223,CC Arize Lèze,2011_2016,2013.5,5,10804,10732,749,466,-72,-283,211,-0.00133640688531822,-0.00525282150757023,0.00391641462225201,EPCI
200066223,CC Arize Lèze,1968_1975,1971.5,7,9863,9265,1002,681,-598,-321,-277,-0.00889541703656171,-0.00477496466343865,-0.00412045237312307,EPCI
200066223,CC Arize Lèze,1975_1982,1978.5,7,9265,8611,1024,525,-654,-499,-155,-0.0104031382564298,-0.00793756267577748,-0.00246557558065232,EPCI
200066223,CC Arize Lèze,1982_1990,1986,8,8611,8923,1067,575,312,-492,804,0.00445888100896719,-0.00703131236029441,0.0114901933692616,EPCI
200066223,CC Arize Lèze,1990_1999,1994.5,9,8923,9325,1317,699,402,-618,1020,0.0049083123390532,-0.00754561449138029,0.0124539268304335,EPCI
200066223,CC Arize Lèze,1999_2006,2002.5,7,9325,10191,1028,582,866,-446,1312,0.0127673891553348,-0.00657535284443341,0.0193427419997682,EPCI
200066231,CC des Portes d'Ariège Pyrénées,2006_2011,2008.5,5,34749,37797,1902,2260,3048,358,2690,0.0169579691629054,0.00199178246729663,0.0149661866956087,EPCI
200066231,CC des Portes d'Ariège Pyrénées,2011_2016,2013.5,5,37797,39464,1933,2315,1667,382,1285,0.00866918753853985,0.00198658046773978,0.00668260707080006,EPCI
200066231,CC des Portes d'Ariège Pyrénées,1968_1975,1971.5,7,28715,29335,2681,2640,620,-41,661,0.00305633367316238,-0.000202112388063964,0.00325844606122635,EPCI
200066231,CC des Portes d'Ariège Pyrénées,1975_1982,1978.5,7,29335,28949,2540,2065,-386,-475,89,-0.00189045102362462,-0.00232633221819092,0.000435881194566298,EPCI
200066231,CC des Portes d'Ariège Pyrénées,1982_1990,1986,8,28949,29602,3004,2496,653,-508,1161,0.00279217406538379,-0.00217216604167682,0.00496434010706061,EPCI
200066231,CC des Portes d'Ariège Pyrénées,1990_1999,1994.5,9,29602,30740,3386,2968,1138,-418,1556,0.00420021980035101,-0.00154278723773877,0.00574300703808979,EPCI
200066231,CC des Portes d'Ariège Pyrénées,1999_2006,2002.5,7,30740,34749,2631,2595,4009,-36,4045,0.0176665330492884,-0.00015864185327373,0.0178251749025622,EPCI
200066280,CC du Pithiverais,2006_2011,2008.5,5,27222,28455,1137,1854,1233,717,516,0.00889904759566607,0.00517487195952358,0.00372417563614249,EPCI
200066280,CC du Pithiverais,2011_2016,2013.5,5,28455,29351,1205,1805,896,600,296,0.00621980821062906,0.00416505014104625,0.00205475806958282,EPCI
200066280,CC du Pithiverais,1968_1975,1971.5,7,21508,23266,1775,2557,1758,782,976,0.0112872410812486,0.00502083192578861,0.00626640915545996,EPCI
200066280,CC du Pithiverais,1975_1982,1978.5,7,23266,24006,1820,2257,740,437,303,0.00448298029778904,0.00264738160828893,0.00183559868950011,EPCI
200066280,CC du Pithiverais,1982_1990,1986,8,24006,25443,1966,2543,1437,577,860,0.00729357662105357,0.00292859687567704,0.00436497974537653,EPCI
200066280,CC du Pithiverais,1990_1999,1994.5,9,25443,26636,2131,3014,1193,883,310,0.00510443102256541,0.00377804911393568,0.00132638190862974,EPCI
200066280,CC du Pithiverais,1999_2006,2002.5,7,26636,27222,1560,2461,586,901,-315,0.00311366393584089,0.00478739113684752,-0.00167372720100662,EPCI
200066322,CC Terres des Confluences,2006_2011,2008.5,5,37252,39011,1919,2435,1759,516,1243,0.00927031019567925,0.00271943152982973,0.00655087866584952,EPCI
200066322,CC Terres des Confluences,2011_2016,2013.5,5,39011,40829,2032,2395,1818,363,1455,0.00915141155432075,0.00182726204302444,0.00732414951129631,EPCI
200066322,CC Terres des Confluences,1968_1975,1971.5,7,33053,31977,2807,3344,-1076,537,-1613,-0.00471676088867579,0.00235399683756403,-0.00707075772623982,EPCI
200066322,CC Terres des Confluences,1975_1982,1978.5,7,31977,31743,2709,2613,-234,-96,-138,-0.00104868771159128,-0.000430230856037448,-0.000618456855553831,EPCI
200066322,CC Terres des Confluences,1982_1990,1986,8,31743,33615,2933,3017,1872,84,1788,0.00718823312070538,0.000322548922082934,0.00686568419862245,EPCI
200066322,CC Terres des Confluences,1990_1999,1994.5,9,33615,34285,3302,3501,670,199,471,0.00219524434110285,0.00065202033414846,0.00154322400695439,EPCI
200066322,CC Terres des Confluences,1999_2006,2002.5,7,34285,37252,2575,2841,2967,266,2701,0.0119273840683354,0.00106932395085177,0.0108580601174836,EPCI
200066330,CC Terres du Haut Berry,2006_2011,2008.5,5,24422,25302,1095,1370,880,275,605,0.00710493686098301,0.00222029276905719,0.00488464409192582,EPCI
200066330,CC Terres du Haut Berry,2011_2016,2013.5,5,25302,25980,1107,1364,678,257,421,0.00530272338225668,0.00201002936466072,0.00329269401759596,EPCI
200066330,CC Terres du Haut Berry,1968_1975,1971.5,7,17713,18610,1786,1691,897,-95,992,0.00708213732354257,-0.000750059136830038,0.00783219646037261,EPCI
200066330,CC Terres du Haut Berry,1975_1982,1978.5,7,18610,20928,1749,1489,2318,-260,2578,0.0169112466734387,-0.00189686114542453,0.0188081078188632,EPCI
200066330,CC Terres du Haut Berry,1982_1990,1986,8,20928,23368,2009,2102,2440,93,2347,0.0138803992211227,0.000529048003100169,0.0133513512180226,EPCI
200066330,CC Terres du Haut Berry,1990_1999,1994.5,9,23368,23869,1977,2161,501,184,317,0.00235977776950147,0.000866664889397745,0.00149311288010372,EPCI
200066330,CC Terres du Haut Berry,1999_2006,2002.5,7,23869,24422,1497,1892,553,395,158,0.00327733296888932,0.00234095212063523,0.000936380848254093,EPCI
200066348,CC du Minervois au Caroux,2006_2011,2008.5,5,14130,14639,927,561,509,-366,875,0.00710290752869192,-0.00510739519744841,0.0122103027261403,EPCI
200066348,CC du Minervois au Caroux,2011_2016,2013.5,5,14639,14729,950,551,90,-399,489,0.00122657949769511,-0.005437835773115,0.00666441527081011,EPCI
200066348,CC du Minervois au Caroux,1968_1975,1971.5,7,15948,14248,1804,943,-1700,-861,-839,-0.0159734611652971,-0.00809008827254164,-0.00788337289275544,EPCI
200066348,CC du Minervois au Caroux,1975_1982,1978.5,7,14248,13803,1663,796,-445,-867,422,-0.00452268260738475,-0.00881160858562378,0.00428892597823903,EPCI
200066348,CC du Minervois au Caroux,1982_1990,1986,8,13803,13477,1725,1025,-326,-700,374,-0.00298322021071651,-0.00640568756902318,0.00342246735830667,EPCI
200066348,CC du Minervois au Caroux,1990_1999,1994.5,9,13477,13582,1695,1025,105,-670,775,0.000862689447618914,-0.0055047802848064,0.00636746973242532,EPCI
200066348,CC du Minervois au Caroux,1999_2006,2002.5,7,13582,14130,1409,770,548,-639,1187,0.00566668238999735,-0.00660768256789836,0.0122743649578957,EPCI
200066355,CA Sète Agglopôle Méditerranée,2006_2011,2008.5,5,115598,121638,5999,6799,6040,800,5240,0.0102382085886819,0.00135605411770621,0.00888215447097565,EPCI
200066355,CA Sète Agglopôle Méditerranée,2011_2016,2013.5,5,121638,124469,6611,6716,2831,105,2726,0.00461205658496389,0.000171058262600215,0.00444099832236367,EPCI
200066355,CA Sète Agglopôle Méditerranée,1968_1975,1971.5,7,71995,74209,6086,7342,2214,1256,958,0.00433634118672077,0.00246000204630591,0.00187633914041486,EPCI
200066355,CA Sète Agglopôle Méditerranée,1975_1982,1978.5,7,74209,81149,6361,6366,6940,5,6935,0.0128535535851988,9.26048529192997e-06,0.0128442930999069,EPCI
200066355,CA Sète Agglopôle Méditerranée,1982_1990,1986,8,81149,91381,7616,8022,10232,406,9826,0.0149545427728546,0.000593387838719601,0.014361154934135,EPCI
200066355,CA Sète Agglopôle Méditerranée,1990_1999,1994.5,9,91381,100231,9136,10128,8850,992,7858,0.0103240335926578,0.00115722500835215,0.00916680858430562,EPCI
200066355,CA Sète Agglopôle Méditerranée,1999_2006,2002.5,7,100231,115598,7877,8979,15367,1102,14265,0.0205863394299155,0.00147628984523764,0.0191100495846779,EPCI
200066363,CC de la Haute Ariège,2006_2011,2008.5,5,7623,7559,434,289,-64,-145,81,-0.0016847964735035,-0.00381711701028137,0.00213232053677787,EPCI
200066363,CC de la Haute Ariège,2011_2016,2013.5,5,7559,7170,492,228,-389,-264,-125,-0.0105110194066251,-0.00713344247647567,-0.00337757693014946,EPCI
200066363,CC de la Haute Ariège,1968_1975,1971.5,7,9160,8290,1039,602,-870,-437,-433,-0.0141554572490874,-0.00711026990557608,-0.00704518734351132,EPCI
200066363,CC de la Haute Ariège,1975_1982,1978.5,7,8290,8129,948,476,-161,-472,311,-0.00279780089430071,-0.00820224858453375,0.00540444769023304,EPCI
200066363,CC de la Haute Ariège,1982_1990,1986,8,8129,7481,1064,671,-648,-393,-255,-0.0103302033569074,-0.00626507703590216,-0.00406512632100522,EPCI
200066363,CC de la Haute Ariège,1990_1999,1994.5,9,7481,7536,876,634,55,-242,297,0.000814227345903973,-0.00358260032197748,0.00439682766788145,EPCI
200066363,CC de la Haute Ariège,1999_2006,2002.5,7,7536,7623,685,461,87,-224,311,0.00164112456368293,-0.00422542416396524,0.00586654872764817,EPCI
200066371,CC Causses et Vallée de la Dordogne,2006_2011,2008.5,5,45077,46284,2887,1917,1207,-970,2177,0.00529882747289778,-0.00425837833364611,0.00955720580654389,EPCI
200066371,CC Causses et Vallée de la Dordogne,2011_2016,2013.5,5,46284,45392,2997,1812,-892,-1185,293,-0.00388452582341126,-0.00516049674971114,0.00127597092629989,EPCI
200066371,CC Causses et Vallée de la Dordogne,1968_1975,1971.5,7,41097,40546,4226,3407,-551,-819,268,-0.00192642692333278,-0.00286341860292114,0.000936991679588358,EPCI
200066371,CC Causses et Vallée de la Dordogne,1975_1982,1978.5,7,40546,41353,4237,3040,807,-1197,2004,0.00281937243059405,-0.00418189442307444,0.00700126685366849,EPCI
200066371,CC Causses et Vallée de la Dordogne,1982_1990,1986,8,41353,41500,4741,3334,147,-1407,1554,0.000443655512021746,-0.00424641704363671,0.00469007255565845,EPCI
200066371,CC Causses et Vallée de la Dordogne,1990_1999,1994.5,9,41500,42737,5040,3485,1237,-1555,2792,0.00326884531963989,-0.00410917903964432,0.00737802435928422,EPCI
200066371,CC Causses et Vallée de la Dordogne,1999_2006,2002.5,7,42737,45077,3947,2773,2340,-1174,3514,0.007644367699845,-0.00383525114513591,0.0114796188449809,EPCI
200066389,CA Saint-Lô Agglo,2006_2011,2008.5,5,73264,75085,3372,4291,1821,919,902,0.00492236507287647,0.00248415897966693,0.00243820609320954,EPCI
200066389,CA Saint-Lô Agglo,2011_2016,2013.5,5,75085,75956,3634,4304,871,670,201,0.00230934646852776,0.00177642036040597,0.000532926108121791,EPCI
200066389,CA Saint-Lô Agglo,1968_1975,1971.5,7,64476,68491,4047,8486,4015,4439,-424,0.0086672432428585,0.00958253866875439,-0.000915295425895891,EPCI
200066389,CA Saint-Lô Agglo,1975_1982,1978.5,7,68491,71129,4067,8222,2638,4155,-1517,0.00541356928189085,0.00852667944134059,-0.00311311015944974,EPCI
200066389,CA Saint-Lô Agglo,1982_1990,1986,8,71129,71267,4788,7907,138,3119,-2981,0.000242311515120441,0.00547659141783085,-0.0052342799027104,EPCI
200066389,CA Saint-Lô Agglo,1990_1999,1994.5,9,71267,70937,5369,7403,-330,2034,-2364,-0.000515559052362113,0.00317771852274103,-0.00369327757510314,EPCI
200066389,CA Saint-Lô Agglo,1999_2006,2002.5,7,70937,73264,4369,5809,2327,1440,887,0.00462167525170498,0.00285999671785783,0.00176167853384715,EPCI
200066405,CC Roumois Seine,2006_2011,2008.5,5,35532,37469,1317,2137,1937,820,1117,0.0106725952476172,0.00451808368768514,0.00615451155993207,EPCI
200066405,CC Roumois Seine,2011_2016,2013.5,5,37469,40050,1395,2334,2581,939,1642,0.0134120957680506,0.00487948776683437,0.00853260800121621,EPCI
200066405,CC Roumois Seine,1968_1975,1971.5,7,18491,22128,1356,2170,3637,814,2823,0.0259832060502183,0.00581532299281763,0.0201678830574007,EPCI
200066405,CC Roumois Seine,1975_1982,1978.5,7,22128,27995,1382,2077,5867,695,5172,0.0341682181954075,0.00404753905672545,0.030120679138682,EPCI
200066405,CC Roumois Seine,1982_1990,1986,8,27995,30813,1674,2755,2818,1081,1737,0.0120609987630746,0.00462666418129301,0.00743433458178164,EPCI
200066405,CC Roumois Seine,1990_1999,1994.5,9,30813,32381,1987,3000,1568,1013,555,0.00553025261038331,0.00357279712647851,0.00195745548390481,EPCI
200066405,CC Roumois Seine,1999_2006,2002.5,7,32381,35532,1802,2768,3151,966,2185,0.0133543646513508,0.00409403879822432,0.00926032585312644,EPCI
200066413,CC Intercom Bernay Terres de Normandie,2006_2011,2008.5,5,52785,54973,2835,3183,2188,348,1840,0.00815610046614457,0.00129722256042884,0.00685887790571572,EPCI
200066413,CC Intercom Bernay Terres de Normandie,2011_2016,2013.5,5,54973,55712,3040,3059,739,19,720,0.00267425104291164,6.87561161235738e-05,0.00260549492678806,EPCI
200066413,CC Intercom Bernay Terres de Normandie,1968_1975,1971.5,7,47129,48489,3748,5935,1360,2187,-827,0.00407233311863853,0.00654867097828122,-0.00247633785964269,EPCI
200066413,CC Intercom Bernay Terres de Normandie,1975_1982,1978.5,7,48489,49938,3779,4904,1449,1125,324,0.0042153264421485,0.00327276897682337,0.000942557465325131,EPCI
200066413,CC Intercom Bernay Terres de Normandie,1982_1990,1986,8,49938,49972,4329,5382,34,1053,-1019,8.50801913103716e-05,0.00263498357205357,-0.0025499033807432,EPCI
200066413,CC Intercom Bernay Terres de Normandie,1990_1999,1994.5,9,49972,51249,4553,5368,1277,815,462,0.00280762925848843,0.00179186988697578,0.00101575937151265,EPCI
200066413,CC Intercom Bernay Terres de Normandie,1999_2006,2002.5,7,51249,52785,4018,4330,1536,312,1224,0.00422761896116763,0.000858735101487176,0.00336888385968046,EPCI
200066462,CC Interco Normandie Sud Eure,2006_2011,2008.5,5,36986,38076,2057,2350,1090,293,797,0.00582584455368584,0.00156602977452289,0.00425981477916295,EPCI
200066462,CC Interco Normandie Sud Eure,2011_2016,2013.5,5,38076,39134,2210,2227,1058,17,1041,0.00549654929361654,8.83188449824963e-05,0.00540823044863404,EPCI
200066462,CC Interco Normandie Sud Eure,1968_1975,1971.5,7,30402,31711,2636,3504,1309,868,441,0.00604034520038721,0.00400536259277013,0.00203498260761708,EPCI
200066462,CC Interco Normandie Sud Eure,1975_1982,1978.5,7,31711,32405,2738,3035,694,297,397,0.00309751714176421,0.00132559451167719,0.00177192263008702,EPCI
200066462,CC Interco Normandie Sud Eure,1982_1990,1986,8,32405,33858,3048,3453,1453,405,1048,0.00549788021854947,0.00153244424536307,0.0039654359731864,EPCI
200066462,CC Interco Normandie Sud Eure,1990_1999,1994.5,9,33858,35156,3477,3711,1298,234,1064,0.0041887475469331,0.000755136306611977,0.00343361124032113,EPCI
200066462,CC Interco Normandie Sud Eure,1999_2006,2002.5,7,35156,36986,2948,3059,1830,111,1719,0.00727550480446926,0.000441301111090758,0.0068342036933785,EPCI
200066512,CC Élan Limousin Avenir Nature,2006_2011,2008.5,5,26595,27486,1617,1458,891,-159,1050,0.00661247771735085,-0.00118000444114342,0.00779248215849427,EPCI
200066512,CC Élan Limousin Avenir Nature,2011_2016,2013.5,5,27486,27888,1644,1417,402,-227,629,0.00290816144985273,-0.00164217076894669,0.00455033221879942,EPCI
200066512,CC Élan Limousin Avenir Nature,1968_1975,1971.5,7,24408,22971,2341,1705,-1437,-636,-801,-0.00863088061578421,-0.00381993046043059,-0.00481095015535362,EPCI
200066512,CC Élan Limousin Avenir Nature,1975_1982,1978.5,7,22971,24161,2451,1462,1190,-989,2179,0.00724140913148075,-0.00601828036221383,0.0132596894936946,EPCI
200066512,CC Élan Limousin Avenir Nature,1982_1990,1986,8,24161,24889,2938,1828,728,-1110,1838,0.00371766542037966,-0.00566841842942503,0.00938608384980468,EPCI
200066512,CC Élan Limousin Avenir Nature,1990_1999,1994.5,9,24889,24905,3087,2039,16,-1048,1064,7.14078528278872e-05,-0.00467721436022661,0.0047486222130545,EPCI
200066512,CC Élan Limousin Avenir Nature,1999_2006,2002.5,7,24905,26595,2222,1838,1690,-384,2074,0.00942335738260325,-0.0021411652277631,0.0115645226103664,EPCI
200066520,CC Ouest Limousin,2006_2011,2008.5,5,11292,11404,807,457,112,-350,462,0.00197588161837414,-0.0061746300574192,0.00815051167579334,EPCI
200066520,CC Ouest Limousin,2011_2016,2013.5,5,11404,11530,756,459,126,-297,423,0.0022000492106482,-0.00518583028224219,0.0073858794928904,EPCI
200066520,CC Ouest Limousin,1968_1975,1971.5,7,13358,12254,1482,901,-1104,-581,-523,-0.0122476709061105,-0.00644555869243675,-0.0058021122136737,EPCI
200066520,CC Ouest Limousin,1975_1982,1978.5,7,12254,11904,1388,635,-350,-753,403,-0.00413114840535689,-0.00888787071209639,0.0047567223067395,EPCI
200066520,CC Ouest Limousin,1982_1990,1986,8,11904,11444,1606,743,-460,-863,403,-0.00491399946770343,-0.00921909030571318,0.00430509083800975,EPCI
200066520,CC Ouest Limousin,1990_1999,1994.5,9,11444,10951,1674,820,-493,-854,361,-0.00488080540230074,-0.0084547825832958,0.00357397718099506,EPCI
200066520,CC Ouest Limousin,1999_2006,2002.5,7,10951,11292,1173,632,341,-541,882,0.00439014200422316,-0.0069650053498086,0.0113551473540318,EPCI
200066553,CC des Monts de Lacaune et de la Montagne du Haut Languedoc,2006_2011,2008.5,5,8609,8175,607,296,-434,-311,-123,-0.0102921596635336,-0.00737525727041231,-0.00291690239312127,EPCI
200066553,CC des Monts de Lacaune et de la Montagne du Haut Languedoc,2011_2016,2013.5,5,8175,7997,602,257,-178,-345,167,-0.00439317075595924,-0.00851485343149404,0.00412168267553479,EPCI
200066553,CC des Monts de Lacaune et de la Montagne du Haut Languedoc,1968_1975,1971.5,7,11125,9832,990,822,-1293,-168,-1125,-0.0174954958050995,-0.00227319667073218,-0.0152222991343673,EPCI
200066553,CC des Monts de Lacaune et de la Montagne du Haut Languedoc,1975_1982,1978.5,7,9832,9341,893,666,-491,-227,-264,-0.00729172250214993,-0.00337112221586158,-0.00392060028628836,EPCI
200066553,CC des Monts de Lacaune et de la Montagne du Haut Languedoc,1982_1990,1986,8,9341,8749,1059,719,-592,-340,-252,-0.00815083839835362,-0.0046812247558112,-0.00346961364254242,EPCI
200066553,CC des Monts de Lacaune et de la Montagne du Haut Languedoc,1990_1999,1994.5,9,8749,8467,1045,680,-282,-365,83,-0.00363373234252506,-0.00470323512419024,0.00106950278166518,EPCI
200066553,CC des Monts de Lacaune et de la Montagne du Haut Languedoc,1999_2006,2002.5,7,8467,8609,841,480,142,-361,503,0.00237881246900562,-0.00604754437542978,0.0084263568444354,EPCI
200066561,CC Sidobre Vals et Plateaux,2006_2011,2008.5,5,12705,12727,702,509,22,-193,215,0.000346080719675568,-0.00303607176806294,0.0033821524877385,EPCI
200066561,CC Sidobre Vals et Plateaux,2011_2016,2013.5,5,12727,12777,729,512,50,-217,267,0.000784499278571715,-0.00340472686900124,0.00418922614757296,EPCI
200066561,CC Sidobre Vals et Plateaux,1968_1975,1971.5,7,12899,12892,1213,1242,-7,29,-36,-7.75434261827135e-05,0.00032125133704267,-0.000398794763225384,EPCI
200066561,CC Sidobre Vals et Plateaux,1975_1982,1978.5,7,12892,13028,1119,1089,136,-30,166,0.00150025618296645,-0.000330938863889659,0.00183119504685611,EPCI
200066561,CC Sidobre Vals et Plateaux,1982_1990,1986,8,13028,12818,1193,1163,-210,-30,-180,-0.00202924508407643,-0.000289892154868061,-0.00173935292920836,EPCI
200066561,CC Sidobre Vals et Plateaux,1990_1999,1994.5,9,12818,12469,1297,1125,-349,-172,-177,-0.00306250859829293,-0.00150931655847102,-0.00155319203982192,EPCI
200066561,CC Sidobre Vals et Plateaux,1999_2006,2002.5,7,12469,12705,993,771,236,-222,458,0.00268216956320377,-0.0025230578094544,0.00520522737265817,EPCI
200066587,CC des Monts du Lyonnais,2006_2011,2008.5,5,31757,33653,1227,2269,1896,1042,854,0.0116653216500453,0.00641100483087933,0.00525431681916598,EPCI
200066587,CC des Monts du Lyonnais,2011_2016,2013.5,5,33653,35093,1236,2061,1440,825,615,0.00841510464680928,0.00482115370390115,0.00359395094290813,EPCI
200066587,CC des Monts du Lyonnais,1968_1975,1971.5,7,24557,23826,2010,2567,-731,557,-1288,-0.00430776977055003,0.00328239091955727,-0.0075901606901073,EPCI
200066587,CC des Monts du Lyonnais,1975_1982,1978.5,7,23826,24869,1917,2365,1043,448,595,0.00613943045419396,0.00263707079911687,0.00350235965507709,EPCI
200066587,CC des Monts du Lyonnais,1982_1990,1986,8,24869,26520,1947,2742,1651,795,856,0.00806700401263338,0.0038844749788271,0.00418252903380628,EPCI
200066587,CC des Monts du Lyonnais,1990_1999,1994.5,9,26520,28491,2265,3068,1971,803,1168,0.00799726224980901,0.00325814387955182,0.00473911837025719,EPCI
200066587,CC des Monts du Lyonnais,1999_2006,2002.5,7,28491,31757,1741,2747,3266,1006,2260,0.0156243644798899,0.00481264870384851,0.0108117157760414,EPCI
200066603,CC du Pays de Lubersac-Pompadour,2006_2011,2008.5,5,7913,7809,549,292,-104,-257,153,-0.00264251478410382,-0.00653006057225656,0.00388754578815274,EPCI
200066603,CC du Pays de Lubersac-Pompadour,2011_2016,2013.5,5,7809,7619,640,248,-190,-392,202,-0.00491424284090591,-0.010138858913869,0.00522461607296313,EPCI
200066603,CC du Pays de Lubersac-Pompadour,1968_1975,1971.5,7,9388,8962,950,623,-426,-327,-99,-0.00661216587712687,-0.00507553577892133,-0.00153663009820554,EPCI
200066603,CC du Pays de Lubersac-Pompadour,1975_1982,1978.5,7,8962,8650,967,510,-312,-457,145,-0.00504922323127688,-0.00739581736119722,0.00234659412992034,EPCI
200066603,CC du Pays de Lubersac-Pompadour,1982_1990,1986,8,8650,8194,1063,524,-456,-539,83,-0.00674678031527176,-0.00797481269721816,0.0012280323819464,EPCI
200066603,CC du Pays de Lubersac-Pompadour,1990_1999,1994.5,9,8194,7830,1158,532,-364,-626,262,-0.00503612809369824,-0.00866103347982171,0.00362490538612346,EPCI
200066603,CC du Pays de Lubersac-Pompadour,1999_2006,2002.5,7,7830,7913,806,429,83,-377,460,0.00150748749353635,-0.00684726247064102,0.00835474996417737,EPCI
200066637,CC Hautes Terres Communauté,2006_2011,2008.5,5,12546,12155,1053,446,-391,-607,216,-0.00631224989685753,-0.00979932400867652,0.00348707411181899,EPCI
200066637,CC Hautes Terres Communauté,2011_2016,2013.5,5,12155,11617,1110,406,-538,-704,166,-0.00901334708976176,-0.0117944170096511,0.00278106991988932,EPCI
200066637,CC Hautes Terres Communauté,1968_1975,1971.5,7,18760,17374,1918,1677,-1386,-241,-1145,-0.0109046948348034,-0.00189612659104446,-0.00900856824375893,EPCI
200066637,CC Hautes Terres Communauté,1975_1982,1978.5,7,17374,15855,1862,1230,-1519,-632,-887,-0.012984948277195,-0.00540255912520555,-0.00758238915198943,EPCI
200066637,CC Hautes Terres Communauté,1982_1990,1986,8,15855,14952,1850,1247,-903,-603,-300,-0.00730318094636862,-0.00487687498411991,-0.00242630596224871,EPCI
200066637,CC Hautes Terres Communauté,1990_1999,1994.5,9,14952,13329,1959,1021,-1623,-938,-685,-0.012685842921392,-0.00733168247705833,-0.00535416044433364,EPCI
200066637,CC Hautes Terres Communauté,1999_2006,2002.5,7,13329,12546,1451,722,-783,-729,-54,-0.008611311693004,-0.00801742812796924,-0.000593883565034759,EPCI
200066645,CC Vézère-Monédières-Millesources,2006_2011,2008.5,5,5111,5041,576,150,-70,-426,356,-0.00275432081611182,-0.0167620095380519,0.0140076887219401,EPCI
200066645,CC Vézère-Monédières-Millesources,2011_2016,2013.5,5,5041,5042,588,111,1,-477,478,3.9671519940887e-05,-0.0189233150118031,0.018962986531744,EPCI
200066645,CC Vézère-Monédières-Millesources,1968_1975,1971.5,7,7272,6586,1058,286,-686,-772,86,-0.0140553133674067,-0.0158173497370816,0.0017620363696749,EPCI
200066645,CC Vézère-Monédières-Millesources,1975_1982,1978.5,7,6586,6081,1057,238,-505,-819,314,-0.011332021675404,-0.0183780707963483,0.00704604912094429,EPCI
200066645,CC Vézère-Monédières-Millesources,1982_1990,1986,8,6081,5549,1084,275,-532,-809,277,-0.0113786954305559,-0.0173033169235333,0.00592462149297742,EPCI
200066645,CC Vézère-Monédières-Millesources,1990_1999,1994.5,9,5549,5129,1155,275,-420,-880,460,-0.00870709652025148,-0.018243440328146,0.00953634380789448,EPCI
200066645,CC Vézère-Monédières-Millesources,1999_2006,2002.5,7,5129,5111,797,226,-18,-571,553,-0.000502106562429772,-0.0159279359526333,0.0154258293902035,EPCI
200066652,CC Grand Sud Tarn et Garonne,2006_2011,2008.5,5,32420,38047,1487,2636,5627,1149,4478,0.0325271534549996,0.00664185166514919,0.0258853017898504,EPCI
200066652,CC Grand Sud Tarn et Garonne,2011_2016,2013.5,5,38047,41252,1427,2741,3205,1314,1891,0.0163070029558141,0.0066856168124617,0.00962138614335241,EPCI
200066652,CC Grand Sud Tarn et Garonne,1968_1975,1971.5,7,18820,19654,1911,1655,834,-256,1090,0.0062136171774887,-0.0019072973590373,0.00812091453652599,EPCI
200066652,CC Grand Sud Tarn et Garonne,1975_1982,1978.5,7,19654,21404,1860,1627,1750,-233,1983,0.0122598201737931,-0.00163230748599646,0.0138921276597896,EPCI
200066652,CC Grand Sud Tarn et Garonne,1982_1990,1986,8,21404,23706,2069,2039,2302,-30,2332,0.0128506641749371,-0.00016747173121117,0.0130181359061482,EPCI
200066652,CC Grand Sud Tarn et Garonne,1990_1999,1994.5,9,23706,26140,2354,2540,2434,186,2248,0.010919018458267,0.000834403218257054,0.01008461524001,EPCI
200066652,CC Grand Sud Tarn et Garonne,1999_2006,2002.5,7,26140,32420,2135,2669,6280,534,5746,0.0312363282855279,0.00265608269179489,0.028580245593733,EPCI
200066660,CC Saint-Flour Communauté,2006_2011,2008.5,5,24000,23846,1474,1153,-154,-321,167,-0.00128663996093459,-0.00268189238610391,0.00139525242516933,EPCI
200066660,CC Saint-Flour Communauté,2011_2016,2013.5,5,23846,23688,1461,1077,-158,-384,226,-0.00132869601768826,-0.00322923589109045,0.00190053987340219,EPCI
200066660,CC Saint-Flour Communauté,1968_1975,1971.5,7,27743,27265,2558,2775,-478,217,-695,-0.00247973860477624,0.00112573907371641,-0.00360547767849265,EPCI
200066660,CC Saint-Flour Communauté,1975_1982,1978.5,7,27265,26699,2578,2382,-566,-196,-370,-0.00299233072100202,-0.00103621346522332,-0.00195611725577871,EPCI
200066660,CC Saint-Flour Communauté,1982_1990,1986,8,26699,25577,2673,2318,-1122,-355,-767,-0.00535220083219801,-0.00169343252712147,-0.00365876830507653,EPCI
200066660,CC Saint-Flour Communauté,1990_1999,1994.5,9,25577,23762,2887,2017,-1815,-870,-945,-0.00814507477369664,-0.00390425071797029,-0.00424082405572635,EPCI
200066660,CC Saint-Flour Communauté,1999_2006,2002.5,7,23762,24000,2158,1617,238,-541,779,0.00142475175460288,-0.00323861638336201,0.0046633681379649,EPCI
200066678,CC de la Châtaigneraie Cantalienne,2006_2011,2008.5,5,20887,21166,1349,1018,279,-331,610,0.00265735749150942,-0.00315263559028536,0.00580999308179478,EPCI
200066678,CC de la Châtaigneraie Cantalienne,2011_2016,2013.5,5,21166,21402,1390,846,236,-544,780,0.00222011179333848,-0.00511754582871242,0.00733765762205089,EPCI
200066678,CC de la Châtaigneraie Cantalienne,1968_1975,1971.5,7,25284,23860,2258,2009,-1424,-249,-1175,-0.00824700077719087,-0.00144206684938239,-0.00680493392780848,EPCI
200066678,CC de la Châtaigneraie Cantalienne,1975_1982,1978.5,7,23860,22598,2256,1592,-1262,-664,-598,-0.00773308888952651,-0.00406875675328495,-0.00366433213624156,EPCI
200066678,CC de la Châtaigneraie Cantalienne,1982_1990,1986,8,22598,21585,2550,1551,-1013,-999,-14,-0.00571644581104336,-0.0056374426112856,-7.90031997577566e-05,EPCI
200066678,CC de la Châtaigneraie Cantalienne,1990_1999,1994.5,9,21585,20524,2645,1404,-1061,-1241,180,-0.00558475759369281,-0.00653221882542204,0.000947461231729224,EPCI
200066678,CC de la Châtaigneraie Cantalienne,1999_2006,2002.5,7,20524,20887,2001,1268,363,-733,1096,0.00250771375208525,-0.0050637856206019,0.00757149937268715,EPCI
200066710,CC Cingal-Suisse Normande,2006_2011,2008.5,5,21138,22818,975,1578,1680,603,1077,0.0154130402427295,0.00553218051569398,0.00988085972703551,EPCI
200066710,CC Cingal-Suisse Normande,2011_2016,2013.5,5,22818,24064,1042,1629,1246,587,659,0.0106901859688944,0.0050362272582191,0.00565395871067527,EPCI
200066710,CC Cingal-Suisse Normande,1968_1975,1971.5,7,16795,16859,1383,1926,64,543,-479,0.000543492748608099,0.00461119628897184,-0.00406770354036374,EPCI
200066710,CC Cingal-Suisse Normande,1975_1982,1978.5,7,16859,18180,1362,1715,1321,353,968,0.0108350572012998,0.00289536350647907,0.00793969369482078,EPCI
200066710,CC Cingal-Suisse Normande,1982_1990,1986,8,18180,18958,1715,1957,778,242,536,0.00525173191147621,0.00163357213698874,0.00361815977448747,EPCI
200066710,CC Cingal-Suisse Normande,1990_1999,1994.5,9,18958,19881,1804,2082,923,278,645,0.00529602972965981,0.00159512054696146,0.00370090918269835,EPCI
200066710,CC Cingal-Suisse Normande,1999_2006,2002.5,7,19881,21138,1428,1959,1257,531,726,0.00879673252125124,0.00371604213904885,0.00508069038220239,EPCI
200066728,CC Vallées de l'Orne et de l'Odon,2006_2011,2008.5,5,20961,23043,582,1492,2082,910,1172,0.0191201871816367,0.00835704627055205,0.0107631409110846,EPCI
200066728,CC Vallées de l'Orne et de l'Odon,2011_2016,2013.5,5,23043,25007,693,1544,1964,851,1113,0.0164932869666214,0.00714653116527233,0.00934675580134912,EPCI
200066728,CC Vallées de l'Orne et de l'Odon,1968_1975,1971.5,7,9110,11263,542,1157,2153,615,1538,0.0307711243421087,0.00878970806799668,0.021981416274112,EPCI
200066728,CC Vallées de l'Orne et de l'Odon,1975_1982,1978.5,7,11263,14235,534,1303,2972,769,2203,0.03402027709551,0.00880268946381131,0.0252175876316987,EPCI
200066728,CC Vallées de l'Orne et de l'Odon,1982_1990,1986,8,14235,17079,663,1570,2844,907,1937,0.023029414505449,0.00734447220690657,0.0156849422985425,EPCI
200066728,CC Vallées de l'Orne et de l'Odon,1990_1999,1994.5,9,17079,18071,893,1600,992,707,285,0.00629291826298029,0.00448497299589421,0.00180794526708607,EPCI
200066728,CC Vallées de l'Orne et de l'Odon,1999_2006,2002.5,7,18071,20961,801,1828,2890,1027,1863,0.0214197683964534,0.00761180004953553,0.0138079683469179,EPCI
200066744,CC Haute-Corrèze Communauté,2006_2011,2008.5,5,35120,34310,2555,1490,-810,-1065,255,-0.00465590987021036,-0.00612165927379511,0.00146574940358474,EPCI
200066744,CC Haute-Corrèze Communauté,2011_2016,2013.5,5,34310,33652,2685,1387,-658,-1298,640,-0.00386538353429866,-0.00762502709349493,0.00375964355919627,EPCI
200066744,CC Haute-Corrèze Communauté,1968_1975,1971.5,7,40547,40228,4310,3258,-319,-1052,733,-0.00112772428406616,-0.00371901550732789,0.00259129122326173,EPCI
200066744,CC Haute-Corrèze Communauté,1975_1982,1978.5,7,40228,39306,4418,2934,-922,-1484,562,-0.00330681919066667,-0.0053224725368214,0.00201565334615474,EPCI
200066744,CC Haute-Corrèze Communauté,1982_1990,1986,8,39306,38049,4697,3125,-1257,-1572,315,-0.00405455503383134,-0.00507061297787022,0.00101605794403888,EPCI
200066744,CC Haute-Corrèze Communauté,1990_1999,1994.5,9,38049,35655,5034,3030,-2394,-2004,-390,-0.00719459556238544,-0.00602254365372616,-0.00117205190865928,EPCI
200066744,CC Haute-Corrèze Communauté,1999_2006,2002.5,7,35655,35120,3712,2372,-535,-1340,805,-0.00215747226288932,-0.00540376230331156,0.00324629004042224,EPCI
200066751,CC Xaintrie Val'Dordogne,2006_2011,2008.5,5,12012,11966,1007,443,-46,-564,518,-0.000767076676797096,-0.00940502708072961,0.00863795040393252,EPCI
200066751,CC Xaintrie Val'Dordogne,2011_2016,2013.5,5,11966,11611,973,348,-355,-625,270,-0.00600517051514915,-0.0105724833013189,0.00456731278616978,EPCI
200066751,CC Xaintrie Val'Dordogne,1968_1975,1971.5,7,15972,14822,1683,1238,-1150,-445,-705,-0.0106181714859811,-0.00410877070544486,-0.00650940078053624,EPCI
200066751,CC Xaintrie Val'Dordogne,1975_1982,1978.5,7,14822,13920,1662,892,-902,-770,-132,-0.0089293103065311,-0.00762258196898996,-0.00130672833754114,EPCI
200066751,CC Xaintrie Val'Dordogne,1982_1990,1986,8,13920,13069,1786,972,-851,-814,-37,-0.00785444651915412,-0.00751294884440829,-0.000341497674745832,EPCI
200066751,CC Xaintrie Val'Dordogne,1990_1999,1994.5,9,13069,12007,1752,789,-1062,-963,-99,-0.00937282098780212,-0.00849908343809175,-0.000873737549710369,EPCI
200066751,CC Xaintrie Val'Dordogne,1999_2006,2002.5,7,12007,12012,1287,655,5,-632,637,5.94784934186965e-05,-0.00751808156812324,0.00757756006154193,EPCI
200066769,CC Midi Corrézien,2006_2011,2008.5,5,12463,12970,946,523,507,-423,930,0.00800683330318841,-0.00668025737129921,0.0146870906744876,EPCI
200066769,CC Midi Corrézien,2011_2016,2013.5,5,12970,13130,947,504,160,-443,603,0.00245514694659965,-0.00679768810839778,0.00925283505499744,EPCI
200066769,CC Midi Corrézien,1968_1975,1971.5,7,13828,12621,1562,843,-1207,-719,-488,-0.0129628813259096,-0.00772188208229413,-0.00524099924361549,EPCI
200066769,CC Midi Corrézien,1975_1982,1978.5,7,12621,12331,1575,655,-290,-920,630,-0.00331530311849493,-0.0105175133414322,0.00720221022293726,EPCI
200066769,CC Midi Corrézien,1982_1990,1986,8,12331,12002,1717,741,-329,-976,647,-0.00337468220678983,-0.0100112153003856,0.0066365330935958,EPCI
200066769,CC Midi Corrézien,1990_1999,1994.5,9,12002,11888,1711,847,-114,-864,750,-0.00105986179287065,-0.00803263674596706,0.0069727749530964,EPCI
200066769,CC Midi Corrézien,1999_2006,2002.5,7,11888,12463,1244,700,575,-544,1119,0.00677064169643793,-0.00640561579628215,0.0131762574927201,EPCI
200066777,CC Ploërmel Communauté,2006_2011,2008.5,5,39855,41649,2430,2383,1794,-47,1841,0.00884478414763423,-0.000231719540099671,0.0090765036877339,EPCI
200066777,CC Ploërmel Communauté,2011_2016,2013.5,5,41649,42168,2587,2147,519,-440,959,0.00247992610873937,-0.00210244217311238,0.00458236828185175,EPCI
200066777,CC Ploërmel Communauté,1968_1975,1971.5,7,37729,36962,3660,4484,-767,824,-1591,-0.00292979569775786,0.00314752497386243,-0.00607732067162029,EPCI
200066777,CC Ploërmel Communauté,1975_1982,1978.5,7,36962,37156,3588,3659,194,71,123,0.000748123656681754,0.000273797833115487,0.000474325823566267,EPCI
200066777,CC Ploërmel Communauté,1982_1990,1986,8,37156,37213,3869,3673,57,-196,253,0.000191630492736072,-0.000658939939934565,0.000850570432670637,EPCI
200066777,CC Ploërmel Communauté,1990_1999,1994.5,9,37213,37384,4216,3612,171,-604,775,0.000509534524323563,-0.00179975937246451,0.00230929389678808,EPCI
200066777,CC Ploërmel Communauté,1999_2006,2002.5,7,37384,39855,3259,3138,2471,-121,2592,0.00918551058542927,-0.000449796349994715,0.00963530693542399,EPCI
200066785,CC de l'Oust à Brocéliande,2006_2011,2008.5,5,37189,38418,1859,2446,1229,587,642,0.00652380413719889,0.00311592597928051,0.00340787815791838,EPCI
200066785,CC de l'Oust à Brocéliande,2011_2016,2013.5,5,38418,39077,2028,2221,659,193,466,0.00340738374958627,0.00099791360192739,0.00240947014765888,EPCI
200066785,CC de l'Oust à Brocéliande,1968_1975,1971.5,7,31932,32001,2924,3677,69,753,-684,0.000308406194257982,0.00336565020690232,-0.00305724401264434,EPCI
200066785,CC de l'Oust à Brocéliande,1975_1982,1978.5,7,32001,32817,2846,3360,816,514,302,0.00360355173570204,0.00226988430410643,0.00133366743159561,EPCI
200066785,CC de l'Oust à Brocéliande,1982_1990,1986,8,32817,33475,3239,3763,658,524,134,0.00248460875855505,0.00197862460407727,0.000505984154477777,EPCI
200066785,CC de l'Oust à Brocéliande,1990_1999,1994.5,9,33475,33472,3318,3839,-3,521,-524,-9.95807650450153e-06,0.00172938595294843,-0.00173934402945293,EPCI
200066785,CC de l'Oust à Brocéliande,1999_2006,2002.5,7,33472,37189,2611,3291,3717,680,3037,0.0151571142543649,0.00277289149662851,0.0123842227577364,EPCI
200066793,CA du Grand Annecy,2006_2011,2008.5,5,179307,187510,6198,11477,8203,5279,2924,0.00898669135786578,0.0057833406897688,0.00320335066809698,EPCI
200066793,CA du Grand Annecy,2011_2016,2013.5,5,187510,200322,6986,11982,12812,4996,7816,0.0133065332130573,0.00518884170562241,0.0081176915074349,EPCI
200066793,CA du Grand Annecy,1968_1975,1971.5,7,100790,124040,6020,14930,23250,8910,14340,0.0300961379435005,0.011533616734477,0.0185625212090235,EPCI
200066793,CA du Grand Annecy,1975_1982,1978.5,7,124040,135136,6590,13923,11096,7333,3763,0.0123148660472112,0.00813851051948448,0.00417635552772673,EPCI
200066793,CA du Grand Annecy,1982_1990,1986,8,135136,151545,8050,16138,16409,8088,8321,0.0144282126555713,0.00711166944714854,0.00731654320842272,EPCI
200066793,CA du Grand Annecy,1990_1999,1994.5,9,151545,166833,9780,19106,15288,9326,5962,0.0107361905188164,0.00654930094050768,0.00418688957830868,EPCI
200066793,CA du Grand Annecy,1999_2006,2002.5,7,166833,179307,8376,15992,12474,7616,4858,0.0103541092660833,0.00632170083136846,0.00403240843471481,EPCI
200066801,CC Isigny-Omaha Intercom,2006_2011,2008.5,5,25535,27103,1287,1553,1568,266,1302,0.0119901853558033,0.00203404930143092,0.0099561360543724,EPCI
200066801,CC Isigny-Omaha Intercom,2011_2016,2013.5,5,27103,26835,1478,1450,-268,-28,-240,-0.00198550970997158,-0.000207441312982105,-0.00177806839698947,EPCI
200066801,CC Isigny-Omaha Intercom,1968_1975,1971.5,7,26454,24617,2017,2674,-1837,657,-2494,-0.0102287715370842,0.00365830315724787,-0.0138870746943321,EPCI
200066801,CC Isigny-Omaha Intercom,1975_1982,1978.5,7,24617,24261,1854,2222,-356,368,-724,-0.00207885595063151,0.00214892974672021,-0.00422778569735172,EPCI
200066801,CC Isigny-Omaha Intercom,1982_1990,1986,8,24261,24063,2060,2428,-198,368,-566,-0.00102381700748277,0.00190285181188718,-0.00292666881936995,EPCI
200066801,CC Isigny-Omaha Intercom,1990_1999,1994.5,9,24063,24192,2382,2326,129,-56,185,0.00059424415360998,-0.000257966454280301,0.000852210607890281,EPCI
200066801,CC Isigny-Omaha Intercom,1999_2006,2002.5,7,24192,25535,1803,2092,1343,289,1054,0.00774815711436228,0.00166732494866024,0.00608083216570204,EPCI
200066819,CC du Volvestre,2006_2011,2008.5,5,25057,27766,1051,1666,2709,615,2094,0.0207440316743617,0.0047093316647222,0.0160347000096395,EPCI
200066819,CC du Volvestre,2011_2016,2013.5,5,27766,29757,1259,1611,1991,352,1639,0.013946791132504,0.00246573102895098,0.011481060103553,EPCI
200066819,CC du Volvestre,1968_1975,1971.5,7,14995,15304,1590,1112,309,-478,787,0.00291816671702749,-0.00451418670142117,0.00743235341844866,EPCI
200066819,CC du Volvestre,1975_1982,1978.5,7,15304,16759,1656,984,1455,-672,2127,0.0130589899229598,-0.00603136854173815,0.019090358464698,EPCI
200066819,CC du Volvestre,1982_1990,1986,8,16759,18765,1918,1289,2006,-629,2635,0.0142325829856547,-0.00446275907177307,0.0186953420574277,EPCI
200066819,CC du Volvestre,1990_1999,1994.5,9,18765,20509,1993,1923,1744,-70,1814,0.0099234004565516,-0.000398301623829479,0.0103217020803811,EPCI
200066819,CC du Volvestre,1999_2006,2002.5,7,20509,25057,1615,1892,4548,277,4271,0.029026051295983,0.00176785756574039,0.0272581937302426,EPCI
200066827,CC du Pays de Honfleur-Beuzeville,2006_2011,2008.5,5,24585,26592,1147,1671,2007,524,1483,0.0158185935529824,0.00413001645329486,0.0116885770996876,EPCI
200066827,CC du Pays de Honfleur-Beuzeville,2011_2016,2013.5,5,26592,27760,1301,1587,1168,286,882,0.00863420496211442,0.002114197447915,0.00652000751419942,EPCI
200066827,CC du Pays de Honfleur-Beuzeville,1968_1975,1971.5,7,19968,19917,1667,2438,-51,771,-822,-0.000365269527391798,0.00552201579645248,-0.00588728532384428,EPCI
200066827,CC du Pays de Honfleur-Beuzeville,1975_1982,1978.5,7,19917,20593,1728,2160,676,432,244,0.00477961090510126,0.00305442590385169,0.00172518500124957,EPCI
200066827,CC du Pays de Honfleur-Beuzeville,1982_1990,1986,8,20593,21577,1901,2413,984,512,472,0.00585164441452357,0.0030447580693456,0.00280688634517797,EPCI
200066827,CC du Pays de Honfleur-Beuzeville,1990_1999,1994.5,9,21577,22860,2109,2714,1283,605,678,0.00643849700484722,0.00303608003735976,0.00340241696748746,EPCI
200066827,CC du Pays de Honfleur-Beuzeville,1999_2006,2002.5,7,22860,24585,1580,2256,1725,676,1049,0.0104467390265148,0.0040939104822748,0.00635282854424003,EPCI
200066835,CC de Sézanne-Sud Ouest Marnais,2006_2011,2008.5,5,21206,21817,1149,1079,611,-70,681,0.00569723222987095,-0.000652710730099782,0.00634994295997073,EPCI
200066835,CC de Sézanne-Sud Ouest Marnais,2011_2016,2013.5,5,21817,21708,1172,1127,-109,-45,-64,-0.00100122368250466,-0.000413349226722107,-0.000587874455782552,EPCI
200066835,CC de Sézanne-Sud Ouest Marnais,1968_1975,1971.5,7,21078,20730,1780,2144,-348,364,-712,-0.00237544787114552,0.00248466386522118,-0.0048601117363667,EPCI
200066835,CC de Sézanne-Sud Ouest Marnais,1975_1982,1978.5,7,20730,20682,1678,1750,-48,72,-120,-0.000331112268073031,0.000496668402109546,-0.000827780670182576,EPCI
200066835,CC de Sézanne-Sud Ouest Marnais,1982_1990,1986,8,20682,20841,1997,1882,159,-115,274,0.000957763815125912,-0.000692722256223144,0.00165048607134906,EPCI
200066835,CC de Sézanne-Sud Ouest Marnais,1990_1999,1994.5,9,20841,20762,2197,2070,-79,-127,48,-0.000421889602631675,-0.000678227589040795,0.000256337986409119,EPCI
200066835,CC de Sézanne-Sud Ouest Marnais,1999_2006,2002.5,7,20762,21206,1642,1589,444,-53,497,0.00302739730111745,-0.000361378506664921,0.00338877580778237,EPCI
200066850,CC des Paysages de la Champagne,2006_2011,2008.5,5,21331,21649,1131,1293,318,162,156,0.0029639539102948,0.00150993878448981,0.001454015125805,EPCI
200066850,CC des Paysages de la Champagne,2011_2016,2013.5,5,21649,21503,1022,1152,-146,130,-276,-0.00135244536474899,0.00120423217409157,-0.00255667753884055,EPCI
200066850,CC des Paysages de la Champagne,1968_1975,1971.5,7,20628,20364,1780,2000,-264,220,-484,-0.00183841377891081,0.00153201148242567,-0.00337042526133648,EPCI
200066850,CC des Paysages de la Champagne,1975_1982,1978.5,7,20364,20224,1663,1626,-140,-37,-103,-0.000985031405690617,-0.000260329728646806,-0.000724701677043811,EPCI
200066850,CC des Paysages de la Champagne,1982_1990,1986,8,20224,21126,1879,1835,902,-44,946,0.00546921326691896,-0.000266790891069218,0.00573600415798818,EPCI
200066850,CC des Paysages de la Champagne,1990_1999,1994.5,9,21126,20990,1962,2105,-136,143,-279,-0.000717339874025225,0.000754261779305935,-0.00147160165333116,EPCI
200066850,CC des Paysages de la Champagne,1999_2006,2002.5,7,20990,21331,1320,1635,341,315,26,0.00230483489728806,0.00212909968517812,0.00017573521210994,EPCI
200066868,CC Presqu'île de Crozon-Aulne maritime,2006_2011,2008.5,5,22974,23469,1533,1309,495,-224,719,0.00427255337066801,-0.00193343829298916,0.00620599166365717,EPCI
200066868,CC Presqu'île de Crozon-Aulne maritime,2011_2016,2013.5,5,23469,23112,1549,1161,-357,-388,31,-0.00306099321950215,-0.0033267937511676,0.000265800531665453,EPCI
200066868,CC Presqu'île de Crozon-Aulne maritime,1968_1975,1971.5,7,22755,22313,2462,2189,-442,-273,-169,-0.00279828223420842,-0.00172835079171696,-0.00106993144249145,EPCI
200066868,CC Presqu'île de Crozon-Aulne maritime,1975_1982,1978.5,7,22313,22085,2503,1913,-228,-590,362,-0.00146618455734426,-0.00379407407382945,0.00232788951648519,EPCI
200066868,CC Presqu'île de Crozon-Aulne maritime,1982_1990,1986,8,22085,21815,2635,2193,-270,-442,172,-0.00153642330048209,-0.00251518184745587,0.000978758546973778,EPCI
200066868,CC Presqu'île de Crozon-Aulne maritime,1990_1999,1994.5,9,21815,21596,2829,2059,-219,-770,551,-0.00112044896329677,-0.0039394780901302,0.00281902912683343,EPCI
200066868,CC Presqu'île de Crozon-Aulne maritime,1999_2006,2002.5,7,21596,22974,2175,1720,1378,-455,1833,0.00887558928843757,-0.00293061910467278,0.0118062083931104,EPCI
200066876,CA de Châlons-en-Champagne,2006_2011,2008.5,5,79628,79473,2974,5482,-155,2508,-2663,-0.000389613772382225,0.00630420220086851,-0.00669381597325074,EPCI
200066876,CA de Châlons-en-Champagne,2011_2016,2013.5,5,79473,80565,3126,5234,1092,2108,-1016,0.00273312232562417,0.00527602734653457,-0.0025429050209104,EPCI
200066876,CA de Châlons-en-Champagne,1968_1975,1971.5,7,70384,78522,4131,11481,8138,7350,788,0.0157532046230466,0.0142278267362242,0.00152537788682241,EPCI
200066876,CA de Châlons-en-Champagne,1975_1982,1978.5,7,78522,80206,4252,10043,1684,5791,-4107,0.00303595416545321,0.0104401487958073,-0.00740419463035413,EPCI
200066876,CA de Châlons-en-Champagne,1982_1990,1986,8,80206,80937,4732,10735,731,6003,-5272,0.0011347369807444,0.0093185035504906,-0.0081837665697462,EPCI
200066876,CA de Châlons-en-Champagne,1990_1999,1994.5,9,80937,79896,5263,10108,-1041,4845,-5886,-0.0014373310852217,0.00668959568482148,-0.00812692677004319,EPCI
200066876,CA de Châlons-en-Champagne,1999_2006,2002.5,7,79896,79628,4155,7876,-268,3721,-3989,-0.000479884696937605,0.0066628767063613,-0.0071427614032989,EPCI
200066884,CC Quercy Vert-Aveyron,2006_2011,2008.5,5,17740,20618,853,1186,2878,333,2545,0.0305251232884298,0.00353192010251811,0.0269932031859117,EPCI
200066884,CC Quercy Vert-Aveyron,2011_2016,2013.5,5,20618,21945,1094,1170,1327,76,1251,0.0125531054934662,0.000718941987568525,0.0118341635058977,EPCI
200066884,CC Quercy Vert-Aveyron,1968_1975,1971.5,7,10637,11012,922,979,375,57,318,0.00496185486259981,0.000754201939115172,0.00420765292348464,EPCI
200066884,CC Quercy Vert-Aveyron,1975_1982,1978.5,7,11012,12352,990,925,1340,-65,1405,0.0165399241697668,-0.000802309754503613,0.0173422339242704,EPCI
200066884,CC Quercy Vert-Aveyron,1982_1990,1986,8,12352,13990,1142,1149,1638,7,1631,0.0156873743800632,6.70400614532615e-05,0.0156203343186099,EPCI
200066884,CC Quercy Vert-Aveyron,1990_1999,1994.5,9,13990,14994,1246,1380,1004,134,870,0.00773054224485525,0.00103176559841694,0.00669877664643832,EPCI
200066884,CC Quercy Vert-Aveyron,1999_2006,2002.5,7,14994,17740,1129,1234,2746,105,2641,0.0243154653754003,0.000929761057690106,0.0233857043177102,EPCI
200066892,CC de Vendeuvre-Soulaines,2006_2011,2008.5,5,7734,7912,347,453,178,106,72,0.00456125120887885,0.00271625071989415,0.0018450004889847,EPCI
200066892,CC de Vendeuvre-Soulaines,2011_2016,2013.5,5,7912,7790,440,449,-122,9,-131,-0.00310312222018716,0.000228918852308889,-0.00333204107249605,EPCI
200066892,CC de Vendeuvre-Soulaines,1968_1975,1971.5,7,7595,7725,635,843,130,208,-78,0.00242746821818618,0.00388394914909789,-0.00145648093091171,EPCI
200066892,CC de Vendeuvre-Soulaines,1975_1982,1978.5,7,7725,7983,640,804,258,164,94,0.0047042386196372,0.00299029121558334,0.00171394740405386,EPCI
200066892,CC de Vendeuvre-Soulaines,1982_1990,1986,8,7983,7845,631,799,-138,168,-306,-0.00217736290869297,0.00265070267145231,-0.00482806558014528,EPCI
200066892,CC de Vendeuvre-Soulaines,1990_1999,1994.5,9,7845,7777,717,831,-68,114,-182,-0.000966835254674558,0.00162087086813088,-0.00258770612280544,EPCI
200066892,CC de Vendeuvre-Soulaines,1999_2006,2002.5,7,7777,7734,525,694,-43,169,-212,-0.000791753044831256,0.00311177359480191,-0.00390352663963317,EPCI
200066918,CA Alès Agglomération,2006_2011,2008.5,5,121003,126574,6799,6523,5571,-276,5847,0.00904299881254245,-0.00044801071122989,0.00949100952377234,EPCI
200066918,CA Alès Agglomération,2011_2016,2013.5,5,126574,128969,7433,6484,2395,-949,3344,0.00375602585864776,-0.00148829584127629,0.00524432169992405,EPCI
200066918,CA Alès Agglomération,1968_1975,1971.5,7,114564,111480,9453,9991,-3084,538,-3622,-0.00389075648679382,0.000678737675063255,-0.00456949416185708,EPCI
200066918,CA Alès Agglomération,1975_1982,1978.5,7,111480,113096,9598,8236,1616,-1362,2978,0.00205808824096043,-0.0017346015991263,0.00379268984008674,EPCI
200066918,CA Alès Agglomération,1982_1990,1986,8,113096,115173,11109,10141,2077,-968,3045,0.00227738057904903,-0.0010613887340007,0.00333876931304973,EPCI
200066918,CA Alès Agglomération,1990_1999,1994.5,9,115173,113864,12203,10309,-1309,-1894,585,-0.00126925958817126,-0.00183649935828599,0.000567239770114733,EPCI
200066918,CA Alès Agglomération,1999_2006,2002.5,7,113864,121003,9632,8389,7139,-1243,8382,0.00872506987255517,-0.00151915700400421,0.0102442268765594,EPCI
200066926,CA Grand Auch Coeur de Gascogne,2006_2011,2008.5,5,36666,38347,1928,1843,1681,-85,1766,0.00900558904755533,-0.000455368869150626,0.00946095791670595,EPCI
200066926,CA Grand Auch Coeur de Gascogne,2011_2016,2013.5,5,38347,38418,2070,1830,71,-240,311,0.000370028817624046,-0.00125080163703903,0.00162083045466308,EPCI
200066926,CA Grand Auch Coeur de Gascogne,1968_1975,1971.5,7,32173,34023,2614,3493,1850,879,971,0.00801900637472874,0.00381011167750625,0.00420889469722249,EPCI
200066926,CA Grand Auch Coeur de Gascogne,1975_1982,1978.5,7,34023,35095,2492,2877,1072,385,687,0.00444153503314104,0.00159514084679039,0.00284639418635065,EPCI
200066926,CA Grand Auch Coeur de Gascogne,1982_1990,1986,8,35095,36576,2747,3156,1481,409,1072,0.00518007260153341,0.00143055347334718,0.00374951912818624,EPCI
200066926,CA Grand Auch Coeur de Gascogne,1990_1999,1994.5,9,36576,35789,3147,3127,-787,-20,-767,-0.00241393775393883,-6.13453050556247e-05,-0.00235259244888321,EPCI
200066926,CA Grand Auch Coeur de Gascogne,1999_2006,2002.5,7,35789,36666,2516,2442,877,-74,951,0.00346446049257243,-0.000292326198917172,0.0037567866914896,EPCI
200066975,CC Senlis Sud Oise,2006_2011,2008.5,5,25842,25491,869,1594,-351,725,-1076,-0.0027313882747132,0.00564175640788339,-0.00837314468259658,EPCI
200066975,CC Senlis Sud Oise,2011_2016,2013.5,5,25491,24043,901,1381,-1448,480,-1928,-0.0116281750190911,0.00385464365273737,-0.0154828186718285,EPCI
200066975,CC Senlis Sud Oise,1968_1975,1971.5,7,17629,20959,1220,2599,3330,1379,1951,0.0250255648371887,0.0103634396127577,0.014662125224431,EPCI
200066975,CC Senlis Sud Oise,1975_1982,1978.5,7,20959,22216,1128,2663,1257,1535,-278,0.00835537025411681,0.0102032564360138,-0.00184788618189696,EPCI
200066975,CC Senlis Sud Oise,1982_1990,1986,8,22216,23138,1249,2666,922,1417,-495,0.00509588226622637,0.00783174096664075,-0.00273585870041438,EPCI
200066975,CC Senlis Sud Oise,1990_1999,1994.5,9,23138,25491,1397,3115,2353,1718,635,0.0108191258978869,0.00789938728965989,0.00291973860822703,EPCI
200066975,CC Senlis Sud Oise,1999_2006,2002.5,7,25491,25842,1115,2479,351,1364,-1013,0.00195557058329521,0.00759942528665146,-0.00564385470335625,EPCI
200067023,CC Coutances Mer et Bocage,2006_2011,2008.5,5,46924,48428,2583,2515,1504,-68,1572,0.00632972602104154,-0.000286184421164112,0.00661591044220565,EPCI
200067023,CC Coutances Mer et Bocage,2011_2016,2013.5,5,48428,48158,2739,2311,-270,-428,158,-0.00111755246190171,-0.00177152760627381,0.000653975144372109,EPCI
200067023,CC Coutances Mer et Bocage,1968_1975,1971.5,7,43367,42231,3629,4304,-1136,675,-1811,-0.0037848528490354,0.00224892224744621,-0.00603377509648161,EPCI
200067023,CC Coutances Mer et Bocage,1975_1982,1978.5,7,42231,42134,3587,3732,-97,145,-242,-0.000328450735337493,0.000490983057978727,-0.00081943379331622,EPCI
200067023,CC Coutances Mer et Bocage,1982_1990,1986,8,42134,42848,4100,4142,714,42,672,0.00210270180895766,0.000123688341703392,0.00197901346725427,EPCI
200067023,CC Coutances Mer et Bocage,1990_1999,1994.5,9,42848,44216,4526,4350,1368,-176,1544,0.00349807570517458,-0.00045004482756632,0.00394812053274089,EPCI
200067023,CC Coutances Mer et Bocage,1999_2006,2002.5,7,44216,46924,3651,3644,2708,-7,2715,0.00852795142984753,-2.20441875956177e-05,0.00854999561744314,EPCI
200067031,CC Côte Ouest Centre Manche,2006_2011,2008.5,5,21986,22318,1384,1178,332,-206,538,0.00300202520103832,-0.00186270238377679,0.0048647275848151,EPCI
200067031,CC Côte Ouest Centre Manche,2011_2016,2013.5,5,22318,22078,1359,1043,-240,-316,76,-0.00216004177834905,-0.00284405500815959,0.000684013229810534,EPCI
200067031,CC Côte Ouest Centre Manche,1968_1975,1971.5,7,21328,20374,1670,2159,-954,489,-1443,-0.00651599044351958,0.00333995736570343,-0.00985594780922302,EPCI
200067031,CC Côte Ouest Centre Manche,1975_1982,1978.5,7,20374,20111,1685,1683,-263,-2,-261,-0.00185437125589716,-1.4101682554351e-05,-0.00184026957334281,EPCI
200067031,CC Côte Ouest Centre Manche,1982_1990,1986,8,20111,20476,2102,1975,365,-127,492,0.00225084680376764,-0.000783171353639698,0.00303401815740734,EPCI
200067031,CC Côte Ouest Centre Manche,1990_1999,1994.5,9,20476,21040,2382,2167,564,-215,779,0.00302366422041733,-0.00115263795636476,0.0041763021767821,EPCI
200067031,CC Côte Ouest Centre Manche,1999_2006,2002.5,7,21040,21986,1865,1754,946,-111,1057,0.00630270746631489,-0.000739535442664855,0.00704224290897975,EPCI
200067049,CC Spelunca-Liamone,2006_2011,2008.5,5,7245,7413,524,236,168,-288,456,0.00459525392576543,-0.00787757815845502,0.0124728320842205,EPCI
200067049,CC Spelunca-Liamone,2011_2016,2013.5,5,7413,7591,534,235,178,-299,477,0.00475690217878655,-0.00799052669357965,0.0127474288723662,EPCI
200067049,CC Spelunca-Liamone,1968_1975,1971.5,7,8210,7955,959,439,-255,-520,265,-0.00449732257488544,-0.00917101074094287,0.00467368816605742,EPCI
200067049,CC Spelunca-Liamone,1975_1982,1978.5,7,7955,7175,1020,376,-780,-644,-136,-0.0146344177370327,-0.0120827756700629,-0.0025516420669698,EPCI
200067049,CC Spelunca-Liamone,1982_1990,1986,8,7175,6511,1066,483,-664,-583,-81,-0.0120653364428807,-0.0105935107623485,-0.00147182568053213,EPCI
200067049,CC Spelunca-Liamone,1990_1999,1994.5,9,6511,6541,1045,442,30,-603,633,0.000510908772155538,-0.0102692663203263,0.0107801750924819,EPCI
200067049,CC Spelunca-Liamone,1999_2006,2002.5,7,6541,7245,803,335,704,-468,1172,0.0147102196276301,-0.00977895282064045,0.0244891724482705,EPCI
200067064,CC Decazeville Communauté,2006_2011,2008.5,5,20700,19957,1488,916,-743,-572,-171,-0.007284089741181,-0.00560767070249735,-0.00167641903868365,EPCI
200067064,CC Decazeville Communauté,2011_2016,2013.5,5,19957,18950,1510,813,-1007,-697,-310,-0.0103017749382558,-0.00713042416282452,-0.00317135077543128,EPCI
200067064,CC Decazeville Communauté,1968_1975,1971.5,7,31018,29581,2907,2618,-1437,-289,-1148,-0.00675357963645962,-0.0013582355705893,-0.00539534406587031,EPCI
200067064,CC Decazeville Communauté,1975_1982,1978.5,7,29581,27061,2801,1834,-2520,-967,-1553,-0.0126392574340278,-0.00485006426139084,-0.00778919317263699,EPCI
200067064,CC Decazeville Communauté,1982_1990,1986,8,27061,23766,2733,1574,-3295,-1159,-2136,-0.016098706690107,-0.00566264068401641,-0.0104360660060906,EPCI
200067064,CC Decazeville Communauté,1990_1999,1994.5,9,23766,21397,2917,1565,-2369,-1352,-1017,-0.011599452950527,-0.00661986508615977,-0.00497958786436723,EPCI
200067064,CC Decazeville Communauté,1999_2006,2002.5,7,21397,20700,2178,1253,-697,-925,228,-0.00471983000362775,-0.00626376291729651,0.00154393291366876,EPCI
200067072,CC Haut-Léon Communauté,2006_2011,2008.5,5,32136,32087,2100,1591,-49,-509,460,-0.000305140109889135,-0.00316972073333816,0.00286458062344902,EPCI
200067072,CC Haut-Léon Communauté,2011_2016,2013.5,5,32087,31517,2155,1556,-570,-599,29,-0.00357835853855448,-0.00376041537648094,0.000182056837926456,EPCI
200067072,CC Haut-Léon Communauté,1968_1975,1971.5,7,35227,33801,3307,3239,-1426,-68,-1358,-0.00588581690813439,-0.000280670090990981,-0.00560514681714341,EPCI
200067072,CC Haut-Léon Communauté,1975_1982,1978.5,7,33801,33064,3411,2677,-737,-734,-3,-0.00314437615341023,-0.00313157679321996,-1.27993601902721e-05,EPCI
200067072,CC Haut-Léon Communauté,1982_1990,1986,8,33064,31972,3947,2763,-1092,-1184,92,-0.00418927010423698,-0.00454221227419101,0.000352942169954031,EPCI
200067072,CC Haut-Léon Communauté,1990_1999,1994.5,9,31972,30940,4030,2776,-1032,-1254,222,-0.0036389932703812,-0.00442179996226552,0.000782806691884327,EPCI
200067072,CC Haut-Léon Communauté,1999_2006,2002.5,7,30940,32136,3125,2260,1196,-865,2061,0.00543285499481128,-0.00392928057735097,0.00936213557216224,EPCI
200067080,"CC Chablis, Villages et Terroirs",2006_2011,2008.5,5,15380,15366,1030,911,-14,-119,105,-0.000182120940378727,-0.00154802799321918,0.00136590705284045,EPCI
200067080,"CC Chablis, Villages et Terroirs",2011_2016,2013.5,5,15366,15203,1040,786,-163,-254,91,-0.0021306269146194,-0.0033201180141922,0.0011894910995728,EPCI
200067080,"CC Chablis, Villages et Terroirs",1968_1975,1971.5,7,14086,13854,1666,1302,-232,-364,132,-0.0023696731273366,-0.00371793542392467,0.00134826229658807,EPCI
200067080,"CC Chablis, Villages et Terroirs",1975_1982,1978.5,7,13854,13689,1626,1138,-165,-488,323,-0.00171016585230654,-0.00505794506621572,0.00334777921390917,EPCI
200067080,"CC Chablis, Villages et Terroirs",1982_1990,1986,8,13689,14014,1728,1274,325,-454,779,0.00293733545751484,-0.00410323168526689,0.00704056714278174,EPCI
200067080,"CC Chablis, Villages et Terroirs",1990_1999,1994.5,9,14014,14891,2049,1479,877,-570,1447,0.00676725885366292,-0.00439833243624614,0.0111655912899091,EPCI
200067080,"CC Chablis, Villages et Terroirs",1999_2006,2002.5,7,14891,15380,1626,1317,489,-309,798,0.00462652094803384,-0.00292350710213181,0.00755002805016566,EPCI
200067106,CA du Pays Basque,2006_2011,2008.5,5,279563,291765,15071,14034,12202,-1037,13239,0.00858080868783606,-0.000729249189418619,0.00931005787725468,EPCI
200067106,CA du Pays Basque,2011_2016,2013.5,5,291765,306306,16009,14054,14541,-1955,16496,0.00977464653158377,-0.00131417605180155,0.0110888225833853,EPCI
200067106,CA du Pays Basque,1968_1975,1971.5,7,218085,227855,19144,22001,9770,2857,6913,0.00628029122947749,0.00183651914458722,0.00444377208489026,EPCI
200067106,CA du Pays Basque,1975_1982,1978.5,7,227855,236541,20246,18822,8686,-1424,10110,0.0053588924421546,-0.000878547413956729,0.00623743985611132,EPCI
200067106,CA du Pays Basque,1982_1990,1986,8,236541,249725,24359,21113,13184,-3246,16430,0.00680287992496376,-0.00167492022424396,0.00847780014920772,EPCI
200067106,CA du Pays Basque,1990_1999,1994.5,9,249725,262370,27703,23399,12645,-4304,16949,0.0055034675031409,-0.00187322452617781,0.00737669202931872,EPCI
200067106,CA du Pays Basque,1999_2006,2002.5,7,262370,279563,21512,19269,17193,-2243,19436,0.00910865480185374,-0.00118831575179189,0.0102969705536456,EPCI
200067114,CA de l'Auxerrois,2006_2011,2008.5,5,69563,68886,3318,4012,-677,694,-1371,-0.00195405882650468,0.00200312677340361,-0.00395718559990829,EPCI
200067114,CA de l'Auxerrois,2011_2016,2013.5,5,68886,68187,3508,3827,-699,319,-1018,-0.00203772770725552,0.000929950126773264,-0.00296767783402878,EPCI
200067114,CA de l'Auxerrois,1968_1975,1971.5,7,53624,60755,4413,7012,7131,2599,4532,0.0179961065074343,0.00655895117274181,0.0114371553346925,EPCI
200067114,CA de l'Auxerrois,1975_1982,1978.5,7,60755,66770,4370,7139,6015,2769,3246,0.0135777074649512,0.00625048578062344,0.0073272216843278,EPCI
200067114,CA de l'Auxerrois,1982_1990,1986,8,66770,68983,5386,7523,2213,2137,76,0.00408409472185833,0.00394383661121159,0.000140258110646739,EPCI
200067114,CA de l'Auxerrois,1990_1999,1994.5,9,68983,69026,6113,7569,43,1456,-1413,6.92410399267818e-05,0.00234453381705568,-0.0022752927771289,EPCI
200067114,CA de l'Auxerrois,1999_2006,2002.5,7,69026,69563,4542,5798,537,1256,-719,0.0011076946946591,0.00259080919272222,-0.00148311449806312,EPCI
200067122,CC Coteaux et Plaines du Pays Lafrançaisain,2006_2011,2008.5,5,9796,10628,429,580,832,151,681,0.0164372063055085,0.00298319489438916,0.0134540114111193,EPCI
200067122,CC Coteaux et Plaines du Pays Lafrançaisain,2011_2016,2013.5,5,10628,10986,432,529,358,97,261,0.00664794151796655,0.00180125789732613,0.00484668362064042,EPCI
200067122,CC Coteaux et Plaines du Pays Lafrançaisain,1968_1975,1971.5,7,8462,8228,715,658,-234,-57,-177,-0.00399806928405666,-0.000973888671757392,-0.00302418061229927,EPCI
200067122,CC Coteaux et Plaines du Pays Lafrançaisain,1975_1982,1978.5,7,8228,8409,666,552,181,-114,295,0.00311334915861394,-0.00196089394520436,0.0050742431038183,EPCI
200067122,CC Coteaux et Plaines du Pays Lafrançaisain,1982_1990,1986,8,8409,8706,647,693,297,46,251,0.0043481612241425,0.000673452580170219,0.00367470864397228,EPCI
200067122,CC Coteaux et Plaines du Pays Lafrançaisain,1990_1999,1994.5,9,8706,8763,766,810,57,44,13,0.00072535949534247,0.000559926627983661,0.000165432867358809,EPCI
200067122,CC Coteaux et Plaines du Pays Lafrançaisain,1999_2006,2002.5,7,8763,9796,622,665,1033,43,990,0.0160467926559214,0.000667969103779882,0.0153788235521415,EPCI
200067130,CC de Puisaye-Forterre,2006_2011,2008.5,5,35673,36204,2793,1544,531,-1249,1780,0.00295947258624296,-0.00696116998157714,0.0099206425678201,EPCI
200067130,CC de Puisaye-Forterre,2011_2016,2013.5,5,36204,35068,2846,1520,-1136,-1326,190,-0.00635583095944159,-0.00741886606709467,0.00106303510765308,EPCI
200067130,CC de Puisaye-Forterre,1968_1975,1971.5,7,38642,35444,4202,2984,-3198,-1218,-1980,-0.0122649902370213,-0.00467128145987866,-0.00759370877714266,EPCI
200067130,CC de Puisaye-Forterre,1975_1982,1978.5,7,35444,34693,4148,2237,-751,-1911,1160,-0.00305476022326268,-0.00777316482910116,0.00471840460583849,EPCI
200067130,CC de Puisaye-Forterre,1982_1990,1986,8,34693,33773,4718,2512,-920,-2206,1286,-0.00335389693029331,-0.0080420615524207,0.00468816462212739,EPCI
200067130,CC de Puisaye-Forterre,1990_1999,1994.5,9,33773,34594,4944,2727,821,-2217,3038,0.00267229644963662,-0.00721617689262411,0.00988847334226073,EPCI
200067130,CC de Puisaye-Forterre,1999_2006,2002.5,7,34594,35673,3803,2163,1079,-1640,2719,0.00439733194304326,-0.00668361852325389,0.0110809504662971,EPCI
200067155,"CC Saint Affricain, Roquefort, Sept Vallons",2006_2011,2008.5,5,13627,13788,745,677,161,-68,229,0.00235186728861447,-0.000993335252334063,0.00334520254094854,EPCI
200067155,"CC Saint Affricain, Roquefort, Sept Vallons",2011_2016,2013.5,5,13788,13787,764,595,-1,-169,168,-1.45057878154775e-05,-0.0024514781408157,0.00243697235300022,EPCI
200067155,"CC Saint Affricain, Roquefort, Sept Vallons",1968_1975,1971.5,7,14366,14099,1270,1221,-267,-49,-218,-0.00267647337976984,-0.00049118799853454,-0.0021852853812353,EPCI
200067155,"CC Saint Affricain, Roquefort, Sept Vallons",1975_1982,1978.5,7,14099,14330,1173,1022,231,-151,382,0.00232432119278947,-0.0015193614723429,0.00384368266513237,EPCI
200067155,"CC Saint Affricain, Roquefort, Sept Vallons",1982_1990,1986,8,14330,13608,1277,1055,-722,-222,-500,-0.00644133840497441,-0.00198057773670958,-0.00446076066826482,EPCI
200067155,"CC Saint Affricain, Roquefort, Sept Vallons",1990_1999,1994.5,9,13608,12975,1396,1100,-633,-296,-337,-0.00527862174724447,-0.00246836024831653,-0.00281026149892794,EPCI
200067155,"CC Saint Affricain, Roquefort, Sept Vallons",1999_2006,2002.5,7,12975,13627,991,861,652,-130,782,0.00702868459648975,-0.00140142484285839,0.00843010943934814,EPCI
200067163,"CC Monts, Rance et Rougier",2006_2011,2008.5,5,6630,6474,397,270,-156,-127,-29,-0.00475080877667866,-0.00386764560665506,-0.000883163170023597,EPCI
200067163,"CC Monts, Rance et Rougier",2011_2016,2013.5,5,6474,6336,450,242,-138,-208,70,-0.00430002848726252,-0.00648120235761307,0.00218117387035055,EPCI
200067163,"CC Monts, Rance et Rougier",1968_1975,1971.5,7,9212,8023,841,625,-1189,-216,-973,-0.0195484819723816,-0.00355128015646293,-0.0159972018159186,EPCI
200067163,"CC Monts, Rance et Rougier",1975_1982,1978.5,7,8023,7565,831,496,-458,-335,-123,-0.00836199517944725,-0.00611630651771796,-0.00224568866172928,EPCI
200067163,"CC Monts, Rance et Rougier",1982_1990,1986,8,7565,6962,897,554,-603,-343,-260,-0.0103294754516472,-0.00587563860682419,-0.004453836844823,EPCI
200067163,"CC Monts, Rance et Rougier",1990_1999,1994.5,9,6962,6558,901,486,-404,-415,11,-0.0066203340482397,-0.00680059066836503,0.000180256620125338,EPCI
200067163,"CC Monts, Rance et Rougier",1999_2006,2002.5,7,6558,6630,590,403,72,-187,259,0.00156109234877055,-0.00405450373916797,0.00561559608793852,EPCI
200067171,"CC Aubrac, Carladez et Viadène",2006_2011,2008.5,5,10867,10495,884,407,-372,-477,105,-0.00694213543419642,-0.00890160914546154,0.00195947371126512,EPCI
200067171,"CC Aubrac, Carladez et Viadène",2011_2016,2013.5,5,10495,10279,929,326,-216,-603,387,-0.00415055737659431,-0.0115869726763258,0.00743641529973147,EPCI
200067171,"CC Aubrac, Carladez et Viadène",1968_1975,1971.5,7,14580,13312,1526,1195,-1268,-331,-937,-0.01291372758795,-0.00337101248549798,-0.00954271510245198,EPCI
200067171,"CC Aubrac, Carladez et Viadène",1975_1982,1978.5,7,13312,13039,1528,1002,-273,-526,253,-0.00295576846629131,-0.0056949971182023,0.00273922865191099,EPCI
200067171,"CC Aubrac, Carladez et Viadène",1982_1990,1986,8,13039,12001,1630,948,-1038,-682,-356,-0.0103157843713153,-0.00677780822855206,-0.00353797614276325,EPCI
200067171,"CC Aubrac, Carladez et Viadène",1990_1999,1994.5,9,12001,11049,1654,779,-952,-875,-77,-0.00914130120137391,-0.00840193125126278,-0.000739369950111125,EPCI
200067171,"CC Aubrac, Carladez et Viadène",1999_2006,2002.5,7,11049,10867,1345,638,-182,-707,525,-0.00236993754601555,-0.00920629585182965,0.0068363583058141,EPCI
200067189,CC Creuse Sud Ouest,2006_2011,2008.5,5,14649,14317,1117,578,-332,-539,207,-0.00457439172770924,-0.00742649741335927,0.00285210568565004,EPCI
200067189,CC Creuse Sud Ouest,2011_2016,2013.5,5,14317,13835,1217,508,-482,-709,227,-0.00682580347727779,-0.0100404453638796,0.00321464188660178,EPCI
200067189,CC Creuse Sud Ouest,1968_1975,1971.5,7,20380,18262,2476,1326,-2118,-1150,-968,-0.0155537189413532,-0.00844512595965823,-0.00710859298169493,EPCI
200067189,CC Creuse Sud Ouest,1975_1982,1978.5,7,18262,17174,2446,984,-1088,-1462,374,-0.00873672335106202,-0.0117399720029896,0.00300324865192757,EPCI
200067189,CC Creuse Sud Ouest,1982_1990,1986,8,17174,15688,2595,1099,-1486,-1496,10,-0.0112488189564606,-0.0113245176035431,7.56986470825064e-05,EPCI
200067189,CC Creuse Sud Ouest,1990_1999,1994.5,9,15688,14993,2524,1223,-695,-1301,606,-0.00502208731423848,-0.00940105841125793,0.00437897109701945,EPCI
200067189,CC Creuse Sud Ouest,1999_2006,2002.5,7,14993,14649,1694,908,-344,-786,442,-0.00331041584559288,-0.00756391527510467,0.00425349942951179,EPCI
200067197,CC Monts d'Arrée Communauté,2006_2011,2008.5,5,8063,8072,642,357,9,-285,294,0.000223142362238526,-0.00706617480422001,0.00728931716645853,EPCI
200067197,CC Monts d'Arrée Communauté,2011_2016,2013.5,5,8072,7833,668,324,-239,-344,105,-0.0059931101721542,-0.00862606652393743,0.00263295635178323,EPCI
200067197,CC Monts d'Arrée Communauté,1968_1975,1971.5,7,12028,10331,1428,666,-1697,-762,-935,-0.021492554458507,-0.00965075220823942,-0.0118418022502675,EPCI
200067197,CC Monts d'Arrée Communauté,1975_1982,1978.5,7,10331,9266,1495,520,-1065,-975,-90,-0.0154223101174455,-0.0141190163047037,-0.00130329381274188,EPCI
200067197,CC Monts d'Arrée Communauté,1982_1990,1986,8,9266,8232,1500,637,-1034,-863,-171,-0.0146815086069253,-0.0122535221738651,-0.00242798643306018,EPCI
200067197,CC Monts d'Arrée Communauté,1990_1999,1994.5,9,8232,7994,1463,576,-238,-887,649,-0.00325444148114373,-0.0121289478730021,0.00887450639185833,EPCI
200067197,CC Monts d'Arrée Communauté,1999_2006,2002.5,7,7994,8063,1057,494,69,-563,632,0.00122853051379113,-0.0100240968009334,0.0112526273147245,EPCI
200067205,CA du Cotentin,2006_2011,2008.5,5,182934,182577,8154,10059,-357,1905,-2262,-0.000390609732810465,0.00208434605323231,-0.00247495578604278,EPCI
200067205,CA du Cotentin,2011_2016,2013.5,5,182577,180794,8892,9595,-1783,703,-2486,-0.00196082312597778,0.000773111978442166,-0.00273393510441995,EPCI
200067205,CA du Cotentin,1968_1975,1971.5,7,153879,154034,11001,19745,155,8744,-8589,0.000143835768172007,0.00811419327029697,-0.00797035750212496,EPCI
200067205,CA du Cotentin,1975_1982,1978.5,7,154034,165887,10881,17550,11853,6669,5184,0.010646774432741,0.00599032638926429,0.00465644804347669,EPCI
200067205,CA du Cotentin,1982_1990,1986,8,165887,183218,12770,24098,17331,11328,6003,0.0124986972971002,0.00816947914035837,0.00432921815674182,EPCI
200067205,CA du Cotentin,1990_1999,1994.5,9,183218,182904,14114,23569,-314,9455,-9769,-0.000190568023682114,0.0057382823691541,-0.00592885039283621,EPCI
200067205,CA du Cotentin,1999_2006,2002.5,7,182904,182934,11335,15665,30,4330,-4300,2.34298487413742e-05,0.00338170816833835,-0.00335827831959697,EPCI
200067213,CU du Grand Reims,2006_2011,2008.5,5,289178,288973,10935,18519,-205,7584,-7789,-0.000141821407592668,0.00524670026918437,-0.00538852167677704,EPCI
200067213,CU du Grand Reims,2011_2016,2013.5,5,288973,294674,11392,18471,5701,7079,-1378,0.00391492385110892,0.00486120784809683,-0.000946283996987913,EPCI
200067213,CU du Grand Reims,1968_1975,1971.5,7,220280,252806,15034,32835,32526,17801,14725,0.0198695271332228,0.010874299099136,0.00899522803408674,EPCI
200067213,CU du Grand Reims,1975_1982,1978.5,7,252806,264704,15394,31238,11898,15844,-3946,0.00659160454187702,0.00877772586665822,-0.0021861213247812,EPCI
200067213,CU du Grand Reims,1982_1990,1986,8,264704,278439,17297,34321,13735,17024,-3289,0.0063433826077306,0.00786237681208633,-0.00151899420435573,EPCI
200067213,CU du Grand Reims,1990_1999,1994.5,9,278439,288789,18973,34581,10350,15608,-5258,0.0040634906578898,0.00612782243365643,-0.00206433177576663,EPCI
200067213,CU du Grand Reims,1999_2006,2002.5,7,288789,289178,15379,26125,389,10746,-10357,0.000192318179031536,0.00531272789684548,-0.00512040971781394,EPCI
200067221,CC Centre Morbihan Communauté,2006_2011,2008.5,5,38330,41701,2075,2634,3371,559,2812,0.0170013515141632,0.00281926891023945,0.0141820826039237,EPCI
200067221,CC Centre Morbihan Communauté,2011_2016,2013.5,5,41701,42645,2193,2490,944,297,647,0.00448702155695901,0.00141170063815342,0.0030753209188056,EPCI
200067221,CC Centre Morbihan Communauté,1968_1975,1971.5,7,36619,36482,3366,3845,-137,479,-616,-0.000535319968900661,0.00187166616863808,-0.00240698613753874,EPCI
200067221,CC Centre Morbihan Communauté,1975_1982,1978.5,7,36482,35966,3408,3263,-516,-145,-371,-0.00203292231172725,-0.000571266928683044,-0.0014616553830442,EPCI
200067221,CC Centre Morbihan Communauté,1982_1990,1986,8,35966,35190,3839,3548,-776,-291,-485,-0.00272279849299339,-0.00102104943487252,-0.00170174905812087,EPCI
200067221,CC Centre Morbihan Communauté,1990_1999,1994.5,9,35190,35031,3936,3420,-159,-516,357,-0.000503047603750084,-0.00163253184613235,0.00112948424238226,EPCI
200067221,CC Centre Morbihan Communauté,1999_2006,2002.5,7,35031,38330,2897,3298,3299,401,2898,0.0129400783021778,0.00157289220950994,0.0113671860926679,EPCI
200067239,CC des Luys en Béarn,2006_2011,2008.5,5,24762,26845,1078,1335,2083,257,1826,0.0162850519768558,0.00200924549114352,0.0142758064857123,EPCI
200067239,CC des Luys en Béarn,2011_2016,2013.5,5,26845,28191,1165,1372,1346,207,1139,0.00983266492901547,0.00151215575059896,0.00832050917841651,EPCI
200067239,CC des Luys en Béarn,1968_1975,1971.5,7,15045,15824,1418,1254,779,-164,943,0.00723779064608632,-0.00152374539917607,0.00876153604526238,EPCI
200067239,CC des Luys en Béarn,1975_1982,1978.5,7,15824,18571,1438,1132,2747,-306,3053,0.0231311044683435,-0.00257667199392542,0.025707776462269,EPCI
200067239,CC des Luys en Béarn,1982_1990,1986,8,18571,20166,1656,1584,1595,-72,1667,0.0103528226618246,-0.000467337449311204,0.0108201601111358,EPCI
200067239,CC des Luys en Béarn,1990_1999,1994.5,9,20166,22298,1777,1883,2132,106,2026,0.0112291309209167,0.000558296377869217,0.0106708345430475,EPCI
200067239,CC des Luys en Béarn,1999_2006,2002.5,7,22298,24762,1405,1794,2464,389,2075,0.0150859805500418,0.00238167468910969,0.0127043058609322,EPCI
200067247,CC Pleyben-Châteaulin-Porzay,2006_2011,2008.5,5,22187,22767,1396,1196,580,-200,780,0.00517445897311641,-0.00178429619762635,0.00695875517074276,EPCI
200067247,CC Pleyben-Châteaulin-Porzay,2011_2016,2013.5,5,22767,23015,1428,1105,248,-323,571,0.0021691608686718,-0.00282515709911691,0.00499431796778871,EPCI
200067247,CC Pleyben-Châteaulin-Porzay,1968_1975,1971.5,7,21807,21120,2192,1813,-687,-379,-308,-0.00456249723290947,-0.00251701084610289,-0.00204548638680657,EPCI
200067247,CC Pleyben-Châteaulin-Porzay,1975_1982,1978.5,7,21120,21752,2206,1526,632,-680,1312,0.00422106204811934,-0.00454164903911575,0.00876271108723508,EPCI
200067247,CC Pleyben-Châteaulin-Porzay,1982_1990,1986,8,21752,21014,2379,1872,-738,-507,-231,-0.0043053086050554,-0.00295771200916408,-0.00134759659589133,EPCI
200067247,CC Pleyben-Châteaulin-Porzay,1990_1999,1994.5,9,21014,20823,2587,2079,-191,-508,317,-0.00101401190223815,-0.00269695312218315,0.001682941219945,EPCI
200067247,CC Pleyben-Châteaulin-Porzay,1999_2006,2002.5,7,20823,22187,1889,1713,1364,-176,1540,0.0091052581925477,-0.00117487202484487,0.0102801302173926,EPCI
200067254,CA Pau Béarn Pyrénées,2006_2011,2008.5,5,164083,162935,6974,8724,-1148,1750,-2898,-0.00140322437699625,0.00213906155029916,-0.00354228592729541,EPCI
200067254,CA Pau Béarn Pyrénées,2011_2016,2013.5,5,162935,162012,7425,8375,-923,950,-1873,-0.00113554312369635,0.00116876052818151,-0.00230430365187785,EPCI
200067254,CA Pau Béarn Pyrénées,1968_1975,1971.5,7,120839,137003,8401,15487,16164,7086,9078,0.0180966150271493,0.00793322284597749,0.0101633921811718,EPCI
200067254,CA Pau Béarn Pyrénées,1975_1982,1978.5,7,137003,143165,8840,13554,6162,4714,1448,0.00630479030794118,0.00482323620766548,0.00148155410027569,EPCI
200067254,CA Pau Béarn Pyrénées,1982_1990,1986,8,143165,149217,10780,15009,6052,4229,1823,0.00518889229407504,0.00362587995896288,0.00156301233511216,EPCI
200067254,CA Pau Béarn Pyrénées,1990_1999,1994.5,9,149217,154488,12040,15876,5271,3836,1435,0.0038646486947278,0.00281251990001439,0.00105212879471341,EPCI
200067254,CA Pau Béarn Pyrénées,1999_2006,2002.5,7,154488,164083,9693,12327,9595,2634,6961,0.00864515161194124,0.00237324954099565,0.00627190207094559,EPCI
200067262,CC du Haut-Béarn,2006_2011,2008.5,5,31586,32211,1938,1461,625,-477,1102,0.00392649349054275,-0.00299669983198223,0.00692319332252497,EPCI
200067262,CC du Haut-Béarn,2011_2016,2013.5,5,32211,32377,1959,1371,166,-588,754,0.00102858564240904,-0.00364342384178624,0.00467200948419528,EPCI
200067262,CC du Haut-Béarn,1968_1975,1971.5,7,30899,30742,2794,2682,-157,-112,-45,-0.000727452866022271,-0.000518947267480856,-0.000208505598541415,EPCI
200067262,CC du Haut-Béarn,1975_1982,1978.5,7,30742,30706,2796,2372,-36,-424,388,-0.000167374929258113,-0.00197130472237333,0.00180392979311522,EPCI
200067262,CC du Haut-Béarn,1982_1990,1986,8,30706,31073,3265,2715,367,-550,917,0.00148625334017449,-0.00222735514195087,0.00371360848212537,EPCI
200067262,CC du Haut-Béarn,1990_1999,1994.5,9,31073,31080,3469,2690,7,-779,786,2.50281567808486e-05,-0.00278527630461158,0.00281030446139243,EPCI
200067262,CC du Haut-Béarn,1999_2006,2002.5,7,31080,31586,2787,2084,506,-703,1209,0.00230972888757797,-0.00320897116199073,0.0055187000495687,EPCI
200067288,CC du Béarn des Gaves,2006_2011,2008.5,5,17079,17753,1250,726,674,-524,1198,0.00777101422759929,-0.00604156002264396,0.0138125742502433,EPCI
200067288,CC du Béarn des Gaves,2011_2016,2013.5,5,17753,17593,1337,748,-160,-589,429,-0.00180904571421514,-0.00665954953545449,0.00485050382123935,EPCI
200067288,CC du Béarn des Gaves,1968_1975,1971.5,7,18937,18673,1931,1595,-264,-336,72,-0.00200356874882146,-0.00254999658940913,0.000546427840587671,EPCI
200067288,CC du Béarn des Gaves,1975_1982,1978.5,7,18673,17896,1880,1243,-777,-637,-140,-0.00605323434181315,-0.0049625614874324,-0.00109067285438075,EPCI
200067288,CC du Béarn des Gaves,1982_1990,1986,8,17896,17284,2167,1293,-612,-874,262,-0.00434005538550664,-0.00619805295250458,0.00185799756699794,EPCI
200067288,CC du Béarn des Gaves,1990_1999,1994.5,9,17284,16778,2425,1390,-506,-1035,529,-0.00329596895686779,-0.0067417546845023,0.00344578572763451,EPCI
200067288,CC du Béarn des Gaves,1999_2006,2002.5,7,16778,17079,1878,1087,301,-791,1092,0.00254339097542777,-0.00668379488891485,0.00922718586434262,EPCI
200067296,CC du Nord Est Béarn,2006_2011,2008.5,5,30708,32598,1197,1743,1890,546,1344,0.0120171789481038,0.00347162947389666,0.00854554947420717,EPCI
200067296,CC du Nord Est Béarn,2011_2016,2013.5,5,32598,33968,1262,1691,1370,429,941,0.00826758288526985,0.00258890004217574,0.00567868284309411,EPCI
200067296,CC du Nord Est Béarn,1968_1975,1971.5,7,19588,20219,1815,1677,631,-138,769,0.00453964777107219,-0.00099282312584463,0.00553247089691682,EPCI
200067296,CC du Nord Est Béarn,1975_1982,1978.5,7,20219,23167,1846,1635,2948,-211,3159,0.0196339883883732,-0.00140528207257352,0.0210392704609467,EPCI
200067296,CC du Nord Est Béarn,1982_1990,1986,8,23167,26102,1993,2063,2935,70,2865,0.0150221002805491,0.000358278371256707,0.0146638219092924,EPCI
200067296,CC du Nord Est Béarn,1990_1999,1994.5,9,26102,27383,2174,2287,1281,113,1168,0.00533757694843451,0.000470840121134348,0.00486673682730016,EPCI
200067296,CC du Nord Est Béarn,1999_2006,2002.5,7,27383,30708,1695,2061,3325,366,2959,0.0165062944017167,0.00181693345895588,0.0146893609427608,EPCI
200067304,CC Serein et Armance,2006_2011,2008.5,5,24831,24841,1330,1544,10,214,-204,8.0531508996895e-05,0.00172337429253355,-0.00164284278353666,EPCI
200067304,CC Serein et Armance,2011_2016,2013.5,5,24841,24315,1280,1353,-526,73,-599,-0.00427126609452844,0.00059278027547638,-0.00486404637000482,EPCI
200067304,CC Serein et Armance,1968_1975,1971.5,7,20950,23305,2269,2382,2355,113,2242,0.0153348596448348,0.000735812798244729,0.0145990468465901,EPCI
200067304,CC Serein et Armance,1975_1982,1978.5,7,23305,24099,2187,2318,794,131,663,0.00479753090978807,0.000791532177811382,0.00400599873197669,EPCI
200067304,CC Serein et Armance,1982_1990,1986,8,24099,24937,2445,2818,838,373,465,0.00428192867876076,0.001905918135057,0.00237601054370376,EPCI
200067304,CC Serein et Armance,1990_1999,1994.5,9,24937,25083,2590,2698,146,108,38,0.000648841685898738,0.000479965082719614,0.000168876603179124,EPCI
200067304,CC Serein et Armance,1999_2006,2002.5,7,25083,24831,1898,2146,-252,248,-500,-0.00144145343010216,0.00141857321692593,-0.00286002664702809,EPCI
200067320,CC Serre-Ponçon Val d'Avance,2006_2011,2008.5,5,6197,7169,229,388,972,159,813,0.0295689033355835,0.00483688850859853,0.024732014826985,EPCI
200067320,CC Serre-Ponçon Val d'Avance,2011_2016,2013.5,5,7169,7516,275,398,347,123,224,0.00949840758096832,0.0033668706987294,0.00613153688223891,EPCI
200067320,CC Serre-Ponçon Val d'Avance,1968_1975,1971.5,7,3500,3502,314,294,2,-20,22,8.16126684601848e-05,-0.000816126684601848,0.000897739353062033,EPCI
200067320,CC Serre-Ponçon Val d'Avance,1975_1982,1978.5,7,3502,4005,321,246,503,-75,578,0.0193577415309665,-0.00288634317062124,0.0222440847015877,EPCI
200067320,CC Serre-Ponçon Val d'Avance,1982_1990,1986,8,4005,4754,330,383,749,53,696,0.0216616276476014,0.00153279875209996,0.0201288288955014,EPCI
200067320,CC Serre-Ponçon Val d'Avance,1990_1999,1994.5,9,4754,5593,381,523,839,142,697,0.0182228740663697,0.00308420514591716,0.0151386689204525,EPCI
200067320,CC Serre-Ponçon Val d'Avance,1999_2006,2002.5,7,5593,6197,296,476,604,180,424,0.0147577630096112,0.00439800884392386,0.0103597541656873,EPCI
200067346,CA Pornic Agglo Pays de Retz,2006_2011,2008.5,5,47147,52128,2169,3081,4981,912,4069,0.0202894590478437,0.00371491400354015,0.0165745450443036,EPCI
200067346,CA Pornic Agglo Pays de Retz,2011_2016,2013.5,5,52128,56370,2616,2986,4242,370,3872,0.0157700288058074,0.00137550934892709,0.0143945194568803,EPCI
200067346,CA Pornic Agglo Pays de Retz,1968_1975,1971.5,7,26560,27591,2502,3145,1031,643,388,0.00545529881458595,0.00340228626360695,0.002053012550979,EPCI
200067346,CA Pornic Agglo Pays de Retz,1975_1982,1978.5,7,27591,30249,2524,2799,2658,275,2383,0.0132257673747735,0.0013683544123637,0.0118574129624098,EPCI
200067346,CA Pornic Agglo Pays de Retz,1982_1990,1986,8,30249,32770,3036,3255,2521,219,2302,0.0100565224195488,0.000873613014629586,0.00918290940491921,EPCI
200067346,CA Pornic Agglo Pays de Retz,1990_1999,1994.5,9,32770,38418,3565,3725,5648,160,5488,0.0178250744339219,0.000504959615691838,0.0173201148182301,EPCI
200067346,CA Pornic Agglo Pays de Retz,1999_2006,2002.5,7,38418,47147,3016,4086,8729,1070,7659,0.0296811414824576,0.00363831153468091,0.0260428299477767,EPCI
200067361,CC Grand-Figeac,2006_2011,2008.5,5,42423,42908,2656,1913,485,-743,1228,0.00227611056403454,-0.00348690752387147,0.00576301808790601,EPCI
200067361,CC Grand-Figeac,2011_2016,2013.5,5,42908,43499,2741,1723,591,-1018,1609,0.00273967819572984,-0.00471910728130792,0.00745878547703777,EPCI
200067361,CC Grand-Figeac,1968_1975,1971.5,7,42604,42113,3867,3755,-491,-112,-379,-0.00165458166220156,-0.000377419849626425,-0.00127716181257513,EPCI
200067361,CC Grand-Figeac,1975_1982,1978.5,7,42113,42073,3946,2936,-40,-1010,970,-0.000135744620096467,-0.0034275516574358,0.00329180703733933,EPCI
200067361,CC Grand-Figeac,1982_1990,1986,8,42073,40427,4374,2857,-1646,-1517,-129,-0.00497611867102643,-0.00458613124176616,-0.000389987429260274,EPCI
200067361,CC Grand-Figeac,1990_1999,1994.5,9,40427,39931,4684,3114,-496,-1570,1074,-0.00137071681794521,-0.00433876089551204,0.00296804407756684,EPCI
200067361,CC Grand-Figeac,1999_2006,2002.5,7,39931,42423,3619,2654,2492,-965,3457,0.00868574743699035,-0.00336346158775911,0.0120492090247495,EPCI
200067379,CC Côtes de Champagne et Val de Saulx,2006_2011,2008.5,5,11963,12340,542,696,377,154,223,0.00622478701860629,0.00254275119592936,0.00368203582267693,EPCI
200067379,CC Côtes de Champagne et Val de Saulx,2011_2016,2013.5,5,12340,11998,628,665,-342,37,-379,-0.00560544041079358,0.000606436535670651,-0.00621187694646423,EPCI
200067379,CC Côtes de Champagne et Val de Saulx,1968_1975,1971.5,7,13322,12995,977,1487,-327,510,-837,-0.00354401024675421,0.00552735543071758,-0.0090713656774718,EPCI
200067379,CC Côtes de Champagne et Val de Saulx,1975_1982,1978.5,7,12995,12797,908,1131,-198,223,-421,-0.00219101045881109,0.00246765319350946,-0.00465866365232056,EPCI
200067379,CC Côtes de Champagne et Val de Saulx,1982_1990,1986,8,12797,12230,984,1269,-567,285,-852,-0.00564883732368438,0.00283936267592601,-0.00848819999961038,EPCI
200067379,CC Côtes de Champagne et Val de Saulx,1990_1999,1994.5,9,12230,11792,1050,1100,-438,50,-488,-0.00404409102267556,0.000461654226332826,-0.00450574524900838,EPCI
200067379,CC Côtes de Champagne et Val de Saulx,1999_2006,2002.5,7,11792,11963,894,904,171,10,161,0.00205886194330729,0.000120401283234344,0.00193846066007294,EPCI
200067429,CC Haut Nivernais-Val d'Yonne,2006_2011,2008.5,5,13823,13553,1138,614,-270,-524,254,-0.0039374172544786,-0.00764150607906218,0.00370408882458358,EPCI
200067429,CC Haut Nivernais-Val d'Yonne,2011_2016,2013.5,5,13553,12655,1167,524,-898,-643,-255,-0.0136175371240336,-0.00975064183825567,-0.00386689528577791,EPCI
200067429,CC Haut Nivernais-Val d'Yonne,1968_1975,1971.5,7,16895,16365,1911,1468,-530,-443,-87,-0.00454290851959893,-0.00379718580034401,-0.000745722719254919,EPCI
200067429,CC Haut Nivernais-Val d'Yonne,1975_1982,1978.5,7,16365,15425,1994,1229,-940,-765,-175,-0.0084151552739139,-0.00684850402611078,-0.00156665124780312,EPCI
200067429,CC Haut Nivernais-Val d'Yonne,1982_1990,1986,8,15425,14781,2063,1297,-644,-766,122,-0.00531669079806707,-0.00632388998652077,0.0010071991884537,EPCI
200067429,CC Haut Nivernais-Val d'Yonne,1990_1999,1994.5,9,14781,14067,2218,1264,-714,-954,240,-0.00548611196041182,-0.00733018320760907,0.00184407124719725,EPCI
200067429,CC Haut Nivernais-Val d'Yonne,1999_2006,2002.5,7,14067,13823,1546,879,-244,-667,423,-0.00249655801578907,-0.00682460736283325,0.00432804934704417,EPCI
200067437,CA Provence-Alpes-Agglomération,2006_2011,2008.5,5,47180,47741,2208,2313,561,105,456,0.0023668953861633,0.000443001810244469,0.00192389357591884,EPCI
200067437,CA Provence-Alpes-Agglomération,2011_2016,2013.5,5,47741,47298,2480,2294,-443,-186,-257,-0.0018627741148437,-0.000782112833771848,-0.00108066128107185,EPCI
200067437,CA Provence-Alpes-Agglomération,1968_1975,1971.5,7,34650,36310,2497,3372,1660,875,785,0.00670746061197591,0.00353555905751742,0.00317190155445849,EPCI
200067437,CA Provence-Alpes-Agglomération,1975_1982,1978.5,7,36310,37478,2719,2717,1168,-2,1170,0.00453323110544512,-7.76238202987179e-06,0.004540993487475,EPCI
200067437,CA Provence-Alpes-Agglomération,1982_1990,1986,8,37478,40786,3173,3723,3308,550,2758,0.0106291916166597,0.00176724769926324,0.00886194391739641,EPCI
200067437,CA Provence-Alpes-Agglomération,1990_1999,1994.5,9,40786,42929,3835,4329,2143,494,1649,0.00570607385927469,0.00131535253685567,0.00439072132241902,EPCI
200067437,CA Provence-Alpes-Agglomération,1999_2006,2002.5,7,42929,47180,3052,3253,4251,201,4050,0.0135803125424316,0.000642117812521468,0.0129381947299102,EPCI
200067445,CC Buëch-Dévoluy,2006_2011,2008.5,5,8733,9235,477,431,502,-46,548,0.0112410430478749,-0.00103005573745467,0.0122710987853295,EPCI
200067445,CC Buëch-Dévoluy,2011_2016,2013.5,5,9235,9306,463,439,71,-24,95,0.00153292167935559,-0.000518170708514566,0.00205109238787016,EPCI
200067445,CC Buëch-Dévoluy,1968_1975,1971.5,7,7758,7305,734,624,-453,-110,-343,-0.00855824277535422,-0.00207816049732663,-0.00648008227802759,EPCI
200067445,CC Buëch-Dévoluy,1975_1982,1978.5,7,7305,7468,730,443,163,-287,450,0.0031575718718877,-0.00555965108731147,0.00871722295919917,EPCI
200067445,CC Buëch-Dévoluy,1982_1990,1986,8,7468,7611,811,630,143,-181,324,0.00237373079925862,-0.00300451241025042,0.00537824320950905,EPCI
200067445,CC Buëch-Dévoluy,1990_1999,1994.5,9,7611,7994,862,663,383,-199,582,0.00547009452060476,-0.00284216399373459,0.00831225851433935,EPCI
200067445,CC Buëch-Dévoluy,1999_2006,2002.5,7,7994,8733,712,514,739,-198,937,0.0127112082856105,-0.00340570939181444,0.0161169176774249,EPCI
200067452,CC du Guillestrois et du Queyras,2006_2011,2008.5,5,7829,8130,394,484,301,90,211,0.00757376408043364,0.00226458062205657,0.00530918345837707,EPCI
200067452,CC du Guillestrois et du Queyras,2011_2016,2013.5,5,8130,7987,351,432,-143,81,-224,-0.00354284996941034,0.00200678914351215,-0.0055496391129225,EPCI
200067452,CC du Guillestrois et du Queyras,1968_1975,1971.5,7,5346,5672,457,561,326,104,222,0.00849202173449148,0.00270911122818133,0.00578291050631015,EPCI
200067452,CC du Guillestrois et du Queyras,1975_1982,1978.5,7,5672,6900,523,614,1228,91,1137,0.0283926906738872,0.00210401860856981,0.0262886720653174,EPCI
200067452,CC du Guillestrois et du Queyras,1982_1990,1986,8,6900,7233,522,743,333,221,112,0.00590894890325355,0.00392155467753464,0.00198739422571891,EPCI
200067452,CC du Guillestrois et du Queyras,1990_1999,1994.5,9,7233,7599,616,829,366,213,153,0.00549982121601333,0.00320071562571268,0.00229910559030066,EPCI
200067452,CC du Guillestrois et du Queyras,1999_2006,2002.5,7,7599,7829,520,644,230,124,106,0.00426881816248237,0.00230144979194702,0.00196736837053535,EPCI
200067460,CC Loudéac Communauté - Bretagne Centre,2006_2011,2008.5,5,50750,51745,2942,2710,995,-232,1227,0.00389078777831675,-0.000907198758361293,0.00479798653667804,EPCI
200067460,CC Loudéac Communauté - Bretagne Centre,2011_2016,2013.5,5,51745,51352,3147,2727,-393,-420,27,-0.00152362312807131,-0.00162829952618307,0.000104676398111769,EPCI
200067460,CC Loudéac Communauté - Bretagne Centre,1968_1975,1971.5,7,52140,52001,4943,5623,-139,680,-819,-0.000381278629051796,0.00186524796946202,-0.00224652659851382,EPCI
200067460,CC Loudéac Communauté - Bretagne Centre,1975_1982,1978.5,7,52001,52010,4780,4734,9,-46,55,2.47229654977144e-05,-0.000126361823654985,0.000151084789152699,EPCI
200067460,CC Loudéac Communauté - Bretagne Centre,1982_1990,1986,8,52010,51204,5183,4990,-806,-193,-613,-0.00195038973709583,-0.000467028808014261,-0.00148336092908156,EPCI
200067460,CC Loudéac Communauté - Bretagne Centre,1990_1999,1994.5,9,51204,49483,5461,4850,-1721,-611,-1110,-0.0037915137415242,-0.00134608651718262,-0.00244542722434158,EPCI
200067460,CC Loudéac Communauté - Bretagne Centre,1999_2006,2002.5,7,49483,50750,4151,3958,1267,-193,1460,0.0036183077101315,-0.000551170787731159,0.00416947849786266,EPCI
200067478,CC Comtal Lot et Truyère,2006_2011,2008.5,5,19129,19018,1226,892,-111,-334,223,-0.00116324471638252,-0.00350021383127712,0.00233696911489461,EPCI
200067478,CC Comtal Lot et Truyère,2011_2016,2013.5,5,19018,19165,1319,796,147,-523,670,0.00154114629026392,-0.00548312591706142,0.00702427220732534,EPCI
200067478,CC Comtal Lot et Truyère,1968_1975,1971.5,7,17560,17685,1871,1462,125,-409,534,0.00101383278857758,-0.00331726088422586,0.00433109367280344,EPCI
200067478,CC Comtal Lot et Truyère,1975_1982,1978.5,7,17685,18468,1821,1449,783,-372,1155,0.00620814571957085,-0.00294946386676929,0.00915760958634014,EPCI
200067478,CC Comtal Lot et Truyère,1982_1990,1986,8,18468,18256,2111,1526,-212,-585,373,-0.00144217300821159,-0.00397958117831972,0.00253740817010813,EPCI
200067478,CC Comtal Lot et Truyère,1990_1999,1994.5,9,18256,18138,2205,1395,-118,-810,692,-0.000720252504033625,-0.00494410617175624,0.00422385366772261,EPCI
200067478,CC Comtal Lot et Truyère,1999_2006,2002.5,7,18138,19129,1745,1254,991,-491,1482,0.00762842402982433,-0.00377957234979187,0.0114079963796162,EPCI
200067486,CC Bouzonvillois-Trois Frontières,2006_2011,2008.5,5,23394,24747,904,1417,1353,513,840,0.0113084000318915,0.00428766387018502,0.00702073616170647,EPCI
200067486,CC Bouzonvillois-Trois Frontières,2011_2016,2013.5,5,24747,25131,1005,1258,384,253,131,0.0030843216206895,0.00203211815113136,0.00105220346955814,EPCI
200067486,CC Bouzonvillois-Trois Frontières,1968_1975,1971.5,7,20485,20588,1663,2337,103,674,-571,0.000716752571832346,0.00469020614966021,-0.00397345357782786,EPCI
200067486,CC Bouzonvillois-Trois Frontières,1975_1982,1978.5,7,20588,21065,1597,2010,477,413,64,0.00327743245280532,0.00283769308806834,0.000439739364736982,EPCI
200067486,CC Bouzonvillois-Trois Frontières,1982_1990,1986,8,21065,21699,1775,2274,634,499,135,0.00371353829843235,0.00292280064813524,0.000790737650297109,EPCI
200067486,CC Bouzonvillois-Trois Frontières,1990_1999,1994.5,9,21699,22090,1815,2123,391,308,83,0.00198628571236292,0.00156464449976414,0.000421641212598779,EPCI
200067486,CC Bouzonvillois-Trois Frontières,1999_2006,2002.5,7,22090,23394,1379,1817,1304,438,866,0.00822716748623042,0.00276341975381053,0.0054637477324199,EPCI
200067502,CA Saint-Avold Synergie,2006_2011,2008.5,5,55959,55184,2416,3109,-775,693,-1468,-0.00278535837833882,0.00249064949185652,-0.00527600787019534,EPCI
200067502,CA Saint-Avold Synergie,2011_2016,2013.5,5,55184,53373,2502,2994,-1811,492,-2303,-0.0066513921260869,0.00180700437660671,-0.00845839650269361,EPCI
200067502,CA Saint-Avold Synergie,1968_1975,1971.5,7,51752,53445,2872,6856,1693,3984,-2291,0.00460916237374676,0.0108463691063243,-0.00623720673257757,EPCI
200067502,CA Saint-Avold Synergie,1975_1982,1978.5,7,53445,54924,2954,6202,1479,3248,-1769,0.00390723107847424,0.00858058589782578,-0.00467335481935154,EPCI
200067502,CA Saint-Avold Synergie,1982_1990,1986,8,54924,56093,3522,7060,1169,3538,-2369,0.00263604528622285,0.00797803954033914,-0.00534199425411629,EPCI
200067502,CA Saint-Avold Synergie,1990_1999,1994.5,9,56093,56064,3905,6335,-29,2430,-2459,-5.74574876779366e-05,0.00481454120887538,-0.00487199869655331,EPCI
200067502,CA Saint-Avold Synergie,1999_2006,2002.5,7,56064,55959,3235,4450,-105,1215,-1320,-0.000267766370383393,0.00309843942872212,-0.00336620579910552,EPCI
200067510,CC Monts et Vallées Ouest Creuse,2006_2011,2008.5,5,25641,26217,2226,990,576,-1236,1812,0.00445296962694863,-0.00955533065782727,0.0140083002847759,EPCI
200067510,CC Monts et Vallées Ouest Creuse,2011_2016,2013.5,5,26217,25119,2223,844,-1098,-1379,281,-0.00852020028042866,-0.0107006886946367,0.00218048841420806,EPCI
200067510,CC Monts et Vallées Ouest Creuse,1968_1975,1971.5,7,33874,30862,3874,2235,-3012,-1639,-1373,-0.013215061911273,-0.00719106456592842,-0.00602399734534455,EPCI
200067510,CC Monts et Vallées Ouest Creuse,1975_1982,1978.5,7,30862,29003,3854,1625,-1859,-2229,370,-0.00883592894224716,-0.0105945592319897,0.00175863028974258,EPCI
200067510,CC Monts et Vallées Ouest Creuse,1982_1990,1986,8,29003,27059,4172,1679,-1944,-2493,549,-0.00863495349604548,-0.0110735283259472,0.00243857482990173,EPCI
200067510,CC Monts et Vallées Ouest Creuse,1990_1999,1994.5,9,27059,25613,4160,1781,-1446,-2379,933,-0.0060836008436701,-0.0100089117614738,0.00392531091780374,EPCI
200067510,CC Monts et Vallées Ouest Creuse,1999_2006,2002.5,7,25613,25641,3100,1418,28,-1682,1710,0.000156097576188508,-0.00937700439818106,0.00953310197436956,EPCI
200067544,CC Creuse Confluence,2006_2011,2008.5,5,17405,17434,1395,708,29,-687,716,0.000333015702618233,-0.00788902716202505,0.00822204286464328,EPCI
200067544,CC Creuse Confluence,2011_2016,2013.5,5,17434,16893,1486,632,-541,-854,313,-0.00628476525481081,-0.00992086788837048,0.00363610263355967,EPCI
200067544,CC Creuse Confluence,1968_1975,1971.5,7,23628,21500,2881,1587,-2128,-1294,-834,-0.0133923020987151,-0.00814362731002695,-0.00524867478868816,EPCI
200067544,CC Creuse Confluence,1975_1982,1978.5,7,21500,20169,2649,1152,-1331,-1497,166,-0.00908790493816214,-0.0102213326013739,0.00113342766321181,EPCI
200067544,CC Creuse Confluence,1982_1990,1986,8,20169,18472,2823,1263,-1697,-1560,-137,-0.0109262081089726,-0.0100441276664686,-0.000882080442503977,EPCI
200067544,CC Creuse Confluence,1990_1999,1994.5,9,18472,17337,2900,1280,-1135,-1620,485,-0.00702113871660504,-0.0100213609875772,0.0030002222709722,EPCI
200067544,CC Creuse Confluence,1999_2006,2002.5,7,17337,17405,2211,956,68,-1255,1323,0.000559381432566175,-0.010323877909861,0.0108832593424272,EPCI
200067551,CA Thonon Agglomération,2006_2011,2008.5,5,73084,81043,2763,4730,7959,1967,5992,0.0208892719282767,0.00516260810188721,0.0157266638263895,EPCI
200067551,CA Thonon Agglomération,2011_2016,2013.5,5,81043,86983,3045,5292,5940,2247,3693,0.0142471000055124,0.00538943328491354,0.00885766672059889,EPCI
200067551,CA Thonon Agglomération,1968_1975,1971.5,7,35546,44322,2701,4418,8776,1717,7059,0.0320240113841788,0.00626540879063753,0.0257586025935412,EPCI
200067551,CA Thonon Agglomération,1975_1982,1978.5,7,44322,48943,2963,4311,4621,1348,3273,0.0142687241233652,0.00416235449432943,0.0101063696290358,EPCI
200067551,CA Thonon Agglomération,1982_1990,1986,8,48943,58778,3714,5667,9835,1953,7882,0.0231528711232314,0.00459761640098331,0.0185552547222481,EPCI
200067551,CA Thonon Agglomération,1990_1999,1994.5,9,58778,64612,4348,6998,5834,2650,3184,0.0105701980629547,0.00480134125245627,0.0057688568104984,EPCI
200067551,CA Thonon Agglomération,1999_2006,2002.5,7,64612,73084,3580,5718,8472,2138,6334,0.0177571466207014,0.00448120626476151,0.0132759403559399,EPCI
200067593,CC Marche et Combraille en Aquitaine,2006_2011,2008.5,5,14453,14194,1290,559,-259,-731,472,-0.00361000129355382,-0.01018884534976,0.00657884405620619,EPCI
200067593,CC Marche et Combraille en Aquitaine,2011_2016,2013.5,5,14194,13723,1122,491,-471,-631,160,-0.00672649175457751,-0.00901149956929599,0.00228500781471848,EPCI
200067593,CC Marche et Combraille en Aquitaine,1968_1975,1971.5,7,21610,19587,2743,1615,-2023,-1128,-895,-0.013943320131497,-0.00777462437386487,-0.00616869575763214,EPCI
200067593,CC Marche et Combraille en Aquitaine,1975_1982,1978.5,7,19587,17951,2490,1055,-1636,-1435,-201,-0.0123827318896034,-0.0108613815779834,-0.00152135031161997,EPCI
200067593,CC Marche et Combraille en Aquitaine,1982_1990,1986,8,17951,16280,2615,1084,-1671,-1531,-140,-0.0121392751176868,-0.0111222203501965,-0.00101705476749021,EPCI
200067593,CC Marche et Combraille en Aquitaine,1990_1999,1994.5,9,16280,14789,2500,1047,-1491,-1453,-38,-0.0106158827869,-0.0103453237353224,-0.000270559051577598,EPCI
200067593,CC Marche et Combraille en Aquitaine,1999_2006,2002.5,7,14789,14453,1882,789,-336,-1093,757,-0.00327771021503165,-0.0106623132887785,0.0073846030737469,EPCI
200067627,CC Billom Communauté,2006_2011,2008.5,5,22772,24542,1168,1487,1770,319,1451,0.0150834693172379,0.00271843317073384,0.0123650361465041,EPCI
200067627,CC Billom Communauté,2011_2016,2013.5,5,24542,25512,1248,1383,970,135,835,0.00778272803454438,0.00108316318006546,0.00669956485447893,EPCI
200067627,CC Billom Communauté,1968_1975,1971.5,7,14893,15140,1675,1423,247,-252,499,0.00235261221730521,-0.00240023594640045,0.00475284816370566,EPCI
200067627,CC Billom Communauté,1975_1982,1978.5,7,15140,16463,1542,1195,1323,-347,1670,0.0120397860584685,-0.00315782748472302,0.0151976135431915,EPCI
200067627,CC Billom Communauté,1982_1990,1986,8,16463,17928,1742,1639,1465,-103,1568,0.0107130149997081,-0.000753201737180844,0.011466216736889,EPCI
200067627,CC Billom Communauté,1990_1999,1994.5,9,17928,19585,1920,1775,1657,-145,1802,0.00987064444764107,-0.000863755850879877,0.010734400298521,EPCI
200067627,CC Billom Communauté,1999_2006,2002.5,7,19585,22772,1662,1835,3187,173,3014,0.0217718714840198,0.0011818430394526,0.0205900284445672,EPCI
200067635,CA Clisson Sèvre et Maine Agglo,2006_2011,2008.5,5,47059,51206,1721,3747,4147,2026,2121,0.0170343739081693,0.00832207415913938,0.00871229974902993,EPCI
200067635,CA Clisson Sèvre et Maine Agglo,2011_2016,2013.5,5,51206,54124,1855,3307,2918,1452,1466,0.0111458568809708,0.00554619060698068,0.00559966627399013,EPCI
200067635,CA Clisson Sèvre et Maine Agglo,1968_1975,1971.5,7,26647,29016,2194,3437,2369,1243,1126,0.0122415834004985,0.00642308491634431,0.00581849848415422,EPCI
200067635,CA Clisson Sèvre et Maine Agglo,1975_1982,1978.5,7,29016,34256,2223,3761,5240,1538,3702,0.0239998015701057,0.00704421656771424,0.0169555850023915,EPCI
200067635,CA Clisson Sèvre et Maine Agglo,1982_1990,1986,8,34256,37702,2455,4263,3446,1808,1638,0.0120534912650567,0.00632406041997172,0.005729430845085,EPCI
200067635,CA Clisson Sèvre et Maine Agglo,1990_1999,1994.5,9,37702,41113,2792,4514,3411,1722,1689,0.00966992445732706,0.00488173846834277,0.00478818598898429,EPCI
200067635,CA Clisson Sèvre et Maine Agglo,1999_2006,2002.5,7,41113,47059,2414,4425,5946,2011,3935,0.0194842099876611,0.0065897656046395,0.0128944443830216,EPCI
200067643,"CC Meurthe, Mortagne, Moselle",2006_2011,2008.5,5,15970,16847,839,1021,877,182,695,0.0107494924992029,0.00223079547873994,0.00851869702046294,EPCI
200067643,"CC Meurthe, Mortagne, Moselle",2011_2016,2013.5,5,16847,16803,907,885,-44,-22,-22,-0.000522894744520386,-0.000261447372260193,-0.000261447372260193,EPCI
200067643,"CC Meurthe, Mortagne, Moselle",1968_1975,1971.5,7,15232,14781,1266,1549,-451,283,-734,-0.00428449607674852,0.00268849753818145,-0.00697299361492997,EPCI
200067643,"CC Meurthe, Mortagne, Moselle",1975_1982,1978.5,7,14781,15322,1352,1278,541,-74,615,0.00514851282834861,-0.000704232808313858,0.00585274563666246,EPCI
200067643,"CC Meurthe, Mortagne, Moselle",1982_1990,1986,8,15322,15059,1468,1618,-263,150,-413,-0.00216189535442834,0.00123302016412263,-0.00339491551855097,EPCI
200067643,"CC Meurthe, Mortagne, Moselle",1990_1999,1994.5,9,15059,15270,1629,1564,211,-65,276,0.00154722907300431,-0.00047663454855583,0.00202386362156014,EPCI
200067643,"CC Meurthe, Mortagne, Moselle",1999_2006,2002.5,7,15270,15970,1232,1235,700,3,697,0.00642366422839791,2.75299895502767e-05,0.00639613423884763,EPCI
200067650,CC Houve-Pays Boulageois,2006_2011,2008.5,5,21311,22908,856,1362,1597,506,1091,0.0145575079085916,0.00461246023904028,0.00994504766955128,EPCI
200067650,CC Houve-Pays Boulageois,2011_2016,2013.5,5,22908,23221,924,1197,313,273,40,0.00271785611910813,0.00237052626363105,0.000347329855477078,EPCI
200067650,CC Houve-Pays Boulageois,1968_1975,1971.5,7,17139,17846,1280,1895,707,615,92,0.00579139495477321,0.00503777637508561,0.000753618579687603,EPCI
200067650,CC Houve-Pays Boulageois,1975_1982,1978.5,7,17846,19451,1359,1830,1605,471,1134,0.0123787168747433,0.00363263280249478,0.00874608407224857,EPCI
200067650,CC Houve-Pays Boulageois,1982_1990,1986,8,19451,20162,1436,2149,711,713,-2,0.00449772981051377,0.00451038165245615,-1.26518419423741e-05,EPCI
200067650,CC Houve-Pays Boulageois,1990_1999,1994.5,9,20162,20180,1581,1831,18,250,-232,9.91571706043803e-05,0.00137718292506084,-0.00127802575445646,EPCI
200067650,CC Houve-Pays Boulageois,1999_2006,2002.5,7,20180,21311,1247,1501,1131,254,877,0.00782061628009112,0.00175635414247847,0.00606426213761265,EPCI
200067668,"CC de la Cléry, du Betz et de l'Ouanne",2006_2011,2008.5,5,19545,20673,1047,1069,1128,22,1106,0.0112850009481953,0.000220097536223667,0.0110649034119716,EPCI
200067668,"CC de la Cléry, du Betz et de l'Ouanne",2011_2016,2013.5,5,20673,20509,1154,1071,-164,-83,-81,-0.00159166931898225,-0.000805539960216625,-0.000786129358765622,EPCI
200067668,"CC de la Cléry, du Betz et de l'Ouanne",1968_1975,1971.5,7,13619,13310,1259,1188,-309,-71,-238,-0.0032732375506811,-0.000752103126531902,-0.00252113442414919,EPCI
200067668,"CC de la Cléry, du Betz et de l'Ouanne",1975_1982,1978.5,7,13310,14562,1294,1069,1252,-225,1477,0.0129256466041265,-0.00232289974914415,0.0152485463532707,EPCI
200067668,"CC de la Cléry, du Betz et de l'Ouanne",1982_1990,1986,8,14562,16101,1564,1320,1539,-244,1783,0.0126374341673374,-0.00200359580040957,0.014641029967747,EPCI
200067668,"CC de la Cléry, du Betz et de l'Ouanne",1990_1999,1994.5,9,16101,17743,1710,1550,1642,-160,1802,0.0108483871760556,-0.00105709010241711,0.0119054772784727,EPCI
200067668,"CC de la Cléry, du Betz et de l'Ouanne",1999_2006,2002.5,7,17743,19545,1367,1411,1802,44,1758,0.0139142613959002,0.000339748890909884,0.0135745125049904,EPCI
200067676,CC Canaux et Forêts en Gâtinais,2006_2011,2008.5,5,26858,28184,1524,1564,1326,40,1286,0.00968473905299727,0.000292148991040642,0.00939259006195663,EPCI
200067676,CC Canaux et Forêts en Gâtinais,2011_2016,2013.5,5,28184,27870,1632,1488,-314,-144,-170,-0.00223821137015467,-0.00102644088312826,-0.00121177048702642,EPCI
200067676,CC Canaux et Forêts en Gâtinais,1968_1975,1971.5,7,19859,20120,1958,1846,261,-112,373,0.00186703221681128,-0.000801178575796412,0.00266821079260769,EPCI
200067676,CC Canaux et Forêts en Gâtinais,1975_1982,1978.5,7,20120,21679,2064,1532,1559,-532,2091,0.0107184214929665,-0.00365760117656074,0.0143760226695273,EPCI
200067676,CC Canaux et Forêts en Gâtinais,1982_1990,1986,8,21679,23020,2343,1987,1341,-356,1697,0.00753063281528044,-0.00199918365565983,0.00952981647094027,EPCI
200067676,CC Canaux et Forêts en Gâtinais,1990_1999,1994.5,9,23020,24524,2607,2308,1504,-299,1803,0.00705687506160846,-0.00140292928418945,0.00845980434579791,EPCI
200067676,CC Canaux et Forêts en Gâtinais,1999_2006,2002.5,7,24524,26858,2028,2114,2334,86,2248,0.0130720589014921,0.000481661124905022,0.0125903977765871,EPCI
200067684,"CA Épernay, Coteaux et Plaine de Champagne",2006_2011,2008.5,5,49494,49432,2517,2848,-62,331,-393,-0.000250661048862844,0.00133820656731615,-0.00158886761617899,EPCI
200067684,"CA Épernay, Coteaux et Plaine de Champagne",2011_2016,2013.5,5,49432,48451,2545,2714,-981,169,-1150,-0.00400097663973653,0.000689261011330758,-0.00469023765106729,EPCI
200067684,"CA Épernay, Coteaux et Plaine de Champagne",1968_1975,1971.5,7,49897,53517,4113,6559,3620,2446,1174,0.0100557194501767,0.00679455518650061,0.00326116426367609,EPCI
200067684,"CA Épernay, Coteaux et Plaine de Champagne",1975_1982,1978.5,7,53517,51773,3970,5313,-1744,1343,-3087,-0.00472175765612948,0.00363607828680154,-0.00835783594293102,EPCI
200067684,"CA Épernay, Coteaux et Plaine de Champagne",1982_1990,1986,8,51773,51182,4522,5897,-591,1375,-1966,-0.00143407948895768,0.00333647935248192,-0.00477055884143961,EPCI
200067684,"CA Épernay, Coteaux et Plaine de Champagne",1990_1999,1994.5,9,51182,50164,4830,5892,-1018,1062,-2080,-0.00222976257468377,0.0023261373814481,-0.00455589995613187,EPCI
200067684,"CA Épernay, Coteaux et Plaine de Champagne",1999_2006,2002.5,7,50164,49494,3528,4331,-670,803,-1473,-0.00191904026238776,0.00229998407566772,-0.00421902433805548,EPCI
200067692,CC Tannay-Brinon-Corbigny,2006_2011,2008.5,5,10622,10292,865,325,-330,-540,210,-0.00629220615309878,-0.0102963373414344,0.00400413118833559,EPCI
200067692,CC Tannay-Brinon-Corbigny,2011_2016,2013.5,5,10292,9902,873,316,-390,-557,167,-0.00769625846041555,-0.0109918358011576,0.00329557734074204,EPCI
200067692,CC Tannay-Brinon-Corbigny,1968_1975,1971.5,7,13847,12977,1810,912,-870,-898,28,-0.00922717208371071,-0.00952413854157726,0.000296966457866553,EPCI
200067692,CC Tannay-Brinon-Corbigny,1975_1982,1978.5,7,12977,11725,1738,693,-1252,-1045,-207,-0.0143890797734667,-0.012010054603253,-0.00237902517021374,EPCI
200067692,CC Tannay-Brinon-Corbigny,1982_1990,1986,8,11725,10875,1756,771,-850,-985,135,-0.00936298389670798,-0.0108500460450087,0.00148706214830068,EPCI
200067692,CC Tannay-Brinon-Corbigny,1990_1999,1994.5,9,10875,10507,1763,753,-368,-1010,642,-0.00381768019942208,-0.0104778722864573,0.00666019208703526,EPCI
200067692,CC Tannay-Brinon-Corbigny,1999_2006,2002.5,7,10507,10622,1288,599,115,-689,804,0.00155629839068716,-0.00932425731463873,0.0108805557053259,EPCI
200067700,CC Sud Nivernais,2006_2011,2008.5,5,22564,22275,1516,1081,-289,-435,146,-0.00257482793357089,-0.0038756060591811,0.00130077812561021,EPCI
200067700,CC Sud Nivernais,2011_2016,2013.5,5,22275,21405,1481,936,-870,-545,-325,-0.00793642569723452,-0.00497166897125611,-0.00296475672597841,EPCI
200067700,CC Sud Nivernais,1968_1975,1971.5,7,28371,26914,2229,2904,-1457,675,-2132,-0.00750326594867212,0.00347611840449807,-0.0109793843531702,EPCI
200067700,CC Sud Nivernais,1975_1982,1978.5,7,26914,26560,2258,2289,-354,31,-385,-0.00188967983275223,0.00016548043733141,-0.00205516027008364,EPCI
200067700,CC Sud Nivernais,1982_1990,1986,8,26560,25176,2545,2257,-1384,-288,-1096,-0.00666707140518708,-0.00138736746003893,-0.00527970394514815,EPCI
200067700,CC Sud Nivernais,1990_1999,1994.5,9,25176,23253,2842,2061,-1923,-781,-1142,-0.0087896987121191,-0.00356981523357515,-0.00521988347854395,EPCI
200067700,CC Sud Nivernais,1999_2006,2002.5,7,23253,22564,2170,1549,-689,-621,-68,-0.00428770146054425,-0.00386453208562841,-0.000423169374915832,EPCI
200067742,CC Serre-Ponçon,2006_2011,2008.5,5,14966,15406,754,806,440,52,388,0.00581204120672396,0.000686877597158286,0.00512516360956568,EPCI
200067742,CC Serre-Ponçon,2011_2016,2013.5,5,15406,16105,856,759,699,-97,796,0.00891404331812828,-0.00123699885816659,0.0101510421762949,EPCI
200067742,CC Serre-Ponçon,1968_1975,1971.5,7,9186,9422,807,835,236,28,208,0.00363040177021379,0.000430725633754178,0.00319967613645961,EPCI
200067742,CC Serre-Ponçon,1975_1982,1978.5,7,9422,10728,819,908,1306,89,1217,0.0187172646961551,0.00127552569522037,0.0174417390009347,EPCI
200067742,CC Serre-Ponçon,1982_1990,1986,8,10728,11966,950,1282,1238,332,906,0.0137451260802097,0.00368609196981392,0.0100590341103958,EPCI
200067742,CC Serre-Ponçon,1990_1999,1994.5,9,11966,13351,1096,1232,1385,136,1249,0.0122434552702977,0.00120224542726389,0.0110412098430338,EPCI
200067742,CC Serre-Ponçon,1999_2006,2002.5,7,13351,14966,1053,1027,1615,-26,1641,0.0164465908114575,-0.000264774836593124,0.0167113656480506,EPCI
200067759,CC Vallées et Plateau d'Ardenne,2006_2011,2008.5,5,25796,26002,1166,1582,206,416,-210,0.00159206939732481,0.00321505276352972,-0.00162298336620491,EPCI
200067759,CC Vallées et Plateau d'Ardenne,2011_2016,2013.5,5,26002,25375,1185,1357,-627,172,-799,-0.00486990751659189,0.00133592359306827,-0.00620583110966016,EPCI
200067759,CC Vallées et Plateau d'Ardenne,1968_1975,1971.5,7,28254,27688,2298,3647,-566,1349,-1915,-0.00288667325987568,0.00688007460701819,-0.00976674786689387,EPCI
200067759,CC Vallées et Plateau d'Ardenne,1975_1982,1978.5,7,27688,27094,2232,2842,-594,610,-1204,-0.00309332081885305,0.00317664259175145,-0.0062699634106045,EPCI
200067759,CC Vallées et Plateau d'Ardenne,1982_1990,1986,8,27094,26185,2282,2873,-909,591,-1500,-0.00425661151708223,0.00276749989724488,-0.00702411141432712,EPCI
200067759,CC Vallées et Plateau d'Ardenne,1990_1999,1994.5,9,26185,25948,2225,2848,-237,623,-860,-0.00100973347358335,0.00265427828709885,-0.00366401176068221,EPCI
200067759,CC Vallées et Plateau d'Ardenne,1999_2006,2002.5,7,25948,25796,1734,2298,-152,564,-716,-0.000838947058777517,0.00311293513914816,-0.00395188219792567,EPCI
200067767,CC du Royans-Vercors,2006_2011,2008.5,5,9321,9608,469,490,287,21,266,0.00608366390971638,0.000445146139735345,0.00563851776998103,EPCI
200067767,CC du Royans-Vercors,2011_2016,2013.5,5,9608,9671,482,443,63,-39,102,0.00130798105347352,-0.000809702556912177,0.00211768361038569,EPCI
200067767,CC du Royans-Vercors,1968_1975,1971.5,7,8062,7654,758,746,-408,-12,-396,-0.00739158652932914,-0.000217399603803798,-0.00717418692552534,EPCI
200067767,CC du Royans-Vercors,1975_1982,1978.5,7,7654,8186,673,669,532,-4,536,0.0096457938166461,-7.25247655386925e-05,0.00971831858218479,EPCI
200067767,CC du Royans-Vercors,1982_1990,1986,8,8186,8422,757,788,236,31,205,0.00355906243393433,0.00046750396377951,0.00309155847015483,EPCI
200067767,CC du Royans-Vercors,1990_1999,1994.5,9,8422,8596,821,837,174,16,158,0.00227476659128856,0.000209173939428833,0.00206559265185972,EPCI
200067767,CC du Royans-Vercors,1999_2006,2002.5,7,8596,9321,593,645,725,52,673,0.0116347258763643,0.000834490683546127,0.0108002351928181,EPCI
200067783,CC de Hanau-La Petite Pierre,2006_2011,2008.5,5,26606,27154,1383,1444,548,61,487,0.00408584658732125,0.000454811390194519,0.00363103519712673,EPCI
200067783,CC de Hanau-La Petite Pierre,2011_2016,2013.5,5,27154,27032,1340,1282,-122,-58,-64,-0.000900197731917407,-0.000427962856157456,-0.000472234875759951,EPCI
200067783,CC de Hanau-La Petite Pierre,1968_1975,1971.5,7,24988,25382,2343,2550,394,207,187,0.00223743529622134,0.00117550534598431,0.00106192995023703,EPCI
200067783,CC de Hanau-La Petite Pierre,1975_1982,1978.5,7,25382,25336,2305,2211,-46,-94,48,-0.000259102448823212,-0.000529470221508303,0.000270367772685091,EPCI
200067783,CC de Hanau-La Petite Pierre,1982_1990,1986,8,25336,25391,2608,2448,55,-160,215,0.000271095650977715,-0.000788641893753353,0.00105973754473107,EPCI
200067783,CC de Hanau-La Petite Pierre,1990_1999,1994.5,9,25391,25528,2579,2412,137,-167,304,0.000598079717291977,-0.000729046078742775,0.00132712579603475,EPCI
200067783,CC de Hanau-La Petite Pierre,1999_2006,2002.5,7,25528,26606,1874,1967,1078,93,985,0.0059261858116082,0.000511257217513509,0.00541492859409469,EPCI
200067791,CA Pays Foix-Varilhes,2006_2011,2008.5,5,29670,31272,1284,1626,1602,342,1260,0.0105728404514684,0.00225712324244832,0.00831571720902013,EPCI
200067791,CA Pays Foix-Varilhes,2011_2016,2013.5,5,31272,31813,1435,1484,541,49,492,0.00343626703303701,0.000311233058445127,0.00312503397459188,EPCI
200067791,CA Pays Foix-Varilhes,1968_1975,1971.5,7,21693,22167,2203,1912,474,-291,765,0.00309263931683379,-0.0018986456565372,0.00499128497337099,EPCI
200067791,CA Pays Foix-Varilhes,1975_1982,1978.5,7,22167,23428,2097,1705,1261,-392,1653,0.00793520268882308,-0.00246677196987998,0.0104019746587031,EPCI
200067791,CA Pays Foix-Varilhes,1982_1990,1986,8,23428,26214,2208,2019,2786,-189,2975,0.0141443138275608,-0.000959538877749097,0.0151038527053099,EPCI
200067791,CA Pays Foix-Varilhes,1990_1999,1994.5,9,26214,27307,2582,2383,1093,-199,1292,0.00454914501716508,-0.000828252386473788,0.00537739740363887,EPCI
200067791,CA Pays Foix-Varilhes,1999_2006,2002.5,7,27307,29670,1886,2036,2363,150,2213,0.0119267567891737,0.00075709416774272,0.0111696626214309,EPCI
200067817,CC Saône-Beaujolais,2006_2011,2008.5,5,37484,41595,1569,2717,4111,1148,2963,0.0210312627965052,0.00587299676243932,0.0151582660340659,EPCI
200067817,CC Saône-Beaujolais,2011_2016,2013.5,5,41595,43868,1711,2679,2273,968,1305,0.0106978485595055,0.00455588095275026,0.00614196760675525,EPCI
200067817,CC Saône-Beaujolais,1968_1975,1971.5,7,31134,31267,2652,3457,133,805,-672,0.000609150979203665,0.00368696645307482,-0.00307781547387115,EPCI
200067817,CC Saône-Beaujolais,1975_1982,1978.5,7,31267,31451,2618,2859,184,241,-57,0.000838572959477091,0.00109834827844554,-0.000259775318968447,EPCI
200067817,CC Saône-Beaujolais,1982_1990,1986,8,31451,31914,2697,3374,463,677,-214,0.0018284202561758,0.00267352162728081,-0.000845101371105013,EPCI
200067817,CC Saône-Beaujolais,1990_1999,1994.5,9,31914,33987,3000,4049,2073,1049,1024,0.00701709564211339,0.0035508602646295,0.00346623537748389,EPCI
200067817,CC Saône-Beaujolais,1999_2006,2002.5,7,33987,37484,2404,3086,3497,682,2815,0.0140891983353653,0.00274773613517847,0.0113414622001868,EPCI
200067825,CA Gap-Tallard-Durance,2006_2011,2008.5,5,45060,49241,2035,2636,4181,601,3580,0.0179047367918292,0.00257372561872504,0.0153310111731042,EPCI
200067825,CA Gap-Tallard-Durance,2011_2016,2013.5,5,49241,50322,2174,2580,1081,406,675,0.00435259462830073,0.0016347395181222,0.00271785511017853,EPCI
200067825,CA Gap-Tallard-Durance,1968_1975,1971.5,7,28366,32115,1916,3404,3749,1488,2261,0.0178913036091155,0.00710116291554118,0.0107901406935743,EPCI
200067825,CA Gap-Tallard-Durance,1975_1982,1978.5,7,32115,35223,2109,3090,3108,981,2127,0.0132840402600569,0.00419293548748901,0.00909110477256791,EPCI
200067825,CA Gap-Tallard-Durance,1982_1990,1986,8,35223,38664,2559,3913,3441,1354,2087,0.011719346720342,0.00461144884026245,0.00710789788007957,EPCI
200067825,CA Gap-Tallard-Durance,1990_1999,1994.5,9,38664,42508,3148,4362,3844,1214,2630,0.0105871356027618,0.00334359589535714,0.00724353970740467,EPCI
200067825,CA Gap-Tallard-Durance,1999_2006,2002.5,7,42508,45060,2556,3682,2552,1126,1426,0.00836373097804399,0.00369026688137835,0.00467346409666565,EPCI
200067841,CC de l'Alsace Bossue,2006_2011,2008.5,5,25198,25267,1278,1328,69,50,19,0.000547063628132838,0.000396422918936839,0.000150640709195999,EPCI
200067841,CC de l'Alsace Bossue,2011_2016,2013.5,5,25267,24763,1315,1148,-504,-167,-337,-0.00402161015176161,-0.00133255733203212,-0.00268905281972949,EPCI
200067841,CC de l'Alsace Bossue,1968_1975,1971.5,7,24737,24893,2177,2563,156,386,-230,0.000898480671257529,0.00222316371221414,-0.00132468304095661,EPCI
200067841,CC de l'Alsace Bossue,1975_1982,1978.5,7,24893,24838,2098,2108,-55,10,-65,-0.000315935928006161,5.74428960011202e-05,-0.000373378824007282,EPCI
200067841,CC de l'Alsace Bossue,1982_1990,1986,8,24838,24712,2228,2424,-126,196,-322,-0.000635520834729064,0.0009885879651341,-0.00162410879986316,EPCI
200067841,CC de l'Alsace Bossue,1990_1999,1994.5,9,24712,25107,2266,2505,395,239,156,0.00176352386048473,0.00106704355102747,0.00069648030945726,EPCI
200067841,CC de l'Alsace Bossue,1999_2006,2002.5,7,25107,25198,1725,1839,91,114,-23,0.000516981384491855,0.000647647009143642,-0.000130665624651787,EPCI
200067866,CC Sèvre et Loire,2006_2011,2008.5,5,40284,44537,1190,3433,4253,2243,2010,0.0202760085587101,0.0106934134016428,0.00958259515706734,EPCI
200067866,CC Sèvre et Loire,2011_2016,2013.5,5,44537,46817,1363,3111,2280,1748,532,0.0100352347045714,0.00769367994017137,0.00234155476439998,EPCI
200067866,CC Sèvre et Loire,1968_1975,1971.5,7,22532,23961,1778,2878,1429,1100,329,0.00882312309819189,0.00679176725543113,0.00203135584276076,EPCI
200067866,CC Sèvre et Loire,1975_1982,1978.5,7,23961,28461,1768,3138,4500,1370,3130,0.0248914922654222,0.00757807653413965,0.0173134157312826,EPCI
200067866,CC Sèvre et Loire,1982_1990,1986,8,28461,30932,2004,3522,2471,1518,953,0.0104614065558541,0.0064267159659193,0.00403469058993485,EPCI
200067866,CC Sèvre et Loire,1990_1999,1994.5,9,30932,34060,2274,3885,3128,1611,1517,0.010761091653906,0.00554223742149701,0.00521885423240904,EPCI
200067866,CC Sèvre et Loire,1999_2006,2002.5,7,34060,40284,1693,4209,6224,2516,3708,0.024265543907311,0.00980914339183714,0.0144564005154738,EPCI
200067874,CA de Haguenau,2006_2011,2008.5,5,93730,95183,3687,5741,1453,2054,-601,0.00308134675214888,0.00435587489945892,-0.00127452814731003,EPCI
200067874,CA de Haguenau,2011_2016,2013.5,5,95183,95800,3920,5414,617,1494,-877,0.00129310144640549,0.0031311078783303,-0.00183800643192482,EPCI
200067874,CA de Haguenau,1968_1975,1971.5,7,65908,70778,5631,8071,4870,2440,2430,0.0102360893744211,0.00512855401921715,0.00510753535520396,EPCI
200067874,CA de Haguenau,1975_1982,1978.5,7,70778,75522,5214,7221,4744,2007,2737,0.00931105012924993,0.00393913946235342,0.00537191066689651,EPCI
200067874,CA de Haguenau,1982_1990,1986,8,75522,78613,5890,8447,3091,2557,534,0.00502672626198741,0.00415831091941178,0.000868415342575632,EPCI
200067874,CA de Haguenau,1990_1999,1994.5,9,78613,86916,6521,10182,8303,3661,4642,0.0112185787399679,0.00494655145935475,0.00627202728061315,EPCI
200067874,CA de Haguenau,1999_2006,2002.5,7,86916,93730,5128,8191,6814,3063,3751,0.0108406491334205,0.00487304201580086,0.00596760711761967,EPCI
200067882,CC Bazois Loire Morvan,2006_2011,2008.5,5,17251,16691,1388,578,-560,-810,250,-0.00657835939383067,-0.00951512698036221,0.00293676758653155,EPCI
200067882,CC Bazois Loire Morvan,2011_2016,2013.5,5,16691,15671,1466,523,-1020,-943,-77,-0.0125323638777768,-0.0115862932713172,-0.000946070606459619,EPCI
200067882,CC Bazois Loire Morvan,1968_1975,1971.5,7,24377,22640,2894,1675,-1737,-1219,-518,-0.0105046950092206,-0.00737203409109953,-0.00313266091812105,EPCI
200067882,CC Bazois Loire Morvan,1975_1982,1978.5,7,22640,21017,2741,1342,-1623,-1399,-224,-0.0105703964222031,-0.00911151238118435,-0.00145888404101879,EPCI
200067882,CC Bazois Loire Morvan,1982_1990,1986,8,21017,18886,2933,1339,-2131,-1594,-537,-0.0132749412330416,-0.009929730795621,-0.00334521043742063,EPCI
200067882,CC Bazois Loire Morvan,1990_1999,1994.5,9,18886,17613,2997,1213,-1273,-1784,511,-0.00772375521593327,-0.0108241785586999,0.00310042334276662,EPCI
200067882,CC Bazois Loire Morvan,1999_2006,2002.5,7,17613,17251,2158,937,-362,-1221,859,-0.00296233972117443,-0.00999175911479001,0.00702941939361558,EPCI
200067890,CC Morvan Sommets et Grands Lacs,2006_2011,2008.5,5,13572,13178,1067,458,-394,-609,215,-0.00587469100724558,-0.00908042340967654,0.00320573240243097,EPCI
200067890,CC Morvan Sommets et Grands Lacs,2011_2016,2013.5,5,13178,12620,1085,437,-558,-648,90,-0.00861585204206539,-0.0100055055972372,0.00138965355517184,EPCI
200067890,CC Morvan Sommets et Grands Lacs,1968_1975,1971.5,7,18749,16991,2275,1291,-1758,-984,-774,-0.0139667789735122,-0.00781758277015698,-0.00614919620335519,EPCI
200067890,CC Morvan Sommets et Grands Lacs,1975_1982,1978.5,7,16991,15779,2267,904,-1212,-1363,151,-0.0105162916262391,-0.0118264896753828,0.00131019804914365,EPCI
200067890,CC Morvan Sommets et Grands Lacs,1982_1990,1986,8,15779,14976,2356,1095,-803,-1261,458,-0.0065076109751715,-0.0102192994267637,0.00371168845159221,EPCI
200067890,CC Morvan Sommets et Grands Lacs,1990_1999,1994.5,9,14976,13889,2372,949,-1087,-1423,336,-0.00833746667584345,-0.0109146412876957,0.00257717461185225,EPCI
200067890,CC Morvan Sommets et Grands Lacs,1999_2006,2002.5,7,13889,13572,1681,756,-317,-925,608,-0.00329289691397172,-0.00960861086884493,0.00631571395487321,EPCI
200067908,CC Amognes Coeur du Nivernais,2006_2011,2008.5,5,8826,8930,563,462,104,-101,205,0.00234564353561817,-0.00227798074132149,0.00462362427693966,EPCI
200067908,CC Amognes Coeur du Nivernais,2011_2016,2013.5,5,8930,8687,608,364,-243,-244,1,-0.00550255311095038,-0.00552519736243577,2.26442514853929e-05,EPCI
200067908,CC Amognes Coeur du Nivernais,1968_1975,1971.5,7,10326,9057,1165,733,-1269,-432,-837,-0.0185580736656583,-0.00631764209894751,-0.0122404315667108,EPCI
200067908,CC Amognes Coeur du Nivernais,1975_1982,1978.5,7,9057,8435,1094,528,-622,-566,-56,-0.0101125527009317,-0.00920209779538158,-0.000910454905550121,EPCI
200067908,CC Amognes Coeur du Nivernais,1982_1990,1986,8,8435,8525,1130,712,90,-418,508,0.00132754380363154,-0.00616570344353314,0.00749324724716467,EPCI
200067908,CC Amognes Coeur du Nivernais,1990_1999,1994.5,9,8525,8603,1074,749,78,-325,403,0.00101250740317771,-0.00421878084657379,0.0052312882497515,EPCI
200067908,CC Amognes Coeur du Nivernais,1999_2006,2002.5,7,8603,8826,773,606,223,-167,390,0.00366253807622807,-0.00274279757278066,0.00640533564900874,EPCI
200067916,"CC Loire, Vignobles et Nohain",2006_2011,2008.5,5,26851,26578,1762,1265,-273,-497,224,-0.00204176441741843,-0.00371705829837715,0.00167529388095872,EPCI
200067916,"CC Loire, Vignobles et Nohain",2011_2016,2013.5,5,26578,25755,1861,1200,-823,-661,-162,-0.0062712576401105,-0.00503681810463309,-0.0012344395354774,EPCI
200067916,"CC Loire, Vignobles et Nohain",1968_1975,1971.5,7,27024,27596,3110,2517,572,-593,1165,0.00299669179047113,-0.00310671019536605,0.00610340198583718,EPCI
200067916,"CC Loire, Vignobles et Nohain",1975_1982,1978.5,7,27596,27645,3115,2226,49,-889,938,0.000253467132514285,-0.00459861797561631,0.00485208510813059,EPCI
200067916,"CC Loire, Vignobles et Nohain",1982_1990,1986,8,27645,27441,3366,2365,-204,-1001,797,-0.000925400858226344,-0.0045408149955126,0.00361541413728626,EPCI
200067916,"CC Loire, Vignobles et Nohain",1990_1999,1994.5,9,27441,26504,3455,2318,-937,-1137,200,-0.00385284537654895,-0.00467522432565225,0.000822378949103299,EPCI
200067916,"CC Loire, Vignobles et Nohain",1999_2006,2002.5,7,26504,26851,2678,1726,347,-952,1299,0.00185992741064411,-0.00510274033121958,0.0069626677418637,EPCI
200067924,CC du Canton d'Erstein,2006_2011,2008.5,5,43322,46157,1718,2781,2835,1063,1772,0.0127583094718686,0.00478380351625973,0.00797450595560889,EPCI
200067924,CC du Canton d'Erstein,2011_2016,2013.5,5,46157,47740,1801,2676,1583,875,708,0.00676699174978901,0.00374044079663006,0.00302655095315895,EPCI
200067924,CC du Canton d'Erstein,1968_1975,1971.5,7,30252,33390,2615,3445,3138,830,2308,0.0141990271378545,0.00375563815309727,0.0104433889847572,EPCI
200067924,CC du Canton d'Erstein,1975_1982,1978.5,7,33390,36125,2563,3176,2735,613,2122,0.0113104408588627,0.00253502751242516,0.00877541334643752,EPCI
200067924,CC du Canton d'Erstein,1982_1990,1986,8,36125,37379,2813,3705,1254,892,362,0.00427459801222563,0.00304062314745236,0.00123397486477327,EPCI
200067924,CC du Canton d'Erstein,1990_1999,1994.5,9,37379,40656,2933,4265,3277,1332,1945,0.00938121668375458,0.00381317687603329,0.00556803980772129,EPCI
200067924,CC du Canton d'Erstein,1999_2006,2002.5,7,40656,43322,2335,3418,2666,1083,1583,0.0091147403373395,0.00370264958189748,0.00541209075544202,EPCI
200067932,CA Golfe du Morbihan - Vannes Agglomération,2006_2011,2008.5,5,150884,159726,6553,8670,8842,2117,6725,0.0114548131435974,0.00274257401323182,0.0087122391303656,EPCI
200067932,CA Golfe du Morbihan - Vannes Agglomération,2011_2016,2013.5,5,159726,166661,7601,8411,6935,810,6125,0.00853662331095739,0.000997067755137057,0.00753955555582034,EPCI
200067932,CA Golfe du Morbihan - Vannes Agglomération,1968_1975,1971.5,7,80067,91076,6387,11597,11009,5210,5799,0.0185747667313267,0.00879049274867947,0.00978427398264727,EPCI
200067932,CA Golfe du Morbihan - Vannes Agglomération,1975_1982,1978.5,7,91076,103732,6508,11208,12656,4700,7956,0.0187618798988101,0.00696751228859097,0.0117943676102191,EPCI
200067932,CA Golfe du Morbihan - Vannes Agglomération,1982_1990,1986,8,103732,117487,7668,12666,13755,4998,8757,0.0156863896319457,0.00569978737771462,0.00998660225423107,EPCI
200067932,CA Golfe du Morbihan - Vannes Agglomération,1990_1999,1994.5,9,117487,134404,9418,14448,16917,5030,11887,0.0150592087002897,0.00447761540240332,0.0105815932978863,EPCI
200067932,CA Golfe du Morbihan - Vannes Agglomération,1999_2006,2002.5,7,134404,150884,8163,12084,16480,3921,12559,0.0166602800533913,0.00396389308794582,0.0126963869654454,EPCI
200067940,CC Couserans-Pyrénées,2006_2011,2008.5,5,29262,29944,2166,1273,682,-893,1575,0.00461847737128607,-0.00604736113278366,0.0106658385040697,EPCI
200067940,CC Couserans-Pyrénées,2011_2016,2013.5,5,29944,29825,2204,1177,-119,-1027,908,-0.000796083480902543,-0.00687040113350346,0.00607431765260092,EPCI
200067940,CC Couserans-Pyrénées,1968_1975,1971.5,7,33563,31947,4049,1985,-1616,-2064,448,-0.00702463821987887,-0.00897206267687499,0.00194742445699612,EPCI
200067940,CC Couserans-Pyrénées,1975_1982,1978.5,7,31947,29778,3824,1530,-2169,-2294,125,-0.00999378601829148,-0.0105697303485296,0.000575944330238097,EPCI
200067940,CC Couserans-Pyrénées,1982_1990,1986,8,29778,28018,4245,1916,-1760,-2329,569,-0.00758641491159895,-0.0100390683688147,0.0024526534572158,EPCI
200067940,CC Couserans-Pyrénées,1990_1999,1994.5,9,28018,27980,4327,2108,-38,-2219,2181,-0.000150787690014087,-0.00880520747740155,0.00865441978738747,EPCI
200067940,CC Couserans-Pyrénées,1999_2006,2002.5,7,27980,29262,3231,1642,1282,-1589,2871,0.00642049165852643,-0.00795800409157449,0.0143784957501009,EPCI
200067957,CC Haut Chemin-Pays de Pange,2006_2011,2008.5,5,17414,18336,419,1028,922,609,313,0.0103717899965494,0.00685078102808958,0.00352100896845984,EPCI
200067957,CC Haut Chemin-Pays de Pange,2011_2016,2013.5,5,18336,19083,523,935,747,412,335,0.00801828479928934,0.00442240071928676,0.00359588408000258,EPCI
200067957,CC Haut Chemin-Pays de Pange,1968_1975,1971.5,7,7784,9541,699,895,1757,196,1561,0.0295022390893485,0.00329108643227792,0.0262111526570705,EPCI
200067957,CC Haut Chemin-Pays de Pange,1975_1982,1978.5,7,9541,13272,697,1138,3731,441,3290,0.0482804748131587,0.00570669777341275,0.0425737770397459,EPCI
200067957,CC Haut Chemin-Pays de Pange,1982_1990,1986,8,13272,14869,756,1423,1597,667,930,0.0143040826453946,0.00597421610800139,0.00832986653739324,EPCI
200067957,CC Haut Chemin-Pays de Pange,1990_1999,1994.5,9,14869,16253,743,1465,1384,722,662,0.00993783312827445,0.00518433202212006,0.0047535011061544,EPCI
200067957,CC Haut Chemin-Pays de Pange,1999_2006,2002.5,7,16253,17414,603,1375,1161,772,389,0.00990544783840819,0.00658656824397168,0.00331887959443651,EPCI
200067965,CA de la Région de Compiègne et de la Basse Automne,2006_2011,2008.5,5,81769,80517,3180,5707,-1252,2527,-3779,-0.0030812145692537,0.00621903292053043,-0.00930024748978413,EPCI
200067965,CA de la Région de Compiègne et de la Basse Automne,2011_2016,2013.5,5,80517,82180,3295,5260,1663,1965,-302,0.00409709447731355,0.00484112486345227,-0.00074403038613872,EPCI
200067965,CA de la Région de Compiègne et de la Basse Automne,1968_1975,1971.5,7,55746,65309,4239,8452,9563,4213,5350,0.022875462377798,0.0100778336293698,0.0127976287484283,EPCI
200067965,CA de la Région de Compiègne et de la Basse Automne,1975_1982,1978.5,7,65309,69929,4205,8572,4620,4367,253,0.00981219691324475,0.00927486232037659,0.000537334592868165,EPCI
200067965,CA de la Région de Compiègne et de la Basse Automne,1982_1990,1986,8,69929,75986,4889,9946,6057,5057,1000,0.0104376803826161,0.00871443779014188,0.00172324259247417,EPCI
200067965,CA de la Région de Compiègne et de la Basse Automne,1990_1999,1994.5,9,75986,78923,5356,10557,2937,5201,-2264,0.00422262145004759,0.00747764867609722,-0.00325502722604963,EPCI
200067965,CA de la Région de Compiègne et de la Basse Automne,1999_2006,2002.5,7,78923,81769,4383,8088,2846,3705,-859,0.0050736138473797,0.00660496813230562,-0.00153135428492592,EPCI
200067973,CC Thelloise,2006_2011,2008.5,5,55618,57430,1888,3489,1812,1601,211,0.0064325857839842,0.00568353743938118,0.000749048344603018,EPCI
200067973,CC Thelloise,2011_2016,2013.5,5,57430,60091,1961,3649,2661,1688,973,0.00909980677624667,0.00577244413314708,0.00332736264309959,EPCI
200067973,CC Thelloise,1968_1975,1971.5,7,29314,33159,2309,3350,3845,1041,2804,0.017762910471107,0.00480915209373794,0.0129537583773691,EPCI
200067973,CC Thelloise,1975_1982,1978.5,7,33159,40787,2400,3455,7628,1055,6573,0.0300202491895911,0.00415198779431288,0.0258682613952782,EPCI
200067973,CC Thelloise,1982_1990,1986,8,40787,49621,2711,4849,8834,2138,6696,0.0248090894059001,0.00600428267487145,0.0188048067310286,EPCI
200067973,CC Thelloise,1990_1999,1994.5,9,49621,54084,3230,5672,4463,2442,2021,0.0096152952225308,0.00526115862276948,0.00435413659976131,EPCI
200067973,CC Thelloise,1999_2006,2002.5,7,54084,55618,2624,4951,1534,2327,-793,0.00400349213144402,0.00607309399600406,-0.00206960186456004,EPCI
200067981,CA Guingamp-Paimpol Agglomération de l'Armor à l'Argoat,2006_2011,2008.5,5,73360,74611,4630,3854,1251,-776,2027,0.00338754911430184,-0.0021013094426045,0.00548885855690633,EPCI
200067981,CA Guingamp-Paimpol Agglomération de l'Armor à l'Argoat,2011_2016,2013.5,5,74611,73703,4958,3362,-908,-1596,688,-0.00244589301583242,-0.00429916878113276,0.00185327576530034,EPCI
200067981,CA Guingamp-Paimpol Agglomération de l'Armor à l'Argoat,1968_1975,1971.5,7,77154,76173,7600,7590,-981,-10,-971,-0.00182638089323717,-1.86175422348335e-05,-0.00180776335100233,EPCI
200067981,CA Guingamp-Paimpol Agglomération de l'Armor à l'Argoat,1975_1982,1978.5,7,76173,75545,7663,6314,-628,-1349,721,-0.00118195294304169,-0.00253894031873127,0.00135698737568958,EPCI
200067981,CA Guingamp-Paimpol Agglomération de l'Armor à l'Argoat,1982_1990,1986,8,75545,72906,8232,6756,-2639,-1476,-1163,-0.00443483258818911,-0.00248041413420505,-0.00195441845398406,EPCI
200067981,CA Guingamp-Paimpol Agglomération de l'Armor à l'Argoat,1990_1999,1994.5,9,72906,71873,8729,6273,-1033,-2456,1423,-0.00158432890279359,-0.00376680714933306,0.00218247824653947,EPCI
200067981,CA Guingamp-Paimpol Agglomération de l'Armor à l'Argoat,1999_2006,2002.5,7,71873,73360,6740,5332,1487,-1408,2895,0.00292973406474673,-0.00277408578558399,0.00570381985033071,EPCI
200067999,CA du Beauvaisis,2006_2011,2008.5,5,99322,99449,3760,7074,127,3314,-3187,0.000255603176306796,0.00666983406520253,-0.00641423088889573,EPCI
200067999,CA du Beauvaisis,2011_2016,2013.5,5,99449,101874,4191,7186,2425,2995,-570,0.00482998809210344,0.00596528426220611,-0.00113529617010266,EPCI
200067999,CA du Beauvaisis,1968_1975,1971.5,7,74417,85131,5032,12363,10714,7331,3383,0.0194010636336084,0.0132750791019211,0.00612598453168725,EPCI
200067999,CA du Beauvaisis,1975_1982,1978.5,7,85131,87417,5216,10252,2286,5036,-2750,0.00379267766682911,0.00835517267285714,-0.00456249500602803,EPCI
200067999,CA du Beauvaisis,1982_1990,1986,8,87417,93130,6160,12048,5713,5888,-175,0.007944717451559,0.00818807917990187,-0.000243361728342871,EPCI
200067999,CA du Beauvaisis,1990_1999,1994.5,9,93130,96899,6734,12820,3769,6086,-2317,0.00441782241930189,0.0071336872496342,-0.00271586483033231,EPCI
200067999,CA du Beauvaisis,1999_2006,2002.5,7,96899,99322,5211,9713,2423,4502,-2079,0.00353450288175639,0.00656720263048586,-0.00303269974872948,EPCI
200068005,CC de l'Oise Picarde,2006_2011,2008.5,5,20201,21062,826,1390,861,564,297,0.00838261113251937,0.0054910484073646,0.00289156272515476,EPCI
200068005,CC de l'Oise Picarde,2011_2016,2013.5,5,21062,21293,885,1403,231,518,-287,0.00218396363113826,0.00489737299103732,-0.00271340935989906,EPCI
200068005,CC de l'Oise Picarde,1968_1975,1971.5,7,15780,15792,1400,1775,12,375,-363,0.000108601221456839,0.00339378817052621,-0.00328518694906937,EPCI
200068005,CC de l'Oise Picarde,1975_1982,1978.5,7,15792,16094,1325,1482,302,157,145,0.00270981479057131,0.00140874477523078,0.00130107001534053,EPCI
200068005,CC de l'Oise Picarde,1982_1990,1986,8,16094,17326,1338,1887,1232,549,683,0.00926285360432066,0.00412768395192536,0.0051351696523953,EPCI
200068005,CC de l'Oise Picarde,1990_1999,1994.5,9,17326,18804,1490,2278,1478,788,690,0.00913719715416295,0.0048715232459272,0.00426567390823575,EPCI
200068005,CC de l'Oise Picarde,1999_2006,2002.5,7,18804,20201,1113,1916,1397,803,594,0.010290081761775,0.00591477140637463,0.00437531035540041,EPCI
200068047,CA Creil Sud Oise,2006_2011,2008.5,5,81123,82321,2648,8130,1198,5482,-4284,0.00293624590235297,0.0134361436032546,-0.0104998977009016,EPCI
200068047,CA Creil Sud Oise,2011_2016,2013.5,5,82321,86331,2783,8188,4010,5405,-1395,0.00955788893713527,0.012882890200802,-0.00332500126366676,EPCI
200068047,CA Creil Sud Oise,1968_1975,1971.5,7,66540,76016,3574,11289,9476,7715,1761,0.0192021160075646,0.0156336349723893,0.00356848103517532,EPCI
200068047,CA Creil Sud Oise,1975_1982,1978.5,7,76016,79787,3568,10981,3771,7413,-3642,0.00694065252323717,0.0136438762012085,-0.0067032236779713,EPCI
200068047,CA Creil Sud Oise,1982_1990,1986,8,79787,79030,4163,12044,-757,7881,-8638,-0.0011909223759019,0.0123984930574411,-0.013589415433343,EPCI
200068047,CA Creil Sud Oise,1990_1999,1994.5,9,79030,78152,4743,12807,-878,8064,-8942,-0.00124054975519972,0.0113938419429732,-0.012634391698173,EPCI
200068047,CA Creil Sud Oise,1999_2006,2002.5,7,78152,81123,3624,10040,2971,6416,-3445,0.00534435510920739,0.0115413606128154,-0.00619700550360803,EPCI
200068070,CC Loue-Lison,2006_2011,2008.5,5,23243,24465,1060,1580,1222,520,702,0.0103005922483486,0.00438323074397811,0.00591736150437045,EPCI
200068070,CC Loue-Lison,2011_2016,2013.5,5,24465,25268,1127,1481,803,354,449,0.00647995430413317,0.0028566672772891,0.00362328702684408,EPCI
200068070,CC Loue-Lison,1968_1975,1971.5,7,18223,18002,1545,1943,-221,398,-619,-0.00174157735806535,0.00313641533262448,-0.00487799269068982,EPCI
200068070,CC Loue-Lison,1975_1982,1978.5,7,18002,19201,1574,1817,1199,243,956,0.00925391199315295,0.00187548007867904,0.00737843191447391,EPCI
200068070,CC Loue-Lison,1982_1990,1986,8,19201,20104,1734,2020,903,286,617,0.00576108649972906,0.00182466305528517,0.00393642344444389,EPCI
200068070,CC Loue-Lison,1990_1999,1994.5,9,20104,21183,1901,2158,1079,257,822,0.00582581252970638,0.00138761243756676,0.00443820009213961,EPCI
200068070,CC Loue-Lison,1999_2006,2002.5,7,21183,23243,1468,2087,2060,619,1441,0.0133461377465482,0.00401032003160843,0.00933581771493982,EPCI
200068088,CC Les Bertranges,2006_2011,2008.5,5,20735,20742,1400,960,7,-440,447,6.75095725082286e-05,-0.00424345884337437,0.0043109684158826,EPCI
200068088,CC Les Bertranges,2011_2016,2013.5,5,20742,20441,1551,885,-301,-666,365,-0.00291931894695929,-0.00645935687267405,0.00354003792571476,EPCI
200068088,CC Les Bertranges,1968_1975,1971.5,7,22215,21228,2227,1790,-987,-437,-550,-0.0064713516582704,-0.00286522864707615,-0.00360612301119424,EPCI
200068088,CC Les Bertranges,1975_1982,1978.5,7,21228,21759,2343,1566,531,-777,1308,0.00353572169542371,-0.00517373965601549,0.0087094613514392,EPCI
200068088,CC Les Bertranges,1982_1990,1986,8,21759,20961,2605,1646,-798,-959,161,-0.0046595973365865,-0.00559969153607325,0.000940094199486749,EPCI
200068088,CC Les Bertranges,1990_1999,1994.5,9,20961,20578,2777,1706,-383,-1071,688,-0.00204690492530824,-0.00572385163186715,0.00367694670655892,EPCI
200068088,CC Les Bertranges,1999_2006,2002.5,7,20578,20735,1972,1469,157,-503,660,0.00108638250710635,-0.00348057580302227,0.00456695831012862,EPCI
200068096,CC Champsaur-Valgaudemar,2006_2011,2008.5,5,10288,10952,570,564,664,-6,670,0.01258734616823,-0.000113741079833403,0.0127010872480634,EPCI
200068096,CC Champsaur-Valgaudemar,2011_2016,2013.5,5,10952,11065,636,506,113,-130,243,0.00205508590372583,-0.0023642581193306,0.00441934402305643,EPCI
200068096,CC Champsaur-Valgaudemar,1968_1975,1971.5,7,9030,9052,836,753,22,-83,105,0.000347683333900894,-0.00131171439608065,0.00165939772998154,EPCI
200068096,CC Champsaur-Valgaudemar,1975_1982,1978.5,7,9052,8986,778,640,-66,-138,72,-0.00104487047420376,-0.00218472917333514,0.00113985869913138,EPCI
200068096,CC Champsaur-Valgaudemar,1982_1990,1986,8,8986,8999,944,812,13,-132,145,0.000180722503824837,-0.00183502850037527,0.00201575100420011,EPCI
200068096,CC Champsaur-Valgaudemar,1990_1999,1994.5,9,8999,9328,948,805,329,-143,472,0.00399765489640669,-0.00173758252336218,0.00573523741976887,EPCI
200068096,CC Champsaur-Valgaudemar,1999_2006,2002.5,7,9328,10288,758,707,960,-51,1011,0.014092307419546,-0.000748653831663383,0.0148409612512094,EPCI
200068104,CA de la Provence Verte,2006_2011,2008.5,5,82767,90653,3862,4870,7886,1008,6878,0.0183685845641555,0.00234789921895368,0.0160206853452018,EPCI
200068104,CA de la Provence Verte,2011_2016,2013.5,5,90653,98371,4339,5137,7718,798,6920,0.0164756538501114,0.001703494658252,0.0147721591918594,EPCI
200068104,CA de la Provence Verte,1968_1975,1971.5,7,28110,31379,2647,2391,3269,-256,3525,0.0158403627082278,-0.00124048114203313,0.0170808438502609,EPCI
200068104,CA de la Provence Verte,1975_1982,1978.5,7,31379,38931,3052,2497,7552,-555,8107,0.0312868838152942,-0.00229928767445555,0.0335861714897498,EPCI
200068104,CA de la Provence Verte,1982_1990,1986,8,38931,54945,4129,4445,16014,316,15698,0.0440086026988136,0.00086841004451262,0.043140192654301,EPCI
200068104,CA de la Provence Verte,1990_1999,1994.5,9,54945,69361,5600,6001,14416,401,14015,0.0262260121359508,0.000729511020152349,0.0254965011157984,EPCI
200068104,CA de la Provence Verte,1999_2006,2002.5,7,69361,82767,5068,5948,13406,880,12526,0.0255648417210173,0.00167813372478705,0.0238867079962302,EPCI
200068112,CC du Pays de Saverne,2006_2011,2008.5,5,35438,36111,1390,2013,673,623,50,0.00376965480901492,0.00348959130165869,0.000280063507356235,EPCI
200068112,CC du Pays de Saverne,2011_2016,2013.5,5,36111,35633,1486,1996,-478,510,-988,-0.0026615225086235,0.00283969974769453,-0.00550122225631804,EPCI
200068112,CC du Pays de Saverne,1968_1975,1971.5,7,28656,30167,2494,3201,1511,707,804,0.007367833666861,0.0034474244887298,0.0039204091781312,EPCI
200068112,CC du Pays de Saverne,1975_1982,1978.5,7,30167,31104,2384,2852,937,468,469,0.00437924909061138,0.00218728769947292,0.00219196139113846,EPCI
200068112,CC du Pays de Saverne,1982_1990,1986,8,31104,31455,2660,3356,351,696,-345,0.00140367482358195,0.00278335520573514,-0.0013796803821532,EPCI
200068112,CC du Pays de Saverne,1990_1999,1994.5,9,31455,33452,2702,3664,1997,962,1035,0.00686273275223659,0.00330593335385658,0.00355679939838,EPCI
200068112,CC du Pays de Saverne,1999_2006,2002.5,7,33452,35438,2015,2860,1986,845,1141,0.00827305056058725,0.00352000388907161,0.00475304667151563,EPCI
200068120,CA Quimper Bretagne Occidentale,2006_2011,2008.5,5,98261,98841,4625,5503,580,878,-298,0.0011777519378795,0.00178287276113483,-0.00060512082325533,EPCI
200068120,CA Quimper Bretagne Occidentale,2011_2016,2013.5,5,98841,100412,4662,5268,1571,606,965,0.00315882332022932,0.00121848945388859,0.00194033386634073,EPCI
200068120,CA Quimper Bretagne Occidentale,1968_1975,1971.5,7,72014,78933,5207,9025,6919,3818,3101,0.0131918036480503,0.00727941990580373,0.00591238374224656,EPCI
200068120,CA Quimper Bretagne Occidentale,1975_1982,1978.5,7,78933,85272,5456,8341,6339,2885,3454,0.0110963638338979,0.00505016716529349,0.00604619666860441,EPCI
200068120,CA Quimper Bretagne Occidentale,1982_1990,1986,8,85272,90117,6437,9521,4845,3084,1761,0.006931748958658,0.00441228354767828,0.00251946541097972,EPCI
200068120,CA Quimper Bretagne Occidentale,1990_1999,1994.5,9,90117,94125,7732,9874,4008,2142,1866,0.00484669184898601,0.0025902230390539,0.00225646880993211,EPCI
200068120,CA Quimper Bretagne Occidentale,1999_2006,2002.5,7,94125,98261,6021,7772,4136,1751,2385,0.00616226880029247,0.00260883285041395,0.00355343594987852,EPCI
200068146,CC Sarrebourg Moselle Sud,2006_2011,2008.5,5,45869,46751,2182,2595,882,413,469,0.00381649197855127,0.00178708751376607,0.0020294044647852,EPCI
200068146,CC Sarrebourg Moselle Sud,2011_2016,2013.5,5,46751,45459,2496,2255,-1292,-241,-1051,-0.00558928650141088,-0.00104258362758516,-0.00454670287382573,EPCI
200068146,CC Sarrebourg Moselle Sud,1968_1975,1971.5,7,44111,45092,3629,5221,981,1592,-611,0.00314717953562571,0.00510734946046497,-0.00196016992483926,EPCI
200068146,CC Sarrebourg Moselle Sud,1975_1982,1978.5,7,45092,45029,3513,4602,-63,1089,-1152,-0.000199711559658144,0.00345215695980507,-0.00365186851946321,EPCI
200068146,CC Sarrebourg Moselle Sud,1982_1990,1986,8,45029,45046,3651,4964,17,1313,-1296,4.71840168272397e-05,0.00364427141730387,-0.00359708740047663,EPCI
200068146,CC Sarrebourg Moselle Sud,1990_1999,1994.5,9,45046,45389,3981,5303,343,1322,-979,0.000843199188513832,0.00324988142045273,-0.0024066822319389,EPCI
200068146,CC Sarrebourg Moselle Sud,1999_2006,2002.5,7,45389,45869,3148,3792,480,644,-164,0.00150394732314196,0.00201779599188213,-0.000513848668740171,EPCI
200068229,CC des Baronnies en Drôme Provençale,2006_2011,2008.5,5,20854,20946,1368,871,92,-497,589,0.000880771848629891,-0.00475808270401148,0.00563885455264137,EPCI
200068229,CC des Baronnies en Drôme Provençale,2011_2016,2013.5,5,20946,21173,1422,790,227,-632,859,0.00215814298999018,-0.00600857431574357,0.00816671730573375,EPCI
200068229,CC des Baronnies en Drôme Provençale,1968_1975,1971.5,7,15257,15841,1730,1293,584,-437,1021,0.00538058097864558,-0.00402622241039061,0.00940680338903619,EPCI
200068229,CC des Baronnies en Drôme Provençale,1975_1982,1978.5,7,15841,17207,1829,1301,1366,-528,1894,0.0118864839669481,-0.0045944828217779,0.016480966788726,EPCI
200068229,CC des Baronnies en Drôme Provençale,1982_1990,1986,8,17207,18426,2091,1638,1219,-453,1672,0.00859250961349511,-0.00319311472921517,0.0117856243427103,EPCI
200068229,CC des Baronnies en Drôme Provençale,1990_1999,1994.5,9,18426,19680,2448,1770,1254,-678,1932,0.00734239985490404,-0.00396981427561797,0.011312214130522,EPCI
200068229,CC des Baronnies en Drôme Provençale,1999_2006,2002.5,7,19680,20854,2002,1299,1174,-703,1877,0.00831190864415299,-0.00497723320003369,0.0132891418441867,EPCI
200068278,CC Berry Loire Puisaye,2006_2011,2008.5,5,18738,18826,1287,1035,88,-252,340,0.00093750830564554,-0.00268468287525768,0.00362219118090322,EPCI
200068278,CC Berry Loire Puisaye,2011_2016,2013.5,5,18826,18469,1268,963,-357,-305,-52,-0.00382172698796945,-0.00326506087207474,-0.00055666611589471,EPCI
200068278,CC Berry Loire Puisaye,1968_1975,1971.5,7,16765,16974,1859,1547,209,-312,521,0.00177147887944829,-0.0026445043559228,0.00441598323537108,EPCI
200068278,CC Berry Loire Puisaye,1975_1982,1978.5,7,16974,17880,1770,1451,906,-319,1225,0.00745623289488151,-0.00262531820470994,0.0100815510995914,EPCI
200068278,CC Berry Loire Puisaye,1982_1990,1986,8,17880,18292,1975,1584,412,-391,803,0.0028516878545175,-0.00270633483280666,0.00555802268732416,EPCI
200068278,CC Berry Loire Puisaye,1990_1999,1994.5,9,18292,18718,2249,1802,426,-447,873,0.00256125463823853,-0.00268751366970099,0.00524876830793952,EPCI
200068278,CC Berry Loire Puisaye,1999_2006,2002.5,7,18718,18738,1784,1490,20,-294,314,0.000152571608425855,-0.00224280264386008,0.00239537425228593,EPCI
200068294,CC des Deux Vallées Vertes,2006_2011,2008.5,5,15952,16466,840,991,514,151,363,0.00636284456627245,0.00186924032978043,0.00449360423649202,EPCI
200068294,CC des Deux Vallées Vertes,2011_2016,2013.5,5,16466,16293,912,878,-173,-34,-139,-0.0021101866501273,-0.000414718763608833,-0.00169546788651847,EPCI
200068294,CC des Deux Vallées Vertes,1968_1975,1971.5,7,13533,14355,1190,1588,822,398,424,0.00845946164953237,0.00409594371838672,0.00436351793114565,EPCI
200068294,CC des Deux Vallées Vertes,1975_1982,1978.5,7,14355,14779,1228,1353,424,125,299,0.00416707832039487,0.00122850186332396,0.00293857645707091,EPCI
200068294,CC des Deux Vallées Vertes,1982_1990,1986,8,14779,14862,1400,1463,83,63,20,0.000700290777025714,0.000531546011477349,0.000168744765548365,EPCI
200068294,CC des Deux Vallées Vertes,1990_1999,1994.5,9,14862,15266,1586,1479,404,-107,511,0.00298450185543642,-0.000790449748840833,0.00377495160427725,EPCI
200068294,CC des Deux Vallées Vertes,1999_2006,2002.5,7,15266,15952,1304,1304,686,0,686,0.00629919699349935,0,0.00629919699349935,EPCI
200068369,CC de Mirecourt Dompaire,2006_2011,2008.5,5,19210,19550,1141,1167,340,26,314,0.00351502519277536,0.00026879604415341,0.00324622914862195,EPCI
200068369,CC de Mirecourt Dompaire,2011_2016,2013.5,5,19550,19318,1233,1039,-232,-194,-38,-0.00238474849335646,-0.001994143136686,-0.000390605356670455,EPCI
200068369,CC de Mirecourt Dompaire,1968_1975,1971.5,7,21386,20653,1812,2218,-733,406,-1139,-0.00496988263746256,0.00275275900519755,-0.00772264164266011,EPCI
200068369,CC de Mirecourt Dompaire,1975_1982,1978.5,7,20653,20479,1947,1959,-174,12,-186,-0.00120792935835423,8.3305472989947e-05,-0.00129123483134418,EPCI
200068369,CC de Mirecourt Dompaire,1982_1990,1986,8,20479,19933,2158,2244,-546,86,-632,-0.00337221640227192,0.000531154964460413,-0.00390337136673233,EPCI
200068369,CC de Mirecourt Dompaire,1990_1999,1994.5,9,19933,19220,2098,2003,-713,-95,-618,-0.00403907050101271,-0.000538165073767472,-0.00350090542724524,EPCI
200068369,CC de Mirecourt Dompaire,1999_2006,2002.5,7,19220,19210,1474,1606,-10,132,-142,-7.43439165942217e-05,0.000981339699043726,-0.00105568361563795,EPCI
200068377,CC de la Porte des Vosges Méridionales,2006_2011,2008.5,5,30621,30197,1672,1686,-424,14,-438,-0.00278480848516682,9.19512235668291e-05,-0.00287675970873365,EPCI
200068377,CC de la Porte des Vosges Méridionales,2011_2016,2013.5,5,30197,29627,1679,1405,-570,-274,-296,-0.00380404102894849,-0.00182860919637173,-0.00197543183257676,EPCI
200068377,CC de la Porte des Vosges Méridionales,1968_1975,1971.5,7,31388,33533,2418,4013,2145,1595,550,0.00948821241561904,0.00705533743725518,0.00243287497836386,EPCI
200068377,CC de la Porte des Vosges Méridionales,1975_1982,1978.5,7,33533,33920,2400,3903,387,1503,-1116,0.00164059893137103,0.00637162840788283,-0.00473102947651181,EPCI
200068377,CC de la Porte des Vosges Méridionales,1982_1990,1986,8,33920,32139,2733,3745,-1781,1012,-2793,-0.0067191455349862,0.00381795355497251,-0.0105370990899587,EPCI
200068377,CC de la Porte des Vosges Méridionales,1990_1999,1994.5,9,32139,31244,3027,3422,-895,395,-1290,-0.00313318000370322,0.00138280011336622,-0.00451598011706944,EPCI
200068377,CC de la Porte des Vosges Méridionales,1999_2006,2002.5,7,31244,30621,2386,2560,-623,174,-797,-0.00287319440479639,0.000802465210970419,-0.00367565961576681,EPCI
200068435,CC Coeur du Perche,2006_2011,2008.5,5,11624,11808,582,664,184,82,102,0.00314600664230058,0.00140202469928613,0.00174398194301445,EPCI
200068435,CC Coeur du Perche,2011_2016,2013.5,5,11808,11566,600,587,-242,-13,-229,-0.00413293743351495,-0.000222017300147497,-0.00391092013336745,EPCI
200068435,CC Coeur du Perche,1968_1975,1971.5,7,10742,10129,1065,880,-613,-185,-428,-0.00835896717239359,-0.00252268992967833,-0.00583627724271527,EPCI
200068435,CC Coeur du Perche,1975_1982,1978.5,7,10129,10449,993,751,320,-242,562,0.00445326980075778,-0.00336778528682307,0.00782105508758084,EPCI
200068435,CC Coeur du Perche,1982_1990,1986,8,10449,11044,1000,942,595,-58,653,0.0069466435202874,-0.00067715180533894,0.00762379532562634,EPCI
200068435,CC Coeur du Perche,1990_1999,1994.5,9,11044,11332,1112,1042,288,-70,358,0.00286446007037866,-0.000696222933772591,0.00356068300415125,EPCI
200068435,CC Coeur du Perche,1999_2006,2002.5,7,11332,11624,743,937,292,194,98,0.0036410904802231,0.00241908066151809,0.00122200981870501,EPCI
200068443,CC Andaine - Passais,2006_2011,2008.5,5,13826,13602,992,561,-224,-431,207,-0.00326147714461689,-0.00627543147022267,0.00301395432560578,EPCI
200068443,CC Andaine - Passais,2011_2016,2013.5,5,13602,13255,1015,544,-347,-471,124,-0.00515506700249291,-0.00699722351058836,0.00184215650809545,EPCI
200068443,CC Andaine - Passais,1968_1975,1971.5,7,15543,14645,1402,1227,-898,-175,-723,-0.00846559138767777,-0.00164975333278799,-0.00681583805488979,EPCI
200068443,CC Andaine - Passais,1975_1982,1978.5,7,14645,14226,1446,1120,-419,-326,-93,-0.00413822868842506,-0.00321971969552881,-0.000918508992896255,EPCI
200068443,CC Andaine - Passais,1982_1990,1986,8,14226,14062,1558,1355,-164,-203,39,-0.0014483442024974,-0.00179276751894495,0.000344423316447552,EPCI
200068443,CC Andaine - Passais,1990_1999,1994.5,9,14062,13663,1600,1222,-399,-378,-21,-0.00319318805375401,-0.00302512552460907,-0.000168062529144948,EPCI
200068443,CC Andaine - Passais,1999_2006,2002.5,7,13663,13826,1253,898,163,-355,518,0.00169563999828481,-0.00369295827847306,0.00538859827675788,EPCI
200068450,CC Argentan Intercom,2006_2011,2008.5,5,34989,34732,1703,1843,-257,140,-397,-0.0014733683612449,0.000802613115075042,-0.00227598147631994,EPCI
200068450,CC Argentan Intercom,2011_2016,2013.5,5,34732,34078,1837,1733,-654,-104,-550,-0.00379466945712992,-0.000603433675139926,-0.00319123578198999,EPCI
200068450,CC Argentan Intercom,1968_1975,1971.5,7,34377,35767,2343,4443,1390,2100,-710,0.00567862611363545,0.00857921930837011,-0.00290059319473466,EPCI
200068450,CC Argentan Intercom,1975_1982,1978.5,7,35767,36298,2367,4009,531,1642,-1111,0.00210749805084198,0.00651697137379009,-0.0044094733229481,EPCI
200068450,CC Argentan Intercom,1982_1990,1986,8,36298,35999,2723,4057,-299,1334,-1633,-0.0010334010531946,0.00461055854502208,-0.00564395959821669,EPCI
200068450,CC Argentan Intercom,1990_1999,1994.5,9,35999,36180,2956,3898,181,942,-761,0.000557413038565935,0.00290101150458072,-0.00234359846601479,EPCI
200068450,CC Argentan Intercom,1999_2006,2002.5,7,36180,34989,2380,2900,-1191,520,-1711,-0.0047704072325232,0.00208279744828889,-0.00685320468081209,EPCI
200068468,CC des Pays de L'Aigle,2006_2011,2008.5,5,26346,26225,1347,1529,-121,182,-303,-0.000920237626467091,0.00138415907452075,-0.00230439670098784,EPCI
200068468,CC des Pays de L'Aigle,2011_2016,2013.5,5,26225,26117,1464,1307,-108,-157,49,-0.000825001696416861,-0.00119930802164303,0.000374306325226168,EPCI
200068468,CC des Pays de L'Aigle,1968_1975,1971.5,7,23818,24538,1890,2846,720,956,-236,0.00426354013900765,0.00566103385123793,-0.00139749371223028,EPCI
200068468,CC des Pays de L'Aigle,1975_1982,1978.5,7,24538,25775,1771,2623,1237,852,385,0.00705075370193153,0.00485629923528348,0.00219445446664805,EPCI
200068468,CC des Pays de L'Aigle,1982_1990,1986,8,25775,26060,2234,2806,285,572,-287,0.00137551287543225,0.00276067847279736,-0.00138516559736511,EPCI
200068468,CC des Pays de L'Aigle,1990_1999,1994.5,9,26060,26078,2273,2946,18,673,-655,7.67224213011897e-05,0.0028685660853167,-0.00279184366401551,EPCI
200068468,CC des Pays de L'Aigle,1999_2006,2002.5,7,26078,26346,1814,2161,268,347,-79,0.0014616977841091,0.00189257138464872,-0.000430873600539621,EPCI
200068484,CC des Causses à l'Aubrac,2006_2011,2008.5,5,14055,14422,951,677,367,-274,641,0.005168634369209,-0.00385887143641217,0.00902750580562117,EPCI
200068484,CC des Causses à l'Aubrac,2011_2016,2013.5,5,14422,14536,1028,621,114,-407,521,0.00157594301492492,-0.00562639304451265,0.00720233605943757,EPCI
200068484,CC des Causses à l'Aubrac,1968_1975,1971.5,7,15933,14979,1707,1280,-954,-427,-527,-0.0087816724365537,-0.00393058084948473,-0.00485109158706897,EPCI
200068484,CC des Causses à l'Aubrac,1975_1982,1978.5,7,14979,14323,1661,1104,-656,-557,-99,-0.00637709140338016,-0.00541469498732127,-0.000962396416058897,EPCI
200068484,CC des Causses à l'Aubrac,1982_1990,1986,8,14323,13806,1727,1079,-517,-648,131,-0.0045848767797575,-0.00574661538352584,0.00116173860376834,EPCI
200068484,CC des Causses à l'Aubrac,1990_1999,1994.5,9,13806,13589,1717,1064,-217,-653,436,-0.00175874474191162,-0.00529244385469258,0.00353369911278096,EPCI
200068484,CC des Causses à l'Aubrac,1999_2006,2002.5,7,13589,14055,1417,928,466,-489,955,0.00482841403531165,-0.00506672631602445,0.0098951403513361,EPCI
200068500,CA de Cambrai,2006_2011,2008.5,5,80338,81733,4158,5258,1395,1100,295,0.00344895453565375,0.0027196057270388,0.00072934880861495,EPCI
200068500,CA de Cambrai,2011_2016,2013.5,5,81733,82083,4382,5028,350,646,-296,0.000854983966581235,0.00157805612117565,-0.000723072154594416,EPCI
200068500,CA de Cambrai,1968_1975,1971.5,7,81743,84477,6706,10975,2734,4269,-1535,0.00471093727554495,0.00735588559959816,-0.00264494832405322,EPCI
200068500,CA de Cambrai,1975_1982,1978.5,7,84477,83150,6786,9516,-1327,2730,-4057,-0.00225931565631643,0.00464802693424556,-0.00690734259056199,EPCI
200068500,CA de Cambrai,1982_1990,1986,8,83150,81912,7144,9942,-1238,2798,-4036,-0.00187333129125145,0.00423391030122903,-0.00610724159248048,EPCI
200068500,CA de Cambrai,1990_1999,1994.5,9,81912,80965,7471,9636,-947,2165,-3112,-0.00129122539985926,0.00295195669555999,-0.00424318209541925,EPCI
200068500,CA de Cambrai,1999_2006,2002.5,7,80965,80338,5577,7441,-627,1864,-2491,-0.00110998752243929,0.00329986721184504,-0.00440985473428434,EPCI
200068534,CC Terroir de Caux,2006_2011,2008.5,5,33871,36562,1549,2230,2691,681,2010,0.0154075426186766,0.00389912171063499,0.0115084209080416,EPCI
200068534,CC Terroir de Caux,2011_2016,2013.5,5,36562,37995,1614,2283,1433,669,764,0.00771866094594431,0.00360347813875558,0.00411518280718873,EPCI
200068534,CC Terroir de Caux,1968_1975,1971.5,7,28429,28249,1869,3137,-180,1268,-1448,-0.000906973050595949,0.00638912126753147,-0.00729609431812742,EPCI
200068534,CC Terroir de Caux,1975_1982,1978.5,7,28249,30346,1918,2690,2097,772,1325,0.01028202247855,0.00378527484665743,0.00649674763189261,EPCI
200068534,CC Terroir de Caux,1982_1990,1986,8,30346,31658,2266,3377,1312,1111,201,0.00530479186517652,0.0044920912821731,0.000812700583003415,EPCI
200068534,CC Terroir de Caux,1990_1999,1994.5,9,31658,32207,2667,3369,549,702,-153,0.00191215238790732,0.00244504731568477,-0.000532894927777449,EPCI
200068534,CC Terroir de Caux,1999_2006,2002.5,7,32207,33871,2108,2851,1664,743,921,0.00722243844754811,0.00322492293661553,0.00399751551093258,EPCI
200068542,CC Les Balcons du Dauphiné,2006_2011,2008.5,5,64388,70892,2185,4544,6504,2359,4145,0.0194324617256736,0.00704815147768512,0.0123843102479885,EPCI
200068542,CC Les Balcons du Dauphiné,2011_2016,2013.5,5,70892,75807,2405,4270,4915,1865,3050,0.0134968804369968,0.00512140020651049,0.00837548023048633,EPCI
200068542,CC Les Balcons du Dauphiné,1968_1975,1971.5,7,32782,35518,3280,3397,2736,117,2619,0.0115172509307222,0.000492514020063778,0.0110247369106584,EPCI
200068542,CC Les Balcons du Dauphiné,1975_1982,1978.5,7,35518,42858,3398,3657,7340,259,7081,0.027199433204927,0.000959762016359141,0.0262396711885679,EPCI
200068542,CC Les Balcons du Dauphiné,1982_1990,1986,8,42858,48934,3718,4842,6076,1124,4952,0.0167106016443226,0.00309129628838357,0.013619305355939,EPCI
200068542,CC Les Balcons du Dauphiné,1990_1999,1994.5,9,48934,55459,3962,5621,6525,1659,4866,0.0140051163293973,0.00356084107133641,0.0104442752580609,EPCI
200068542,CC Les Balcons du Dauphiné,1999_2006,2002.5,7,55459,64388,3168,5482,8929,2314,6615,0.0215552098316674,0.00558615248633422,0.0159690573453331,EPCI
200068559,CC de l'Ouest Vosgien,2006_2011,2008.5,5,24410,24213,1272,1266,-197,-6,-191,-0.0016193285492937,-4.93196512475238e-05,-0.00157000889804617,EPCI
200068559,CC de l'Ouest Vosgien,2011_2016,2013.5,5,24213,23534,1419,1173,-679,-246,-433,-0.00567254898429392,-0.00205515029475155,-0.00361739868954237,EPCI
200068559,CC de l'Ouest Vosgien,1968_1975,1971.5,7,26127,27138,2019,3539,1011,1520,-509,0.00543840577985089,0.00817643598948897,-0.00273803020963808,EPCI
200068559,CC de l'Ouest Vosgien,1975_1982,1978.5,7,27138,27440,1947,3105,302,1158,-856,0.00158222799449814,0.00606695370075778,-0.00448472570625963,EPCI
200068559,CC de l'Ouest Vosgien,1982_1990,1986,8,27440,25799,2056,2891,-1641,835,-2476,-0.00767862648065953,0.00390716216413815,-0.0115857886447977,EPCI
200068559,CC de l'Ouest Vosgien,1990_1999,1994.5,9,25799,24819,2273,2727,-980,454,-1434,-0.00429367156707428,0.00198910907290992,-0.00628278063998419,EPCI
200068559,CC de l'Ouest Vosgien,1999_2006,2002.5,7,24819,24410,1819,1938,-409,119,-528,-0.00237098540206315,0.000689846608424243,-0.0030608320104874,EPCI
200068567,CC Les Vals du Dauphiné,2006_2011,2008.5,5,53609,59368,2302,3661,5759,1359,4400,0.0206173397330625,0.00486524825442471,0.0157520914786378,EPCI
200068567,CC Les Vals du Dauphiné,2011_2016,2013.5,5,59368,62133,2451,3859,2765,1408,1357,0.00914594852808204,0.00465732207144286,0.00448862645663918,EPCI
200068567,CC Les Vals du Dauphiné,1968_1975,1971.5,7,34887,36894,3252,3857,2007,605,1402,0.00802267761645581,0.00241839559439749,0.00560428202205832,EPCI
200068567,CC Les Vals du Dauphiné,1975_1982,1978.5,7,36894,40716,3111,3801,3822,690,3132,0.0141813575438157,0.00256021368530424,0.0116211438585114,EPCI
200068567,CC Les Vals du Dauphiné,1982_1990,1986,8,40716,43779,3554,4382,3063,828,2235,0.00910786582096312,0.00246206754807622,0.0066457982728869,EPCI
200068567,CC Les Vals du Dauphiné,1990_1999,1994.5,9,43779,46271,3828,4752,2492,924,1568,0.00617019824310772,0.00228782631486016,0.00388237192824755,EPCI
200068567,CC Les Vals du Dauphiné,1999_2006,2002.5,7,46271,53609,3163,4394,7338,1231,6107,0.0212514558838723,0.00356507797670303,0.0176863779071693,EPCI
200068625,CC Alpes-Provence-Verdon - Sources de Lumière,2006_2011,2008.5,5,10845,11131,590,446,286,-144,430,0.0052195474692387,-0.00262802390059571,0.0078475713698344,EPCI
200068625,CC Alpes-Provence-Verdon - Sources de Lumière,2011_2016,2013.5,5,11131,11403,666,389,272,-277,549,0.00484016999501291,-0.00492914370815653,0.00976931370316944,EPCI
200068625,CC Alpes-Provence-Verdon - Sources de Lumière,1968_1975,1971.5,7,8664,8154,929,585,-510,-344,-166,-0.00862939479118941,-0.00582061138856697,-0.00280878340262243,EPCI
200068625,CC Alpes-Provence-Verdon - Sources de Lumière,1975_1982,1978.5,7,8154,8760,960,582,606,-378,984,0.0102936618870115,-0.00642079899882897,0.0167144608858405,EPCI
200068625,CC Alpes-Provence-Verdon - Sources de Lumière,1982_1990,1986,8,8760,9323,1058,808,563,-250,813,0.00781646031153738,-0.0034708971187999,0.0112873574303373,EPCI
200068625,CC Alpes-Provence-Verdon - Sources de Lumière,1990_1999,1994.5,9,9323,9541,1123,721,218,-402,620,0.00257150471158063,-0.00474194905530006,0.00731345376688069,EPCI
200068625,CC Alpes-Provence-Verdon - Sources de Lumière,1999_2006,2002.5,7,9541,10845,861,661,1304,-200,1504,0.0184693211637443,-0.00283271796989944,0.0213020391336438,EPCI
200068641,CA Le Muretain Agglo,2006_2011,2008.5,5,102411,111607,3252,6383,9196,3131,6065,0.0173466644575659,0.00590609030193986,0.0114405741556261,EPCI
200068641,CA Le Muretain Agglo,2011_2016,2013.5,5,111607,119336,3646,6925,7729,3279,4450,0.0134819268833881,0.00571965820295376,0.00776226868043436,EPCI
200068641,CA Le Muretain Agglo,1968_1975,1971.5,7,33742,44389,2343,4043,10647,1700,8947,0.039955926735141,0.00637973846621018,0.0335761882689309,EPCI
200068641,CA Le Muretain Agglo,1975_1982,1978.5,7,44389,56855,2967,4102,12466,1135,11331,0.0359914854795134,0.00327694015877167,0.0327145453207417,EPCI
200068641,CA Le Muretain Agglo,1982_1990,1986,8,56855,70435,3728,5949,13580,2221,11359,0.0271348904245008,0.00443789334556821,0.0226969970789326,EPCI
200068641,CA Le Muretain Agglo,1990_1999,1994.5,9,70435,85111,5007,8157,14676,3150,11526,0.0212522335306069,0.0045614973849422,0.0166907361456647,EPCI
200068641,CA Le Muretain Agglo,1999_2006,2002.5,7,85111,102411,4427,8328,17300,3901,13399,0.0267864539110492,0.00604011310445103,0.0207463408065981,EPCI
200068658,"CA de Chaumont, du Bassin Nogentais et du Bassin de Bologne Vignory Froncles",2006_2011,2008.5,5,47887,46376,2194,2571,-1511,377,-1888,-0.00639188141665681,0.00159479767973502,-0.00798667909639183,EPCI
200068658,"CA de Chaumont, du Bassin Nogentais et du Bassin de Bologne Vignory Froncles",2011_2016,2013.5,5,46376,45435,2280,2296,-941,16,-957,-0.00409147718426528,6.95681561617901e-05,-0.00416104534042707,EPCI
200068658,"CA de Chaumont, du Bassin Nogentais et du Bassin de Bologne Vignory Froncles",1968_1975,1971.5,7,48653,50128,3396,6451,1475,3055,-1580,0.00427572386674902,0.00885582129689372,-0.00458009743014471,EPCI
200068658,"CA de Chaumont, du Bassin Nogentais et du Bassin de Bologne Vignory Froncles",1975_1982,1978.5,7,50128,51695,3230,5498,1567,2268,-701,0.00440701543131983,0.00637850095611574,-0.00197148552479592,EPCI
200068658,"CA de Chaumont, du Bassin Nogentais et du Bassin de Bologne Vignory Froncles",1982_1990,1986,8,51695,50827,3669,5987,-868,2318,-3186,-0.00211443088309049,0.00564660228917483,-0.00776103317226532,EPCI
200068658,"CA de Chaumont, du Bassin Nogentais et du Bassin de Bologne Vignory Froncles",1990_1999,1994.5,9,50827,49175,4122,5376,-1652,1254,-2906,-0.00366464044160131,0.00278175491148186,-0.00644639535308317,EPCI
200068658,"CA de Chaumont, du Bassin Nogentais et du Bassin de Bologne Vignory Froncles",1999_2006,2002.5,7,49175,47887,3125,3948,-1288,823,-2111,-0.0037844345437571,0.00241815965024231,-0.00620259419399941,EPCI
200068666,CA de Saint-Dizier Der et Blaise,2006_2011,2008.5,5,61320,59403,3225,3588,-1917,363,-2280,-0.00633213179066883,0.00119904217006405,-0.00753117396073288,EPCI
200068666,CA de Saint-Dizier Der et Blaise,2011_2016,2013.5,5,59403,58981,3145,3414,-422,269,-691,-0.00142485832416794,0.000908262770618902,-0.00233312109478685,EPCI
200068666,CA de Saint-Dizier Der et Blaise,1968_1975,1971.5,7,70609,71846,4487,9786,1237,5299,-4062,0.00248412667232079,0.0106413801427873,-0.00815725347046648,EPCI
200068666,CA de Saint-Dizier Der et Blaise,1975_1982,1978.5,7,71846,71407,4572,8510,-439,3938,-4377,-0.000875193320679979,0.00785082299963043,-0.00872601632031041,EPCI
200068666,CA de Saint-Dizier Der et Blaise,1982_1990,1986,8,71407,69649,4935,8866,-1758,3931,-5689,-0.00311109562303213,0.0069566080171441,-0.0100677036401762,EPCI
200068666,CA de Saint-Dizier Der et Blaise,1990_1999,1994.5,9,69649,65593,5202,7780,-4056,2578,-6634,-0.00664442307120772,0.00422320578835638,-0.0108676288595641,EPCI
200068666,CA de Saint-Dizier Der et Blaise,1999_2006,2002.5,7,65593,61320,4246,5411,-4273,1165,-5438,-0.00957712002046118,0.00261112680174053,-0.0121882468222017,EPCI
200068674,CA Grand Lac,2006_2011,2008.5,5,65453,70250,2773,3783,4797,1010,3787,0.0142461184462834,0.00299949544105613,0.0112466230052273,EPCI
200068674,CA Grand Lac,2011_2016,2013.5,5,70250,74316,3076,3843,4066,767,3299,0.0113167480555205,0.00213476285257851,0.00918198520294201,EPCI
200068674,CA Grand Lac,1968_1975,1971.5,7,38203,40670,3453,4004,2467,551,1916,0.00897960165081457,0.00200557783121152,0.00697402381960305,EPCI
200068674,CA Grand Lac,1975_1982,1978.5,7,40670,45339,3481,3781,4669,300,4369,0.015646410120842,0.00100533798163474,0.0146410721392073,EPCI
200068674,CA Grand Lac,1982_1990,1986,8,45339,52244,4011,4948,6905,937,5968,0.01787760780137,0.00242596937145311,0.0154516384299169,EPCI
200068674,CA Grand Lac,1990_1999,1994.5,9,52244,59053,4498,5947,6809,1449,5360,0.0137053234465405,0.00291658300397081,0.0107887404425697,EPCI
200068674,CA Grand Lac,1999_2006,2002.5,7,59053,65453,3779,4974,6400,1195,5205,0.0148081388540411,0.00276495717665298,0.0120431816773881,EPCI
200068682,CC Terre d'Eau,2006_2011,2008.5,5,18499,18313,887,1030,-186,143,-329,-0.00201905624025589,0.00155228517396017,-0.00357134141421606,EPCI
200068682,CC Terre d'Eau,2011_2016,2013.5,5,18313,18076,928,837,-237,-91,-146,-0.0026018290821489,-0.000999014542090927,-0.00160281454005797,EPCI
200068682,CC Terre d'Eau,1968_1975,1971.5,7,18842,20241,1343,2765,1399,1422,-23,0.010284212674164,0.0104532883650188,-0.000169075690854734,EPCI
200068682,CC Terre d'Eau,1975_1982,1978.5,7,20241,20192,1269,2319,-49,1050,-1099,-0.000346192055210248,0.00741840118307675,-0.007764593238287,EPCI
200068682,CC Terre d'Eau,1982_1990,1986,8,20192,19767,1296,2174,-425,878,-1303,-0.00265554350953279,0.00548604047381126,-0.00814158398334405,EPCI
200068682,CC Terre d'Eau,1990_1999,1994.5,9,19767,19086,1433,2033,-681,600,-1281,-0.00388784475279047,0.00342541387911055,-0.00731325863190102,EPCI
200068682,CC Terre d'Eau,1999_2006,2002.5,7,19086,18499,1159,1498,-587,339,-926,-0.00445268661194698,0.00257148340962526,-0.00702417002157223,EPCI
200068757,CA d'Épinal,2006_2011,2008.5,5,112416,112725,5006,6568,309,1562,-1253,0.000549140367141598,0.00277591344166724,-0.00222677307452564,EPCI
200068757,CA d'Épinal,2011_2016,2013.5,5,112725,111367,5413,6083,-1358,670,-2028,-0.00242109850205474,0.00119450367921699,-0.00361560218127173,EPCI
200068757,CA d'Épinal,1968_1975,1971.5,7,106713,111668,8094,13852,4955,5758,-803,0.00650495096958181,0.00755913374023251,-0.0010541827706507,EPCI
200068757,CA d'Épinal,1975_1982,1978.5,7,111668,112825,8160,12170,1157,4010,-2853,0.00147362219122638,0.00510736818221069,-0.00363374599098431,EPCI
200068757,CA d'Épinal,1982_1990,1986,8,112825,112798,8894,12993,-27,4099,-4126,-2.99167153295921e-05,0.00454180059762955,-0.00457171731295914,EPCI
200068757,CA d'Épinal,1990_1999,1994.5,9,112798,112060,9404,12980,-738,3576,-4314,-0.000729085895752824,0.00353280645421693,-0.00426189234996976,EPCI
200068757,CA d'Épinal,1999_2006,2002.5,7,112060,112416,7491,9323,356,1832,-1476,0.000453221809165072,0.00233230998424273,-0.00187908817507766,EPCI
200068765,CC du Sisteronais-Buëch,2006_2011,2008.5,5,24162,24769,1426,1008,607,-418,1025,0.00497467685500097,-0.0034257247535262,0.00840040160852717,EPCI
200068765,CC du Sisteronais-Buëch,2011_2016,2013.5,5,24769,24859,1411,1056,90,-355,445,0.000725660913127868,-0.0028623291573377,0.00358799007046557,EPCI
200068765,CC du Sisteronais-Buëch,1968_1975,1971.5,7,20171,21326,1710,1765,1155,55,1100,0.00798615719253992,0.000380293199644758,0.00760586399289516,EPCI
200068765,CC du Sisteronais-Buëch,1975_1982,1978.5,7,21326,20326,1830,1464,-1000,-366,-634,-0.0068373937646371,-0.00250248611785718,-0.00433490764677992,EPCI
200068765,CC du Sisteronais-Buëch,1982_1990,1986,8,20326,21099,2104,1872,773,-232,1005,0.00467649976280482,-0.00140355490940585,0.00608005467221067,EPCI
200068765,CC du Sisteronais-Buëch,1990_1999,1994.5,9,21099,22294,2360,1989,1195,-371,1566,0.00614010004710264,-0.0019062570020712,0.00804635704917383,EPCI
200068765,CC du Sisteronais-Buëch,1999_2006,2002.5,7,22294,24162,1908,1593,1868,-315,2183,0.0115611143280925,-0.00194954551035821,0.0135106598384507,EPCI
200068773,CC des Vosges côté Sud Ouest,2006_2011,2008.5,5,13053,12801,833,604,-252,-229,-23,-0.00389134890915743,-0.00353618611189306,-0.000355162797264369,EPCI
200068773,CC des Vosges côté Sud Ouest,2011_2016,2013.5,5,12801,12195,842,510,-606,-332,-274,-0.00965256427265238,-0.00528820352891186,-0.00436436074374051,EPCI
200068773,CC des Vosges côté Sud Ouest,1968_1975,1971.5,7,16786,16181,1482,1772,-605,290,-895,-0.00523020193567314,0.00250703894437225,-0.00773724088004539,EPCI
200068773,CC des Vosges côté Sud Ouest,1975_1982,1978.5,7,16181,15431,1620,1366,-750,-254,-496,-0.00675696000707371,-0.00228835712239563,-0.00446860288467808,EPCI
200068773,CC des Vosges côté Sud Ouest,1982_1990,1986,8,15431,14425,1578,1436,-1006,-142,-864,-0.00839155030812822,-0.00118449318464633,-0.00720705712348189,EPCI
200068773,CC des Vosges côté Sud Ouest,1990_1999,1994.5,9,14425,13544,1667,1339,-881,-328,-553,-0.0069776719377237,-0.00259781656705264,-0.00437985537067106,EPCI
200068773,CC des Vosges côté Sud Ouest,1999_2006,2002.5,7,13544,13053,1188,877,-491,-311,-180,-0.00526120433173127,-0.00333245325288885,-0.00192875107884242,EPCI
200068781,CA Valence Romans Agglo,2006_2011,2008.5,5,209507,214540,8453,13750,5033,5297,-264,0.00475909860336965,0.00500873143295232,-0.000249632829582671,EPCI
200068781,CA Valence Romans Agglo,2011_2016,2013.5,5,214540,220156,9405,13716,5616,4311,1305,0.00518141429914576,0.00397739975847888,0.00120401454066688,EPCI
200068781,CA Valence Romans Agglo,1968_1975,1971.5,7,157205,172837,11083,20571,15632,9488,6144,0.0136347261748189,0.00827573451552466,0.00535899165929421,EPCI
200068781,CA Valence Romans Agglo,1975_1982,1978.5,7,172837,181327,11215,18475,8490,7260,1230,0.0068739575459944,0.00587808383791747,0.000995873708076928,EPCI
200068781,CA Valence Romans Agglo,1982_1990,1986,8,181327,190101,13027,21168,8774,8141,633,0.00592416370533844,0.00549676507011172,0.000427398635226718,EPCI
200068781,CA Valence Romans Agglo,1990_1999,1994.5,9,190101,199616,14658,23545,9515,8887,628,0.00544141893489747,0.00508227956641448,0.000359139368482986,EPCI
200068781,CA Valence Romans Agglo,1999_2006,2002.5,7,199616,209507,11873,18578,9891,6705,3186,0.00693272523208366,0.00469961810546162,0.00223310712662203,EPCI
200068799,CC Intercom de la Vire au Noireau,2006_2011,2008.5,5,48210,48883,2672,2735,673,63,610,0.00277649120353218,0.000259909280568392,0.00251658192296379,EPCI
200068799,CC Intercom de la Vire au Noireau,2011_2016,2013.5,5,48883,47786,2808,2612,-1097,-196,-901,-0.00452910815722485,-0.000809211667106719,-0.00371989649011813,EPCI
200068799,CC Intercom de la Vire au Noireau,1968_1975,1971.5,7,48244,48198,3553,5340,-46,1787,-1833,-0.00013626804341893,0.00529371725194844,-0.00542998529536737,EPCI
200068799,CC Intercom de la Vire au Noireau,1975_1982,1978.5,7,48198,48580,3630,4783,382,1153,-771,0.00112840719491136,0.00340589920348901,-0.00227749200857765,EPCI
200068799,CC Intercom de la Vire au Noireau,1982_1990,1986,8,48580,47164,4068,4848,-1416,780,-2196,-0.00369080141964551,0.00203306857861829,-0.00572386999826379,EPCI
200068799,CC Intercom de la Vire au Noireau,1990_1999,1994.5,9,47164,47535,4364,4876,371,512,-141,0.000870978203257655,0.00120199687349844,-0.00033101867024078,EPCI
200068799,CC Intercom de la Vire au Noireau,1999_2006,2002.5,7,47535,48210,3594,3836,675,242,433,0.00201634246237892,0.000722896112438071,0.00129344634994085,EPCI
200068807,CC Bassin Auterivain Haut-Garonnais,2006_2011,2008.5,5,26331,29001,986,1693,2670,707,1963,0.0195044459901905,0.00516466041762723,0.0143397855725633,EPCI
200068807,CC Bassin Auterivain Haut-Garonnais,2011_2016,2013.5,5,29001,31317,1157,1842,2316,685,1631,0.0154848201660243,0.00457992306292168,0.0109048971031026,EPCI
200068807,CC Bassin Auterivain Haut-Garonnais,1968_1975,1971.5,7,13813,15484,1280,1467,1671,187,1484,0.0164476626908725,0.0018406420844962,0.0146070206063763,EPCI
200068807,CC Bassin Auterivain Haut-Garonnais,1975_1982,1978.5,7,15484,17532,1435,1206,2048,-229,2277,0.0179041849602108,-0.00200198161908608,0.0199061665792969,EPCI
200068807,CC Bassin Auterivain Haut-Garonnais,1982_1990,1986,8,17532,20185,1643,1727,2653,84,2569,0.0177700377280428,0.000562639716982884,0.0172073980110599,EPCI
200068807,CC Bassin Auterivain Haut-Garonnais,1990_1999,1994.5,9,20185,22475,1841,2141,2290,300,1990,0.0120119965738272,0.00157362400530488,0.0104383725685224,EPCI
200068807,CC Bassin Auterivain Haut-Garonnais,1999_2006,2002.5,7,22475,26331,1470,2160,3856,690,3166,0.0228782648559998,0.00409388038139,0.0187843844746098,EPCI
200068815,CC Coeur de Garonne,2006_2011,2008.5,5,29417,33107,1468,1974,3690,506,3184,0.0239159061781788,0.00327952534584241,0.0206363808323364,EPCI
200068815,CC Coeur de Garonne,2011_2016,2013.5,5,33107,34626,1560,1882,1519,322,1197,0.00901239013451338,0.00191046058150975,0.00710192955300363,EPCI
200068815,CC Coeur de Garonne,1968_1975,1971.5,7,19705,19528,1824,1425,-177,-399,222,-0.00128818066153535,-0.00290386488108817,0.00161568421955282,EPCI
200068815,CC Coeur de Garonne,1975_1982,1978.5,7,19528,21114,1828,1189,1586,-639,2225,0.011217737124132,-0.00451963053109731,0.0157373676552293,EPCI
200068815,CC Coeur de Garonne,1982_1990,1986,8,21114,22473,2185,1624,1359,-561,1920,0.00782776060514734,-0.0032313272255244,0.0110590878306717,EPCI
200068815,CC Coeur de Garonne,1990_1999,1994.5,9,22473,23974,2406,2117,1501,-289,1790,0.00720979086186158,-0.00138816093209727,0.00859795179395884,EPCI
200068815,CC Coeur de Garonne,1999_2006,2002.5,7,23974,29417,1918,2090,5443,172,5271,0.0296603345101172,0.000937273109634421,0.0287230614004828,EPCI
200068831,CC Pays Ségali,2006_2011,2008.5,5,16893,17640,1037,904,747,-133,880,0.00869149674422509,-0.00154748201737876,0.0102389787616039,EPCI
200068831,CC Pays Ségali,2011_2016,2013.5,5,17640,17924,1083,847,284,-236,520,0.0031994165114928,-0.00265867005884613,0.00585808657033894,EPCI
200068831,CC Pays Ségali,1968_1975,1971.5,7,19271,18079,1697,1394,-1192,-303,-889,-0.00908000146783261,-0.00230808762143732,-0.00677191384639529,EPCI
200068831,CC Pays Ségali,1975_1982,1978.5,7,18079,16909,1671,1020,-1170,-651,-519,-0.00951232871057139,-0.00529275725690767,-0.00421957145366372,EPCI
200068831,CC Pays Ségali,1982_1990,1986,8,16909,16423,1880,1206,-486,-674,188,-0.00363876773099214,-0.0050463568944212,0.00140758916342906,EPCI
200068831,CC Pays Ségali,1990_1999,1994.5,9,16423,15943,2022,1220,-480,-802,322,-0.00329045564941843,-0.0054978029809033,0.00220734733148487,EPCI
200068831,CC Pays Ségali,1999_2006,2002.5,7,15943,16893,1541,1105,950,-436,1386,0.00830277464320095,-0.00381053657309012,0.0121133112162911,EPCI
200068856,CC des Hauts du Perche,2006_2011,2008.5,5,8652,8736,577,436,84,-141,225,0.00193425043599627,-0.00324677751756516,0.00518102795356143,EPCI
200068856,CC des Hauts du Perche,2011_2016,2013.5,5,8736,8352,617,376,-384,-241,-143,-0.00894998586199836,-0.00561704841859793,-0.00333293744340043,EPCI
200068856,CC des Hauts du Perche,1968_1975,1971.5,7,9230,9222,886,955,-8,69,-77,-0.000123865860883199,0.00106834305011759,-0.00119220891100079,EPCI
200068856,CC des Hauts du Perche,1975_1982,1978.5,7,9222,8834,762,846,-388,84,-472,-0.0061217595769848,0.00132532939295547,-0.00744708896994027,EPCI
200068856,CC des Hauts du Perche,1982_1990,1986,8,8834,8282,870,825,-552,-45,-507,-0.0080329902060553,-0.000654863332015378,-0.00737812687403992,EPCI
200068856,CC des Hauts du Perche,1990_1999,1994.5,9,8282,8324,993,793,42,-200,242,0.000562205023370899,-0.00267716677795666,0.00323937180132756,EPCI
200068856,CC des Hauts du Perche,1999_2006,2002.5,7,8324,8652,748,652,328,-96,424,0.00553635493280091,-0.00162039656569783,0.00715675149849874,EPCI
200068864,CC de la Mossig et du Vignoble,2006_2011,2008.5,5,22688,23906,910,1297,1218,387,831,0.0105135476214671,0.00334051143637746,0.00717303618508959,EPCI
200068864,CC de la Mossig et du Vignoble,2011_2016,2013.5,5,23906,24511,952,1179,605,227,378,0.00501101794983661,0.00188016706547588,0.00313085088436072,EPCI
200068864,CC de la Mossig et du Vignoble,1968_1975,1971.5,7,15691,16614,1383,1712,923,329,594,0.00819891621081559,0.00292247392563199,0.0052764422851836,EPCI
200068864,CC de la Mossig et du Vignoble,1975_1982,1978.5,7,16614,18402,1455,1508,1788,53,1735,0.0147090779560197,0.000436007344333918,0.0142730706116858,EPCI
200068864,CC de la Mossig et du Vignoble,1982_1990,1986,8,18402,19465,1561,1943,1063,382,681,0.00704452508788767,0.00253152265623056,0.0045130024316571,EPCI
200068864,CC de la Mossig et du Vignoble,1990_1999,1994.5,9,19465,21450,1645,2185,1985,540,1445,0.0108480473325876,0.00295110607536388,0.00789694125722372,EPCI
200068864,CC de la Mossig et du Vignoble,1999_2006,2002.5,7,21450,22688,1199,1787,1238,588,650,0.00804814285976274,0.0038225428122298,0.00422560004753294,EPCI
200068872,CC Éguzon - Argenton - Vallée de la Creuse,2006_2011,2008.5,5,20156,20079,1582,924,-77,-658,581,-0.000765210683211004,-0.00653907311107585,0.00577386242786485,EPCI
200068872,CC Éguzon - Argenton - Vallée de la Creuse,2011_2016,2013.5,5,20079,19882,1557,849,-197,-708,511,-0.00196999560577704,-0.00707998420756419,0.00510998860178715,EPCI
200068872,CC Éguzon - Argenton - Vallée de la Creuse,1968_1975,1971.5,7,21419,20842,2171,1914,-577,-257,-320,-0.00389357132085,-0.00173422500772695,-0.00215934631312305,EPCI
200068872,CC Éguzon - Argenton - Vallée de la Creuse,1975_1982,1978.5,7,20842,20518,2169,1382,-324,-787,463,-0.00223573015323741,-0.00543061614382051,0.00319488599058309,EPCI
200068872,CC Éguzon - Argenton - Vallée de la Creuse,1982_1990,1986,8,20518,19769,2413,1458,-749,-955,206,-0.00463764966962033,-0.00591315812348119,0.00127550845386086,EPCI
200068872,CC Éguzon - Argenton - Vallée de la Creuse,1990_1999,1994.5,9,19769,19670,2743,1538,-99,-1205,1106,-0.000557669090628044,-0.00678779044653326,0.00623012135590521,EPCI
200068872,CC Éguzon - Argenton - Vallée de la Creuse,1999_2006,2002.5,7,19670,20156,2271,1328,486,-943,1429,0.00349285419334588,-0.00677728704593656,0.0102701412392824,EPCI
200068880,CC Champagne Boischauts,2006_2011,2008.5,5,9891,10398,587,614,507,27,480,0.0100477888640182,0.000535089347787954,0.00951269951623029,EPCI
200068880,CC Champagne Boischauts,2011_2016,2013.5,5,10398,10006,549,466,-392,-83,-309,-0.00765625380495727,-0.00162109455564146,-0.00603515924931581,EPCI
200068880,CC Champagne Boischauts,1968_1975,1971.5,7,11507,10447,1017,884,-1060,-133,-927,-0.0137109496770543,-0.00172033613872474,-0.0119906135383296,EPCI
200068880,CC Champagne Boischauts,1975_1982,1978.5,7,10447,9869,1016,630,-578,-386,-192,-0.00809793713693196,-0.00540796493919678,-0.00268997219773519,EPCI
200068880,CC Champagne Boischauts,1982_1990,1986,8,9869,9453,1096,642,-416,-454,38,-0.0053688334887857,-0.0058592557786267,0.000490422289841001,EPCI
200068880,CC Champagne Boischauts,1990_1999,1994.5,9,9453,9263,1076,821,-190,-255,65,-0.00225347722937486,-0.00302440364995046,0.000770926420575609,EPCI
200068880,CC Champagne Boischauts,1999_2006,2002.5,7,9263,9891,837,779,628,-58,686,0.00941508603087682,-0.00086954616208735,0.0102846321929642,EPCI
200068914,CC La Rochefoucauld - Porte du Périgord,2006_2011,2008.5,5,21200,21820,1239,1048,620,-191,811,0.0057818102610856,-0.00178117058043121,0.0075629808415168,EPCI
200068914,CC La Rochefoucauld - Porte du Périgord,2011_2016,2013.5,5,21820,21881,1343,978,61,-365,426,0.000558495889503297,-0.00334181966670005,0.00390031555620335,EPCI
200068914,CC La Rochefoucauld - Porte du Périgord,1968_1975,1971.5,7,19160,19415,1742,1850,255,108,147,0.00189052631589148,0.000800693498495216,0.00108983281739627,EPCI
200068914,CC La Rochefoucauld - Porte du Périgord,1975_1982,1978.5,7,19415,19720,1763,1464,305,-299,604,0.00222925051957179,-0.00218539641099005,0.00441464693056184,EPCI
200068914,CC La Rochefoucauld - Porte du Périgord,1982_1990,1986,8,19720,20289,1952,1641,569,-311,880,0.00356201872469453,-0.00194690302878734,0.00550892175348187,EPCI
200068914,CC La Rochefoucauld - Porte du Périgord,1990_1999,1994.5,9,20289,19881,2044,1577,-408,-467,59,-0.00225460626931751,-0.00258064001904724,0.000326033749729737,EPCI
200068914,CC La Rochefoucauld - Porte du Périgord,1999_2006,2002.5,7,19881,21200,1589,1411,1319,-178,1497,0.00921890327306207,-0.00124409763654666,0.0104630009096087,EPCI
200068922,CC du Confluent et des Coteaux de Prayssas,2006_2011,2008.5,5,17645,18080,968,998,435,30,405,0.00488266109709445,0.00033673524807548,0.00454592584901897,EPCI
200068922,CC du Confluent et des Coteaux de Prayssas,2011_2016,2013.5,5,18080,18319,978,987,239,9,230,0.00262993575746573,9.9035237728835e-05,0.00253090051973689,EPCI
200068922,CC du Confluent et des Coteaux de Prayssas,1968_1975,1971.5,7,17019,16000,1541,1409,-1019,-132,-887,-0.00878145080732817,-0.00113753827926135,-0.00764391252806682,EPCI
200068922,CC du Confluent et des Coteaux de Prayssas,1975_1982,1978.5,7,16000,16213,1419,1190,213,-229,442,0.00189102392458707,-0.00203307267009595,0.00392409659468302,EPCI
200068922,CC du Confluent et des Coteaux de Prayssas,1982_1990,1986,8,16213,16456,1544,1493,243,-51,294,0.00186132546754392,-0.000390648554916625,0.00225197402246054,EPCI
200068922,CC du Confluent et des Coteaux de Prayssas,1990_1999,1994.5,9,16456,16744,1752,1494,288,-258,546,0.00192961852157536,-0.00172861659224459,0.00365823511381995,EPCI
200068922,CC du Confluent et des Coteaux de Prayssas,1999_2006,2002.5,7,16744,17645,1461,1311,901,-150,1051,0.00751559738837138,-0.0012512093321373,0.00876680672050867,EPCI
200068930,CC Fumel Vallée du Lot,2006_2011,2008.5,5,25163,24975,1438,1118,-188,-320,132,-0.00149874317569187,-0.00255105221394362,0.00105230903825174,EPCI
200068930,CC Fumel Vallée du Lot,2011_2016,2013.5,5,24975,24458,1528,1017,-517,-511,-6,-0.0041748537204237,-0.00412640280684045,-4.84509135832536e-05,EPCI
200068930,CC Fumel Vallée du Lot,1968_1975,1971.5,7,25788,26812,2059,2768,1024,709,315,0.00557839893697532,0.00386238754522998,0.00171601139174534,EPCI
200068930,CC Fumel Vallée du Lot,1975_1982,1978.5,7,26812,26893,2004,2230,81,226,-145,0.00043101874759266,0.00120259551797458,-0.000771576770381922,EPCI
200068930,CC Fumel Vallée du Lot,1982_1990,1986,8,26893,26294,2415,2302,-599,-113,-486,-0.00281169643414936,-0.000530420195423835,-0.00228127623872552,EPCI
200068930,CC Fumel Vallée du Lot,1990_1999,1994.5,9,26294,24875,2638,2176,-1419,-462,-957,-0.00614520642019945,-0.00200076488099517,-0.00414444153920428,EPCI
200068930,CC Fumel Vallée du Lot,1999_2006,2002.5,7,24875,25163,2074,1692,288,-382,670,0.00164583555501374,-0.0021830179931085,0.00382885354812225,EPCI
200068948,CC Albret Communauté,2006_2011,2008.5,5,25884,26378,1592,1241,494,-351,845,0.00378821967613585,-0.002691629769886,0.00647984944602185,EPCI
200068948,CC Albret Communauté,2011_2016,2013.5,5,26378,26307,1675,1183,-71,-492,421,-0.000538907924606091,-0.00373440420994644,0.00319549628534034,EPCI
200068948,CC Albret Communauté,1968_1975,1971.5,7,27629,26267,2671,2372,-1362,-299,-1063,-0.00719577798468363,-0.00157968988063172,-0.00561608810405191,EPCI
200068948,CC Albret Communauté,1975_1982,1978.5,7,26267,25442,2603,1883,-825,-720,-105,-0.00454848797318452,-0.00396958950387013,-0.000578898469314394,EPCI
200068948,CC Albret Communauté,1982_1990,1986,8,25442,25347,2800,2221,-95,-579,484,-0.000467512169013196,-0.00284936364061727,0.00238185147160407,EPCI
200068948,CC Albret Communauté,1990_1999,1994.5,9,25347,24950,3074,2068,-397,-1006,609,-0.00175252449253249,-0.00444090589291609,0.0026883814003836,EPCI
200068948,CC Albret Communauté,1999_2006,2002.5,7,24950,25884,2435,1700,934,-735,1669,0.00526397701142156,-0.00414242302290669,0.00940640003432825,EPCI
200068955,CC Anjou Loir et Sarthe,2006_2011,2008.5,5,25408,26734,1148,1894,1326,746,580,0.0102263510521534,0.00575328648937138,0.00447306456278204,EPCI
200068955,CC Anjou Loir et Sarthe,2011_2016,2013.5,5,26734,27690,1210,1821,956,611,345,0.00705178226856096,0.00450694452519953,0.00254483774336143,EPCI
200068955,CC Anjou Loir et Sarthe,1968_1975,1971.5,7,19499,18997,1645,2119,-502,474,-976,-0.00371908276544319,0.00351164388609576,-0.00723072665153896,EPCI
200068955,CC Anjou Loir et Sarthe,1975_1982,1978.5,7,18997,20542,1655,1989,1545,334,1211,0.0112326894329522,0.00242829661527899,0.00880439281767321,EPCI
200068955,CC Anjou Loir et Sarthe,1982_1990,1986,8,20542,21361,1879,2246,819,367,452,0.00489886774836923,0.00219521912533762,0.00270364862303161,EPCI
200068955,CC Anjou Loir et Sarthe,1990_1999,1994.5,9,21361,22641,1961,2473,1280,512,768,0.00648712779902638,0.00259485111961055,0.00389227667941583,EPCI
200068955,CC Anjou Loir et Sarthe,1999_2006,2002.5,7,22641,25408,1575,2557,2767,982,1785,0.0166080719637354,0.00589415492171599,0.0107139170420194,EPCI
200068963,CC Maine Coeur de Sarthe,2006_2011,2008.5,5,19512,20739,636,1402,1227,766,461,0.0122719549418939,0.00766122044457274,0.00461073449732119,EPCI
200068963,CC Maine Coeur de Sarthe,2011_2016,2013.5,5,20739,21179,722,1261,440,539,-99,0.00420765524298083,0.00515437767265152,-0.000946722429670688,EPCI
200068963,CC Maine Coeur de Sarthe,1968_1975,1971.5,7,12375,12800,897,1331,425,434,-9,0.00483549093048086,0.00493788956194986,-0.000102398631469007,EPCI
200068963,CC Maine Coeur de Sarthe,1975_1982,1978.5,7,12800,15064,921,1163,2264,242,2022,0.0235388553701346,0.00251607906341544,0.0210227763067191,EPCI
200068963,CC Maine Coeur de Sarthe,1982_1990,1986,8,15064,15812,1012,1411,748,399,349,0.00607605404261014,0.0032411036938522,0.00283495034875794,EPCI
200068963,CC Maine Coeur de Sarthe,1990_1999,1994.5,9,15812,16956,1047,1678,1144,631,513,0.00779159864208334,0.00429763876149877,0.00349395988058458,EPCI
200068963,CC Maine Coeur de Sarthe,1999_2006,2002.5,7,16956,19512,922,1640,2556,718,1838,0.0202607914303274,0.00569141167722031,0.0145693797531071,EPCI
200068989,CA Dinan Agglomération,2006_2011,2008.5,5,88266,93812,5050,5153,5546,103,5443,0.0122621303609474,0.00022773159523577,0.0120343987657116,EPCI
200068989,CA Dinan Agglomération,2011_2016,2013.5,5,93812,96891,5411,4706,3079,-705,3784,0.00647967398571847,-0.00148365383563869,0.00796332782135716,EPCI
200068989,CA Dinan Agglomération,1968_1975,1971.5,7,75729,78973,6934,9024,3244,2090,1154,0.00601010918999534,0.00387211103794398,0.00213799815205136,EPCI
200068989,CA Dinan Agglomération,1975_1982,1978.5,7,78973,81952,7068,8130,2979,1062,1917,0.00530368473496012,0.0018907395731882,0.00341294516177192,EPCI
200068989,CA Dinan Agglomération,1982_1990,1986,8,81952,82330,7571,7906,378,335,43,0.000575396888968793,0.000509941687313613,6.54552016551802e-05,EPCI
200068989,CA Dinan Agglomération,1990_1999,1994.5,9,82330,81480,8443,7391,-850,-1052,202,-0.00115244319911312,-0.00142631793584353,0.000273874736730412,EPCI
200068989,CA Dinan Agglomération,1999_2006,2002.5,7,81480,88266,6687,6481,6786,-206,6992,0.0114937500703229,-0.000348911363761645,0.0118426614340846,EPCI
200068997,CA Arlysère,2006_2011,2008.5,5,57211,59061,2434,3402,1850,968,882,0.00638522327748592,0.00334102493654398,0.00304419834094194,EPCI
200068997,CA Arlysère,2011_2016,2013.5,5,59061,60768,2526,3406,1707,880,827,0.00571477267132958,0.00294610424766844,0.00276866842366114,EPCI
200068997,CA Arlysère,1968_1975,1971.5,7,45022,47261,3220,5189,2239,1969,270,0.00695754516082769,0.00611853792839202,0.000839007232435675,EPCI
200068997,CA Arlysère,1975_1982,1978.5,7,47261,48659,3247,4519,1398,1272,126,0.00417316282335989,0.00379704085215578,0.00037612197120411,EPCI
200068997,CA Arlysère,1982_1990,1986,8,48659,52129,3680,5285,3470,1605,1865,0.00864775633801096,0.00399989882493014,0.00464785751308082,EPCI
200068997,CA Arlysère,1990_1999,1994.5,9,52129,53558,4196,5718,1429,1522,-93,0.00300938168509335,0.0032052336771953,-0.000195851992101947,EPCI
200068997,CA Arlysère,1999_2006,2002.5,7,53558,57211,3368,4539,3653,1171,2482,0.0094704217037187,0.00303582365591421,0.00643459804780449,EPCI
200069003,CC du Barséquanais en Champagne,2006_2011,2008.5,5,19445,19594,1140,1112,149,-28,177,0.00152785184109527,-0.000287113097655488,0.00181496493875076,EPCI
200069003,CC du Barséquanais en Champagne,2011_2016,2013.5,5,19594,19051,1069,991,-543,-78,-465,-0.0056049937371716,-0.000805137221914153,-0.00479985651525745,EPCI
200069003,CC du Barséquanais en Champagne,1968_1975,1971.5,7,19263,19773,1899,2100,510,201,309,0.00374000690213494,0.00147400272025318,0.00226600418188176,EPCI
200069003,CC du Barséquanais en Champagne,1975_1982,1978.5,7,19773,20092,1819,1808,319,-11,330,0.00228895211009994,-7.89293831068945e-05,0.00236788149320683,EPCI
200069003,CC du Barséquanais en Champagne,1982_1990,1986,8,20092,19899,2046,2104,-193,58,-251,-0.0012058032688459,0.000362365749186849,-0.00156816901803274,EPCI
200069003,CC du Barséquanais en Champagne,1990_1999,1994.5,9,19899,19373,2141,1993,-526,-148,-378,-0.00297214497336185,-0.000836268927866071,-0.00213587604549577,EPCI
200069003,CC du Barséquanais en Champagne,1999_2006,2002.5,7,19373,19445,1551,1523,72,-28,100,0.00053008666100407,-0.000206144812612694,0.000736231473616764,EPCI
200069029,CA des Deux Baies en Montreuillois,2006_2011,2008.5,5,68142,67406,3521,3966,-736,445,-1181,-0.00216958871466844,0.00131177578536339,-0.00348136450003182,EPCI
200069029,CA des Deux Baies en Montreuillois,2011_2016,2013.5,5,67406,66584,3778,3586,-822,-192,-630,-0.00245093679448216,-0.00057248158703233,-0.00187845520744983,EPCI
200069029,CA des Deux Baies en Montreuillois,1968_1975,1971.5,7,51852,56478,4192,7125,4626,2933,1693,0.0122830640296778,0.00778777060074472,0.00449529342893311,EPCI
200069029,CA des Deux Baies en Montreuillois,1975_1982,1978.5,7,56478,59529,4535,6732,3051,2197,854,0.00754437460297819,0.00543264208546152,0.00211173251751667,EPCI
200069029,CA des Deux Baies en Montreuillois,1982_1990,1986,8,59529,62423,4984,7593,2894,2609,285,0.00595141577633007,0.00536532265392023,0.000586093122409838,EPCI
200069029,CA des Deux Baies en Montreuillois,1990_1999,1994.5,9,62423,64043,5693,7481,1620,1788,-168,0.00285082651554602,0.00314646778382487,-0.000295641268278847,EPCI
200069029,CA des Deux Baies en Montreuillois,1999_2006,2002.5,7,64043,68142,4693,5823,4099,1130,2969,0.00890210879914344,0.00245410659747062,0.00644800220167282,EPCI
200069037,CA du Pays de Saint-Omer,2006_2011,2008.5,5,100971,103017,4471,6838,2046,2367,-321,0.00402019464053827,0.00465092899030014,-0.000630734349761869,EPCI
200069037,CA du Pays de Saint-Omer,2011_2016,2013.5,5,103017,105351,4644,6700,2334,2056,278,0.00449077528803432,0.00395588431542355,0.000534890972610772,EPCI
200069037,CA du Pays de Saint-Omer,1968_1975,1971.5,7,81471,89472,6434,12319,8001,5885,2116,0.0134726054793972,0.00990954671244252,0.00356305876695469,EPCI
200069037,CA du Pays de Saint-Omer,1975_1982,1978.5,7,89472,93892,6292,11644,4420,5352,-932,0.00691227430366648,0.00836979458670203,-0.00145752028303556,EPCI
200069037,CA du Pays de Saint-Omer,1982_1990,1986,8,93892,96912,6908,12908,3020,6000,-2980,0.00396511091792751,0.007877703810452,-0.00391259289252449,EPCI
200069037,CA du Pays de Saint-Omer,1990_1999,1994.5,9,96912,100399,7326,12470,3487,5144,-1657,0.00393537854704484,0.00580544515227952,-0.00187006660523467,EPCI
200069037,CA du Pays de Saint-Omer,1999_2006,2002.5,7,100399,100971,5885,9562,572,3677,-3105,0.000811915117693074,0.00521925155202349,-0.00440733643433041,EPCI
200069052,CA Grand Belfort,2006_2011,2008.5,5,102601,104436,3915,6923,1835,3008,-1173,0.0035516450607882,0.00582198819773891,-0.00227034313695071,EPCI
200069052,CA Grand Belfort,2011_2016,2013.5,5,104436,105041,4325,6532,605,2207,-1602,0.00115592887871951,0.00421675212451896,-0.00306082324579944,EPCI
200069052,CA Grand Belfort,1968_1975,1971.5,7,86292,93553,6128,11298,7261,5170,2091,0.0116084651063082,0.00826549574433458,0.00334296936197362,EPCI
200069052,CA Grand Belfort,1975_1982,1978.5,7,93553,95559,6203,10651,2006,4448,-2442,0.00303541717087863,0.00673057605985451,-0.00369515888897588,EPCI
200069052,CA Grand Belfort,1982_1990,1986,8,95559,96839,6618,11661,1280,5043,-3763,0.00166462744811002,0.00655837204751472,-0.0048937445994047,EPCI
200069052,CA Grand Belfort,1990_1999,1994.5,9,96839,99646,6950,12250,2807,5300,-2493,0.00317994529476118,0.0060041717357443,-0.00282422644098312,EPCI
200069052,CA Grand Belfort,1999_2006,2002.5,7,99646,102601,5507,9637,2955,4130,-1175,0.00418355156640016,0.00584706191852205,-0.00166351035212189,EPCI
200069060,CC des Vosges du Sud,2006_2011,2008.5,5,15095,15234,857,851,139,-6,145,0.0018349231733541,-7.92053168354287e-05,0.00191412849018953,EPCI
200069060,CC des Vosges du Sud,2011_2016,2013.5,5,15234,15438,910,722,204,-188,392,0.00266398824269598,-0.00245504798836688,0.00511903623106286,EPCI
200069060,CC des Vosges du Sud,1968_1975,1971.5,7,11705,12312,1234,1177,607,-57,664,0.00724875963979765,-0.000680690773424162,0.00792945041322182,EPCI
200069060,CC des Vosges du Sud,1975_1982,1978.5,7,12312,13002,1150,989,690,-161,851,0.00782024753817168,-0.00182472442557339,0.00964497196374507,EPCI
200069060,CC des Vosges du Sud,1982_1990,1986,8,13002,13473,1295,1203,471,-92,563,0.00445796868291515,-0.000870770952926101,0.00532873963584125,EPCI
200069060,CC des Vosges du Sud,1990_1999,1994.5,9,13473,14215,1420,1280,742,-140,882,0.00597444985054296,-0.00112725468878169,0.00710170453932465,EPCI
200069060,CC des Vosges du Sud,1999_2006,2002.5,7,14215,15095,1260,1174,880,-86,966,0.00861775201078485,-0.000842189401053974,0.00945994141183883,EPCI
200069086,CC Leff Armor Communauté,2006_2011,2008.5,5,28394,30412,1673,1957,2018,284,1734,0.0138265977658394,0.00194586410579702,0.0118807336600424,EPCI
200069086,CC Leff Armor Communauté,2011_2016,2013.5,5,30412,31258,1749,1864,846,115,731,0.00550269975120821,0.000748002921263527,0.00475469682994468,EPCI
200069086,CC Leff Armor Communauté,1968_1975,1971.5,7,23843,23040,2409,2088,-803,-321,-482,-0.00488216293583288,-0.00195164919352722,-0.00293051374230566,EPCI
200069086,CC Leff Armor Communauté,1975_1982,1978.5,7,23040,24075,2420,1851,1035,-569,1604,0.00629719043681232,-0.00346193367975479,0.00975912411656711,EPCI
200069086,CC Leff Armor Communauté,1982_1990,1986,8,24075,24551,2644,2258,476,-386,862,0.00245032576872406,-0.0019870288796796,0.00443735464840365,EPCI
200069086,CC Leff Armor Communauté,1990_1999,1994.5,9,24551,25801,2875,2476,1250,-399,1649,0.00553310296597465,-0.00176616646673911,0.00729926943271375,EPCI
200069086,CC Leff Armor Communauté,1999_2006,2002.5,7,25801,28394,2275,2468,2593,193,2400,0.0137746661761093,0.00102526439336255,0.0127494017827468,EPCI
200069094,CC Isle et Crempse-en-Périgord,2006_2011,2008.5,5,13726,14238,959,636,512,-323,835,0.00735141035068931,-0.00463770613920439,0.0119891164898937,EPCI
200069094,CC Isle et Crempse-en-Périgord,2011_2016,2013.5,5,14238,14299,940,593,61,-347,408,0.000855397257540913,-0.00486594833388028,0.00572134559142119,EPCI
200069094,CC Isle et Crempse-en-Périgord,1968_1975,1971.5,7,12781,12965,1271,1094,184,-177,361,0.00204404705621308,-0.00196628439646585,0.00401033145267893,EPCI
200069094,CC Isle et Crempse-en-Périgord,1975_1982,1978.5,7,12965,13259,1313,886,294,-427,721,0.00320844294756939,-0.00465988142385078,0.00786832437142017,EPCI
200069094,CC Isle et Crempse-en-Périgord,1982_1990,1986,8,13259,13310,1522,992,51,-530,581,0.0004799983216488,-0.00498821785242871,0.00546821617407751,EPCI
200069094,CC Isle et Crempse-en-Périgord,1990_1999,1994.5,9,13310,13026,1632,952,-284,-680,396,-0.00239360544508915,-0.00573116796711487,0.00333756252202572,EPCI
200069094,CC Isle et Crempse-en-Périgord,1999_2006,2002.5,7,13026,13726,1412,871,700,-541,1241,0.00750581192319366,-0.00580092035778253,0.0133067322809762,EPCI
200069102,CC Randon - Margeride,2006_2011,2008.5,5,5173,5276,377,260,103,-117,220,0.00395087296915353,-0.00448788482903848,0.008438757798192,EPCI
200069102,CC Randon - Margeride,2011_2016,2013.5,5,5276,5364,354,233,88,-121,209,0.00331382472992847,-0.00455650900365165,0.00787033373358012,EPCI
200069102,CC Randon - Margeride,1968_1975,1971.5,7,6476,5909,684,463,-567,-221,-346,-0.0130041942632763,-0.00506865420138281,-0.00793554006189345,EPCI
200069102,CC Randon - Margeride,1975_1982,1978.5,7,5909,5539,620,378,-370,-242,-128,-0.00919498423838971,-0.00601401671808192,-0.00318096752030779,EPCI
200069102,CC Randon - Margeride,1982_1990,1986,8,5539,5035,644,354,-504,-290,-214,-0.0118542349195715,-0.00682088914022963,-0.00503334577934187,EPCI
200069102,CC Randon - Margeride,1990_1999,1994.5,9,5035,4926,605,380,-109,-225,116,-0.00242884850393554,-0.0050136781044541,0.00258482960051856,EPCI
200069102,CC Randon - Margeride,1999_2006,2002.5,7,4926,5173,528,360,247,-168,415,0.00701383845711812,-0.00477054599512487,0.011784384452243,EPCI
200069110,CA du Grand Chambéry,2006_2011,2008.5,5,125709,129201,4744,8014,3492,3270,222,0.00549496608249322,0.00514562975078833,0.000349336331704896,EPCI
200069110,CA du Grand Chambéry,2011_2016,2013.5,5,129201,133638,5153,7939,4437,2786,1651,0.0067759174599995,0.00425461033210697,0.00252130712789254,EPCI
200069110,CA du Grand Chambéry,1968_1975,1971.5,7,83572,95998,5648,10907,12426,5259,7167,0.0200000628151316,0.00846453648356485,0.0115355263315667,EPCI
200069110,CA du Grand Chambéry,1975_1982,1978.5,7,95998,102856,5845,10555,6858,4710,2148,0.00990625873208084,0.00680351102771956,0.00310274770436128,EPCI
200069110,CA du Grand Chambéry,1982_1990,1986,8,102856,110134,6889,11836,7278,4947,2331,0.00858260295530378,0.00583376433359271,0.00274883862171106,EPCI
200069110,CA du Grand Chambéry,1990_1999,1994.5,9,110134,119095,8083,12962,8961,4879,4082,0.00872940179360482,0.00475290161265461,0.00397650018095021,EPCI
200069110,CA du Grand Chambéry,1999_2006,2002.5,7,119095,125709,6621,10488,6614,3867,2747,0.00775105914877416,0.00453180310376621,0.00321925604500796,EPCI
200069128,CC Mont Lozère,2006_2011,2008.5,5,5408,5538,367,263,130,-104,234,0.00476212022610878,-0.00380969618088702,0.0085718164069958,EPCI
200069128,CC Mont Lozère,2011_2016,2013.5,5,5538,5444,354,243,-94,-111,17,-0.00341801323976931,-0.00403616457036589,0.000618151330596578,EPCI
200069128,CC Mont Lozère,1968_1975,1971.5,7,6346,5549,641,385,-797,-256,-541,-0.0189898011766602,-0.00609960991370765,-0.0128901912629525,EPCI
200069128,CC Mont Lozère,1975_1982,1978.5,7,5549,5433,597,378,-116,-219,103,-0.0030134879845326,-0.00568925748804,0.0026757695035074,EPCI
200069128,CC Mont Lozère,1982_1990,1986,8,5433,4987,675,401,-446,-274,-172,-0.0106500004768538,-0.00654282540506266,-0.00410717507179116,EPCI
200069128,CC Mont Lozère,1990_1999,1994.5,9,4987,5053,706,428,66,-278,344,0.00146191196918233,-0.00615775041564678,0.0076196623848291,EPCI
200069128,CC Mont Lozère,1999_2006,2002.5,7,5053,5408,512,349,355,-163,518,0.00974679537610768,-0.00447528914452268,0.0142220845206304,EPCI
200069136,CC des Cévennes au Mont Lozère,2006_2011,2008.5,5,5041,5090,354,151,49,-203,252,0.00193654377598618,-0.00802282421479988,0.00995936799078605,EPCI
200069136,CC des Cévennes au Mont Lozère,2011_2016,2013.5,5,5090,5089,330,176,-1,-154,153,-3.929581904627e-05,-0.00605155613312558,0.00601226031407931,EPCI
200069136,CC des Cévennes au Mont Lozère,1968_1975,1971.5,7,4978,4498,578,252,-480,-326,-154,-0.014380646425911,-0.00976685569759787,-0.0046137907283131,EPCI
200069136,CC des Cévennes au Mont Lozère,1975_1982,1978.5,7,4498,4208,497,249,-290,-248,-42,-0.00947558927908054,-0.00810326255590336,-0.00137232672317718,EPCI
200069136,CC des Cévennes au Mont Lozère,1982_1990,1986,8,4208,4446,565,385,238,-180,418,0.00690086953292757,-0.0052191450249032,0.0121200145578308,EPCI
200069136,CC des Cévennes au Mont Lozère,1990_1999,1994.5,9,4446,4796,645,392,350,-253,603,0.00845525899240229,-0.00611194435736509,0.0145672033497674,EPCI
200069136,CC des Cévennes au Mont Lozère,1999_2006,2002.5,7,4796,5041,506,235,245,-271,516,0.00714285189897779,-0.00790086883519584,0.0150437207341736,EPCI
200069144,CC des Hautes Terres de l'Aubrac,2006_2011,2008.5,5,5302,5312,379,236,10,-143,153,0.000376931882435594,-0.00539012591882899,0.00576705780126459,EPCI
200069144,CC des Hautes Terres de l'Aubrac,2011_2016,2013.5,5,5312,5114,434,169,-198,-265,67,-0.0075685204700584,-0.0101295854776034,0.00256106500754501,EPCI
200069144,CC des Hautes Terres de l'Aubrac,1968_1975,1971.5,7,6681,6148,707,461,-533,-246,-287,-0.0118070081869994,-0.00544938839399973,-0.00635761979299969,EPCI
200069144,CC des Hautes Terres de l'Aubrac,1975_1982,1978.5,7,6148,5704,613,368,-444,-245,-199,-0.0106513176095926,-0.00587741624853645,-0.00477390136105614,EPCI
200069144,CC des Hautes Terres de l'Aubrac,1982_1990,1986,8,5704,5156,659,371,-548,-288,-260,-0.0125464534230253,-0.00659375654348775,-0.00595269687953755,EPCI
200069144,CC des Hautes Terres de l'Aubrac,1990_1999,1994.5,9,5156,5080,667,407,-76,-260,184,-0.00164861991810716,-0.00564001550931398,0.00399139559120682,EPCI
200069144,CC des Hautes Terres de l'Aubrac,1999_2006,2002.5,7,5080,5302,544,328,222,-216,438,0.00612911322766485,-0.00596346151880904,0.0120925747464739,EPCI
200069151,CC Gorges Causses Cévennes,2006_2011,2008.5,5,6966,7072,450,354,106,-96,202,0.00302499677508328,-0.00273961972083014,0.00576461649591342,EPCI
200069151,CC Gorges Causses Cévennes,2011_2016,2013.5,5,7072,7041,495,333,-31,-162,131,-0.000878238082659855,-0.00458950223841601,0.00371126415575616,EPCI
200069151,CC Gorges Causses Cévennes,1968_1975,1971.5,7,6608,6445,727,504,-163,-223,60,-0.00356169916651139,-0.00487275407442969,0.0013110549079183,EPCI
200069151,CC Gorges Causses Cévennes,1975_1982,1978.5,7,6445,6429,723,525,-16,-198,182,-0.00035502713888802,-0.00439346084373925,0.00403843370485123,EPCI
200069151,CC Gorges Causses Cévennes,1982_1990,1986,8,6429,6365,728,564,-64,-164,100,-0.00124981497367505,-0.0032026508700423,0.00195283589636726,EPCI
200069151,CC Gorges Causses Cévennes,1990_1999,1994.5,9,6365,6709,776,557,344,-219,563,0.00586554383748461,-0.00373416889653817,0.00959971273402278,EPCI
200069151,CC Gorges Causses Cévennes,1999_2006,2002.5,7,6709,6966,697,476,257,-221,478,0.00538462574595156,-0.00463035910449531,0.0100149848504469,EPCI
200069169,CC Dômes Sancy Artense,2006_2011,2008.5,5,11731,12083,775,601,352,-174,526,0.00593043491666068,-0.00293152180539477,0.00886195672205544,EPCI
200069169,CC Dômes Sancy Artense,2011_2016,2013.5,5,12083,12241,733,603,158,-130,288,0.00260167189943106,-0.00214061611978505,0.00474228801921611,EPCI
200069169,CC Dômes Sancy Artense,1968_1975,1971.5,7,14783,13546,1487,1077,-1237,-410,-827,-0.0124061965425105,-0.00411199723721044,-0.00829419930530008,EPCI
200069169,CC Dômes Sancy Artense,1975_1982,1978.5,7,13546,12888,1453,857,-658,-596,-62,-0.00708828091936209,-0.00642038818835837,-0.000667892731003724,EPCI
200069169,CC Dômes Sancy Artense,1982_1990,1986,8,12888,12115,1480,892,-773,-588,-185,-0.00770172500173838,-0.00585849198062376,-0.00184323302111462,EPCI
200069169,CC Dômes Sancy Artense,1990_1999,1994.5,9,12115,11397,1522,808,-718,-714,-4,-0.00676525540913076,-0.00672756596395454,-3.76894451762158e-05,EPCI
200069169,CC Dômes Sancy Artense,1999_2006,2002.5,7,11397,11731,1055,746,334,-309,643,0.00413491780123043,-0.00382541796580899,0.00796033576703942,EPCI
200069177,CC Mond'Arverne Communauté,2006_2011,2008.5,5,37439,39052,1270,2112,1613,842,771,0.00847191516908996,0.00442241325007672,0.00404950191901324,EPCI
200069177,CC Mond'Arverne Communauté,2011_2016,2013.5,5,39052,40101,1431,2099,1049,668,381,0.00531551353690274,0.00338490280519641,0.00193061073170633,EPCI
200069177,CC Mond'Arverne Communauté,1968_1975,1971.5,7,18247,21508,1853,2210,3261,357,2904,0.0237672258643635,0.0026019318103581,0.0211652940540054,EPCI
200069177,CC Mond'Arverne Communauté,1975_1982,1978.5,7,21508,26668,1806,1986,5160,180,4980,0.0311966378969841,0.00108825481035991,0.0301083830866242,EPCI
200069177,CC Mond'Arverne Communauté,1982_1990,1986,8,26668,31447,1952,2615,4779,663,4116,0.0208186521599312,0.00288821225822021,0.017930439901711,EPCI
200069177,CC Mond'Arverne Communauté,1990_1999,1994.5,9,31447,34706,2139,2973,3259,834,2425,0.0110167977061504,0.00281927256426187,0.00819752514188852,EPCI
200069177,CC Mond'Arverne Communauté,1999_2006,2002.5,7,34706,37439,1763,2798,2733,1035,1698,0.0108874644754606,0.00412313418664535,0.00676433028881528,EPCI
200069185,CC des Terres d'Apcher-Margeride-Aubrac,2006_2011,2008.5,5,11141,10995,629,520,-146,-109,-37,-0.00263479742621897,-0.00196707479080731,-0.000667722635411657,EPCI
200069185,CC des Terres d'Apcher-Margeride-Aubrac,2011_2016,2013.5,5,10995,10623,681,421,-372,-260,-112,-0.00686019314132325,-0.00479475864716141,-0.00206543449416184,EPCI
200069185,CC des Terres d'Apcher-Margeride-Aubrac,1968_1975,1971.5,7,12912,12086,1043,1225,-826,182,-1008,-0.00939973703701957,0.00207112849968228,-0.0114708655367019,EPCI
200069185,CC des Terres d'Apcher-Margeride-Aubrac,1975_1982,1978.5,7,12086,11764,1041,1002,-322,-39,-283,-0.0038502454735988,-0.000466334079100476,-0.00338391139449833,EPCI
200069185,CC des Terres d'Apcher-Margeride-Aubrac,1982_1990,1986,8,11764,11209,1096,959,-555,-137,-418,-0.00602266481134839,-0.00148667581829681,-0.00453598899305158,EPCI
200069185,CC des Terres d'Apcher-Margeride-Aubrac,1990_1999,1994.5,9,11209,10709,1199,872,-500,-327,-173,-0.00505744756400839,-0.00330757070686149,-0.0017498768571469,EPCI
200069185,CC des Terres d'Apcher-Margeride-Aubrac,1999_2006,2002.5,7,10709,11141,842,697,432,-145,577,0.00566563041343238,-0.0019016583563604,0.00756728876979278,EPCI
200069193,CC de la Dombes,2006_2011,2008.5,5,35405,36844,1513,2183,1439,670,769,0.00799977456614087,0.00372470393281055,0.00427507063333032,EPCI
200069193,CC de la Dombes,2011_2016,2013.5,5,36844,38195,1602,2154,1351,552,799,0.00722836619868694,0.00295341091167668,0.00427495528701026,EPCI
200069193,CC de la Dombes,1968_1975,1971.5,7,17364,18554,1602,1885,1190,283,907,0.00951444899015086,0.00226267988589302,0.00725176910425784,EPCI
200069193,CC de la Dombes,1975_1982,1978.5,7,18554,22582,1540,1919,4028,379,3649,0.0284644025782648,0.00267825436374438,0.0257861482145204,EPCI
200069193,CC de la Dombes,1982_1990,1986,8,22582,26068,1972,2642,3486,670,2816,0.0181063909727481,0.00348000055987988,0.0146263904128683,EPCI
200069193,CC de la Dombes,1990_1999,1994.5,9,26068,31083,2432,3144,5015,712,4303,0.0197426402106964,0.00280294313659338,0.016939697074103,EPCI
200069193,CC de la Dombes,1999_2006,2002.5,7,31083,35405,1985,2995,4322,1010,3312,0.0187728942120138,0.00438700211803191,0.0143858920939819,EPCI
200069227,CC Pays Fort Sancerrois Val de Loire,2006_2011,2008.5,5,19588,19143,1363,892,-445,-471,26,-0.00458545859235571,-0.00485337302696525,0.000267914434609547,EPCI
200069227,CC Pays Fort Sancerrois Val de Loire,2011_2016,2013.5,5,19143,18747,1334,831,-396,-503,107,-0.00417194793262909,-0.00529921669220312,0.00112726875957402,EPCI
200069227,CC Pays Fort Sancerrois Val de Loire,1968_1975,1971.5,7,20442,19438,2566,1498,-1004,-1068,64,-0.00716870917166024,-0.00762567868061069,0.000456969508950454,EPCI
200069227,CC Pays Fort Sancerrois Val de Loire,1975_1982,1978.5,7,19438,19268,2431,1297,-170,-1134,964,-0.00125410214343047,-0.00836559900382442,0.00711149686039395,EPCI
200069227,CC Pays Fort Sancerrois Val de Loire,1982_1990,1986,8,19268,19812,2727,1710,544,-1017,1561,0.00348632890133738,-0.00651764061150756,0.0100039695128449,EPCI
200069227,CC Pays Fort Sancerrois Val de Loire,1990_1999,1994.5,9,19812,19420,2595,1750,-392,-845,453,-0.00221802009042338,-0.00478119126634631,0.00256317117592293,EPCI
200069227,CC Pays Fort Sancerrois Val de Loire,1999_2006,2002.5,7,19420,19588,1973,1264,168,-709,877,0.00123128183108778,-0.00519630248953118,0.00642758432061896,EPCI
200069235,CC du Haut Pays du Montreuillois,2006_2011,2008.5,5,14665,15638,827,992,973,165,808,0.0129309199979899,0.00219280760500343,0.0107381123929865,EPCI
200069235,CC du Haut Pays du Montreuillois,2011_2016,2013.5,5,15638,15770,893,1006,132,113,19,0.00168252411254155,0.0014403426114939,0.000242181501047647,EPCI
200069235,CC du Haut Pays du Montreuillois,1968_1975,1971.5,7,15220,14670,1346,1701,-550,355,-905,-0.00524416684747642,0.00338487132882569,-0.0086290381763021,EPCI
200069235,CC du Haut Pays du Montreuillois,1975_1982,1978.5,7,14670,14415,1305,1324,-255,19,-274,-0.00250190230730762,0.000186416250348411,-0.00268831855765604,EPCI
200069235,CC du Haut Pays du Montreuillois,1982_1990,1986,8,14415,14064,1472,1424,-351,-48,-303,-0.00307663120874291,-0.000420735891793902,-0.00265589531694901,EPCI
200069235,CC du Haut Pays du Montreuillois,1990_1999,1994.5,9,14064,13596,1548,1359,-468,-189,-279,-0.0037532399336212,-0.00151573151165472,-0.00223750842196648,EPCI
200069235,CC du Haut Pays du Montreuillois,1999_2006,2002.5,7,13596,14665,1219,1365,1069,146,923,0.0108712487305032,0.00148475427002195,0.00938649446048121,EPCI
200069250,CA Troyes Champagne Métropole,2006_2011,2008.5,5,163164,164535,6729,10274,1371,3545,-2174,0.00167489779105434,0.00433078969313468,-0.00265589190208033,EPCI
200069250,CA Troyes Champagne Métropole,2011_2016,2013.5,5,164535,170145,7054,10018,5610,2964,2646,0.00672807270040088,0.00355472504170913,0.00317334765869175,EPCI
200069250,CA Troyes Champagne Métropole,1968_1975,1971.5,7,135948,150522,10101,17911,14574,7810,6764,0.0146544521696759,0.00785311317724499,0.00680133899243088,EPCI
200069250,CA Troyes Champagne Métropole,1975_1982,1978.5,7,150522,154227,10037,15939,3705,5902,-2197,0.00347979622039785,0.00554325433003727,-0.00206345810963942,EPCI
200069250,CA Troyes Champagne Métropole,1982_1990,1986,8,154227,154651,11017,17216,424,6199,-5775,0.000343236673037373,0.00501821730226102,-0.00467498062922365,EPCI
200069250,CA Troyes Champagne Métropole,1990_1999,1994.5,9,154651,158427,12224,18368,3776,6144,-2368,0.00268392352183122,0.00436706200162368,-0.00168313847979246,EPCI
200069250,CA Troyes Champagne Métropole,1999_2006,2002.5,7,158427,163164,9346,13713,4737,4367,370,0.00421771399063386,0.00388827464578807,0.000329439344845795,EPCI
200069268,CC Aubrac Lot Causses Tarn,2006_2011,2008.5,5,7444,7649,450,469,205,19,186,0.00544810354412406,0.000504946182138328,0.00494315736198573,EPCI
200069268,CC Aubrac Lot Causses Tarn,2011_2016,2013.5,5,7649,7945,452,384,296,-68,364,0.0076224802435374,-0.00175111032621805,0.00937359056975545,EPCI
200069268,CC Aubrac Lot Causses Tarn,1968_1975,1971.5,7,6697,6608,740,542,-89,-198,109,-0.00190940743058932,-0.00424789518265938,0.00233848775207006,EPCI
200069268,CC Aubrac Lot Causses Tarn,1975_1982,1978.5,7,6608,6507,678,500,-101,-178,77,-0.00219794037039234,-0.00387359788049343,0.00167565751010109,EPCI
200069268,CC Aubrac Lot Causses Tarn,1982_1990,1986,8,6507,6493,749,526,-14,-223,209,-0.000269194633932934,-0.00428788595478888,0.00401869132085595,EPCI
200069268,CC Aubrac Lot Causses Tarn,1990_1999,1994.5,9,6493,6848,790,605,355,-185,540,0.00593218896738645,-0.00309142241962393,0.00902361138701038,EPCI
200069268,CC Aubrac Lot Causses Tarn,1999_2006,2002.5,7,6848,7444,619,593,596,-26,622,0.0119930177855512,-0.000523185339638139,0.0125162031251893,EPCI
200069300,CA Tarbes-Lourdes-Pyrénées,2006_2011,2008.5,5,124164,123485,6509,6576,-679,67,-746,-0.00109611506837848,0.000108158629722177,-0.00120427369810066,EPCI
200069300,CA Tarbes-Lourdes-Pyrénées,2011_2016,2013.5,5,123485,122365,6952,6459,-1120,-493,-627,-0.00182060263408024,-0.000801390266608533,-0.0010192123674717,EPCI
200069300,CA Tarbes-Lourdes-Pyrénées,1968_1975,1971.5,7,117003,122743,9036,12978,5740,3942,1798,0.00686533957460456,0.00471483773573017,0.00215050183887439,EPCI
200069300,CA Tarbes-Lourdes-Pyrénées,1975_1982,1978.5,7,122743,125023,9087,10411,2280,1324,956,0.00263274271118452,0.00152883831123171,0.00110390439995281,EPCI
200069300,CA Tarbes-Lourdes-Pyrénées,1982_1990,1986,8,125023,122914,10061,11385,-2109,1324,-3433,-0.00212433995681693,0.00133363020522789,-0.00345797016204482,EPCI
200069300,CA Tarbes-Lourdes-Pyrénées,1990_1999,1994.5,9,122914,122106,11614,12175,-808,561,-1369,-0.00073255420404339,0.00050861746097567,-0.00124117166501906,EPCI
200069300,CA Tarbes-Lourdes-Pyrénées,1999_2006,2002.5,7,122106,124164,9199,9118,2058,-81,2139,0.00239053169713266,-9.40879822486615e-05,0.00248461967938132,EPCI
200069383,CC du Grand Villefranchois,2006_2011,2008.5,5,26709,26962,1581,1329,253,-252,505,0.0018873548181304,-0.00187989491766349,0.00376724973579389,EPCI
200069383,CC du Grand Villefranchois,2011_2016,2013.5,5,26962,27486,1642,1246,524,-396,920,0.00385708284456721,-0.00291489466879506,0.00677197751336227,EPCI
200069383,CC du Grand Villefranchois,1968_1975,1971.5,7,24263,25268,2545,2333,1005,-212,1217,0.00581487208852094,-0.0012266197838472,0.00704149187236814,EPCI
200069383,CC du Grand Villefranchois,1975_1982,1978.5,7,25268,26139,2363,2177,871,-186,1057,0.00485312112623237,-0.00103637259412081,0.00588949372035318,EPCI
200069383,CC du Grand Villefranchois,1982_1990,1986,8,26139,26055,2555,2210,-84,-345,261,-0.000402264514436146,-0.00165215782714846,0.00124989331271231,EPCI
200069383,CC du Grand Villefranchois,1990_1999,1994.5,9,26055,25749,2817,2214,-306,-603,297,-0.00131179406242399,-0.00258500594654139,0.0012732118841174,EPCI
200069383,CC du Grand Villefranchois,1999_2006,2002.5,7,25749,26709,2195,1726,960,-469,1429,0.00524295297644972,-0.00256140098536971,0.00780435396181943,EPCI
200069391,CA de Lamballe Terre et Mer,2006_2011,2008.5,5,60599,65672,3340,3951,5073,611,4462,0.016208813107822,0.00195221462820406,0.0142565984796179,EPCI
200069391,CA de Lamballe Terre et Mer,2011_2016,2013.5,5,65672,67297,3542,3624,1625,82,1543,0.00490056952205986,0.000247290277420867,0.004653279244639,EPCI
200069391,CA de Lamballe Terre et Mer,1968_1975,1971.5,7,52289,52158,4786,5466,-131,680,-811,-0.000358285882660847,0.00185980458175096,-0.00221809046441181,EPCI
200069391,CA de Lamballe Terre et Mer,1975_1982,1978.5,7,52158,53802,4670,4801,1644,131,1513,0.00444313700271159,0.000354045588415583,0.00408909141429601,EPCI
200069391,CA de Lamballe Terre et Mer,1982_1990,1986,8,53802,54829,5413,5223,1027,-190,1217,0.00236637168090104,-0.00043779028176358,0.00280416196266462,EPCI
200069391,CA de Lamballe Terre et Mer,1990_1999,1994.5,9,54829,56229,5934,5405,1400,-529,1929,0.00280541527591383,-0.00106004620068458,0.00386546147659841,EPCI
200069391,CA de Lamballe Terre et Mer,1999_2006,2002.5,7,56229,60599,4486,4958,4370,472,3898,0.0107496168496972,0.00116105701442954,0.00958855983526768,EPCI
200069409,CA Saint-Brieuc Armor Agglomération,2006_2011,2008.5,5,144296,150100,6899,8880,5804,1981,3823,0.00791818295779811,0.00270260517563716,0.00521557778216096,EPCI
200069409,CA Saint-Brieuc Armor Agglomération,2011_2016,2013.5,5,150100,151517,7621,8086,1417,465,952,0.00188098508437884,0.000617260454647961,0.00126372462973088,EPCI
200069409,CA Saint-Brieuc Armor Agglomération,1968_1975,1971.5,7,109431,123274,8336,15607,13843,7271,6572,0.0171620772416294,0.00901433674954039,0.00814774049208905,EPCI
200069409,CA Saint-Brieuc Armor Agglomération,1975_1982,1978.5,7,123274,129652,8576,13430,6378,4854,1524,0.00723237360375384,0.00550422412552856,0.00172814947822528,EPCI
200069409,CA Saint-Brieuc Armor Agglomération,1982_1990,1986,8,129652,132310,9986,14021,2658,4035,-1377,0.00253993468772284,0.00385576992662215,-0.00131583523889931,EPCI
200069409,CA Saint-Brieuc Armor Agglomération,1990_1999,1994.5,9,132310,137001,11592,14117,4691,2525,2166,0.00387867723196167,0.00208775527834219,0.00179092195361948,EPCI
200069409,CA Saint-Brieuc Armor Agglomération,1999_2006,2002.5,7,137001,144296,9575,11916,7295,2341,4954,0.00743874822609003,0.00238712948557598,0.00505161874051405,EPCI
200069417,CC Pays d'Orthe et Arrigans,2006_2011,2008.5,5,21481,22908,1099,1153,1427,54,1373,0.0129465645870459,0.000489919052347918,0.012456645534698,EPCI
200069417,CC Pays d'Orthe et Arrigans,2011_2016,2013.5,5,22908,23619,1136,1084,711,-52,763,0.00613177852440971,-0.000448456375906196,0.00658023490031591,EPCI
200069417,CC Pays d'Orthe et Arrigans,1968_1975,1971.5,7,18623,18159,1742,1512,-464,-230,-234,-0.00359795043340072,-0.00178346680965984,-0.00181448362374088,EPCI
200069417,CC Pays d'Orthe et Arrigans,1975_1982,1978.5,7,18159,18479,1788,1264,320,-524,844,0.00249863734958145,-0.00409151865993962,0.00659015600952106,EPCI
200069417,CC Pays d'Orthe et Arrigans,1982_1990,1986,8,18479,18616,1968,1299,137,-669,806,0.00092373560676795,-0.00451079650312233,0.00543453210989028,EPCI
200069417,CC Pays d'Orthe et Arrigans,1990_1999,1994.5,9,18616,19080,2115,1497,464,-618,1082,0.00273921592828841,-0.00364835224931516,0.00638756817760357,EPCI
200069417,CC Pays d'Orthe et Arrigans,1999_2006,2002.5,7,19080,21481,1613,1373,2401,-240,2641,0.0170767628615667,-0.00170696505071887,0.0187837279122855,EPCI
200069425,CA Mont-Saint-Michel-Normandie,2006_2011,2008.5,5,87232,88747,5029,4488,1515,-541,2056,0.0034496140492124,-0.00123184237664945,0.00468145642586185,EPCI
200069425,CA Mont-Saint-Michel-Normandie,2011_2016,2013.5,5,88747,87984,5060,4212,-763,-848,85,-0.00172543875640707,-0.00191765670436854,0.000192217947961469,EPCI
200069425,CA Mont-Saint-Michel-Normandie,1968_1975,1971.5,7,95042,92546,7393,9865,-2496,2472,-4968,-0.00379465075581031,0.00375816372931214,-0.00755281448512245,EPCI
200069425,CA Mont-Saint-Michel-Normandie,1975_1982,1978.5,7,92546,91268,7057,8435,-1278,1378,-2656,-0.00198454032224193,0.00213982516748778,-0.00412436548972972,EPCI
200069425,CA Mont-Saint-Michel-Normandie,1982_1990,1986,8,91268,87384,8144,8105,-3884,-39,-3845,-0.00542125588293752,-5.44358855392799e-05,-0.00536681999739824,EPCI
200069425,CA Mont-Saint-Michel-Normandie,1990_1999,1994.5,9,87384,85392,8431,7855,-1992,-576,-1416,-0.00255891814508746,-0.000739928138338544,-0.00181899000674892,EPCI
200069425,CA Mont-Saint-Michel-Normandie,1999_2006,2002.5,7,85392,87232,6632,6502,1840,-130,1970,0.00305018759626874,-0.000215502384518987,0.00326568998078773,EPCI
200069433,CC de Vezouze en Piémont,2006_2011,2008.5,5,12152,12107,756,676,-45,-80,35,-0.000741718304458572,-0.00131861031903746,0.000576892014578889,EPCI
200069433,CC de Vezouze en Piémont,2011_2016,2013.5,5,12107,11834,761,567,-273,-194,-79,-0.00455102326024537,-0.00323406048530257,-0.0013169627749428,EPCI
200069433,CC de Vezouze en Piémont,1968_1975,1971.5,7,15536,14057,1614,1509,-1479,-105,-1374,-0.0141897090707077,-0.00100738299690623,-0.0131823260738015,EPCI
200069433,CC de Vezouze en Piémont,1975_1982,1978.5,7,14057,13066,1502,1067,-991,-435,-556,-0.0103895173384478,-0.00456048440184138,-0.00582903293660646,EPCI
200069433,CC de Vezouze en Piémont,1982_1990,1986,8,13066,12430,1520,1257,-636,-263,-373,-0.00621815312967944,-0.00257134319670706,-0.00364680993297237,EPCI
200069433,CC de Vezouze en Piémont,1990_1999,1994.5,9,12430,11891,1455,1116,-539,-339,-200,-0.00491356586457237,-0.00309035033040822,-0.00182321553416414,EPCI
200069433,CC de Vezouze en Piémont,1999_2006,2002.5,7,11891,12152,1168,946,261,-222,483,0.0031065229636833,-0.00264232987715591,0.00574885284083921,EPCI
200069441,CC du Pays de Bitche,2006_2011,2008.5,5,35485,35042,1641,1747,-443,106,-549,-0.00250939218066348,0.000600441469865303,-0.00310983365052879,EPCI
200069441,CC du Pays de Bitche,2011_2016,2013.5,5,35042,34531,1630,1615,-511,-15,-496,-0.0029336625290507,-8.61153384261457e-05,-0.00284754719062455,EPCI
200069441,CC du Pays de Bitche,1968_1975,1971.5,7,34350,34147,2800,3737,-203,937,-1140,-0.000846396495812751,0.00390676609151009,-0.00475316258732284,EPCI
200069441,CC du Pays de Bitche,1975_1982,1978.5,7,34147,34687,2689,3266,540,577,-37,0.00224397717965141,0.00239773117159049,-0.000153753991939078,EPCI
200069441,CC du Pays de Bitche,1982_1990,1986,8,34687,34652,2987,3768,-35,781,-816,-0.000126183658229473,0.00281569820220624,-0.00294188186043571,EPCI
200069441,CC du Pays de Bitche,1990_1999,1994.5,9,34652,35074,3132,3527,422,395,27,0.00134586833779338,0.00125975827826631,8.61100595270644e-05,EPCI
200069441,CC du Pays de Bitche,1999_2006,2002.5,7,35074,35485,2234,2571,411,337,74,0.00166566521463074,0.00136576442172886,0.000299900792901885,EPCI
200069458,CC des Vallées d'Auge et du Merlerault,2006_2011,2008.5,5,16298,16060,1187,777,-238,-410,172,-0.00293781462796938,-0.00506094116582961,0.00212312653786023,EPCI
200069458,CC des Vallées d'Auge et du Merlerault,2011_2016,2013.5,5,16060,14973,1175,657,-1087,-518,-569,-0.0139188503329992,-0.00663290199861417,-0.00728594833438506,EPCI
200069458,CC des Vallées d'Auge et du Merlerault,1968_1975,1971.5,7,19864,19090,1605,2224,-774,619,-1393,-0.0056616848339166,0.00452788489947594,-0.0101895697333925,EPCI
200069458,CC des Vallées d'Auge et du Merlerault,1975_1982,1978.5,7,19090,17750,1573,1761,-1340,188,-1528,-0.0103431552470959,0.00145112924362242,-0.0117942844907184,EPCI
200069458,CC des Vallées d'Auge et du Merlerault,1982_1990,1986,8,17750,16781,1763,1686,-969,-77,-892,-0.00699271413450087,-0.000555664590667251,-0.00643704954383362,EPCI
200069458,CC des Vallées d'Auge et du Merlerault,1990_1999,1994.5,9,16781,16682,1921,1826,-99,-95,-4,-0.000657228397363152,-0.000630673714641409,-2.65546827217435e-05,EPCI
200069458,CC des Vallées d'Auge et du Merlerault,1999_2006,2002.5,7,16682,16298,1565,1255,-384,-310,-74,-0.00332131403932445,-0.00268126914632964,-0.000640044892994816,EPCI
200069482,CC des Campagnes de l'Artois,2006_2011,2008.5,5,32300,33155,1394,2027,855,633,222,0.00523893640322681,0.00387865116168722,0.00136028524153959,EPCI
200069482,CC des Campagnes de l'Artois,2011_2016,2013.5,5,33155,33544,1451,1919,389,468,-79,0.00233561832641449,0.00280994698396396,-0.000474328657549472,EPCI
200069482,CC des Campagnes de l'Artois,1968_1975,1971.5,7,28135,27435,2442,2891,-700,449,-1149,-0.00359278507215643,0.0023045149962832,-0.00589730006843963,EPCI
200069482,CC des Campagnes de l'Artois,1975_1982,1978.5,7,27435,29063,2356,2662,1628,306,1322,0.00826919057798103,0.00155428274991535,0.00671490782806568,EPCI
200069482,CC des Campagnes de l'Artois,1982_1990,1986,8,29063,31081,2463,3392,2018,929,1089,0.00842665764084427,0.00387926905269788,0.00454738858814639,EPCI
200069482,CC des Campagnes de l'Artois,1990_1999,1994.5,9,31081,31120,2540,3191,39,651,-612,0.000139342962459432,0.00232595560413052,-0.00218661264167109,EPCI
200069482,CC des Campagnes de l'Artois,1999_2006,2002.5,7,31120,32300,1970,2742,1180,772,408,0.00533080572388522,0.00348761188037237,0.00184319384351286,EPCI
200069516,CC Seulles Terre et Mer,2006_2011,2008.5,5,15216,16251,604,1035,1035,431,604,0.0132483802014913,0.00551695832545194,0.00773142187603938,EPCI
200069516,CC Seulles Terre et Mer,2011_2016,2013.5,5,16251,16940,606,954,689,348,341,0.00833922802821996,0.00421197584008787,0.00412725218813208,EPCI
200069516,CC Seulles Terre et Mer,1968_1975,1971.5,7,10225,10009,855,1132,-216,277,-493,-0.00304549784729025,0.00390556899860832,-0.00695106684589857,EPCI
200069516,CC Seulles Terre et Mer,1975_1982,1978.5,7,10009,11834,926,1062,1825,136,1689,0.0242159945724911,0.00180458918458016,0.022411405387911,EPCI
200069516,CC Seulles Terre et Mer,1982_1990,1986,8,11834,13767,1142,1450,1933,308,1625,0.0190921785656937,0.00304210605185393,0.0160500725138397,EPCI
200069516,CC Seulles Terre et Mer,1990_1999,1994.5,9,13767,14308,1326,1442,541,116,425,0.0042918947248376,0.000920258388320076,0.00337163633651752,EPCI
200069516,CC Seulles Terre et Mer,1999_2006,2002.5,7,14308,15216,956,1298,908,342,566,0.00882855588984732,0.00332529307745351,0.00550326281239382,EPCI
200069524,CC Pré-Bocage Intercom,2006_2011,2008.5,5,23103,24478,1045,1705,1375,660,715,0.0116295587094191,0.00558218818052115,0.00604737052889791,EPCI
200069524,CC Pré-Bocage Intercom,2011_2016,2013.5,5,24478,24779,1178,1534,301,356,-55,0.00244734292683368,0.0028945318337302,-0.00044718890689652,EPCI
200069524,CC Pré-Bocage Intercom,1968_1975,1971.5,7,19175,18465,1659,2203,-710,544,-1254,-0.00537554249073824,0.00411872551403043,-0.00949426800476867,EPCI
200069524,CC Pré-Bocage Intercom,1975_1982,1978.5,7,18465,19726,1465,1905,1261,440,821,0.00948188725662158,0.00330850943133505,0.00617337782528653,EPCI
200069524,CC Pré-Bocage Intercom,1982_1990,1986,8,19726,20436,1710,2281,710,571,139,0.00442984399556279,0.00356259284713571,0.000867251148427081,EPCI
200069524,CC Pré-Bocage Intercom,1990_1999,1994.5,9,20436,21416,1928,2437,980,509,471,0.0052180395440391,0.00271018584481215,0.00250785369922695,EPCI
200069524,CC Pré-Bocage Intercom,1999_2006,2002.5,7,21416,23103,1400,2158,1687,758,929,0.0108909034951208,0.00489348242400804,0.00599742107111275,EPCI
200069532,CA Lisieux Normandie,2006_2011,2008.5,5,76454,76424,3909,4767,-30,858,-888,-7.84908829430941e-05,0.00224483925217249,-0.00232333013511559,EPCI
200069532,CA Lisieux Normandie,2011_2016,2013.5,5,76424,74829,3978,4227,-1595,249,-1844,-0.0042093701787258,0.000657136786522085,-0.00486650696524789,EPCI
200069532,CA Lisieux Normandie,1968_1975,1971.5,7,69857,71251,5169,9047,1394,3878,-2484,0.00282663867517763,0.00786348980081696,-0.00503685112563933,EPCI
200069532,CA Lisieux Normandie,1975_1982,1978.5,7,71251,72884,5196,7999,1633,2803,-1170,0.00324242848583278,0.00556554013826656,-0.00232311165243377,EPCI
200069532,CA Lisieux Normandie,1982_1990,1986,8,72884,73581,5906,8594,697,2688,-1991,0.00119042099504285,0.00459089187184388,-0.00340047087680103,EPCI
200069532,CA Lisieux Normandie,1990_1999,1994.5,9,73581,74002,6824,8685,421,1861,-1440,0.00063412092883941,0.00280308562605735,-0.00216896469721793,EPCI
200069532,CA Lisieux Normandie,1999_2006,2002.5,7,74002,76454,5495,6643,2452,1148,1304,0.00466759270652939,0.00218531665052844,0.00248227605600095,EPCI
200069540,CC Norge et Tille,2006_2011,2008.5,5,14638,15103,328,719,465,391,74,0.00627410272362461,0.00527564336545639,0.000998459358168217,EPCI
200069540,CC Norge et Tille,2011_2016,2013.5,5,15103,15790,346,749,687,403,284,0.00893637887034049,0.00524215529075286,0.00369422357958763,EPCI
200069540,CC Norge et Tille,1968_1975,1971.5,7,4891,7047,375,726,2156,351,1805,0.0535571212579289,0.00871917883187989,0.044837942426049,EPCI
200069540,CC Norge et Tille,1975_1982,1978.5,7,7047,9642,380,779,2595,399,2196,0.0458077034263245,0.00704326538231347,0.038764438044011,EPCI
200069540,CC Norge et Tille,1982_1990,1986,8,9642,11311,478,938,1669,460,1209,0.0201563434533114,0.0055553732705352,0.0146009701827762,EPCI
200069540,CC Norge et Tille,1990_1999,1994.5,9,11311,13185,524,1162,1874,638,1236,0.0171796929534123,0.005848796213595,0.0113308967398173,EPCI
200069540,CC Norge et Tille,1999_2006,2002.5,7,13185,14638,418,1077,1453,659,794,0.0150465141538056,0.00682426209728694,0.00822225205651871,EPCI
200069565,CC des Lacs et Montagnes du Haut-Doubs,2006_2011,2008.5,5,12496,13979,384,1010,1483,626,857,0.0226829550552856,0.00957486841848199,0.0131080866368036,EPCI
200069565,CC des Lacs et Montagnes du Haut-Doubs,2011_2016,2013.5,5,13979,15721,409,1192,1742,783,959,0.0237662601035871,0.0106825382669969,0.0130837218365901,EPCI
200069565,CC des Lacs et Montagnes du Haut-Doubs,1968_1975,1971.5,7,7067,7005,561,710,-62,149,-211,-0.00125804826720322,0.0030233740615045,-0.00428142232870772,EPCI
200069565,CC des Lacs et Montagnes du Haut-Doubs,1975_1982,1978.5,7,7005,7502,471,698,497,227,270,0.00984031083362424,0.00449446792602154,0.00534584290760271,EPCI
200069565,CC des Lacs et Montagnes du Haut-Doubs,1982_1990,1986,8,7502,9355,555,1038,1853,483,1370,0.0279768666369225,0.00729240506510175,0.0206844615718207,EPCI
200069565,CC des Lacs et Montagnes du Haut-Doubs,1990_1999,1994.5,9,9355,10785,646,1506,1430,860,570,0.0159305957652967,0.00958063801269589,0.00634995775260076,EPCI
200069565,CC des Lacs et Montagnes du Haut-Doubs,1999_2006,2002.5,7,10785,12496,511,1171,1711,660,1051,0.0212588619953866,0.00820037926180899,0.0130584827335776,EPCI
200069581,CC Convergence Garonne,2006_2011,2008.5,5,27850,30598,1435,1984,2748,549,2199,0.0189985550119376,0.00379556284627137,0.0152029921656662,EPCI
200069581,CC Convergence Garonne,2011_2016,2013.5,5,30598,32400,1392,1898,1802,506,1296,0.0115104968602684,0.00323213729816638,0.00827835956210202,EPCI
200069581,CC Convergence Garonne,1968_1975,1971.5,7,24987,24151,2463,2049,-836,-414,-422,-0.00484961709380982,-0.00240160463736515,-0.00244801245644467,EPCI
200069581,CC Convergence Garonne,1975_1982,1978.5,7,24151,25003,2506,1843,852,-663,1515,0.00496514720186858,-0.00386372370286252,0.0088288709047311,EPCI
200069581,CC Convergence Garonne,1982_1990,1986,8,25003,25800,2807,2285,797,-522,1319,0.00393003670265713,-0.00257400145393603,0.00650403815659316,EPCI
200069581,CC Convergence Garonne,1990_1999,1994.5,9,25800,25847,2722,2408,47,-314,361,0.000202248019757434,-0.00135118889795392,0.00155343691771135,EPCI
200069581,CC Convergence Garonne,1999_2006,2002.5,7,25847,27850,2101,2303,2003,202,1801,0.0107196807763386,0.00108106615917144,0.00963861461716712,EPCI
200069599,CC Rurales de l'Entre-deux-Mers,2006_2011,2008.5,5,15473,16173,811,859,700,48,652,0.00888859414107301,0.000609503598245007,0.00827909054282801,EPCI
200069599,CC Rurales de l'Entre-deux-Mers,2011_2016,2013.5,5,16173,16526,844,809,353,-35,388,0.00432768010576856,-0.000429090095472804,0.00475677020124136,EPCI
200069599,CC Rurales de l'Entre-deux-Mers,1968_1975,1971.5,7,15168,13700,1287,1184,-1468,-103,-1365,-0.0144365100673378,-0.00101291589709523,-0.0134235941702426,EPCI
200069599,CC Rurales de l'Entre-deux-Mers,1975_1982,1978.5,7,13700,13640,1192,911,-60,-281,221,-0.000626829234528947,-0.00293565024837724,0.00230882101384829,EPCI
200069599,CC Rurales de l'Entre-deux-Mers,1982_1990,1986,8,13640,13938,1360,1194,298,-166,464,0.00270518625594507,-0.0015069158338486,0.00421210208979366,EPCI
200069599,CC Rurales de l'Entre-deux-Mers,1990_1999,1994.5,9,13938,14275,1400,1359,337,-41,378,0.00265806335013941,-0.000323384561886397,0.0029814479120258,EPCI
200069599,CC Rurales de l'Entre-deux-Mers,1999_2006,2002.5,7,14275,15473,1112,1121,1198,9,1189,0.0115789247286371,8.69869136542018e-05,0.0114919378149829,EPCI
200069615,CC Bresse Haute Seille,2006_2011,2008.5,5,18027,18593,925,978,566,53,513,0.00620205997577172,0.000580758266282511,0.00562130170948921,EPCI
200069615,CC Bresse Haute Seille,2011_2016,2013.5,5,18593,18933,968,941,340,-27,367,0.00363082864111886,-0.000288330509735909,0.00391915915085476,EPCI
200069615,CC Bresse Haute Seille,1968_1975,1971.5,7,14908,14329,1665,1241,-579,-424,-155,-0.00564295067219178,-0.00413231620899709,-0.00151063446319469,EPCI
200069615,CC Bresse Haute Seille,1975_1982,1978.5,7,14329,15422,1614,1099,1093,-515,1608,0.0105567051698743,-0.00497411085314296,0.0155308160230172,EPCI
200069615,CC Bresse Haute Seille,1982_1990,1986,8,15422,16234,1648,1398,812,-250,1062,0.00643470771342924,-0.00198112922211491,0.00841583693554416,EPCI
200069615,CC Bresse Haute Seille,1990_1999,1994.5,9,16234,16990,1712,1570,756,-142,898,0.00507026912472552,-0.000952352137183895,0.00602262126190942,EPCI
200069615,CC Bresse Haute Seille,1999_2006,2002.5,7,16990,18027,1309,1367,1037,58,979,0.00849958931743911,0.000475386866356286,0.00802420245108282,EPCI
200069623,CC Champagnole Nozeroy Jura,2006_2011,2008.5,5,21615,22147,1136,1134,532,-2,534,0.00487474891958706,-1.83261237578461e-05,0.0048930750433449,EPCI
200069623,CC Champagnole Nozeroy Jura,2011_2016,2013.5,5,22147,22113,1166,1045,-34,-121,87,-0.000307228048283981,-0.00109337040712828,0.000786142358844303,EPCI
200069623,CC Champagnole Nozeroy Jura,1968_1975,1971.5,7,21064,22309,1496,2676,1245,1180,65,0.00823727868711477,0.00780721996047826,0.000430058726636514,EPCI
200069623,CC Champagnole Nozeroy Jura,1975_1982,1978.5,7,22309,22710,1424,2356,401,932,-531,0.0025482658422018,0.00592265278037925,-0.00337438693817745,EPCI
200069623,CC Champagnole Nozeroy Jura,1982_1990,1986,8,22710,22194,1621,2234,-516,613,-1129,-0.00286879886437441,0.00340808857337503,-0.00627688743774944,EPCI
200069623,CC Champagnole Nozeroy Jura,1990_1999,1994.5,9,22194,21643,1916,2294,-551,378,-929,-0.00278942514222158,0.00191361652225001,-0.00470304166447159,EPCI
200069623,CC Champagnole Nozeroy Jura,1999_2006,2002.5,7,21643,21615,1549,1683,-28,134,-162,-0.000184919816336504,0.000884973406753269,-0.00106989322308977,EPCI
200069631,CC Terres de Chalosse,2006_2011,2008.5,5,15845,17658,916,899,1813,-17,1830,0.021903422789552,-0.000205382342759175,0.0221088051323112,EPCI
200069631,CC Terres de Chalosse,2011_2016,2013.5,5,17658,18231,854,942,573,88,485,0.00640734041082558,0.000984024356287349,0.00542331605453823,EPCI
200069631,CC Terres de Chalosse,1968_1975,1971.5,7,14897,14062,1452,1160,-835,-292,-543,-0.00820667225974048,-0.00286987820340625,-0.00533679405633423,EPCI
200069631,CC Terres de Chalosse,1975_1982,1978.5,7,14062,14120,1416,914,58,-502,560,0.00058818838471919,-0.00509087188153506,0.00567906026625425,EPCI
200069631,CC Terres de Chalosse,1982_1990,1986,8,14120,14405,1488,1073,285,-415,700,0.00250101439050132,-0.0036418279721335,0.00614284236263483,EPCI
200069631,CC Terres de Chalosse,1990_1999,1994.5,9,14405,14658,1674,1176,253,-498,751,0.00193641609985273,-0.00381160165109352,0.00574801775094626,EPCI
200069631,CC Terres de Chalosse,1999_2006,2002.5,7,14658,15845,1179,979,1187,-200,1387,0.0111860629815617,-0.00188476208619405,0.0130708250677557,EPCI
200069649,CC Chalosse Tursan,2006_2011,2008.5,5,24387,25379,1325,1205,992,-120,1112,0.00800625137901756,-0.000968498150687608,0.00897474952970517,EPCI
200069649,CC Chalosse Tursan,2011_2016,2013.5,5,25379,26069,1390,1193,690,-197,887,0.00537937888541373,-0.00153585165279204,0.00691523053820577,EPCI
200069649,CC Chalosse Tursan,1968_1975,1971.5,7,22951,23005,2143,2039,54,-104,158,0.000335781371291422,-0.000646690048413108,0.00098247141970453,EPCI
200069649,CC Chalosse Tursan,1975_1982,1978.5,7,23005,23038,2181,1748,33,-433,466,0.000204798525052619,-0.00268720488932678,0.0028920034143794,EPCI
200069649,CC Chalosse Tursan,1982_1990,1986,8,23038,23163,2346,1939,125,-407,532,0.000676622742272537,-0.00220308364883938,0.00287970639111192,EPCI
200069649,CC Chalosse Tursan,1990_1999,1994.5,9,23163,23138,2542,2005,-25,-537,512,-0.000119980622648397,-0.00257718377448756,0.00245720315183917,EPCI
200069649,CC Chalosse Tursan,1999_2006,2002.5,7,23138,24387,1964,1764,1249,-200,1449,0.00753883439765168,-0.00120717924702189,0.00874601364467357,EPCI
200069656,CC Coeur Haute Lande,2006_2011,2008.5,5,14170,14956,875,773,786,-102,888,0.0108555997244733,-0.00140874194897745,0.0122643416734507,EPCI
200069656,CC Coeur Haute Lande,2011_2016,2013.5,5,14956,15557,940,737,601,-203,804,0.00791075416827347,-0.00267201846282781,0.0105827726311013,EPCI
200069656,CC Coeur Haute Lande,1968_1975,1971.5,7,13007,12508,1445,1019,-499,-426,-73,-0.0055728756634752,-0.00475760527583253,-0.000815270387642664,EPCI
200069656,CC Coeur Haute Lande,1975_1982,1978.5,7,12508,12514,1352,908,6,-444,450,6.8513487024191e-05,-0.00506999803979014,0.00513851152681433,EPCI
200069656,CC Coeur Haute Lande,1982_1990,1986,8,12514,12999,1460,1116,485,-344,829,0.00476436539930814,-0.00337926123167422,0.00814362663098236,EPCI
200069656,CC Coeur Haute Lande,1990_1999,1994.5,9,12999,13115,1568,1238,116,-330,446,0.00098761869591657,-0.00280960491079714,0.00379722360671371,EPCI
200069656,CC Coeur Haute Lande,1999_2006,2002.5,7,13115,14170,1213,972,1055,-241,1296,0.0111142292493585,-0.00253889028350274,0.0136531195328612,EPCI
200069664,CC Meuse Rognon,2006_2011,2008.5,5,11900,11534,744,562,-366,-182,-184,-0.00622836381090575,-0.00309716451799138,-0.00313119929291436,EPCI
200069664,CC Meuse Rognon,2011_2016,2013.5,5,11534,11102,754,534,-432,-220,-212,-0.00760571364771501,-0.00387328009837338,-0.00373243354934162,EPCI
200069664,CC Meuse Rognon,1968_1975,1971.5,7,15369,14410,1255,1803,-959,548,-1507,-0.00916206777619733,0.00523546730068419,-0.0143975350768815,EPCI
200069664,CC Meuse Rognon,1975_1982,1978.5,7,14410,13841,1151,1324,-569,173,-742,-0.00573878534167349,0.00174483280159844,-0.00748361814327194,EPCI
200069664,CC Meuse Rognon,1982_1990,1986,8,13841,12791,1177,1213,-1050,36,-1086,-0.00981320854355028,0.000336452864350295,-0.0101496614079006,EPCI
200069664,CC Meuse Rognon,1990_1999,1994.5,9,12791,12008,1389,1197,-783,-192,-591,-0.00699417105671885,-0.00171504577636018,-0.00527912528035867,EPCI
200069664,CC Meuse Rognon,1999_2006,2002.5,7,12008,11900,1049,885,-108,-164,56,-0.0012898380448767,-0.00195864295703499,0.000668804912158289,EPCI
200069672,CC du Ternois,2006_2011,2008.5,5,37751,38483,2149,2388,732,239,493,0.00384830978683182,0.0012564836599082,0.00259182612692361,EPCI
200069672,CC du Ternois,2011_2016,2013.5,5,38483,38395,2244,2222,-88,-22,-66,-0.000457763705017267,-0.000114440926254317,-0.00034332277876295,EPCI
200069672,CC du Ternois,1968_1975,1971.5,7,39158,38206,3494,4373,-952,879,-1831,-0.00350985066537546,0.003240712956791,-0.00675056362216645,EPCI
200069672,CC du Ternois,1975_1982,1978.5,7,38206,37830,3507,3674,-376,167,-543,-0.00141187845996926,0.000627084315996986,-0.00203896277596625,EPCI
200069672,CC du Ternois,1982_1990,1986,8,37830,37354,3724,4182,-476,458,-934,-0.00158155274443172,0.00152174612804565,-0.00310329887247738,EPCI
200069672,CC du Ternois,1990_1999,1994.5,9,37354,36999,3917,4037,-355,120,-475,-0.00106045017371503,0.00035846203055156,-0.00141891220426659,EPCI
200069672,CC du Ternois,1999_2006,2002.5,7,36999,37751,3135,3209,752,74,678,0.00287857518650081,0.000283264047607792,0.00259531113889302,EPCI
200069698,CC Mâconnais - Tournugeois,2006_2011,2008.5,5,15422,15834,848,871,412,23,389,0.00528681923465024,0.000295137966982902,0.00499168126766734,EPCI
200069698,CC Mâconnais - Tournugeois,2011_2016,2013.5,5,15834,15732,824,806,-102,-18,-84,-0.00129169947307994,-0.000227946965837637,-0.00106375250724231,EPCI
200069698,CC Mâconnais - Tournugeois,1968_1975,1971.5,7,14831,14893,1428,1590,62,162,-100,0.000596137497071547,0.00155764958912243,-0.000961512092050883,EPCI
200069698,CC Mâconnais - Tournugeois,1975_1982,1978.5,7,14893,14995,1384,1151,102,-233,335,0.000975548151741723,-0.00222845803290021,0.00320400618464193,EPCI
200069698,CC Mâconnais - Tournugeois,1982_1990,1986,8,14995,14688,1452,1312,-307,-140,-167,-0.00258240712539104,-0.00117764494317507,-0.00140476218221597,EPCI
200069698,CC Mâconnais - Tournugeois,1990_1999,1994.5,9,14688,14600,1604,1417,-88,-187,99,-0.000667477711336906,-0.00141839013659092,0.000750912425254019,EPCI
200069698,CC Mâconnais - Tournugeois,1999_2006,2002.5,7,14600,15422,1214,1191,822,-23,845,0.0078554840624645,-0.000219800648949737,0.00807528471141424,EPCI
200069722,CC Interrégionale Aumale - Blangy-sur-Bresle,2006_2011,2008.5,5,21930,22190,1145,1254,260,109,151,0.00236001536544017,0.000989391057049918,0.00137062430839025,EPCI
200069722,CC Interrégionale Aumale - Blangy-sur-Bresle,2011_2016,2013.5,5,22190,21877,1223,1147,-313,-76,-237,-0.00283714374078825,-0.000688891131948585,-0.00214825260883967,EPCI
200069722,CC Interrégionale Aumale - Blangy-sur-Bresle,1968_1975,1971.5,7,22763,22451,1696,2781,-312,1085,-1397,-0.00196966539236065,0.00684963766253625,-0.0088193030548969,EPCI
200069722,CC Interrégionale Aumale - Blangy-sur-Bresle,1975_1982,1978.5,7,22451,22087,1655,2181,-364,526,-890,-0.00233241232864589,0.00337046396941687,-0.00570287629806276,EPCI
200069722,CC Interrégionale Aumale - Blangy-sur-Bresle,1982_1990,1986,8,22087,21962,1966,2357,-125,391,-516,-0.00070918752954241,0.00221833859240866,-0.00292752612195107,EPCI
200069722,CC Interrégionale Aumale - Blangy-sur-Bresle,1990_1999,1994.5,9,21962,21750,1986,2317,-212,331,-543,-0.00107718937464651,0.00168183812739621,-0.00275902750204272,EPCI
200069722,CC Interrégionale Aumale - Blangy-sur-Bresle,1999_2006,2002.5,7,21750,21930,1600,1782,180,182,-2,0.00117809410761693,0.00119118404214601,-1.30899345290769e-05,EPCI
200069730,CC des Quatre Rivières,2006_2011,2008.5,5,28621,29762,1601,1726,1141,125,1016,0.00784898260180511,0.000859879776709587,0.00698910282509552,EPCI
200069730,CC des Quatre Rivières,2011_2016,2013.5,5,29762,29708,1681,1610,-54,-71,17,-0.00036314248796121,-0.000477465123060109,0.000114322635098899,EPCI
200069730,CC des Quatre Rivières,1968_1975,1971.5,7,26544,26116,2077,3103,-428,1026,-1454,-0.00231953145176145,0.00556037212501693,-0.00787990357677838,EPCI
200069730,CC des Quatre Rivières,1975_1982,1978.5,7,26116,25841,2131,2398,-275,267,-542,-0.00151111075898958,0.00146715117327352,-0.00297826193226309,EPCI
200069730,CC des Quatre Rivières,1982_1990,1986,8,25841,26040,2537,2787,199,250,-51,0.00095938985585664,0.00120526363801085,-0.000245873782154214,EPCI
200069730,CC des Quatre Rivières,1990_1999,1994.5,9,26040,27149,2688,2829,1109,141,968,0.00464479778092986,0.000590546877467186,0.00405425090346267,EPCI
200069730,CC des Quatre Rivières,1999_2006,2002.5,7,27149,28621,2195,2415,1472,220,1252,0.00757144823845746,0.00113160231824772,0.00643984592020974,EPCI
200069748,CC Val de Gâtine,2006_2011,2008.5,5,20175,21483,1172,1297,1308,125,1183,0.0126427949535692,0.00120821817216831,0.0114345767814009,EPCI
200069748,CC Val de Gâtine,2011_2016,2013.5,5,21483,21473,1309,1204,-10,-105,95,-9.31142061866286e-05,-0.0009776991649596,0.000884584958772972,EPCI
200069748,CC Val de Gâtine,1968_1975,1971.5,7,21568,19914,1970,1797,-1654,-173,-1481,-0.0113335336226913,-0.0011854300584798,-0.0101481035642115,EPCI
200069748,CC Val de Gâtine,1975_1982,1978.5,7,19914,19147,1865,1458,-767,-407,-360,-0.00559528157151312,-0.00296907379348871,-0.00262620777802441,EPCI
200069748,CC Val de Gâtine,1982_1990,1986,8,19147,18799,1998,1627,-348,-371,23,-0.0022901696082126,-0.00244153139266343,0.000151361784450833,EPCI
200069748,CC Val de Gâtine,1990_1999,1994.5,9,18799,18973,2221,1802,174,-419,593,0.00102421736942859,-0.00246636251603782,0.00349057988546641,EPCI
200069748,CC Val de Gâtine,1999_2006,2002.5,7,18973,20175,1678,1620,1202,-58,1260,0.00881394439203609,-0.000425298481479279,0.00923924287351537,EPCI
200069755,CC Mellois-en-Poitou,2006_2011,2008.5,5,46490,48187,2886,2412,1697,-474,2171,0.00719617681551932,-0.00201001049531889,0.00920618731083821,EPCI
200069755,CC Mellois-en-Poitou,2011_2016,2013.5,5,48187,48168,3139,2237,-19,-902,883,-7.88718839852542e-05,-0.00374433891340523,0.00366546702941997,EPCI
200069755,CC Mellois-en-Poitou,1968_1975,1971.5,7,48979,46510,4336,4839,-2469,503,-2972,-0.00736195160559761,0.0014998224615697,-0.00886177406716731,EPCI
200069755,CC Mellois-en-Poitou,1975_1982,1978.5,7,46510,45973,4464,3669,-537,-795,258,-0.00165763540158381,-0.00245404123698162,0.000796405835397809,EPCI
200069755,CC Mellois-en-Poitou,1982_1990,1986,8,45973,45842,4887,4098,-131,-789,658,-0.000356632162722415,-0.00214796012509912,0.00179132796237671,EPCI
200069755,CC Mellois-en-Poitou,1990_1999,1994.5,9,45842,45321,5382,3971,-521,-1411,890,-0.0012692161122142,-0.00343735879910602,0.00216814268689182,EPCI
200069755,CC Mellois-en-Poitou,1999_2006,2002.5,7,45321,46490,4206,3322,1169,-884,2053,0.00364473086125416,-0.00275615233648305,0.00640088319773721,EPCI
200069763,CC du Haut-Poitou,2006_2011,2008.5,5,36828,39773,1555,2724,2945,1169,1776,0.0155049464113084,0.0061545950271034,0.00935035138420499,EPCI
200069763,CC du Haut-Poitou,2011_2016,2013.5,5,39773,41624,1684,2561,1851,877,974,0.00913923687712836,0.00433015167003867,0.0048090852070897,EPCI
200069763,CC du Haut-Poitou,1968_1975,1971.5,7,25174,25218,2362,2292,44,-70,114,0.000249503889736324,-0.000396938006398698,0.000646441896135022,EPCI
200069763,CC du Haut-Poitou,1975_1982,1978.5,7,25218,28825,2291,2410,3607,119,3488,0.0192813936577163,0.000636120278699263,0.018645273379017,EPCI
200069763,CC du Haut-Poitou,1982_1990,1986,8,28825,30720,2490,2854,1895,364,1531,0.00799061114502342,0.00153487200885938,0.00645573913616404,EPCI
200069763,CC du Haut-Poitou,1990_1999,1994.5,9,30720,32565,2706,3165,1845,459,1386,0.00650150850301579,0.00161744845684783,0.00488406004616796,EPCI
200069763,CC du Haut-Poitou,1999_2006,2002.5,7,32565,36828,2201,3385,4263,1184,3079,0.0177296705916257,0.00492421533673113,0.0128054552548945,EPCI
200069821,CA Fécamp Caux Littoral Agglomération,2006_2011,2008.5,5,38649,39451,2023,2362,802,339,463,0.00411614696539586,0.00173986760756758,0.00237627935782828,EPCI
200069821,CA Fécamp Caux Littoral Agglomération,2011_2016,2013.5,5,39451,39319,2127,2177,-132,50,-182,-0.000670081976223869,0.000253818930387829,-0.000923900906611698,EPCI
200069821,CA Fécamp Caux Littoral Agglomération,1968_1975,1971.5,7,36674,37011,2998,4629,337,1631,-1294,0.00130758394774722,0.0063283959014116,-0.00502081195366438,EPCI
200069821,CA Fécamp Caux Littoral Agglomération,1975_1982,1978.5,7,37011,37879,3094,3872,868,778,90,0.00331716150881478,0.00297321619108053,0.000343945317734252,EPCI
200069821,CA Fécamp Caux Littoral Agglomération,1982_1990,1986,8,37879,38340,3480,4634,461,1154,-693,0.0015132524130741,0.00378805484747832,-0.00227480243440423,EPCI
200069821,CA Fécamp Caux Littoral Agglomération,1990_1999,1994.5,9,38340,38803,3848,4545,463,697,-234,0.00133464825245833,0.00200917890272884,-0.000674530650270515,EPCI
200069821,CA Fécamp Caux Littoral Agglomération,1999_2006,2002.5,7,38803,38649,2777,3397,-154,620,-774,-0.000567933200616766,0.0022864843141714,-0.00285441751478816,EPCI
200069839,CC de la Côte d'Albâtre,2006_2011,2008.5,5,27748,27616,1428,1576,-132,148,-280,-0.000953235506513828,0.00106877920427308,-0.00202201471078691,EPCI
200069839,CC de la Côte d'Albâtre,2011_2016,2013.5,5,27616,28020,1448,1628,404,180,224,0.00290886777080757,0.00129603019491426,0.0016128375758933,EPCI
200069839,CC de la Côte d'Albâtre,1968_1975,1971.5,7,23162,22133,1909,2248,-1029,339,-1368,-0.00647087276032232,0.00213180356243855,-0.00860267632276087,EPCI
200069839,CC de la Côte d'Albâtre,1975_1982,1978.5,7,22133,26855,2046,2253,4722,207,4515,0.0280111827427332,0.00122793621934472,0.0267832465233885,EPCI
200069839,CC de la Côte d'Albâtre,1982_1990,1986,8,26855,27067,2389,3409,212,1020,-808,0.000983389502843934,0.00473140232500384,-0.0037480128221599,EPCI
200069839,CC de la Côte d'Albâtre,1990_1999,1994.5,9,27067,27803,2404,3182,736,778,-42,0.00298540913420431,0.00315577215544966,-0.000170363021245355,EPCI
200069839,CC de la Côte d'Albâtre,1999_2006,2002.5,7,27803,27748,1958,2391,-55,433,-488,-0.000282840424580377,0.0022267255244237,-0.00250956594900407,EPCI
200069847,CC Plateau de Caux-Doudeville-Yerville,2006_2011,2008.5,5,18990,20204,793,1318,1214,525,689,0.0124707350801765,0.00539302793829708,0.00707770714187941,EPCI
200069847,CC Plateau de Caux-Doudeville-Yerville,2011_2016,2013.5,5,20204,21040,779,1407,836,628,208,0.00814192328983521,0.0061161816100676,0.00202574167976761,EPCI
200069847,CC Plateau de Caux-Doudeville-Yerville,1968_1975,1971.5,7,12998,13316,1015,1463,318,448,-130,0.00345894270349745,0.0048729758841725,-0.00141403318067506,EPCI
200069847,CC Plateau de Caux-Doudeville-Yerville,1975_1982,1978.5,7,13316,15478,923,1519,2162,596,1566,0.0217259799469609,0.00598921556354704,0.0157367643834139,EPCI
200069847,CC Plateau de Caux-Doudeville-Yerville,1982_1990,1986,8,15478,16804,1054,1845,1326,791,535,0.0103276271381307,0.00616074891874918,0.00416687821938156,EPCI
200069847,CC Plateau de Caux-Doudeville-Yerville,1990_1999,1994.5,9,16804,17580,1303,1950,776,647,129,0.00502870604077144,0.00419274846440608,0.000835957576365355,EPCI
200069847,CC Plateau de Caux-Doudeville-Yerville,1999_2006,2002.5,7,17580,18990,1046,1699,1410,653,757,0.0110824796319831,0.0051325242550957,0.00594995537688736,EPCI
200069854,CU du Grand Poitiers,2006_2011,2008.5,5,183636,187738,6869,10807,4102,3938,164,0.00442814266138036,0.00425110331558164,0.000177039345798728,EPCI
200069854,CU du Grand Poitiers,2011_2016,2013.5,5,187738,191791,7164,10843,4053,3679,374,0.00428090975653261,0.00388587885375857,0.000395030902774043,EPCI
200069854,CU du Grand Poitiers,1968_1975,1971.5,7,125188,142859,8048,16608,17671,8560,9111,0.0190421063474986,0.00922417691893995,0.00981792942855864,EPCI
200069854,CU du Grand Poitiers,1975_1982,1978.5,7,142859,150449,8434,15122,7590,6688,902,0.00742255826699179,0.00654045713961015,0.000882101127381633,EPCI
200069854,CU du Grand Poitiers,1982_1990,1986,8,150449,157460,9639,15620,7011,5981,1030,0.00570965095501275,0.00487083473997022,0.000838816215042523,EPCI
200069854,CU du Grand Poitiers,1990_1999,1994.5,9,157460,172889,10978,16462,15429,5484,9945,0.0104406058540951,0.00371095226546488,0.00672965358863024,EPCI
200069854,CU du Grand Poitiers,1999_2006,2002.5,7,172889,183636,9408,13925,10747,4517,6230,0.00865232647320324,0.00363660171949931,0.00501572475370394,EPCI
200069912,CC des Forêts du Perche,2006_2011,2008.5,5,7955,8051,518,408,96,-110,206,0.00240200931872514,-0.00275230234437256,0.0051543116630977,EPCI
200069912,CC des Forêts du Perche,2011_2016,2013.5,5,8051,7940,519,403,-111,-116,5,-0.00277275520542963,-0.00289765408855709,0.000124898883127461,EPCI
200069912,CC des Forêts du Perche,1968_1975,1971.5,7,7312,7261,623,840,-51,217,-268,-0.000999396520851348,0.00425233421617142,-0.00525173073702277,EPCI
200069912,CC des Forêts du Perche,1975_1982,1978.5,7,7261,7503,609,664,242,55,187,0.00469461105663038,0.00106695705832509,0.0036276539983053,EPCI
200069912,CC des Forêts du Perche,1982_1990,1986,8,7503,7278,710,662,-225,-48,-177,-0.00379862208384674,-0.000810372711220637,-0.0029882493726261,EPCI
200069912,CC des Forêts du Perche,1990_1999,1994.5,9,7278,7649,838,805,371,-33,404,0.00553960061807768,-0.000492740755785885,0.00603234137386356,EPCI
200069912,CC des Forêts du Perche,1999_2006,2002.5,7,7649,7955,777,534,306,-243,549,0.00561940731808752,-0.0044624705173048,0.0100818778353923,EPCI
200069953,CC des Portes Euréliennes d'Île-de-France,2006_2011,2008.5,5,45686,47684,1588,3071,1998,1483,515,0.00859754977461358,0.00638146462249847,0.00221608515211511,EPCI
200069953,CC des Portes Euréliennes d'Île-de-France,2011_2016,2013.5,5,47684,48424,1686,2981,740,1295,-555,0.00308467720221839,0.00539818510388218,-0.00231350790166379,EPCI
200069953,CC des Portes Euréliennes d'Île-de-France,1968_1975,1971.5,7,22281,26853,1869,2671,4572,802,3770,0.0270219681429904,0.00474007402683253,0.0222818941161579,EPCI
200069953,CC des Portes Euréliennes d'Île-de-France,1975_1982,1978.5,7,26853,33175,1966,2979,6322,1013,5309,0.0306634479382542,0.00491333007931848,0.0257501178589357,EPCI
200069953,CC des Portes Euréliennes d'Île-de-France,1982_1990,1986,8,33175,39152,2341,3851,5977,1510,4467,0.020922740410193,0.00528581864135712,0.0156369217688359,EPCI
200069953,CC des Portes Euréliennes d'Île-de-France,1990_1999,1994.5,9,39152,43859,2914,4762,4707,1848,2859,0.0126941661904558,0.00498381540683288,0.00771035078362294,EPCI
200069953,CC des Portes Euréliennes d'Île-de-France,1999_2006,2002.5,7,43859,45686,2328,4212,1827,1884,-57,0.00584730949485568,0.00602973786990044,-0.000182428375044758,EPCI
200069961,CC du Grand Châteaudun,2006_2011,2008.5,5,41419,41594,2436,2246,175,-190,365,0.00084359829822489,-0.000915906723787024,0.00175950502201191,EPCI
200069961,CC du Grand Châteaudun,2011_2016,2013.5,5,41594,40831,2473,2029,-763,-444,-319,-0.0036960186999887,-0.00215076317535384,-0.00154525552463486,EPCI
200069961,CC du Grand Châteaudun,1968_1975,1971.5,7,40110,40980,3387,4245,870,858,12,0.00307019815222231,0.00302785059150201,4.23475607203077e-05,EPCI
200069961,CC du Grand Châteaudun,1975_1982,1978.5,7,40980,41852,3200,3908,872,708,164,0.00301244871853945,0.00244588726230038,0.000566561456239071,EPCI
200069961,CC du Grand Châteaudun,1982_1990,1986,8,41852,41422,3658,4096,-430,438,-868,-0.00129009771562838,0.00131409953359356,-0.00260419724922194,EPCI
200069961,CC du Grand Châteaudun,1990_1999,1994.5,9,41422,41324,4180,4033,-98,-147,49,-0.000263153776387082,-0.000394730664580623,0.000131576888193541,EPCI
200069961,CC du Grand Châteaudun,1999_2006,2002.5,7,41324,41419,3403,2992,95,-411,506,0.00032809206224127,-0.00141942986927539,0.00174752193151666,EPCI
200069995,CC Médoc Coeur de Presqu'île,2006_2011,2008.5,5,27660,28986,1481,1690,1326,209,1117,0.00940911571929237,0.00148303558471501,0.00792608013457736,EPCI
200069995,CC Médoc Coeur de Presqu'île,2011_2016,2013.5,5,28986,29861,1604,1606,875,2,873,0.00596579013934417,1.36360917470724e-05,0.0059521540475971,EPCI
200069995,CC Médoc Coeur de Presqu'île,1968_1975,1971.5,7,22901,23930,2294,2541,1029,247,782,0.00629865709227939,0.0015119225479038,0.00478673454437559,EPCI
200069995,CC Médoc Coeur de Presqu'île,1975_1982,1978.5,7,23930,25667,2173,2314,1737,141,1596,0.0100607320035684,0.000816674273173945,0.00924405773039444,EPCI
200069995,CC Médoc Coeur de Presqu'île,1982_1990,1986,8,25667,26939,2385,2638,1272,253,1019,0.00606443098535725,0.00120621150888002,0.00485821947647723,EPCI
200069995,CC Médoc Coeur de Presqu'île,1990_1999,1994.5,9,26939,26746,2581,2598,-193,17,-210,-0.000798583331112379,7.03415369373598e-05,-0.000868924868049739,EPCI
200069995,CC Médoc Coeur de Presqu'île,1999_2006,2002.5,7,26746,27660,2059,2260,914,201,713,0.0048118824996608,0.00105819297859061,0.00375368952107019,EPCI
200070035,CC du Civraisien en Poitou,2006_2011,2008.5,5,26885,27574,1811,1330,689,-481,1170,0.00507378617697674,-0.00354207714241772,0.00861586331939446,EPCI
200070035,CC du Civraisien en Poitou,2011_2016,2013.5,5,27574,27468,1806,1208,-106,-598,492,-0.000770025176534683,-0.00434410429780887,0.00357407912127419,EPCI
200070035,CC du Civraisien en Poitou,1968_1975,1971.5,7,30189,28263,2809,2597,-1926,-212,-1714,-0.0093735193639578,-0.0010317684865831,-0.0083417508773747,EPCI
200070035,CC du Civraisien en Poitou,1975_1982,1978.5,7,28263,27293,2588,1999,-970,-589,-381,-0.00497661394367444,-0.00302188207507654,-0.0019547318685979,EPCI
200070035,CC du Civraisien en Poitou,1982_1990,1986,8,27293,26343,3046,2039,-950,-1007,57,-0.00441866808414948,-0.00468378816919845,0.000265120085048969,EPCI
200070035,CC du Civraisien en Poitou,1990_1999,1994.5,9,26343,25886,3419,2098,-457,-1321,864,-0.00194258884114951,-0.00561522945111269,0.00367264060996318,EPCI
200070035,CC du Civraisien en Poitou,1999_2006,2002.5,7,25886,26885,2622,1745,999,-877,1876,0.00542411873035942,-0.00476171384036558,0.010185832570725,EPCI
200070043,CC Vienne et Gartempe,2006_2011,2008.5,5,39914,39893,2870,1796,-21,-1074,1053,-0.000105248388523216,-0.00538270329875875,0.00527745491023554,EPCI
200070043,CC Vienne et Gartempe,2011_2016,2013.5,5,39893,39557,2939,1665,-336,-1274,938,-0.00169021002448844,-0.00640871300951866,0.00471850298503022,EPCI
200070043,CC Vienne et Gartempe,1968_1975,1971.5,7,47230,44497,4704,3993,-2733,-711,-2022,-0.00847920598484742,-0.00220589661735328,-0.00627330936749414,EPCI
200070043,CC Vienne et Gartempe,1975_1982,1978.5,7,44497,42915,4426,3129,-1582,-1297,-285,-0.00515813035011614,-0.00422888436415969,-0.000929245985956448,EPCI
200070043,CC Vienne et Gartempe,1982_1990,1986,8,42915,40415,4965,3103,-2500,-1862,-638,-0.00747447761102427,-0.00556699092469087,-0.00190748668633339,EPCI
200070043,CC Vienne et Gartempe,1990_1999,1994.5,9,40415,40606,5310,3217,191,-2093,2284,0.000524007883548672,-0.00574213874485534,0.00626614662840401,EPCI
200070043,CC Vienne et Gartempe,1999_2006,2002.5,7,40606,39914,4136,2486,-692,-1650,958,-0.0024525161409602,-0.00584776247483286,0.00339524633387265,EPCI
200070068,CC Communauté Bray-Eawy,2006_2011,2008.5,5,24139,25310,1284,1532,1171,248,923,0.0095191788474398,0.00201601738186599,0.00750316146557382,EPCI
200070068,CC Communauté Bray-Eawy,2011_2016,2013.5,5,25310,25302,1391,1508,-8,117,-125,-6.32241141824697e-05,0.000924652669918619,-0.000987876784101088,EPCI
200070068,CC Communauté Bray-Eawy,1968_1975,1971.5,7,23148,22159,1600,2676,-989,1076,-2065,-0.00621839230037036,0.00676540962102983,-0.0129838019214002,EPCI
200070068,CC Communauté Bray-Eawy,1975_1982,1978.5,7,22159,21840,1571,2004,-319,433,-752,-0.00206936784708633,0.00280889115294164,-0.00487825900002797,EPCI
200070068,CC Communauté Bray-Eawy,1982_1990,1986,8,21840,22170,1806,2315,330,509,-179,0.00187636727202767,0.00289415436806692,-0.00101778709603925,EPCI
200070068,CC Communauté Bray-Eawy,1990_1999,1994.5,9,22170,22925,2077,2407,755,330,425,0.00372781937810984,0.00162937800632616,0.00209844137178369,EPCI
200070068,CC Communauté Bray-Eawy,1999_2006,2002.5,7,22925,24139,1724,2030,1214,306,908,0.00739877548333645,0.00186493022891347,0.00553384525442298,EPCI
200070092,CA du Libournais,2006_2011,2008.5,5,81090,87007,4021,5384,5917,1363,4554,0.0141854573561058,0.00326766577258276,0.010917791583523,EPCI
200070092,CA du Libournais,2011_2016,2013.5,5,87007,90791,3943,5185,3784,1242,2542,0.00855066720403275,0.00280653506009743,0.00574413214393532,EPCI
200070092,CA du Libournais,1968_1975,1971.5,7,61501,62968,5841,6681,1467,840,627,0.00337328046183982,0.00193153073479581,0.00144174972704401,EPCI
200070092,CA du Libournais,1975_1982,1978.5,7,62968,66930,5672,5978,3962,306,3656,0.00875533948038298,0.000676207440938211,0.00807913203944477,EPCI
200070092,CA du Libournais,1982_1990,1986,8,66930,70423,6474,6616,3493,142,3351,0.00637933901234122,0.000259337572216563,0.00612000144012466,EPCI
200070092,CA du Libournais,1990_1999,1994.5,9,70423,73407,6873,7353,2984,480,2504,0.00462168994588419,0.00074343538003499,0.0038782545658492,EPCI
200070092,CA du Libournais,1999_2006,2002.5,7,73407,81090,5387,6363,7683,976,6707,0.0143216358637106,0.00181933054835111,0.0125023053153595,EPCI
200070100,CC du Val de Sully,2006_2011,2008.5,5,23958,24534,1307,1561,576,254,322,0.00476282904450054,0.00210027530781795,0.00266255373668259,EPCI
200070100,CC du Val de Sully,2011_2016,2013.5,5,24534,24790,1289,1412,256,123,133,0.00207824364824938,0.000998531127869818,0.00107971252037956,EPCI
200070100,CC du Val de Sully,1968_1975,1971.5,7,15911,17722,1559,1780,1811,221,1590,0.0155186269696119,0.00189376949767213,0.0136248574719398,EPCI
200070100,CC du Val de Sully,1975_1982,1978.5,7,17722,20392,1667,1892,2670,225,2445,0.0202502906725104,0.00170648516903177,0.0185438055034786,EPCI
200070100,CC du Val de Sully,1982_1990,1986,8,20392,21340,1874,2450,948,576,372,0.0056962345472511,0.00346100326921586,0.00223523127803524,EPCI
200070100,CC du Val de Sully,1990_1999,1994.5,9,21340,22597,2112,2463,1257,351,906,0.0063795865632339,0.00178141199975744,0.00459817456347646,EPCI
200070100,CC du Val de Sully,1999_2006,2002.5,7,22597,23958,1721,2140,1361,419,942,0.00839002105025211,0.00258296753861545,0.00580705351163665,EPCI
200070118,CC Val de Saône Centre,2006_2011,2008.5,5,17797,19394,722,1232,1597,510,1087,0.017335309473512,0.00553600991326934,0.0117992995602427,EPCI
200070118,CC Val de Saône Centre,2011_2016,2013.5,5,19394,20296,721,1070,902,349,553,0.0091334744149334,0.00353390528914829,0.00559956912578511,EPCI
200070118,CC Val de Saône Centre,1968_1975,1971.5,7,9103,9457,851,884,354,33,321,0.00546504754524779,0.000509453584726489,0.0049555939605213,EPCI
200070118,CC Val de Saône Centre,1975_1982,1978.5,7,9457,11259,859,794,1802,-65,1867,0.0252290856636459,-0.000910039161008315,0.0261391248246542,EPCI
200070118,CC Val de Saône Centre,1982_1990,1986,8,11259,13213,1015,1256,1954,241,1713,0.0202055974137598,0.00249209261858553,0.0177135047951743,EPCI
200070118,CC Val de Saône Centre,1990_1999,1994.5,9,13213,15145,1187,1479,1932,292,1640,0.015278795469045,0.00230921753465897,0.012969577934386,EPCI
200070118,CC Val de Saône Centre,1999_2006,2002.5,7,15145,17797,920,1493,2652,573,2079,0.0233190869910254,0.00503840001729168,0.0182806869737337,EPCI
200070126,CC Seine et Aube,2006_2011,2008.5,5,9440,10089,514,597,649,83,566,0.0133867591987962,0.001712020051618,0.0116747391471782,EPCI
200070126,CC Seine et Aube,2011_2016,2013.5,5,10089,10148,522,570,59,48,11,0.00116686431920132,0.000949313344434974,0.000217550974766348,EPCI
200070126,CC Seine et Aube,1968_1975,1971.5,7,8617,8281,740,849,-336,109,-445,-0.00566578316667221,0.00183800703918831,-0.00750379020586052,EPCI
200070126,CC Seine et Aube,1975_1982,1978.5,7,8281,8919,744,756,638,12,626,0.0106592808641466,0.000200488041331911,0.0104587928228147,EPCI
200070126,CC Seine et Aube,1982_1990,1986,8,8919,9262,800,866,343,66,277,0.0047281645828865,0.000909792601954836,0.00381837198093166,EPCI
200070126,CC Seine et Aube,1990_1999,1994.5,9,9262,9138,848,868,-124,20,-144,-0.00149648635897393,0.00024136876757644,-0.00173785512655037,EPCI
200070126,CC Seine et Aube,1999_2006,2002.5,7,9138,9440,797,735,302,-62,364,0.00465572393467006,-0.000955810874005113,0.00561153480867518,EPCI
200070142,CC Lyons Andelle,2006_2011,2008.5,5,19812,20783,926,1334,971,408,563,0.00961544015032856,0.00404026733402065,0.00557517281630791,EPCI
200070142,CC Lyons Andelle,2011_2016,2013.5,5,20783,20870,934,1265,87,331,-244,0.00083582435709828,0.00317997542758081,-0.00234415107048253,EPCI
200070142,CC Lyons Andelle,1968_1975,1971.5,7,15713,16065,1244,1823,352,579,-227,0.00316995619840754,0.00521421772408513,-0.00204426152567759,EPCI
200070142,CC Lyons Andelle,1975_1982,1978.5,7,16065,17410,1252,1532,1345,280,1065,0.011552182872816,0.00240491539359738,0.00914726747921862,EPCI
200070142,CC Lyons Andelle,1982_1990,1986,8,17410,18126,1373,1851,716,478,238,0.00505053841979497,0.00337172816293575,0.00167881025685922,EPCI
200070142,CC Lyons Andelle,1990_1999,1994.5,9,18126,18696,1474,1946,570,472,98,0.00344617173193651,0.0028536720306562,0.000592499701280312,EPCI
200070142,CC Lyons Andelle,1999_2006,2002.5,7,18696,19812,1167,1701,1116,534,582,0.00831699814681186,0.00397963889820567,0.00433735924860619,EPCI
200070159,CC Coeur de Beauce,2006_2011,2008.5,5,23661,24629,1106,1657,968,551,417,0.00805153815706983,0.00458305529395194,0.00346848286311789,EPCI
200070159,CC Coeur de Beauce,2011_2016,2013.5,5,24629,24806,1111,1545,177,434,-257,0.00143321586922074,0.00351421292227006,-0.00208099705304932,EPCI
200070159,CC Coeur de Beauce,1968_1975,1971.5,7,23201,21692,1802,2017,-1509,215,-1724,-0.00956140376322212,0.00136229410808002,-0.0109236978713021,EPCI
200070159,CC Coeur de Beauce,1975_1982,1978.5,7,21692,21192,1737,1622,-500,-115,-385,-0.00332585377049777,-0.000764946367214486,-0.00256090740328328,EPCI
200070159,CC Coeur de Beauce,1982_1990,1986,8,21192,21705,2039,1937,513,-102,615,0.00299433619327028,-0.000595365091059587,0.00358970128432986,EPCI
200070159,CC Coeur de Beauce,1990_1999,1994.5,9,21705,22309,2188,2283,604,95,509,0.00305438133924807,0.000480407660974448,0.00257397367827362,EPCI
200070159,CC Coeur de Beauce,1999_2006,2002.5,7,22309,23661,1586,2037,1352,451,901,0.00844084452373006,0.00281569591730936,0.0056251486064207,EPCI
200070167,CC Terres de Perche,2006_2011,2008.5,5,14032,14509,811,866,477,55,422,0.00670814164619027,0.000773475451866803,0.00593466619432347,EPCI
200070167,CC Terres de Perche,2011_2016,2013.5,5,14509,14451,775,794,-58,19,-77,-0.00080078524369509,0.000262326200520805,-0.0010631114442159,EPCI
200070167,CC Terres de Perche,1968_1975,1971.5,7,12294,12315,1125,1292,21,167,-146,0.000243843023118417,0.00193913261241789,-0.00169528958929947,EPCI
200070167,CC Terres de Perche,1975_1982,1978.5,7,12315,12384,1037,975,69,-62,131,0.00079850224400424,-0.000717494769974824,0.00151599701397906,EPCI
200070167,CC Terres de Perche,1982_1990,1986,8,12384,13164,1167,1247,780,80,700,0.00766428570430033,0.000786080585056445,0.00687820511924389,EPCI
200070167,CC Terres de Perche,1990_1999,1994.5,9,13164,13431,1380,1352,267,-28,295,0.00223356145097653,-0.000234231163398288,0.00246779261437482,EPCI
200070167,CC Terres de Perche,1999_2006,2002.5,7,13431,14032,1165,1078,601,-87,688,0.00627316118726307,-0.000908094880685336,0.0071812560679484,EPCI
200070183,CC des Terres du Val de Loire,2006_2011,2008.5,5,44921,47161,2279,3115,2240,836,1404,0.00977989128946843,0.00364999514196233,0.00612989614750611,EPCI
200070183,CC des Terres du Val de Loire,2011_2016,2013.5,5,47161,48336,2360,2839,1175,479,696,0.00493400125125976,0.00201139285051355,0.00292260840074621,EPCI
200070183,CC des Terres du Val de Loire,1968_1975,1971.5,7,29208,31561,2900,3048,2353,148,2205,0.011129987792053,0.000700058730651867,0.0104299290614011,EPCI
200070183,CC des Terres du Val de Loire,1975_1982,1978.5,7,31561,37824,3102,3177,6263,75,6188,0.0261975113140547,0.000313717603154096,0.0258837937109006,EPCI
200070183,CC des Terres du Val de Loire,1982_1990,1986,8,37824,39939,3628,3763,2115,135,1980,0.00682436411254073,0.00043559770931111,0.00638876640322962,EPCI
200070183,CC des Terres du Val de Loire,1990_1999,1994.5,9,39939,41915,3949,4147,1976,198,1778,0.00538002820495764,0.000539091895031181,0.00484093630992646,EPCI
200070183,CC des Terres du Val de Loire,1999_2006,2002.5,7,41915,44921,3128,3906,3006,778,2228,0.00994363164913858,0.00257356800499994,0.00737006364413865,EPCI
200070233,"CC Terres-de-Montaigu, communauté de communes Montaigu-Rocheservière",2006_2011,2008.5,5,40567,45304,1542,3489,4737,1947,2790,0.0223338277896719,0.00917964169442497,0.0131541860952469,EPCI
200070233,"CC Terres-de-Montaigu, communauté de communes Montaigu-Rocheservière",2011_2016,2013.5,5,45304,48162,1641,3253,2858,1612,1246,0.0123101537141261,0.00694330573378983,0.00536684798033631,EPCI
200070233,"CC Terres-de-Montaigu, communauté de communes Montaigu-Rocheservière",1968_1975,1971.5,7,25091,27901,1737,3607,2810,1870,940,0.0152803276076854,0.0101687589417693,0.00511156866591611,EPCI
200070233,"CC Terres-de-Montaigu, communauté de communes Montaigu-Rocheservière",1975_1982,1978.5,7,27901,30530,1888,3756,2629,1868,761,0.0129469924575305,0.00919930844833282,0.00374768400919769,EPCI
200070233,"CC Terres-de-Montaigu, communauté de communes Montaigu-Rocheservière",1982_1990,1986,8,30530,32525,2152,3911,1995,1759,236,0.00794378798516893,0.00700407171223666,0.000939716272932265,EPCI
200070233,"CC Terres-de-Montaigu, communauté de communes Montaigu-Rocheservière",1990_1999,1994.5,9,32525,35357,2396,4006,2832,1610,1222,0.00931953314707945,0.00529818092047949,0.00402135222659996,EPCI
200070233,"CC Terres-de-Montaigu, communauté de communes Montaigu-Rocheservière",1999_2006,2002.5,7,35357,40567,2017,3968,5210,1951,3259,0.019831006500399,0.00742616001579242,0.0124048464846066,EPCI
200070282,CC Lavalette Tude Dronne,2006_2011,2008.5,5,18222,18300,1162,781,78,-381,459,0.000854645913009877,-0.00417461657508671,0.00502926248809659,EPCI
200070282,CC Lavalette Tude Dronne,2011_2016,2013.5,5,18300,18077,1215,688,-223,-527,304,-0.00244912555712729,-0.00578784380540843,0.00333871824828114,EPCI
200070282,CC Lavalette Tude Dronne,1968_1975,1971.5,7,20313,19160,1901,1732,-1153,-169,-984,-0.00831329508004886,-0.00121851419646857,-0.00709478088358029,EPCI
200070282,CC Lavalette Tude Dronne,1975_1982,1978.5,7,19160,18614,1851,1361,-546,-490,-56,-0.00412159521249966,-0.00369886749839713,-0.000422727714102529,EPCI
200070282,CC Lavalette Tude Dronne,1982_1990,1986,8,18614,18325,2094,1501,-289,-593,304,-0.00195405559149398,-0.00400953275348072,0.00205547716198674,EPCI
200070282,CC Lavalette Tude Dronne,1990_1999,1994.5,9,18325,17804,2107,1451,-521,-656,135,-0.00319965866002159,-0.00402874487710971,0.000829086217088128,EPCI
200070282,CC Lavalette Tude Dronne,1999_2006,2002.5,7,17804,18222,1681,1111,418,-570,988,0.0033207162794695,-0.00452824947200387,0.00784896575147337,EPCI
200070290,CC Coeur du Pays Haut,2006_2011,2008.5,5,22603,23218,1120,1291,615,171,444,0.00538347894100077,0.00149686975432704,0.00388660918667373,EPCI
200070290,CC Coeur du Pays Haut,2011_2016,2013.5,5,23218,23307,1206,1274,89,68,21,0.000765473769731795,0.000584856363390585,0.00018061740634121,EPCI
200070290,CC Coeur du Pays Haut,1968_1975,1971.5,7,31022,27150,2018,2788,-3872,770,-4642,-0.0188654323133931,0.0037516484714134,-0.0226170807848065,EPCI
200070290,CC Coeur du Pays Haut,1975_1982,1978.5,7,27150,24314,1887,2088,-2836,201,-3037,-0.0156371262256896,0.00110827305055134,-0.0167453992762409,EPCI
200070290,CC Coeur du Pays Haut,1982_1990,1986,8,24314,22314,2002,2015,-2000,13,-2013,-0.0106723955156859,6.93705708519582e-05,-0.0107417660865378,EPCI
200070290,CC Coeur du Pays Haut,1990_1999,1994.5,9,22314,21870,2119,1797,-444,-322,-122,-0.00223066940454086,-0.00161773772131117,-0.000612931683229697,EPCI
200070290,CC Coeur du Pays Haut,1999_2006,2002.5,7,21870,22603,1679,1695,733,16,717,0.00472065106575159,0.000103042860916815,0.00461760820483478,EPCI
200070308,CA Mâconnais Beaujolais Agglomération,2006_2011,2008.5,5,73625,75595,3223,4656,1970,1433,537,0.00529506988300743,0.00385169296565972,0.00144337691734771,EPCI
200070308,CA Mâconnais Beaujolais Agglomération,2011_2016,2013.5,5,75595,77129,3331,4640,1534,1309,225,0.00402592260225099,0.00343541896111248,0.000590503641138509,EPCI
200070308,CA Mâconnais Beaujolais Agglomération,1968_1975,1971.5,7,61870,68586,4649,8334,6716,3685,3031,0.0148307607254137,0.00813748559755053,0.00669327512786314,EPCI
200070308,CA Mâconnais Beaujolais Agglomération,1975_1982,1978.5,7,68586,70865,4450,7444,2279,2994,-715,0.00468066687943991,0.00614915166171263,-0.00146848478227272,EPCI
200070308,CA Mâconnais Beaujolais Agglomération,1982_1990,1986,8,70865,71928,4915,8141,1063,3226,-2163,0.00186285296670707,0.00565339950197274,-0.00379054653526566,EPCI
200070308,CA Mâconnais Beaujolais Agglomération,1990_1999,1994.5,9,71928,71323,5811,8171,-605,2360,-2965,-0.000938088900904965,0.00365932199361276,-0.00459741089451772,EPCI
200070308,CA Mâconnais Beaujolais Agglomération,1999_2006,2002.5,7,71323,73625,4602,6196,2302,1594,708,0.00454828159385312,0.00314941827133009,0.00139886332252303,EPCI
200070316,"CC Entre Arroux, Loire et Somme",2006_2011,2008.5,5,24922,24009,1552,985,-913,-567,-346,-0.00743664776786324,-0.00461837818661386,-0.00281826958124938,EPCI
200070316,"CC Entre Arroux, Loire et Somme",2011_2016,2013.5,5,24009,23051,1684,882,-958,-802,-156,-0.00811084963101527,-0.00679008497293763,-0.00132076465807764,EPCI
200070316,"CC Entre Arroux, Loire et Somme",1968_1975,1971.5,7,30988,31695,2514,3501,707,987,-280,0.00322789947894897,0.00450627551021589,-0.00127837603126692,EPCI
200070316,"CC Entre Arroux, Loire et Somme",1975_1982,1978.5,7,31695,30623,2379,2744,-1072,365,-1437,-0.00490330779206594,0.00166950311950006,-0.006572810911566,EPCI
200070316,"CC Entre Arroux, Loire et Somme",1982_1990,1986,8,30623,28903,2706,2525,-1720,-181,-1539,-0.00719970264602055,-0.00075764312728472,-0.00644205951873583,EPCI
200070316,"CC Entre Arroux, Loire et Somme",1990_1999,1994.5,9,28903,26093,2731,2322,-2810,-409,-2401,-0.0112999281681667,-0.00164472264084704,-0.00965520552731968,EPCI
200070316,"CC Entre Arroux, Loire et Somme",1999_2006,2002.5,7,26093,24922,2193,1567,-1171,-626,-545,-0.00653798115800575,-0.00349511204518497,-0.00304286911282078,EPCI
200070324,CC du Territoire de Lunéville à Baccarat,2006_2011,2008.5,5,42137,43053,2087,2767,916,680,236,0.00431040323533116,0.00319986266378296,0.0011105405715482,EPCI
200070324,CC du Territoire de Lunéville à Baccarat,2011_2016,2013.5,5,43053,41927,2195,2451,-1126,256,-1382,-0.00528635857730164,0.00120187193231725,-0.00648823050961889,EPCI
200070324,CC du Territoire de Lunéville à Baccarat,1968_1975,1971.5,7,43171,42611,3730,5456,-560,1726,-2286,-0.00186348121994262,0.005743515331466,-0.00760699655140862,EPCI
200070324,CC du Territoire de Lunéville à Baccarat,1975_1982,1978.5,7,42611,43024,3449,4690,413,1241,-828,0.00137890175781852,0.00414338276380819,-0.00276448100598967,EPCI
200070324,CC du Territoire de Lunéville à Baccarat,1982_1990,1986,8,43024,42633,3647,5311,-391,1664,-2055,-0.00114053637450473,0.00485384278050095,-0.00599437915500568,EPCI
200070324,CC du Territoire de Lunéville à Baccarat,1990_1999,1994.5,9,42633,41856,3907,5019,-777,1112,-1889,-0.00204162919443651,0.00292186829371094,-0.00496349748814745,EPCI
200070324,CC du Territoire de Lunéville à Baccarat,1999_2006,2002.5,7,41856,42137,2894,3746,281,852,-571,0.000956322519323205,0.00289959710485185,-0.00194327458552865,EPCI
200070332,CC des Savoir-Faire,2006_2011,2008.5,5,16934,16355,1184,702,-579,-482,-97,-0.0069338043233399,-0.00577218252823805,-0.00116162179510185,EPCI
200070332,CC des Savoir-Faire,2011_2016,2013.5,5,16355,15638,1097,606,-717,-491,-226,-0.00892588787590032,-0.00611242809911723,-0.00281345977678309,EPCI
200070332,CC des Savoir-Faire,1968_1975,1971.5,7,23014,21170,2246,2126,-1844,-120,-1724,-0.0118601983590255,-0.000771813342235934,-0.0110883850167896,EPCI
200070332,CC des Savoir-Faire,1975_1982,1978.5,7,21170,20109,2059,1625,-1061,-434,-627,-0.00731846141024928,-0.00299360249957416,-0.00432485891067511,EPCI
200070332,CC des Savoir-Faire,1982_1990,1986,8,20109,18563,2165,1593,-1546,-572,-974,-0.00994981030518605,-0.0036813010960973,-0.00626850920908875,EPCI
200070332,CC des Savoir-Faire,1990_1999,1994.5,9,18563,17259,2248,1507,-1304,-741,-563,-0.00806029638068595,-0.00458027578074255,-0.0034800205999434,EPCI
200070332,CC des Savoir-Faire,1999_2006,2002.5,7,17259,16934,1670,1051,-325,-619,294,-0.00271207442449806,-0.00516545867312092,0.00245338424862286,EPCI
200070340,CC Haute-Maurienne Vanoise,2006_2011,2008.5,5,9232,8913,383,566,-319,183,-502,-0.00700829150194593,0.00402043054813826,-0.0110287220500842,EPCI
200070340,CC Haute-Maurienne Vanoise,2011_2016,2013.5,5,8913,8666,373,463,-247,90,-337,-0.00560494571618686,0.00204228791278064,-0.0076472336289675,EPCI
200070340,CC Haute-Maurienne Vanoise,1968_1975,1971.5,7,13475,10163,647,1432,-3312,785,-4097,-0.0394963453213861,0.00936130165377056,-0.0488576469751567,EPCI
200070340,CC Haute-Maurienne Vanoise,1975_1982,1978.5,7,10163,10179,551,1029,16,478,-462,0.000224753869734862,0.00671452185832899,-0.00648976798859413,EPCI
200070340,CC Haute-Maurienne Vanoise,1982_1990,1986,8,10179,9682,658,1095,-497,437,-934,-0.00623774932775945,0.00548470111917682,-0.0117224504469363,EPCI
200070340,CC Haute-Maurienne Vanoise,1990_1999,1994.5,9,9682,9121,673,1043,-561,370,-931,-0.0066101720923355,0.00435965004307332,-0.0109698221354088,EPCI
200070340,CC Haute-Maurienne Vanoise,1999_2006,2002.5,7,9121,9232,512,793,111,281,-170,0.00172953142688304,0.00437836334192913,-0.00264883191504609,EPCI
200070365,CC Corbières Salanque Méditerranée,2006_2011,2008.5,5,18002,19937,993,1075,1935,82,1853,0.02062877944523,0.000874191170288817,0.0197545882749412,EPCI
200070365,CC Corbières Salanque Méditerranée,2011_2016,2013.5,5,19937,21697,1096,1159,1760,63,1697,0.0170632827493113,0.000610787962049213,0.0164524947872621,EPCI
200070365,CC Corbières Salanque Méditerranée,1968_1975,1971.5,7,11010,10507,1206,681,-503,-525,22,-0.00665805754734417,-0.00694926483569719,0.000291207288353025,EPCI
200070365,CC Corbières Salanque Méditerranée,1975_1982,1978.5,7,10507,11286,1222,717,779,-505,1284,0.0102697062737662,-0.00665751176925795,0.0169272180430242,EPCI
200070365,CC Corbières Salanque Méditerranée,1982_1990,1986,8,11286,13201,1359,1072,1915,-287,2202,0.0197843624608445,-0.002965071554184,0.0227494340150285,EPCI
200070365,CC Corbières Salanque Méditerranée,1990_1999,1994.5,9,13201,14802,1578,1219,1601,-359,1960,0.0128000867414488,-0.00287022557163031,0.0156703123130792,EPCI
200070365,CC Corbières Salanque Méditerranée,1999_2006,2002.5,7,14802,18002,1212,1207,3200,-5,3205,0.0283546311062484,-4.43041111035131e-05,0.0283989352173519,EPCI
200070373,CC Loir-Lucé-Bercé,2006_2011,2008.5,5,24499,24664,1727,1171,165,-556,721,0.00134337956556507,-0.00452678205123746,0.00587016161680253,EPCI
200070373,CC Loir-Lucé-Bercé,2011_2016,2013.5,5,24664,24113,1849,1042,-551,-807,256,-0.00450852125335954,-0.00660322441281516,0.00209470315945561,EPCI
200070373,CC Loir-Lucé-Bercé,1968_1975,1971.5,7,25405,24484,2476,2330,-921,-146,-775,-0.00526127675335852,-0.000834035185657269,-0.00442724156770126,EPCI
200070373,CC Loir-Lucé-Bercé,1975_1982,1978.5,7,24484,24238,2403,1829,-246,-574,328,-0.00144155901737286,-0.00336363770720335,0.00192207868983048,EPCI
200070373,CC Loir-Lucé-Bercé,1982_1990,1986,8,24238,23740,2677,2025,-498,-652,154,-0.00259166835932723,-0.00339310797245251,0.000801439613125287,EPCI
200070373,CC Loir-Lucé-Bercé,1990_1999,1994.5,9,23740,23839,3139,2093,99,-1046,1145,0.000462496454868289,-0.00488657870497202,0.00534907515984031,EPCI
200070373,CC Loir-Lucé-Bercé,1999_2006,2002.5,7,23839,24499,2515,1752,660,-763,1423,0.00390896377349614,-0.00451899902905691,0.00842796280255305,EPCI
200070407,CA Pays d'Issoire,2006_2011,2008.5,5,51932,54149,2819,3134,2217,315,1902,0.00839591677474827,0.00119292457557316,0.00720299219917511,EPCI
200070407,CA Pays d'Issoire,2011_2016,2013.5,5,54149,55727,2768,2948,1578,180,1398,0.0057615870846246,0.000657215256801285,0.00510437182782331,EPCI
200070407,CA Pays d'Issoire,1968_1975,1971.5,7,47987,48892,4345,4853,905,508,397,0.00267265705726683,0.00150023180673099,0.00117242525053583,EPCI
200070407,CA Pays d'Issoire,1975_1982,1978.5,7,48892,48637,4306,3811,-255,-495,240,-0.000746753296704927,-0.0014495799288978,0.000702826632192873,EPCI
200070407,CA Pays d'Issoire,1982_1990,1986,8,48637,47861,4683,4258,-776,-425,-351,-0.00200842810209312,-0.00109997673117213,-0.000908451370920985,EPCI
200070407,CA Pays d'Issoire,1990_1999,1994.5,9,47861,48427,4953,4435,566,-518,1084,0.00130713498878654,-0.00119628255157496,0.0025034175403615,EPCI
200070407,CA Pays d'Issoire,1999_2006,2002.5,7,48427,51932,3818,3906,3505,88,3417,0.0100325146027522,0.000251886243949271,0.00978062835880296,EPCI
200070431,CC Saint-Marcellin Vercors Isère Communauté,2006_2011,2008.5,5,41772,43781,1824,2502,2009,678,1331,0.00943900398500741,0.00318548765646343,0.00625351632854398,EPCI
200070431,CC Saint-Marcellin Vercors Isère Communauté,2011_2016,2013.5,5,43781,44230,2018,2322,449,304,145,0.0020427553008362,0.00138306817695814,0.000659687123878059,EPCI
200070431,CC Saint-Marcellin Vercors Isère Communauté,1968_1975,1971.5,7,29774,30646,2718,3092,872,374,498,0.00413231724594376,0.00177234707566854,0.00235997017027522,EPCI
200070431,CC Saint-Marcellin Vercors Isère Communauté,1975_1982,1978.5,7,30646,33211,2748,2674,2565,-74,2639,0.011548893451979,-0.00033318445046645,0.0118820779024454,EPCI
200070431,CC Saint-Marcellin Vercors Isère Communauté,1982_1990,1986,8,33211,35188,3080,3215,1977,135,1842,0.00725418114476684,0.000495353795924898,0.00675882734884194,EPCI
200070431,CC Saint-Marcellin Vercors Isère Communauté,1990_1999,1994.5,9,35188,37586,3311,3730,2398,419,1979,0.00735206415471135,0.00128461838232863,0.00606744577238272,EPCI
200070431,CC Saint-Marcellin Vercors Isère Communauté,1999_2006,2002.5,7,37586,41772,2685,3270,4186,585,3601,0.0151992974900528,0.00212412542562849,0.0130751720644243,EPCI
200070449,CC Inter-Caux-Vexin,2006_2011,2008.5,5,50477,52486,1728,2931,2009,1203,806,0.00783628025520744,0.00469240674316304,0.0031438735120444,EPCI
200070449,CC Inter-Caux-Vexin,2011_2016,2013.5,5,52486,54382,1906,2888,1896,982,914,0.00712259575583185,0.00368902375117451,0.00343357200465734,EPCI
200070449,CC Inter-Caux-Vexin,1968_1975,1971.5,7,29354,32731,2383,3265,3377,882,2495,0.015677888179424,0.00409472827191351,0.0115831599075104,EPCI
200070449,CC Inter-Caux-Vexin,1975_1982,1978.5,7,32731,38651,2284,3096,5920,812,5108,0.0240342783217096,0.00329659358061287,0.0207376847410967,EPCI
200070449,CC Inter-Caux-Vexin,1982_1990,1986,8,38651,43419,2602,4102,4768,1500,3268,0.0146467888758821,0.00460784046011392,0.0100389484157682,EPCI
200070449,CC Inter-Caux-Vexin,1990_1999,1994.5,9,43419,47270,3037,4902,3851,1865,1986,0.00948679611179037,0.00459435854284317,0.00489243756894721,EPCI
200070449,CC Inter-Caux-Vexin,1999_2006,2002.5,7,47270,50477,2356,4088,3207,1732,1475,0.00942152607626112,0.00508827039728228,0.00433325567897885,EPCI
200070464,CC Coeur de Maurienne Arvan,2006_2011,2008.5,5,15779,15464,691,832,-315,141,-456,-0.00402491824572226,0.00180163007189473,-0.00582654831761699,EPCI
200070464,CC Coeur de Maurienne Arvan,2011_2016,2013.5,5,15464,14756,743,739,-708,-4,-704,-0.00932920286064298,-5.27073607945931e-05,-0.00927649549984839,EPCI
200070464,CC Coeur de Maurienne Arvan,1968_1975,1971.5,7,15089,15552,1011,1768,463,757,-294,0.00432694089054841,0.00707450162882322,-0.0027475607382748,EPCI
200070464,CC Coeur de Maurienne Arvan,1975_1982,1978.5,7,15552,15748,956,1572,196,616,-420,0.00179076226929786,0.00562810998922186,-0.00383734771992399,EPCI
200070464,CC Coeur de Maurienne Arvan,1982_1990,1986,8,15748,15746,1178,1729,-2,551,-553,-1.58759138783049e-05,0.004373814273473,-0.0043896901873513,EPCI
200070464,CC Coeur de Maurienne Arvan,1990_1999,1994.5,9,15746,15666,1226,1645,-80,419,-499,-0.000565796078912051,0.00296335696330187,-0.00352915304221392,EPCI
200070464,CC Coeur de Maurienne Arvan,1999_2006,2002.5,7,15666,15779,973,1218,113,245,-132,0.00102726772248296,0.00222726187617987,-0.00119999415369691,EPCI
200070506,CC Pays de Nexon Monts de Chalus,2006_2011,2008.5,5,12324,12913,948,639,589,-309,898,0.00938092262323331,-0.00492140083290169,0.014302323456135,EPCI
200070506,CC Pays de Nexon Monts de Chalus,2011_2016,2013.5,5,12913,13133,1009,619,220,-390,610,0.00338443244972209,-0.00599967570632552,0.0093841081560476,EPCI
200070506,CC Pays de Nexon Monts de Chalus,1968_1975,1971.5,7,13691,13033,1440,864,-658,-576,-82,-0.00701160037730864,-0.00613781431205133,-0.000873786065257307,EPCI
200070506,CC Pays de Nexon Monts de Chalus,1975_1982,1978.5,7,13033,12544,1527,714,-489,-813,324,-0.00544826677106525,-0.00905816131876492,0.00360989454769967,EPCI
200070506,CC Pays de Nexon Monts de Chalus,1982_1990,1986,8,12544,11789,1693,791,-755,-902,147,-0.00772941949786143,-0.00923435283055763,0.0015049333326962,EPCI
200070506,CC Pays de Nexon Monts de Chalus,1990_1999,1994.5,9,11789,11783,1723,762,-6,-961,955,-5.65626868027636e-05,-0.0090594570029093,0.00900289431610653,EPCI
200070506,CC Pays de Nexon Monts de Chalus,1999_2006,2002.5,7,11783,12324,1343,785,541,-558,1099,0.00643357366933861,-0.00663573772179472,0.0130693113911333,EPCI
200070514,CA du Grand Cognac,2006_2011,2008.5,5,69875,69797,3542,3566,-78,24,-102,-0.000223355567089301,6.8724789873631e-05,-0.000292080356962932,EPCI
200070514,CA du Grand Cognac,2011_2016,2013.5,5,69797,69775,3694,3192,-22,-502,480,-6.30479083137958e-05,-0.00143863863516025,0.00137559072684645,EPCI
200070514,CA du Grand Cognac,1968_1975,1971.5,7,68025,70546,5261,7920,2521,2659,-138,0.00521206359725146,0.00549737290959605,-0.000285309312344586,EPCI
200070514,CA du Grand Cognac,1975_1982,1978.5,7,70546,69786,5347,6472,-760,1125,-1885,-0.00154616955042741,0.00228873782135637,-0.00383490737178378,EPCI
200070514,CA du Grand Cognac,1982_1990,1986,8,69786,70312,5992,7014,526,1022,-496,0.000939073738567275,0.001824588138433,-0.00088551439986572,EPCI
200070514,CA du Grand Cognac,1990_1999,1994.5,9,70312,69214,6574,7161,-1098,587,-1685,-0.00174728582256045,0.000934113641022755,-0.00268139946358321,EPCI
200070514,CA du Grand Cognac,1999_2006,2002.5,7,69214,69875,5065,5256,661,191,470,0.00135874757291399,0.000392618436348822,0.000966129136565165,EPCI
200070530,CC du Grand Autunois Morvan,2006_2011,2008.5,5,38275,37608,2409,1672,-667,-737,70,-0.00350985557053607,-0.00387820623011257,0.000368350659576499,EPCI
200070530,CC du Grand Autunois Morvan,2011_2016,2013.5,5,37608,36298,2495,1630,-1310,-865,-445,-0.00706574945774696,-0.00466555212286345,-0.00240019733488351,EPCI
200070530,CC du Grand Autunois Morvan,1968_1975,1971.5,7,45633,44795,4513,4938,-838,425,-1263,-0.00264429951426681,0.00134108268921646,-0.00398538220348327,EPCI
200070530,CC du Grand Autunois Morvan,1975_1982,1978.5,7,44795,43671,4299,3737,-1124,-562,-562,-0.00362374117341591,-0.00181187058670795,-0.00181187058670795,EPCI
200070530,CC du Grand Autunois Morvan,1982_1990,1986,8,43671,41772,4620,3924,-1899,-696,-1203,-0.00554183799951891,-0.00203113177865464,-0.00351070622086427,EPCI
200070530,CC du Grand Autunois Morvan,1990_1999,1994.5,9,41772,39791,4628,3828,-1981,-800,-1181,-0.00538384405474024,-0.00217419245017274,-0.0032096516045675,EPCI
200070530,CC du Grand Autunois Morvan,1999_2006,2002.5,7,39791,38275,3551,2682,-1516,-869,-647,-0.00553374845333532,-0.0031720497400715,-0.00236169871326382,EPCI
200070548,CC La Clayette Chauffailles en Brionnais,2006_2011,2008.5,5,15815,15633,986,732,-182,-254,72,-0.00231228098267311,-0.00322702950329104,0.000914748520617933,EPCI
200070548,CC La Clayette Chauffailles en Brionnais,2011_2016,2013.5,5,15633,15271,1058,618,-362,-440,78,-0.00467473119663586,-0.0056819937196679,0.00100726252303204,EPCI
200070548,CC La Clayette Chauffailles en Brionnais,1968_1975,1971.5,7,17287,17803,1514,1906,516,392,124,0.00421058377186512,0.00319873805924637,0.00101184571261875,EPCI
200070548,CC La Clayette Chauffailles en Brionnais,1975_1982,1978.5,7,17803,17484,1613,1667,-319,54,-373,-0.00257963920069471,0.000436678736167756,-0.00301631793686246,EPCI
200070548,CC La Clayette Chauffailles en Brionnais,1982_1990,1986,8,17484,16500,1592,1628,-984,36,-1020,-0.00721457362128608,0.000263947815412905,-0.00747852143669899,EPCI
200070548,CC La Clayette Chauffailles en Brionnais,1990_1999,1994.5,9,16500,15851,1768,1377,-649,-391,-258,-0.00444871845995343,-0.00268019864074236,-0.00176851981921107,EPCI
200070548,CC La Clayette Chauffailles en Brionnais,1999_2006,2002.5,7,15851,15815,1382,1096,-36,-286,250,-0.000324766260323406,-0.00258008751256928,0.00225532125224587,EPCI
200070555,CC de la Veyle,2006_2011,2008.5,5,19693,21183,715,1194,1490,479,1011,0.0146940577389225,0.00472379440063348,0.00997026333828904,EPCI
200070555,CC de la Veyle,2011_2016,2013.5,5,21183,22033,794,1238,850,444,406,0.00789950902910119,0.00412633177520109,0.0037731772539001,EPCI
200070555,CC de la Veyle,1968_1975,1971.5,7,12517,13555,1133,1526,1038,393,645,0.0114461201630938,0.00433364665134475,0.00711247351174902,EPCI
200070555,CC de la Veyle,1975_1982,1978.5,7,13555,15315,1018,1384,1760,366,1394,0.0175925660387495,0.00365845407396722,0.0139341119647823,EPCI
200070555,CC de la Veyle,1982_1990,1986,8,15315,16990,1170,1742,1675,572,1103,0.0130585522395186,0.00445939813791321,0.00859915410160537,EPCI
200070555,CC de la Veyle,1990_1999,1994.5,9,16990,17882,1269,1771,892,502,390,0.00570171376059014,0.00320881200427831,0.00249290175631183,EPCI
200070555,CC de la Veyle,1999_2006,2002.5,7,17882,19693,1009,1528,1811,519,1292,0.013876630671271,0.00397679255570935,0.00989983811556163,EPCI
200070563,CC Terres Touloises,2006_2011,2008.5,5,44523,44609,1613,2871,86,1258,-1172,0.000386019047901698,0.00564665072395739,-0.0052606316760557,EPCI
200070563,CC Terres Touloises,2011_2016,2013.5,5,44609,44646,1657,2733,37,1076,-1039,0.00016583079896737,0.00482253891051055,-0.00465670811154318,EPCI
200070563,CC Terres Touloises,1968_1975,1971.5,7,34369,36819,2528,4737,2450,2209,241,0.00988554535187025,0.00891313048256383,0.00097241486930642,EPCI
200070563,CC Terres Touloises,1975_1982,1978.5,7,36819,39540,2361,4625,2721,2264,457,0.010237592275733,0.00851815836540221,0.00171943391033075,EPCI
200070563,CC Terres Touloises,1982_1990,1986,8,39540,41664,2628,5487,2124,2859,-735,0.0065620148994725,0.00883276864293403,-0.00227075374346153,EPCI
200070563,CC Terres Touloises,1990_1999,1994.5,9,41664,42338,2780,5299,674,2519,-1845,0.00178465519928195,0.00666995021808787,-0.00488529501880593,EPCI
200070563,CC Terres Touloises,1999_2006,2002.5,7,42338,44523,2108,4202,2185,2094,91,0.00721459808998293,0.00691412741438181,0.00030047067560112,EPCI
200070571,CC Coeur de Berry,2006_2011,2008.5,5,7868,8315,373,489,447,116,331,0.0111127351965243,0.00288384179596605,0.00822889340055829,EPCI
200070571,CC Coeur de Berry,2011_2016,2013.5,5,8315,8387,365,420,72,55,17,0.00172584262658448,0.0013183520064187,0.000407490620165781,EPCI
200070571,CC Coeur de Berry,1968_1975,1971.5,7,5935,6031,622,597,96,-25,121,0.0022948872902524,-0.000597626898503229,0.00289251418875563,EPCI
200070571,CC Coeur de Berry,1975_1982,1978.5,7,6031,6699,578,451,668,-127,795,0.0151196522941421,-0.0028745446726887,0.0179941969668308,EPCI
200070571,CC Coeur de Berry,1982_1990,1986,8,6699,7390,616,574,691,-42,733,0.0123467840767699,-0.000750455761540285,0.0130972398383102,EPCI
200070571,CC Coeur de Berry,1990_1999,1994.5,9,7390,7431,661,727,41,66,-25,0.000614933907182147,0.000989893606683456,-0.000374959699501309,EPCI
200070571,CC Coeur de Berry,1999_2006,2002.5,7,7431,7868,555,603,437,48,389,0.00819676262987734,0.000900330906714216,0.00729643172316313,EPCI
200070589,CC de Seille et Grand Couronné,2006_2011,2008.5,5,17289,18173,540,1072,884,532,352,0.0100232021300506,0.00603206282034719,0.0039911393097034,EPCI
200070589,CC de Seille et Grand Couronné,2011_2016,2013.5,5,18173,18624,537,1015,451,478,-27,0.00491485757362331,0.00520909516672271,-0.0002942375930994,EPCI
200070589,CC de Seille et Grand Couronné,1968_1975,1971.5,7,12015,12332,984,1153,317,169,148,0.00372716306649878,0.00198703646131954,0.00174012660517924,EPCI
200070589,CC de Seille et Grand Couronné,1975_1982,1978.5,7,12332,14242,943,1201,1910,258,1652,0.0207841631804311,0.00280749429348231,0.0179766688869488,EPCI
200070589,CC de Seille et Grand Couronné,1982_1990,1986,8,14242,15393,1010,1521,1151,511,640,0.00976203015451893,0.00433396820934767,0.00542806194517126,EPCI
200070589,CC de Seille et Grand Couronné,1990_1999,1994.5,9,15393,16167,1005,1618,774,613,161,0.0054659135598274,0.00432894704415271,0.00113696651567469,EPCI
200070589,CC de Seille et Grand Couronné,1999_2006,2002.5,7,16167,17289,723,1385,1122,662,460,0.00963156403205923,0.00568279446454831,0.00394876956751091,EPCI
200070647,CA Bergeracoise,2006_2011,2008.5,5,58867,60531,3283,3059,1664,-224,1888,0.00559056289681137,-0.000752575774570761,0.00634313867138213,EPCI
200070647,CA Bergeracoise,2011_2016,2013.5,5,60531,60844,3537,2971,313,-566,879,0.00103204838556792,-0.00186626001990876,0.00289830840547668,EPCI
200070647,CA Bergeracoise,1968_1975,1971.5,7,49950,51093,4346,5135,1143,789,354,0.00323737135136515,0.00223472090658539,0.00100265044477976,EPCI
200070647,CA Bergeracoise,1975_1982,1978.5,7,51093,52579,4480,4384,1486,-96,1582,0.0041040126261509,-0.000265131367503692,0.00436914399365459,EPCI
200070647,CA Bergeracoise,1982_1990,1986,8,52579,56163,5170,5024,3584,-146,3730,0.0082767364273677,-0.000337166160266653,0.00861390258763436,EPCI
200070647,CA Bergeracoise,1990_1999,1994.5,9,56163,56253,5905,4951,90,-954,1044,0.000177926482755941,-0.00188602071721298,0.00206394719996892,EPCI
200070647,CA Bergeracoise,1999_2006,2002.5,7,56253,58867,4603,3986,2614,-617,3231,0.00650985315412855,-0.00153656442084825,0.0080464175749768,EPCI
200070662,CC Bretagne porte de Loire Communauté,2006_2011,2008.5,5,28174,31100,1176,2355,2926,1179,1747,0.0199582044930291,0.00804194227521576,0.0119162622178133,EPCI
200070662,CC Bretagne porte de Loire Communauté,2011_2016,2013.5,5,31100,31876,1256,2077,776,821,-45,0.00494127932336697,0.0052278225830983,-0.000286543259731331,EPCI
200070662,CC Bretagne porte de Loire Communauté,1968_1975,1971.5,7,20037,19653,1920,2172,-384,252,-636,-0.00276054922759084,0.00181161043060649,-0.00457215965819732,EPCI
200070662,CC Bretagne porte de Loire Communauté,1975_1982,1978.5,7,19653,20630,1971,1935,977,-36,1013,0.00695497839758685,-0.000256273513114766,0.00721125191070162,EPCI
200070662,CC Bretagne porte de Loire Communauté,1982_1990,1986,8,20630,21163,2103,2202,533,99,434,0.00319359454117407,0.000593181725283739,0.00260041281589033,EPCI
200070662,CC Bretagne porte de Loire Communauté,1990_1999,1994.5,9,21163,22692,2187,2556,1529,369,1160,0.00778101213025106,0.00187782437937387,0.0059031877508772,EPCI
200070662,CC Bretagne porte de Loire Communauté,1999_2006,2002.5,7,22692,28174,1686,2757,5482,1071,4411,0.0313951979499172,0.00613357479101811,0.0252616231588991,EPCI
200070670,CC du Pays de Dol et de la Baie du Mont-Saint-Michel,2006_2011,2008.5,5,21020,22956,1200,1389,1936,189,1747,0.0177771606073345,0.00173547693945569,0.0160416836678788,EPCI
200070670,CC du Pays de Dol et de la Baie du Mont-Saint-Michel,2011_2016,2013.5,5,22956,23537,1245,1368,581,123,458,0.00501137731935919,0.00106092841700719,0.00395044890235199,EPCI
200070670,CC du Pays de Dol et de la Baie du Mont-Saint-Michel,1968_1975,1971.5,7,20536,19845,1805,2013,-691,208,-899,-0.00487768773233277,0.00146824753737368,-0.00634593526970645,EPCI
200070670,CC du Pays de Dol et de la Baie du Mont-Saint-Michel,1975_1982,1978.5,7,19845,19631,1827,1718,-214,-109,-105,-0.00154767779658083,-0.000788303176763131,-0.000759374619817695,EPCI
200070670,CC du Pays de Dol et de la Baie du Mont-Saint-Michel,1982_1990,1986,8,19631,19867,2037,1934,236,-103,339,0.00149488051660973,-0.000652426666147467,0.0021473071827572,EPCI
200070670,CC du Pays de Dol et de la Baie du Mont-Saint-Michel,1990_1999,1994.5,9,19867,19753,2078,1939,-114,-139,25,-0.000639205092445083,-0.000779381647805847,0.000140176555360764,EPCI
200070670,CC du Pays de Dol et de la Baie du Mont-Saint-Michel,1999_2006,2002.5,7,19753,21020,1601,1646,1267,45,1222,0.00892083945946243,0.000316841180486037,0.00860399827897639,EPCI
200070688,CC Couesnon Marches de Bretagne,2006_2011,2008.5,5,20608,21560,1234,1528,952,294,658,0.00907299153296304,0.0028019532675327,0.00627103826543033,EPCI
200070688,CC Couesnon Marches de Bretagne,2011_2016,2013.5,5,21560,21970,1157,1278,410,121,289,0.0037747345037813,0.00111400701209155,0.00266072749168974,EPCI
200070688,CC Couesnon Marches de Bretagne,1968_1975,1971.5,7,21262,20630,1890,2141,-632,251,-883,-0.00430145282005401,0.00170833015479993,-0.00600978297485394,EPCI
200070688,CC Couesnon Marches de Bretagne,1975_1982,1978.5,7,20630,19858,1875,1756,-772,-119,-653,-0.00543366657785316,-0.000837572956948868,-0.00459609362090429,EPCI
200070688,CC Couesnon Marches de Bretagne,1982_1990,1986,8,19858,19531,1955,1808,-327,-147,-180,-0.00207334785833324,-0.000932055459250723,-0.00114129239908252,EPCI
200070688,CC Couesnon Marches de Bretagne,1990_1999,1994.5,9,19531,18960,2014,1809,-571,-205,-366,-0.0032913992114918,-0.00118167572391562,-0.00210972348757618,EPCI
200070688,CC Couesnon Marches de Bretagne,1999_2006,2002.5,7,18960,20608,1646,1757,1648,111,1537,0.0119780047136897,0.000806770948555556,0.0111712337651341,EPCI
200070712,CC Thiers Dore et Montagne,2006_2011,2008.5,5,38372,37478,2162,2014,-894,-148,-746,-0.00470368940138566,-0.000778686836023576,-0.00392500256536208,EPCI
200070712,CC Thiers Dore et Montagne,2011_2016,2013.5,5,37478,37460,2089,1837,-18,-252,234,-9.60748120260035e-05,-0.00134504736836405,0.00124897255633805,EPCI
200070712,CC Thiers Dore et Montagne,1968_1975,1971.5,7,43640,43407,4143,4503,-233,360,-593,-0.000764485138193716,0.00118117875429072,-0.00194566389248444,EPCI
200070712,CC Thiers Dore et Montagne,1975_1982,1978.5,7,43407,43195,4063,3643,-212,-420,208,-0.000699179832961305,-0.00138516759360259,0.000685987760641281,EPCI
200070712,CC Thiers Dore et Montagne,1982_1990,1986,8,43195,41717,4216,3827,-1478,-389,-1089,-0.00434254728318972,-0.00114293023894506,-0.00319961704424466,EPCI
200070712,CC Thiers Dore et Montagne,1990_1999,1994.5,9,41717,39570,4294,3851,-2147,-443,-1704,-0.00585362971118697,-0.0012078052920614,-0.00464582441912557,EPCI
200070712,CC Thiers Dore et Montagne,1999_2006,2002.5,7,39570,38372,3236,2939,-1198,-297,-901,-0.00438225953295002,-0.00108641993429562,-0.0032958395986544,EPCI
200070720,CC Médoc Atlantique,2006_2011,2008.5,5,22047,24684,1527,1157,2637,-370,3007,0.0228529619693916,-0.00320652101959609,0.0260594829889877,EPCI
200070720,CC Médoc Atlantique,2011_2016,2013.5,5,24684,25956,1692,1064,1272,-628,1900,0.0101001731382446,-0.00498656346762392,0.0150867366058686,EPCI
200070720,CC Médoc Atlantique,1968_1975,1971.5,7,16423,16819,1660,1497,396,-163,559,0.0034095720392664,-0.00140343495555662,0.00481300699482302,EPCI
200070720,CC Médoc Atlantique,1975_1982,1978.5,7,16819,16875,1771,1242,56,-529,585,0.000474975195483562,-0.00448681925733579,0.00496179445281936,EPCI
200070720,CC Médoc Atlantique,1982_1990,1986,8,16875,17958,2092,1426,1083,-666,1749,0.00780561386792256,-0.00480012819578617,0.0126057420637087,EPCI
200070720,CC Médoc Atlantique,1990_1999,1994.5,9,17958,19250,2574,1510,1292,-1064,2356,0.00774935677565525,-0.0063818232270102,0.0141311800026655,EPCI
200070720,CC Médoc Atlantique,1999_2006,2002.5,7,19250,22047,1983,1271,2797,-712,3509,0.0195698090484226,-0.004981660365562,0.0245514694139847,EPCI
200070738,CC Mad et Moselle,2006_2011,2008.5,5,19962,20621,1148,1267,659,119,540,0.0065170456778203,0.00117682615426497,0.00534021952355533,EPCI
200070738,CC Mad et Moselle,2011_2016,2013.5,5,20621,20183,1280,1040,-438,-240,-198,-0.00428465617657003,-0.00234775680907947,-0.00193689936749056,EPCI
200070738,CC Mad et Moselle,1968_1975,1971.5,7,16385,16212,1947,1526,-173,-421,248,-0.00151521852189385,-0.00368732368622722,0.00217210516433338,EPCI
200070738,CC Mad et Moselle,1975_1982,1978.5,7,16212,16488,1869,1304,276,-565,841,0.00241450091264883,-0.00494272831756011,0.00735722923020894,EPCI
200070738,CC Mad et Moselle,1982_1990,1986,8,16488,17449,1981,1674,961,-307,1268,0.00710631799271155,-0.00227017650755718,0.00937649450026873,EPCI
200070738,CC Mad et Moselle,1990_1999,1994.5,9,17449,18652,2144,1887,1203,-257,1460,0.00743539948995009,-0.00158844361505999,0.00902384310501008,EPCI
200070738,CC Mad et Moselle,1999_2006,2002.5,7,18652,19962,1725,1539,1310,-186,1496,0.00974389234200568,-0.00138348395084966,0.0111273762928553,EPCI
200070746,CA Sarreguemines Confluences,2006_2011,2008.5,5,65312,66018,2939,3339,706,400,306,0.00215264271334115,0.00121962759962671,0.000933015113714434,EPCI
200070746,CA Sarreguemines Confluences,2011_2016,2013.5,5,66018,65342,3170,3045,-676,-125,-551,-0.00205636623390026,-0.000380245235558481,-0.00167612099834178,EPCI
200070746,CA Sarreguemines Confluences,1968_1975,1971.5,7,60240,62086,4476,7029,1846,2553,-707,0.00432130103829254,0.0059763171997621,-0.00165501616146957,EPCI
200070746,CA Sarreguemines Confluences,1975_1982,1978.5,7,62086,63555,4438,6537,1469,2099,-630,0.00334632248598754,0.00478143696261937,-0.00143511447663182,EPCI
200070746,CA Sarreguemines Confluences,1982_1990,1986,8,63555,63341,4970,7006,-214,2036,-2250,-0.000421516630512153,0.00401031710150815,-0.0044318337320203,EPCI
200070746,CA Sarreguemines Confluences,1990_1999,1994.5,9,63341,65488,5354,6568,2147,1214,933,0.00371065538190818,0.00209815353220146,0.00161250184970672,EPCI
200070746,CA Sarreguemines Confluences,1999_2006,2002.5,7,65488,65312,4145,4970,-176,825,-1001,-0.000384373698439688,0.00180175171143604,-0.00218612540987573,EPCI
200070753,CA Riom Limagne et Volcans,2006_2011,2008.5,5,61277,63836,2457,3513,2559,1056,1503,0.00821611370232289,0.00339047130506173,0.00482564239726116,EPCI
200070753,CA Riom Limagne et Volcans,2011_2016,2013.5,5,63836,66628,2603,3615,2792,1012,1780,0.00859827767082089,0.00311656769443794,0.00548170997638294,EPCI
200070753,CA Riom Limagne et Volcans,1968_1975,1971.5,7,38932,43253,3334,4838,4321,1504,2817,0.015149328085071,0.0052729899189879,0.00987633816608306,EPCI
200070753,CA Riom Limagne et Volcans,1975_1982,1978.5,7,43253,50104,3290,4363,6851,1073,5778,0.0212270483563404,0.00332456909740961,0.0179024792589308,EPCI
200070753,CA Riom Limagne et Volcans,1982_1990,1986,8,50104,55715,3715,5083,5611,1368,4243,0.0133569887710312,0.00325652479749968,0.0101004639735315,EPCI
200070753,CA Riom Limagne et Volcans,1990_1999,1994.5,9,55715,57534,4261,5343,1819,1082,737,0.0035760083711851,0.00212712537527338,0.00144888299591172,EPCI
200070753,CA Riom Limagne et Volcans,1999_2006,2002.5,7,57534,61277,3492,4690,3743,1198,2545,0.00904472875353246,0.002894893146335,0.00614983560719747,EPCI
200070761,CC Ambert Livradois Forez,2006_2011,2008.5,5,28470,28044,2009,1139,-426,-870,444,-0.00301069792084463,-0.00614860842989396,0.00313791050904933,EPCI
200070761,CC Ambert Livradois Forez,2011_2016,2013.5,5,28044,27606,1982,1055,-438,-927,489,-0.0031433622481859,-0.00665273242937975,0.00350937018119385,EPCI
200070761,CC Ambert Livradois Forez,1968_1975,1971.5,7,37007,34072,4080,2578,-2935,-1502,-1433,-0.0117350510076987,-0.00600546733000457,-0.00572958367769411,EPCI
200070761,CC Ambert Livradois Forez,1975_1982,1978.5,7,34072,31928,3856,2232,-2144,-1624,-520,-0.00924168283019933,-0.00700022990496442,-0.00224145292523491,EPCI
200070761,CC Ambert Livradois Forez,1982_1990,1986,8,31928,29975,3891,2380,-1953,-1511,-442,-0.00785891433169339,-0.0060802967512487,-0.00177861758044469,EPCI
200070761,CC Ambert Livradois Forez,1990_1999,1994.5,9,29975,29009,4000,2468,-966,-1532,566,-0.00363311468187899,-0.00576183405035053,0.00212871936847154,EPCI
200070761,CC Ambert Livradois Forez,1999_2006,2002.5,7,29009,28470,2930,1790,-539,-1140,601,-0.00267573174232649,-0.00565924709879815,0.00298351535647166,EPCI
200070779,CC Brie des Rivières et Châteaux,2006_2011,2008.5,5,35214,36883,1073,2339,1669,1266,403,0.00930442138253595,0.00705775762150421,0.00224666376103175,EPCI
200070779,CC Brie des Rivières et Châteaux,2011_2016,2013.5,5,36883,38925,1173,2423,2042,1250,792,0.0108354786469667,0.00663288359877979,0.00420259504818687,EPCI
200070779,CC Brie des Rivières et Châteaux,1968_1975,1971.5,7,17202,19315,1506,1908,2113,402,1711,0.0166886307281082,0.00317502581765239,0.0135136049104558,EPCI
200070779,CC Brie des Rivières et Châteaux,1975_1982,1978.5,7,19315,24624,1585,1871,5309,286,5023,0.0353001334721812,0.00190164591694176,0.0333984875552394,EPCI
200070779,CC Brie des Rivières et Châteaux,1982_1990,1986,8,24624,29060,1733,2592,4436,859,3577,0.0209209735216092,0.0040511984344144,0.0168697750871948,EPCI
200070779,CC Brie des Rivières et Châteaux,1990_1999,1994.5,9,29060,32941,2114,3610,3881,1496,2385,0.0140258323004472,0.00540650479811105,0.00861932750233613,EPCI
200070779,CC Brie des Rivières et Châteaux,1999_2006,2002.5,7,32941,35214,1587,3087,2273,1500,773,0.00957781192637319,0.00632059739971834,0.00325721452665485,EPCI
200070787,CC du Plateau de Lannemezan,2006_2011,2008.5,5,17340,17659,1063,697,319,-366,685,0.00365257386464846,-0.00419072738075654,0.00784330124540499,EPCI
200070787,CC du Plateau de Lannemezan,2011_2016,2013.5,5,17659,17886,1037,675,227,-362,589,0.00255780872395661,-0.00407897250252112,0.00663678122647773,EPCI
200070787,CC du Plateau de Lannemezan,1968_1975,1971.5,7,21213,20712,1659,1870,-501,211,-712,-0.00340860017913447,0.00143555815927619,-0.00484415833841066,EPCI
200070787,CC du Plateau de Lannemezan,1975_1982,1978.5,7,20712,19311,1559,1159,-1401,-400,-1001,-0.00995559180956551,-0.00284242449951906,-0.00711316731004645,EPCI
200070787,CC du Plateau de Lannemezan,1982_1990,1986,8,19311,18267,1744,1285,-1044,-459,-585,-0.0069232640709076,-0.0030438488587611,-0.0038794152121465,EPCI
200070787,CC du Plateau de Lannemezan,1990_1999,1994.5,9,18267,17330,1867,1157,-937,-710,-227,-0.00583370078427448,-0.00442041361455163,-0.00141328716972285,EPCI
200070787,CC du Plateau de Lannemezan,1999_2006,2002.5,7,17330,17340,1583,1001,10,-582,592,8.24130564667236e-05,-0.00479643988636331,0.00487885294283004,EPCI
200070795,CC du Pays de Trie et du Magnoac,2006_2011,2008.5,5,6911,6911,518,232,0,-286,286,0,,,EPCI
200070795,CC du Pays de Trie et du Magnoac,2011_2016,2013.5,5,6911,6969,560,207,58,-353,411,0.0016728771698673,-0.0101814765683303,0.0118543537381976,EPCI
200070795,CC du Pays de Trie et du Magnoac,1968_1975,1971.5,7,8613,7938,934,602,-675,-332,-343,-0.0115910621933706,-0.00570108540473931,-0.00588997678863127,EPCI
200070795,CC du Pays de Trie et du Magnoac,1975_1982,1978.5,7,7938,7443,910,393,-495,-517,22,-0.00915602044302799,-0.00956295468494035,0.000406934241912356,EPCI
200070795,CC du Pays de Trie et du Magnoac,1982_1990,1986,8,7443,6967,904,408,-476,-496,20,-0.00822713005919007,-0.00857280779276948,0.000345677733579415,EPCI
200070795,CC du Pays de Trie et du Magnoac,1990_1999,1994.5,9,6967,6718,932,455,-249,-477,228,-0.00403563760140535,-0.00773092022437893,0.00369528262297357,EPCI
200070795,CC du Pays de Trie et du Magnoac,1999_2006,2002.5,7,6718,6911,804,354,193,-450,643,0.00405446202745474,-0.0094534088723038,0.0135078708997585,EPCI
200070803,CC des Coteaux du Val-d'Arros,2006_2011,2008.5,5,9851,10843,445,517,992,72,920,0.0193746464096174,0.00140622433618191,0.0179684220734355,EPCI
200070803,CC des Coteaux du Val-d'Arros,2011_2016,2013.5,5,10843,11265,419,509,422,90,332,0.00766540259962789,0.00163480150229031,0.00603060109733758,EPCI
200070803,CC des Coteaux du Val-d'Arros,1968_1975,1971.5,7,8143,8121,848,597,-22,-251,229,-0.000386405781009347,-0.00440853868333391,0.00402213290232457,EPCI
200070803,CC des Coteaux du Val-d'Arros,1975_1982,1978.5,7,8121,8523,816,484,402,-332,734,0.0069260308107657,-0.00572000554520949,0.0126460363559752,EPCI
200070803,CC des Coteaux du Val-d'Arros,1982_1990,1986,8,8523,9002,871,608,479,-263,742,0.0068582084526374,-0.00376557165562346,0.0106237801082609,EPCI
200070803,CC des Coteaux du Val-d'Arros,1990_1999,1994.5,9,9002,9169,914,667,167,-247,414,0.00204447088609716,-0.00302385813692215,0.00506832902301931,EPCI
200070803,CC des Coteaux du Val-d'Arros,1999_2006,2002.5,7,9169,9851,634,637,682,3,679,0.0103019525718833,4.53165069144425e-05,0.0102566360649688,EPCI
200070811,CC Pyrénées Vallées des Gaves,2006_2011,2008.5,5,15773,15765,962,605,-8,-357,349,-0.000101459754273558,-0.00452764153445755,0.00442618178018399,EPCI
200070811,CC Pyrénées Vallées des Gaves,2011_2016,2013.5,5,15765,15471,937,586,-294,-351,57,-0.003757919134178,-0.00448649529284516,0.000728576158667164,EPCI
200070811,CC Pyrénées Vallées des Gaves,1968_1975,1971.5,7,17079,15690,1438,1291,-1389,-147,-1242,-0.0120448828680998,-0.00127472842448572,-0.0107701544436141,EPCI
200070811,CC Pyrénées Vallées des Gaves,1975_1982,1978.5,7,15690,15571,1351,1093,-119,-258,139,-0.00108703116535103,-0.00235675664420643,0.0012697254788554,EPCI
200070811,CC Pyrénées Vallées des Gaves,1982_1990,1986,8,15571,15362,1565,1329,-209,-236,27,-0.0016877344570454,-0.00190576713809911,0.000218032681053712,EPCI
200070811,CC Pyrénées Vallées des Gaves,1990_1999,1994.5,9,15362,15444,1683,1330,82,-353,435,0.000591691738926148,-0.00254716077854793,0.00313885251747408,EPCI
200070811,CC Pyrénées Vallées des Gaves,1999_2006,2002.5,7,15444,15773,1365,951,329,-414,743,0.00301582979255688,-0.00379499554443328,0.00681082533699016,EPCI
200070829,CC Neste Barousse,2006_2011,2008.5,5,6923,7154,615,298,231,-317,548,0.00658608130258509,-0.00903804230701071,0.0156241236095958,EPCI
200070829,CC Neste Barousse,2011_2016,2013.5,5,7154,7247,665,252,93,-413,506,0.00258652916772295,-0.011486414476017,0.0140729436437399,EPCI
200070829,CC Neste Barousse,1968_1975,1971.5,7,7607,7180,1015,502,-427,-513,86,-0.00821882396791784,-0.00987413746028537,0.00165531349236753,EPCI
200070829,CC Neste Barousse,1975_1982,1978.5,7,7180,6902,867,327,-278,-540,262,-0.00562528398688533,-0.0109268106220075,0.00530152663512215,EPCI
200070829,CC Neste Barousse,1982_1990,1986,8,6902,6836,947,410,-66,-537,471,-0.00120033644701123,-0.0097663738188641,0.00856603737185287,EPCI
200070829,CC Neste Barousse,1990_1999,1994.5,9,6836,6665,1137,415,-171,-722,551,-0.00281079913311477,-0.0118678185620401,0.00905701942892538,EPCI
200070829,CC Neste Barousse,1999_2006,2002.5,7,6665,6923,880,355,258,-525,783,0.00544035212666105,-0.0110704839786707,0.0165108361053318,EPCI
200070845,CC Orne Lorraine Confluences,2006_2011,2008.5,5,52839,53670,2684,3028,831,344,487,0.00312580151510122,0.00129395393645586,0.00183184757864536,EPCI
200070845,CC Orne Lorraine Confluences,2011_2016,2013.5,5,53670,53134,2664,2956,-536,292,-828,-0.00200541876094673,0.0010925042503665,-0.00309792301131323,EPCI
200070845,CC Orne Lorraine Confluences,1968_1975,1971.5,7,65180,60669,4061,6673,-4511,2612,-7123,-0.0101933794815915,0.00590226273684704,-0.0160956422184385,EPCI
200070845,CC Orne Lorraine Confluences,1975_1982,1978.5,7,60669,55225,3911,4880,-5444,969,-6413,-0.01334122206494,0.00237465910744432,-0.0157158811723844,EPCI
200070845,CC Orne Lorraine Confluences,1982_1990,1986,8,55225,52725,4283,5243,-2500,960,-3460,-0.0057740187748605,0.00221722320954643,-0.00799124198440693,EPCI
200070845,CC Orne Lorraine Confluences,1990_1999,1994.5,9,52725,51768,4659,4919,-957,260,-1217,-0.002033211176799,0.000552387571544138,-0.00258559874834314,EPCI
200070845,CC Orne Lorraine Confluences,1999_2006,2002.5,7,51768,52839,3767,3988,1071,221,850,0.00292961963885219,0.000604524687382197,0.00232509495146999,EPCI
200070852,CC Usses et Rhône,2006_2011,2008.5,5,16914,18560,681,1080,1646,399,1247,0.0187469678241818,0.00454437433891164,0.0142025934852702,EPCI
200070852,CC Usses et Rhône,2011_2016,2013.5,5,18560,20326,690,1138,1766,448,1318,0.0183446588068275,0.00465368468032769,0.0136909741264998,EPCI
200070852,CC Usses et Rhône,1968_1975,1971.5,7,10562,10655,969,985,93,16,77,0.0012531575845709,0.000215597003797143,0.00103756058077375,EPCI
200070852,CC Usses et Rhône,1975_1982,1978.5,7,10655,10874,909,923,219,14,205,0.00291070693000983,0.000186072589133049,0.00272463434087678,EPCI
200070852,CC Usses et Rhône,1982_1990,1986,8,10874,12409,1020,1158,1535,138,1397,0.0166429000048915,0.00149623465842022,0.0151466653464713,EPCI
200070852,CC Usses et Rhône,1990_1999,1994.5,9,12409,14023,1157,1440,1614,283,1331,0.0136790270225786,0.00239849110742859,0.01128053591515,EPCI
200070852,CC Usses et Rhône,1999_2006,2002.5,7,14023,16914,999,1317,2891,318,2573,0.0271392891294593,0.00298522792914841,0.0241540612003109,EPCI
200070894,CC de Gevrey-Chambertin et de Nuits-Saint-Georges,2006_2011,2008.5,5,28339,29640,1053,1668,1301,615,686,0.00901758616472836,0.00426273289108989,0.00475485327363848,EPCI
200070894,CC de Gevrey-Chambertin et de Nuits-Saint-Georges,2011_2016,2013.5,5,29640,29798,1149,1521,158,372,-214,0.00106386084636334,0.00250478629650103,-0.00144092545013769,EPCI
200070894,CC de Gevrey-Chambertin et de Nuits-Saint-Georges,1968_1975,1971.5,7,20446,22258,1546,2196,1812,650,1162,0.0122044785078264,0.00437798621969488,0.00782649228813147,EPCI
200070894,CC de Gevrey-Chambertin et de Nuits-Saint-Georges,1975_1982,1978.5,7,22258,23404,1571,1928,1146,357,789,0.00719798950688566,0.00224230563172616,0.0049556838751595,EPCI
200070894,CC de Gevrey-Chambertin et de Nuits-Saint-Georges,1982_1990,1986,8,23404,25314,1824,2425,1910,601,1309,0.00985457143292789,0.0031008363514082,0.00675373508151969,EPCI
200070894,CC de Gevrey-Chambertin et de Nuits-Saint-Georges,1990_1999,1994.5,9,25314,27290,2025,2862,1976,837,1139,0.00838638505217992,0.00355233010560455,0.00483405494657537,EPCI
200070894,CC de Gevrey-Chambertin et de Nuits-Saint-Georges,1999_2006,2002.5,7,27290,28339,1579,2382,1049,803,246,0.00540291669408499,0.00413588379918994,0.00126703289489505,EPCI
200070902,CC Auxonne Pontailler Val de Saône,2006_2011,2008.5,5,21527,22770,1027,1456,1243,429,814,0.0112904451276856,0.00389670230070566,0.00739374282697997,EPCI
200070902,CC Auxonne Pontailler Val de Saône,2011_2016,2013.5,5,22770,23406,1043,1481,636,438,198,0.00552491026875068,0.00380489103413962,0.00172001923461106,EPCI
200070902,CC Auxonne Pontailler Val de Saône,1968_1975,1971.5,7,17091,17765,1546,1870,674,324,350,0.0055407535530676,0.00266350764272092,0.00287724591034668,EPCI
200070902,CC Auxonne Pontailler Val de Saône,1975_1982,1978.5,7,17765,18923,1677,1674,1158,-3,1161,0.00906193927215693,-2.34765266118055e-05,0.00908541579876873,EPCI
200070902,CC Auxonne Pontailler Val de Saône,1982_1990,1986,8,18923,19138,1728,1976,215,248,-33,0.00141321939660011,0.00163013214119454,-0.000216912744594435,EPCI
200070902,CC Auxonne Pontailler Val de Saône,1990_1999,1994.5,9,19138,19902,1836,1975,764,139,625,0.00435884355830707,0.000793035673566338,0.00356580788474073,EPCI
200070902,CC Auxonne Pontailler Val de Saône,1999_2006,2002.5,7,19902,21527,1426,1897,1625,471,1154,0.0112756291970686,0.00326819775496573,0.00800743144210287,EPCI
200070910,CC Tille et Venelle,2006_2011,2008.5,5,4860,5064,252,305,204,53,151,0.00825755647344062,0.00214534555437428,0.00611221091906634,EPCI
200070910,CC Tille et Venelle,2011_2016,2013.5,5,5064,4980,216,271,-84,55,-139,-0.00333976928311619,0.00218675369727846,-0.00552652298039465,EPCI
200070910,CC Tille et Venelle,1968_1975,1971.5,7,4897,5035,346,674,138,328,-190,0.0039779989527533,0.00945495403263104,-0.00547695507987774,EPCI
200070910,CC Tille et Venelle,1975_1982,1978.5,7,5035,4948,321,485,-87,164,-251,-0.00248691273031509,0.00468797342266294,-0.00717488615297803,EPCI
200070910,CC Tille et Venelle,1982_1990,1986,8,4948,4735,367,495,-213,128,-341,-0.00548511749291769,0.00329622084081439,-0.00878133833373208,EPCI
200070910,CC Tille et Venelle,1990_1999,1994.5,9,4735,4800,434,473,65,39,26,0.00151605819778555,0.000909634918671332,0.000606423279114221,EPCI
200070910,CC Tille et Venelle,1999_2006,2002.5,7,4800,4860,338,429,60,91,-31,0.00177622132970012,0.00269393568337852,-0.000917714353678397,EPCI
200070928,CC Terre de Picardie,2006_2011,2008.5,5,16808,17780,772,1181,972,409,563,0.0113073030106168,0.00475790836557846,0.00654939464503832,EPCI
200070928,CC Terre de Picardie,2011_2016,2013.5,5,17780,18341,739,1213,561,474,87,0.00623229259695801,0.00526578732791105,0.000966505269046965,EPCI
200070928,CC Terre de Picardie,1968_1975,1971.5,7,15637,15159,1379,1701,-478,322,-800,-0.00442524901499464,0.00298102548708844,-0.00740627450208307,EPCI
200070928,CC Terre de Picardie,1975_1982,1978.5,7,15159,15008,1291,1479,-151,188,-339,-0.00142912393040817,0.00177930661534262,-0.0032084305457508,EPCI
200070928,CC Terre de Picardie,1982_1990,1986,8,15008,15486,1443,1712,478,269,209,0.00392681452433452,0.00220986005658156,0.00171695446775296,EPCI
200070928,CC Terre de Picardie,1990_1999,1994.5,9,15486,15964,1357,1882,478,525,-47,0.0033834662904968,0.00371615021445778,-0.000332683923960982,EPCI
200070928,CC Terre de Picardie,1999_2006,2002.5,7,15964,16808,1026,1540,844,514,330,0.00738697527292698,0.00449870295057401,0.00288827232235296,EPCI
200070936,CC Ponthieu-Marquenterre,2006_2011,2008.5,5,32820,33351,1941,1836,531,-105,636,0.0032150916072593,-0.000635752577706642,0.00385084418496594,EPCI
200070936,CC Ponthieu-Marquenterre,2011_2016,2013.5,5,33351,33180,2017,1726,-171,-291,120,-0.00102756612344357,-0.00174866515743906,0.000721099033995487,EPCI
200070936,CC Ponthieu-Marquenterre,1968_1975,1971.5,7,32940,31872,2941,3547,-1068,606,-1674,-0.00469748121050728,0.00266542473180469,-0.00736290594231198,EPCI
200070936,CC Ponthieu-Marquenterre,1975_1982,1978.5,7,31872,31204,3107,2652,-668,-455,-213,-0.00302136783593587,-0.00205796761280063,-0.000963400223135241,EPCI
200070936,CC Ponthieu-Marquenterre,1982_1990,1986,8,31204,30981,3324,2822,-223,-502,279,-0.000896120540042622,-0.00201727583453541,0.00112115529449279,EPCI
200070936,CC Ponthieu-Marquenterre,1990_1999,1994.5,9,30981,31115,3431,2991,134,-440,574,0.000479659962712375,-0.00157500286263765,0.00205466282535003,EPCI
200070936,CC Ponthieu-Marquenterre,1999_2006,2002.5,7,31115,32820,2792,2612,1705,-180,1885,0.00765026741900732,-0.000807652865349746,0.00845792028435706,EPCI
200070944,CC du Vimeu,2006_2011,2008.5,5,22813,23149,1079,1280,336,201,135,0.0029284864921586,0.00175186245513059,0.00117662403702801,EPCI
200070944,CC du Vimeu,2011_2016,2013.5,5,23149,22955,1110,1210,-194,100,-294,-0.00168174534956866,0.000866879046169415,-0.00254862439573808,EPCI
200070944,CC du Vimeu,1968_1975,1971.5,7,21817,22779,1677,2741,962,1064,-102,0.00618326314693207,0.006838869010744,-0.000655605863811925,EPCI
200070944,CC du Vimeu,1975_1982,1978.5,7,22779,22790,1693,2203,11,510,-499,6.89715724848661e-05,0.00319777290611652,-0.00312880133363165,EPCI
200070944,CC du Vimeu,1982_1990,1986,8,22790,22747,1796,2458,-43,662,-705,-0.00023604397322019,0.00363397930864572,-0.00387002328186591,EPCI
200070944,CC du Vimeu,1990_1999,1994.5,9,22747,22524,1881,2221,-223,340,-563,-0.00109405232981052,0.00166806184814161,-0.00276211417795213,EPCI
200070944,CC du Vimeu,1999_2006,2002.5,7,22524,22813,1530,1743,289,213,76,0.00182296551622696,0.00134356974033336,0.000479395775893595,EPCI
200070951,CC du Territoire Nord Picardie,2006_2011,2008.5,5,30473,31858,1300,1833,1385,533,852,0.0089291253579602,0.00343626268288288,0.00549286267507732,EPCI
200070951,CC du Territoire Nord Picardie,2011_2016,2013.5,5,31858,31606,1462,1800,-252,338,-590,-0.00158704967972778,0.00212866187201583,-0.00371571155174361,EPCI
200070951,CC du Territoire Nord Picardie,1968_1975,1971.5,7,26659,27323,2246,3468,664,1222,-558,0.00352075960312503,0.00647947023346204,-0.002958710630337,EPCI
200070951,CC du Territoire Nord Picardie,1975_1982,1978.5,7,27323,28009,2236,2796,686,560,126,0.00354871737772622,0.00289691214508263,0.000651805232643591,EPCI
200070951,CC du Territoire Nord Picardie,1982_1990,1986,8,28009,29501,2443,3163,1492,720,772,0.00650837225218126,0.00314076945145476,0.0033676028007265,EPCI
200070951,CC du Territoire Nord Picardie,1990_1999,1994.5,9,29501,29793,2640,3186,292,546,-254,0.00109496631759654,0.00204743701851955,-0.000952470700923014,EPCI
200070951,CC du Territoire Nord Picardie,1999_2006,2002.5,7,29793,30473,1952,2734,680,782,-102,0.00322914234929317,0.00371351370168714,-0.000484371352393975,EPCI
200070969,CC Avre Luce Noye,2006_2011,2008.5,5,19997,21202,827,1411,1205,584,621,0.0117713948290736,0.00570497475533527,0.00606642007373836,EPCI
200070969,CC Avre Luce Noye,2011_2016,2013.5,5,21202,21827,831,1502,625,671,-46,0.00582735711163651,0.00625625059505296,-0.000428893483416447,EPCI
200070969,CC Avre Luce Noye,1968_1975,1971.5,7,16232,16062,1466,1898,-170,432,-602,-0.00150292215923309,0.00381919042816879,-0.00532211258740188,EPCI
200070969,CC Avre Luce Noye,1975_1982,1978.5,7,16062,17120,1270,1764,1058,494,564,0.00915466954959521,0.0042744865382798,0.0048801830113154,EPCI
200070969,CC Avre Luce Noye,1982_1990,1986,8,17120,18074,1462,2038,954,576,378,0.00680140908478721,0.0041065111455319,0.00269489793925531,EPCI
200070969,CC Avre Luce Noye,1990_1999,1994.5,9,18074,18917,1540,2095,843,555,288,0.00507802158087656,0.00334318146783688,0.00173484011303968,EPCI
200070969,CC Avre Luce Noye,1999_2006,2002.5,7,18917,19997,1239,1965,1080,726,354,0.00796314906843776,0.00535300576267205,0.00261014330576571,EPCI
200070977,CC du Grand Roye,2006_2011,2008.5,5,25026,25787,1453,1677,761,224,537,0.00600902308379747,0.00176875318103894,0.00424026990275853,EPCI
200070977,CC du Grand Roye,2011_2016,2013.5,5,25787,25873,1552,1587,86,35,51,0.000666114744301227,0.000271093209890034,0.000395021534411193,EPCI
200070977,CC du Grand Roye,1968_1975,1971.5,7,22190,22871,2160,2739,681,579,102,0.0043276223053963,0.00367943218035896,0.000648190125037331,EPCI
200070977,CC du Grand Roye,1975_1982,1978.5,7,22871,23244,2295,2457,373,162,211,0.00231371562272065,0.00100488453319235,0.0013088310895283,EPCI
200070977,CC du Grand Roye,1982_1990,1986,8,23244,23623,2447,2784,379,337,42,0.00202376749610034,0.00179949774719212,0.000224269748908217,EPCI
200070977,CC du Grand Roye,1990_1999,1994.5,9,23623,24657,2708,2820,1034,112,922,0.00477134926626288,0.000516819262883407,0.00425453000337947,EPCI
200070977,CC du Grand Roye,1999_2006,2002.5,7,24657,25026,2186,2276,369,90,279,0.00212431725841689,0.000518126160589484,0.0016061910978274,EPCI
200070985,CC de l'Est de la Somme,2006_2011,2008.5,5,21103,20931,1281,1316,-172,35,-207,-0.0016354405761777,0.000332793140501277,-0.00196823371667898,EPCI
200070985,CC de l'Est de la Somme,2011_2016,2013.5,5,20931,20483,1267,1088,-448,-179,-269,-0.00431785908667059,-0.00172521601900455,-0.00259264306766605,EPCI
200070985,CC de l'Est de la Somme,1968_1975,1971.5,7,21721,22510,1743,2797,789,1054,-265,0.0051101726767897,0.00682651711195988,-0.00171634443517018,EPCI
200070985,CC de l'Est de la Somme,1975_1982,1978.5,7,22510,22621,1731,2427,111,696,-585,0.00070296460060626,0.00440777803623384,-0.00370481343562758,EPCI
200070985,CC de l'Est de la Somme,1982_1990,1986,8,22621,21895,1929,2609,-726,680,-1406,-0.00406924535708264,0.00381141438404435,-0.00788065974112699,EPCI
200070985,CC de l'Est de la Somme,1990_1999,1994.5,9,21895,21106,2099,2331,-789,232,-1021,-0.00406957895142879,0.00119663158014129,-0.00526621053157008,EPCI
200070985,CC de l'Est de la Somme,1999_2006,2002.5,7,21106,21103,1763,1806,-3,43,-46,-2.0306905058054e-05,0.000291065639165441,-0.000311372544223495,EPCI
200070993,CA de la Baie de Somme,2006_2011,2008.5,5,50641,51038,2803,2988,397,185,212,0.00156300591032132,0.000728352880124547,0.000834653030196778,EPCI
200070993,CA de la Baie de Somme,2011_2016,2013.5,5,51038,49575,2858,2584,-1463,-274,-1189,-0.00579987121174563,-0.0010862369870255,-0.00471363422472014,EPCI
200070993,CA de la Baie de Somme,1968_1975,1971.5,7,49283,50952,4301,6633,1669,2332,-663,0.00476916774735492,0.00666369034561514,-0.00189452259826022,EPCI
200070993,CA de la Baie de Somme,1975_1982,1978.5,7,50952,50585,4283,5562,-367,1279,-1646,-0.00103217028987146,0.00359712752246756,-0.00462929781233902,EPCI
200070993,CA de la Baie de Somme,1982_1990,1986,8,50585,49775,4663,5600,-810,937,-1747,-0.00201574561397866,0.00233179461765186,-0.00434754023163052,EPCI
200070993,CA de la Baie de Somme,1990_1999,1994.5,9,49775,50079,4816,5755,304,939,-635,0.000676774307469152,0.00209043116682084,-0.00141365685935168,EPCI
200070993,CA de la Baie de Somme,1999_2006,2002.5,7,50079,50641,3903,4304,562,401,161,0.00159552382942452,0.00113844315942924,0.00045708066999528,EPCI
200071017,CC des Terres d'Auxois,2006_2011,2008.5,5,15800,15944,954,784,144,-170,314,0.00181617582866878,-0.00214409646440064,0.00396027229306941,EPCI
200071017,CC des Terres d'Auxois,2011_2016,2013.5,5,15944,15903,1071,788,-41,-283,242,-0.000514829876939071,-0.00355358183350627,0.0030387519565672,EPCI
200071017,CC des Terres d'Auxois,1968_1975,1971.5,7,15862,15385,1717,1543,-477,-174,-303,-0.00435240114148561,-0.00158766834091928,-0.00276473280056633,EPCI
200071017,CC des Terres d'Auxois,1975_1982,1978.5,7,15385,15339,1658,1297,-46,-361,315,-0.000427680519749951,-0.00335636233977679,0.00292868182002684,EPCI
200071017,CC des Terres d'Auxois,1982_1990,1986,8,15339,15466,1805,1557,127,-248,375,0.00103121401353046,-0.00201370925476814,0.00304492326829859,EPCI
200071017,CC des Terres d'Auxois,1990_1999,1994.5,9,15466,15455,1986,1478,-11,-508,497,-7.905138669273e-05,-0.00365073676726426,0.00357168538057153,EPCI
200071017,CC des Terres d'Auxois,1999_2006,2002.5,7,15455,15800,1528,1116,345,-412,757,0.00315888801147679,-0.00377235321950272,0.00693124123097951,EPCI
200071025,CC Haute-Provence-Pays de Banon,2006_2011,2008.5,5,9146,9556,491,386,410,-105,515,0.0088090945515189,-0.00225598762904752,0.0110650821805664,EPCI
200071025,CC Haute-Provence-Pays de Banon,2011_2016,2013.5,5,9556,9709,444,418,153,-26,179,0.00318186360043438,-0.000540708847132639,0.00372257244756702,EPCI
200071025,CC Haute-Provence-Pays de Banon,1968_1975,1971.5,7,5333,5285,576,372,-48,-204,156,-0.00129078226533497,-0.00548582462767361,0.00419504236233864,EPCI
200071025,CC Haute-Provence-Pays de Banon,1975_1982,1978.5,7,5285,6351,629,376,1066,-253,1319,0.0265960495760316,-0.00631219563108442,0.032908245207116,EPCI
200071025,CC Haute-Provence-Pays de Banon,1982_1990,1986,8,6351,7385,699,681,1034,-18,1052,0.019033704140047,-0.000331341077873159,0.0193650452179202,EPCI
200071025,CC Haute-Provence-Pays de Banon,1990_1999,1994.5,9,7385,8060,895,742,675,-153,828,0.00976544496047693,-0.0022135008577081,0.011978945818185,EPCI
200071025,CC Haute-Provence-Pays de Banon,1999_2006,2002.5,7,8060,9146,652,499,1086,-153,1239,0.0182216051698685,-0.00256713222006434,0.0207887373899328,EPCI
200071033,CC Jabron-Lure-Vançon-Durance,2006_2011,2008.5,5,4570,5067,142,234,497,92,405,0.0208617712007844,0.00386173631885747,0.0170000348819269,EPCI
200071033,CC Jabron-Lure-Vançon-Durance,2011_2016,2013.5,5,5067,5266,234,255,199,21,178,0.00773418238030077,0.000816169999931237,0.00691801238036953,EPCI
200071033,CC Jabron-Lure-Vançon-Durance,1968_1975,1971.5,7,1929,2187,187,150,258,-37,295,0.0180944720016514,-0.00259494365915155,0.0206894156608029,EPCI
200071033,CC Jabron-Lure-Vançon-Durance,1975_1982,1978.5,7,2187,2616,224,164,429,-60,489,0.0259181379433107,-0.00362491439766583,0.0295430523409765,EPCI
200071033,CC Jabron-Lure-Vançon-Durance,1982_1990,1986,8,2616,3458,217,283,842,66,776,0.0354959536412667,0.00278234315952922,0.0327136104817375,EPCI
200071033,CC Jabron-Lure-Vançon-Durance,1990_1999,1994.5,9,3458,3903,259,344,445,85,360,0.0135414325858978,0.00258656577483441,0.0109548668110634,EPCI
200071033,CC Jabron-Lure-Vançon-Durance,1999_2006,2002.5,7,3903,4570,181,314,667,133,534,0.0227941504282272,0.00454516043021622,0.018248989998011,EPCI
200071041,CC du Chaourçois et du Val d'Armance,2006_2011,2008.5,5,10547,10678,730,552,131,-178,309,0.00247186819773138,-0.00335872167325332,0.00583058987098469,EPCI
200071041,CC du Chaourçois et du Val d'Armance,2011_2016,2013.5,5,10678,10599,739,523,-79,-216,137,-0.00148407627461611,-0.00405772753565923,0.00257365126104313,EPCI
200071041,CC du Chaourçois et du Val d'Armance,1968_1975,1971.5,7,10705,9985,1157,836,-720,-321,-399,-0.00989740299232678,-0.00441259216741235,-0.00548481082491442,EPCI
200071041,CC du Chaourçois et du Val d'Armance,1975_1982,1978.5,7,9985,10085,1178,693,100,-485,585,0.00142461444877062,-0.00690938007653752,0.00833399452530814,EPCI
200071041,CC du Chaourçois et du Val d'Armance,1982_1990,1986,8,10085,9950,1265,861,-135,-404,269,-0.00168315942514685,-0.00503701042784688,0.00335385100270002,EPCI
200071041,CC du Chaourçois et du Val d'Armance,1990_1999,1994.5,9,9950,10136,1263,835,186,-428,614,0.00205999575386429,-0.00474020528308556,0.00680020103694985,EPCI
200071041,CC du Chaourçois et du Val d'Armance,1999_2006,2002.5,7,10136,10547,1010,721,411,-289,700,0.00569444007440345,-0.00400411966302335,0.0096985597374268,EPCI
200071058,CC Les Avant-Monts,2006_2011,2008.5,5,21602,24723,1260,1160,3121,-100,3221,0.0273571349301798,-0.000876550302152508,0.0282336852323323,EPCI
200071058,CC Les Avant-Monts,2011_2016,2013.5,5,24723,26514,1329,1273,1791,-56,1847,0.0140860689472855,-0.000440435433304292,0.0145265043805898,EPCI
200071058,CC Les Avant-Monts,1968_1975,1971.5,7,17096,16556,1715,1098,-540,-617,77,-0.00457463919235346,-0.00522694885496682,0.000652309662613364,EPCI
200071058,CC Les Avant-Monts,1975_1982,1978.5,7,16556,16830,1721,857,274,-864,1138,0.00234767066127239,-0.00740287390999762,0.00975054457127002,EPCI
200071058,CC Les Avant-Monts,1982_1990,1986,8,16830,17349,2118,1182,519,-936,1455,0.00380369822332338,-0.00685984881894159,0.010663547042265,EPCI
200071058,CC Les Avant-Monts,1990_1999,1994.5,9,17349,18274,2168,1428,925,-740,1665,0.00578828964278144,-0.00463063171422515,0.0104189213570066,EPCI
200071058,CC Les Avant-Monts,1999_2006,2002.5,7,18274,21602,1572,1339,3328,-233,3561,0.0241888623384985,-0.00169351109521339,0.0258823734337119,EPCI
200071066,CA de Saint-Dié-des-Vosges,2006_2011,2008.5,5,78753,78868,3983,4455,115,472,-357,0.000291881926400173,0.00119798495009462,-0.000906103023694449,EPCI
200071066,CA de Saint-Dié-des-Vosges,2011_2016,2013.5,5,78868,75669,4231,3674,-3199,-557,-2642,-0.00824720437643856,-0.00143597775482222,-0.00681122662161634,EPCI
200071066,CA de Saint-Dié-des-Vosges,1968_1975,1971.5,7,80222,80851,6927,9145,629,2218,-1589,0.00111636024683781,0.00393654535371425,-0.00282018510687644,EPCI
200071066,CA de Saint-Dié-des-Vosges,1975_1982,1978.5,7,80851,78864,6770,7446,-1987,676,-2663,-0.0035484186536574,0.00120721238544157,-0.00475563103909898,EPCI
200071066,CA de Saint-Dié-des-Vosges,1982_1990,1986,8,78864,77499,7331,8136,-1365,805,-2170,-0.00218009724257329,0.00128569837382527,-0.00346579561639856,EPCI
200071066,CA de Saint-Dié-des-Vosges,1990_1999,1994.5,9,77499,77670,7668,8609,171,941,-770,0.000244924364776633,0.00134780015938486,-0.00110287579460823,EPCI
200071066,CA de Saint-Dié-des-Vosges,1999_2006,2002.5,7,77670,78753,5739,6453,1083,714,369,0.00198014215252762,0.00130546767950574,0.000674674473021876,EPCI
200071074,CC Les Portes de l'Ile de France,2006_2011,2008.5,5,20833,21799,692,1310,966,618,348,0.00910637890358967,0.00582582004391141,0.00328055885967827,EPCI
200071074,CC Les Portes de l'Ile de France,2011_2016,2013.5,5,21799,22554,718,1328,755,610,145,0.00683290582878326,0.00552062590140105,0.00131227992738222,EPCI
200071074,CC Les Portes de l'Ile de France,1968_1975,1971.5,7,10862,13539,854,1400,2677,546,2131,0.0319724725757429,0.00652109451862369,0.0254513780571192,EPCI
200071074,CC Les Portes de l'Ile de France,1975_1982,1978.5,7,13539,14767,884,1258,1228,374,854,0.0124801713925371,0.00380096425147303,0.00867920714106407,EPCI
200071074,CC Les Portes de l'Ile de France,1982_1990,1986,8,14767,17259,951,1614,2492,663,1829,0.0196835643469779,0.00523683915009886,0.0144467251968791,EPCI
200071074,CC Les Portes de l'Ile de France,1990_1999,1994.5,9,17259,19480,1150,2074,2221,924,1297,0.013541370729212,0.00563360042944255,0.00790777029976947,EPCI
200071074,CC Les Portes de l'Ile de France,1999_2006,2002.5,7,19480,20833,894,1737,1353,843,510,0.00963901171186121,0.00600568135484036,0.00363333035702086,EPCI
200071082,CA Montluçon Communauté,2006_2011,2008.5,5,65306,64244,3825,3020,-1062,-805,-257,-0.00327374586481066,-0.00248151169601938,-0.000792234168791281,EPCI
200071082,CA Montluçon Communauté,2011_2016,2013.5,5,64244,62414,3877,3099,-1830,-778,-1052,-0.00576307440969648,-0.00245009392936823,-0.00331298048032825,EPCI
200071082,CA Montluçon Communauté,1968_1975,1971.5,7,77305,77667,6269,7899,362,1630,-1268,0.000667625645618175,0.00300615967502106,-0.00233853402940289,EPCI
200071082,CA Montluçon Communauté,1975_1982,1978.5,7,77667,73821,6390,6055,-3846,-335,-3511,-0.00722905984011824,-0.000629676299126263,-0.00659938354099197,EPCI
200071082,CA Montluçon Communauté,1982_1990,1986,8,73821,69144,6770,5670,-4677,-1100,-3577,-0.00814811735036836,-0.00191638423891494,-0.00623173311145341,EPCI
200071082,CA Montluçon Communauté,1990_1999,1994.5,9,69144,66185,7250,6029,-2959,-1221,-1738,-0.0048479257218218,-0.00200044518632795,-0.00284748053549385,EPCI
200071082,CA Montluçon Communauté,1999_2006,2002.5,7,66185,65306,5472,4518,-879,-954,75,-0.00190816791267123,-0.00207098087450325,0.000162812961832016,EPCI
200071116,CA ECLA  (Espace Communautaire Lons Agglomération),2006_2011,2008.5,5,34625,34577,1759,1750,-48,-9,-39,-0.000277410187823124,-5.20144102168357e-05,-0.000225395777606288,EPCI
200071116,CA ECLA  (Espace Communautaire Lons Agglomération),2011_2016,2013.5,5,34577,34407,1808,1559,-170,-249,79,-0.000985252138328896,-0.00144310460261115,0.000457852464282252,EPCI
200071116,CA ECLA  (Espace Communautaire Lons Agglomération),1968_1975,1971.5,7,31928,34997,2530,4312,3069,1782,1287,0.0131976120012736,0.00766312954912658,0.00553448245214698,EPCI
200071116,CA ECLA  (Espace Communautaire Lons Agglomération),1975_1982,1978.5,7,34997,35112,2352,3391,115,1039,-924,0.000468768245497353,0.00423521919192826,-0.00376645094643091,EPCI
200071116,CA ECLA  (Espace Communautaire Lons Agglomération),1982_1990,1986,8,35112,34483,2609,3456,-629,847,-1476,-0.0022570120361971,0.00303925150184252,-0.00529626353803963,EPCI
200071116,CA ECLA  (Espace Communautaire Lons Agglomération),1990_1999,1994.5,9,34483,34474,3085,3588,-9,503,-512,-2.90031615072239e-05,0.00162095447090374,-0.00164995763241096,EPCI
200071116,CA ECLA  (Espace Communautaire Lons Agglomération),1999_2006,2002.5,7,34474,34625,2415,2631,151,216,-65,0.000624558923654872,0.000893408791453327,-0.000268849867798455,EPCI
200071140,CA Moulins Communauté,2006_2011,2008.5,5,65184,64755,3465,3394,-429,-71,-358,-0.00131975283301422,-0.000218420632037319,-0.0011013322009769,EPCI
200071140,CA Moulins Communauté,2011_2016,2013.5,5,64755,65451,3461,3107,696,-354,1050,0.00214045819749553,-0.00108868132458824,0.00322913952208378,EPCI
200071140,CA Moulins Communauté,1968_1975,1971.5,7,67114,68978,5857,7648,1864,1791,73,0.00392123186910021,0.00376766431199489,0.000153567557105319,EPCI
200071140,CA Moulins Communauté,1975_1982,1978.5,7,68978,69207,5424,6483,229,1059,-830,0.000473597883506427,0.00219013169708867,-0.00171653381358225,EPCI
200071140,CA Moulins Communauté,1982_1990,1986,8,69207,68205,6133,6498,-1002,365,-1367,-0.00182135651744042,0.000663468192480792,-0.00248482470992121,EPCI
200071140,CA Moulins Communauté,1990_1999,1994.5,9,68205,65665,6481,6386,-2540,-95,-2445,-0.00420799003937966,-0.000157385454228767,-0.00405060458515089,EPCI
200071140,CA Moulins Communauté,1999_2006,2002.5,7,65665,65184,5102,4894,-481,-208,-273,-0.00104973706768785,-0.000453940353594746,-0.000595796714093104,EPCI
200071157,CC des Hautes-Vosges,2006_2011,2008.5,5,38251,37700,1962,1898,-551,-64,-487,-0.0028977153482822,-0.000336576737368532,-0.00256113861091367,EPCI
200071157,CC des Hautes-Vosges,2011_2016,2013.5,5,37700,36328,2025,1613,-1372,-412,-960,-0.00738684230781816,-0.00221820629068592,-0.00516863601713224,EPCI
200071157,CC des Hautes-Vosges,1968_1975,1971.5,7,39583,40413,2752,4582,830,1830,-1000,0.00296893891317707,0.00654597374833016,-0.00357703483515309,EPCI
200071157,CC des Hautes-Vosges,1975_1982,1978.5,7,40413,40008,2960,4138,-405,1178,-1583,-0.00143783407723253,0.00418214455056769,-0.00561997862780022,EPCI
200071157,CC des Hautes-Vosges,1982_1990,1986,8,40008,39087,3244,4346,-921,1102,-2023,-0.00290695450502687,0.00347824523837091,-0.00638519974339778,EPCI
200071157,CC des Hautes-Vosges,1990_1999,1994.5,9,39087,38678,3553,4005,-409,452,-861,-0.00116809146596808,0.00129089814820922,-0.0024589896141773,EPCI
200071157,CC des Hautes-Vosges,1999_2006,2002.5,7,38678,38251,2758,2785,-427,27,-454,-0.00158463730840575,0.000100199548775071,-0.00168483685718082,EPCI
200071165,CA Les Sables d'Olonne Agglomération,2006_2011,2008.5,5,48102,49611,3107,1960,1509,-1147,2656,0.006196887158467,-0.00471029129937817,0.0109071784578452,EPCI
200071165,CA Les Sables d'Olonne Agglomération,2011_2016,2013.5,5,49611,51938,3499,1806,2327,-1693,4020,0.00920977460646411,-0.00670053648850182,0.0159103110949659,EPCI
200071165,CA Les Sables d'Olonne Agglomération,1968_1975,1971.5,7,31215,34025,2822,3572,2810,750,2060,0.0123899559140106,0.00330692773505621,0.00908302817895439,EPCI
200071165,CA Les Sables d'Olonne Agglomération,1975_1982,1978.5,7,34025,36225,3033,3185,2200,152,2048,0.00899073887386392,0.000621178322194235,0.00836956055166969,EPCI
200071165,CA Les Sables d'Olonne Agglomération,1982_1990,1986,8,36225,39711,3724,3417,3486,-307,3793,0.0115510464063682,-0.00101726082809955,0.0125683072344677,EPCI
200071165,CA Les Sables d'Olonne Agglomération,1990_1999,1994.5,9,39711,43935,4496,3720,4224,-776,5000,0.0112947585821155,-0.00207498405769925,0.0133697426398147,EPCI
200071165,CA Les Sables d'Olonne Agglomération,1999_2006,2002.5,7,43935,48102,3941,2917,4167,-1024,5191,0.013028785596326,-0.0032016982122961,0.0162304838086221,EPCI
200071173,CC du Pays Arnay Liernais,2006_2011,2008.5,5,7540,7575,525,325,35,-200,235,0.00092666296217736,-0.00529521692672777,0.00622187988890513,EPCI
200071173,CC du Pays Arnay Liernais,2011_2016,2013.5,5,7575,7256,499,291,-319,-208,-111,-0.00856801128963058,-0.00558666566847386,-0.00298134562115672,EPCI
200071173,CC du Pays Arnay Liernais,1968_1975,1971.5,7,10603,10014,1076,965,-589,-111,-478,-0.00813145455251896,-0.00153241333672259,-0.00659904121579637,EPCI
200071173,CC du Pays Arnay Liernais,1975_1982,1978.5,7,10014,9171,965,758,-843,-207,-636,-0.0124839610193043,-0.00306545662039856,-0.00941850439890571,EPCI
200071173,CC du Pays Arnay Liernais,1982_1990,1986,8,9171,8151,1011,725,-1020,-286,-734,-0.0146301381811808,-0.00410217599982127,-0.0105279621813595,EPCI
200071173,CC du Pays Arnay Liernais,1990_1999,1994.5,9,8151,7729,1020,663,-422,-357,-65,-0.00588938153165564,-0.00498224930521579,-0.000907132226439848,EPCI
200071173,CC du Pays Arnay Liernais,1999_2006,2002.5,7,7729,7540,743,500,-189,-243,54,-0.00353051105318714,-0.00453922849695489,0.00100871744376775,EPCI
200071181,CC Somme Sud-Ouest,2006_2011,2008.5,5,37369,38226,1906,2217,857,311,546,0.00454518388654934,0.00164941912335688,0.00289576476319246,EPCI
200071181,CC Somme Sud-Ouest,2011_2016,2013.5,5,38226,38755,1965,2170,529,205,324,0.00275255481591019,0.0010666800326306,0.00168587478327959,EPCI
200071181,CC Somme Sud-Ouest,1968_1975,1971.5,7,34348,34255,2920,4116,-93,1196,-1289,-0.000387246908463923,0.0049800785217511,-0.00536732543021502,EPCI
200071181,CC Somme Sud-Ouest,1975_1982,1978.5,7,34255,35023,2982,3114,768,132,636,0.00317251452983802,0.00054527593481591,0.00262723859502211,EPCI
200071181,CC Somme Sud-Ouest,1982_1990,1986,8,35023,35286,3337,3514,263,177,86,0.000935599423232958,0.000629661969248036,0.000305937453984922,EPCI
200071181,CC Somme Sud-Ouest,1990_1999,1994.5,9,35286,35902,3420,3692,616,272,344,0.00192481892838647,0.000849920046300521,0.00107489888208595,EPCI
200071181,CC Somme Sud-Ouest,1999_2006,2002.5,7,35902,37369,2597,3140,1467,543,924,0.00573760873682772,0.00212373656721026,0.00361387216961746,EPCI
200071199,CC Plaine Limagne,2006_2011,2008.5,5,18254,19802,1065,1177,1548,112,1436,0.0164129787559388,0.00118750233893098,0.0152254764170079,EPCI
200071199,CC Plaine Limagne,2011_2016,2013.5,5,19802,21019,1103,1192,1217,89,1128,0.0120002010947731,0.000877582495837965,0.0111226185989351,EPCI
200071199,CC Plaine Limagne,1968_1975,1971.5,7,15651,15825,1827,1494,174,-333,507,0.00158069874957922,-0.00302513036557403,0.00460582911515326,EPCI
200071199,CC Plaine Limagne,1975_1982,1978.5,7,15825,16357,1790,1250,532,-540,1072,0.0047347410947336,-0.00480594020894012,0.00954068130367371,EPCI
200071199,CC Plaine Limagne,1982_1990,1986,8,16357,16850,1922,1431,493,-491,984,0.0037187369731102,-0.00370365081906108,0.00742238779217128,EPCI
200071199,CC Plaine Limagne,1990_1999,1994.5,9,16850,17016,1931,1539,166,-392,558,0.00108986248001486,-0.00257365115762545,0.00366351363764031,EPCI
200071199,CC Plaine Limagne,1999_2006,2002.5,7,17016,18254,1463,1391,1238,-72,1310,0.0100833775308475,-0.000586432295816658,0.0106698098266642,EPCI
200071207,CC de Pouilly-en-Auxois/Bligny-sur-Ouche,2006_2011,2008.5,5,8065,8691,476,472,626,-4,630,0.015063182348533,-9.62503664443002e-05,0.0151594327149773,EPCI
200071207,CC de Pouilly-en-Auxois/Bligny-sur-Ouche,2011_2016,2013.5,5,8691,8564,478,468,-127,-10,-117,-0.00293979765276176,-0.000231480130138721,-0.00270831752262303,EPCI
200071207,CC de Pouilly-en-Auxois/Bligny-sur-Ouche,1968_1975,1971.5,7,8201,7535,844,798,-666,-46,-620,-0.0120267034916819,-0.000830673214140191,-0.0111960302775417,EPCI
200071207,CC de Pouilly-en-Auxois/Bligny-sur-Ouche,1975_1982,1978.5,7,7535,7533,859,589,-2,-270,268,-3.79226001916422e-05,-0.00511955102587169,0.00508162842568005,EPCI
200071207,CC de Pouilly-en-Auxois/Bligny-sur-Ouche,1982_1990,1986,8,7533,7360,895,668,-173,-227,54,-0.0028999664629964,-0.00380515830693747,0.000905191843941071,EPCI
200071207,CC de Pouilly-en-Auxois/Bligny-sur-Ouche,1990_1999,1994.5,9,7360,7567,954,692,207,-262,469,0.00308661548144951,-0.00390673070598923,0.00699334618743874,EPCI
200071207,CC de Pouilly-en-Auxois/Bligny-sur-Ouche,1999_2006,2002.5,7,7567,8065,795,615,498,-180,678,0.00914686836975909,-0.00330609700111774,0.0124529653708768,EPCI
200071215,CC Chavanon Combrailles et Volcans,2006_2011,2008.5,5,13227,13078,1052,543,-149,-509,360,-0.00226318829972161,-0.00773129425878053,0.00546810595905892,EPCI
200071215,CC Chavanon Combrailles et Volcans,2011_2016,2013.5,5,13078,12762,1013,537,-316,-476,160,-0.00487993895750427,-0.00735079412586086,0.00247085516835659,EPCI
200071215,CC Chavanon Combrailles et Volcans,1968_1975,1971.5,7,19672,17535,1906,1492,-2137,-414,-1723,-0.0162939960499218,-0.0031566281537986,-0.0131373678961232,EPCI
200071215,CC Chavanon Combrailles et Volcans,1975_1982,1978.5,7,17535,16180,1928,1180,-1355,-748,-607,-0.0114232495079815,-0.00630597094610342,-0.00511727856187804,EPCI
200071215,CC Chavanon Combrailles et Volcans,1982_1990,1986,8,16180,14715,2019,1166,-1465,-853,-612,-0.011793471605725,-0.00686677903050061,-0.00492669257522436,EPCI
200071215,CC Chavanon Combrailles et Volcans,1990_1999,1994.5,9,14715,13514,2038,970,-1201,-1068,-133,-0.00941552666417,-0.00837284136330855,-0.00104268530086146,EPCI
200071215,CC Chavanon Combrailles et Volcans,1999_2006,2002.5,7,13514,13227,1521,768,-287,-753,466,-0.00306187288905513,-0.0080334156287753,0.00497154273972017,EPCI
200071223,CC Nièvre et Somme,2006_2011,2008.5,5,27665,28447,1215,1781,782,566,216,0.00559049492025632,0.00404631729522388,0.00154417762503244,EPCI
200071223,CC Nièvre et Somme,2011_2016,2013.5,5,28447,28284,1251,1604,-163,353,-516,-0.00114862644619218,0.00248751616874748,-0.00363614261493966,EPCI
200071223,CC Nièvre et Somme,1968_1975,1971.5,7,25256,27598,2156,3396,2342,1240,1102,0.0127490933531897,0.00675016044319184,0.00599893290999791,EPCI
200071223,CC Nièvre et Somme,1975_1982,1978.5,7,27598,27932,2011,2659,334,648,-314,0.00172000303330488,0.0033370118729987,-0.00161700883969381,EPCI
200071223,CC Nièvre et Somme,1982_1990,1986,8,27932,27668,2285,2786,-264,501,-765,-0.00118635500451347,0.0022513782472017,-0.00343773325171518,EPCI
200071223,CC Nièvre et Somme,1990_1999,1994.5,9,27668,27587,2308,3017,-81,709,-790,-0.00032570955291833,0.00285096386443328,-0.00317667341735161,EPCI
200071223,CC Nièvre et Somme,1999_2006,2002.5,7,27587,27665,1811,2430,78,619,-541,0.000403428367042658,0.00320156614358212,-0.00279813777653946,EPCI
200071298,CC des Terres du Lauragais,2006_2011,2008.5,5,31878,36252,1569,2317,4374,748,3626,0.0260491879787066,0.00445468509558128,0.0215945028831253,EPCI
200071298,CC des Terres du Lauragais,2011_2016,2013.5,5,36252,39095,1553,2330,2843,777,2066,0.0152145869641165,0.00415818996521931,0.0110563969988972,EPCI
200071298,CC des Terres du Lauragais,1968_1975,1971.5,7,19327,19144,1816,1633,-183,-183,0,-0.00135818132109455,-0.00135818132109455,0,EPCI
200071298,CC des Terres du Lauragais,1975_1982,1978.5,7,19144,20509,1791,1423,1365,-368,1733,0.00988777324831602,-0.0026657146925863,0.0125534879409023,EPCI
200071298,CC des Terres du Lauragais,1982_1990,1986,8,20509,23164,2307,1797,2655,-510,3165,0.0153333090583718,-0.00294538140104318,0.018278690459415,EPCI
200071298,CC des Terres du Lauragais,1990_1999,1994.5,9,23164,26397,2660,2540,3233,-120,3353,0.0146226599477139,-0.000542752611730799,0.0151654125594447,EPCI
200071298,CC des Terres du Lauragais,1999_2006,2002.5,7,26397,31878,2173,2608,5481,435,5046,0.0273187470289757,0.00216815452610919,0.0251505925028666,EPCI
200071314,CC des Hauts Tolosans,2006_2011,2008.5,5,25185,30311,975,2114,5126,1139,3987,0.0377474189082032,0.00838749710035963,0.0293599218078436,EPCI
200071314,CC des Hauts Tolosans,2011_2016,2013.5,5,30311,33018,1012,2225,2707,1213,1494,0.0172556243643796,0.00773220256889265,0.0095234217954869,EPCI
200071314,CC des Hauts Tolosans,1968_1975,1971.5,7,12231,13393,1265,1125,1162,-140,1302,0.0130499121786409,-0.00157227857573987,0.0146221907543808,EPCI
200071314,CC des Hauts Tolosans,1975_1982,1978.5,7,13393,15692,1375,1067,2299,-308,2607,0.0228892935921097,-0.00306650823243575,0.0259558018245454,EPCI
200071314,CC des Hauts Tolosans,1982_1990,1986,8,15692,17829,1650,1470,2137,-180,2317,0.016087446241781,-0.0013550492856905,0.0174424955274715,EPCI
200071314,CC des Hauts Tolosans,1990_1999,1994.5,9,17829,20696,1821,2034,2867,213,2654,0.0167062476565441,0.00124116873067453,0.0154650789258695,EPCI
200071314,CC des Hauts Tolosans,1999_2006,2002.5,7,20696,25185,1366,2133,4489,767,3722,0.0284409545604554,0.00485948143191563,0.0235814731285397,EPCI
200071363,CA Vichy Communauté,2006_2011,2008.5,5,82541,83344,5261,4035,803,-1226,2029,0.00193817211492853,-0.00295915194632923,0.00489732406125776,EPCI
200071363,CA Vichy Communauté,2011_2016,2013.5,5,83344,82461,5419,3971,-883,-1448,565,-0.0021279660043656,-0.00348957505585661,0.00136160905149101,EPCI
200071363,CA Vichy Communauté,1968_1975,1971.5,7,83724,84140,8051,8033,416,-18,434,0.000708308363017718,-3.06479580151897e-05,0.000738956321032908,EPCI
200071363,CA Vichy Communauté,1975_1982,1978.5,7,84140,84652,8214,6730,512,-1484,1996,0.000867040925117024,-0.00251306393139387,0.0033801048565109,EPCI
200071363,CA Vichy Communauté,1982_1990,1986,8,84652,83512,9246,7007,-1140,-2239,1099,-0.00169336474881598,-0.00332582778298157,0.00163246303416558,EPCI
200071363,CA Vichy Communauté,1990_1999,1994.5,9,83512,81737,9837,7139,-1775,-2698,923,-0.00238421527527977,-0.00362400721842524,0.00123979194314548,EPCI
200071363,CA Vichy Communauté,1999_2006,2002.5,7,81737,82541,7587,5637,804,-1950,2754,0.00139931582483044,-0.00339386300798427,0.00479317883281471,EPCI
200071371,CC Bresse et Saône,2006_2011,2008.5,5,21797,24064,905,1468,2267,563,1704,0.0199860190864092,0.00496344452829659,0.0150225745581126,EPCI
200071371,CC Bresse et Saône,2011_2016,2013.5,5,24064,25162,1064,1383,1098,319,779,0.00896352839754999,0.00260415806814066,0.00635937032940933,EPCI
200071371,CC Bresse et Saône,1968_1975,1971.5,7,16082,16185,1406,1653,103,247,-144,0.000912452210357628,0.00218811355299354,-0.00127566134263591,EPCI
200071371,CC Bresse et Saône,1975_1982,1978.5,7,16185,17106,1344,1290,921,-54,975,0.00793767933660461,-0.000465401394328609,0.00840308073093322,EPCI
200071371,CC Bresse et Saône,1982_1990,1986,8,17106,17939,1487,1585,833,98,735,0.00596117683724495,0.000701314922028818,0.00525986191521614,EPCI
200071371,CC Bresse et Saône,1990_1999,1994.5,9,17939,19366,1719,1821,1427,102,1325,0.00854091587255557,0.00061049293552955,0.00793042293702602,EPCI
200071371,CC Bresse et Saône,1999_2006,2002.5,7,19366,21797,1304,1749,2431,445,1986,0.0170368414911362,0.00311863202943463,0.0139182094617015,EPCI
200071389,CC Saint-Pourçain Sioule Limagne,2006_2011,2008.5,5,33152,33546,2161,1647,394,-514,908,0.00236571081545334,-0.0030862318759975,0.00545194269145084,EPCI
200071389,CC Saint-Pourçain Sioule Limagne,2011_2016,2013.5,5,33546,33949,2246,1576,403,-670,1073,0.00239120783152846,-0.00397545718889348,0.00636666502042194,EPCI
200071389,CC Saint-Pourçain Sioule Limagne,1968_1975,1971.5,7,35993,34257,3860,2840,-1736,-1020,-716,-0.0070370590839417,-0.00413467757236206,-0.00290238151157964,EPCI
200071389,CC Saint-Pourçain Sioule Limagne,1975_1982,1978.5,7,34257,33168,3762,2212,-1089,-1550,461,-0.00460441953638557,-0.00655358152561767,0.00194916198923209,EPCI
200071389,CC Saint-Pourçain Sioule Limagne,1982_1990,1986,8,33168,32176,4026,2563,-992,-1463,471,-0.00378839618479454,-0.00558712058301856,0.00179872439822402,EPCI
200071389,CC Saint-Pourçain Sioule Limagne,1990_1999,1994.5,9,32176,32336,4080,2736,160,-1344,1504,0.000551299424250473,-0.00463091516370398,0.00518221458795445,EPCI
200071389,CC Saint-Pourçain Sioule Limagne,1999_2006,2002.5,7,32336,33152,3062,2234,816,-828,1644,0.00356661471237318,-0.00361906492873161,0.0071856796411048,EPCI
200071405,CC Ardèche Rhône Coiron,2006_2011,2008.5,5,20377,21457,821,1389,1080,568,512,0.0103823501582583,0.00546034712026917,0.00492200303798911,EPCI
200071405,CC Ardèche Rhône Coiron,2011_2016,2013.5,5,21457,22346,895,1330,889,435,454,0.00815233107786639,0.00398904839018209,0.0041632826876843,EPCI
200071405,CC Ardèche Rhône Coiron,1968_1975,1971.5,7,16000,14975,1290,1538,-1025,248,-1273,-0.00941349562202809,0.00227760674562241,-0.0116911023676505,EPCI
200071405,CC Ardèche Rhône Coiron,1975_1982,1978.5,7,14975,17260,1230,1232,2285,2,2283,0.0204942587967798,1.79380820978379e-05,0.020476320714682,EPCI
200071405,CC Ardèche Rhône Coiron,1982_1990,1986,8,17260,17539,1447,1815,279,368,-89,0.00200642106444549,0.00264646219253025,-0.00064004112808476,EPCI
200071405,CC Ardèche Rhône Coiron,1990_1999,1994.5,9,17539,18972,1486,2132,1433,646,787,0.00876454513898151,0.00395107896704958,0.00481346617193192,EPCI
200071405,CC Ardèche Rhône Coiron,1999_2006,2002.5,7,18972,20377,1196,1796,1405,600,805,0.0102583462824435,0.00438078844801857,0.00587755783442492,EPCI
200071413,CA Privas Centre Ardèche,2006_2011,2008.5,5,41457,42866,2113,2403,1409,290,1119,0.00670683585028842,0.00138039914590748,0.00532643670438094,EPCI
200071413,CA Privas Centre Ardèche,2011_2016,2013.5,5,42866,43606,2286,2274,740,-12,752,0.00342902262302003,-5.56057722651897e-05,0.00348462839528522,EPCI
200071413,CA Privas Centre Ardèche,1968_1975,1971.5,7,39555,39271,3288,3975,-284,687,-971,-0.00102886684979731,0.00248884340074207,-0.00351771025053938,EPCI
200071413,CA Privas Centre Ardèche,1975_1982,1978.5,7,39271,39594,3222,3315,323,93,230,0.00117086473213779,0.00033712204361862,0.000833742688519168,EPCI
200071413,CA Privas Centre Ardèche,1982_1990,1986,8,39594,40193,3494,3774,599,280,319,0.00187866992828201,0.000878176260298768,0.00100049366798324,EPCI
200071413,CA Privas Centre Ardèche,1990_1999,1994.5,9,40193,40149,3717,4007,-44,290,-334,-0.00012169455318578,0.00080207773690628,-0.000923772290092061,EPCI
200071413,CA Privas Centre Ardèche,1999_2006,2002.5,7,40149,41457,3018,3119,1308,101,1207,0.00459039114317439,0.000354456808456126,0.00423593433471826,EPCI
200071454,CA Evreux Portes de Normandie,2006_2011,2008.5,5,108212,109041,3935,7765,829,3830,-3001,0.00152750390737566,0.00705710490379829,-0.00552960099642263,EPCI
200071454,CA Evreux Portes de Normandie,2011_2016,2013.5,5,109041,111800,4338,7404,2759,3066,-307,0.00501002891953961,0.00556750585984358,-0.000557476940303972,EPCI
200071454,CA Evreux Portes de Normandie,1968_1975,1971.5,7,67147,79692,4100,10423,12545,6323,6222,0.0247711094317022,0.0124852710192629,0.0122858384124393,EPCI
200071454,CA Evreux Portes de Normandie,1975_1982,1978.5,7,79692,86436,4595,9878,6744,5283,1461,0.0116726066770163,0.00914388805970895,0.00252871861730736,EPCI
200071454,CA Evreux Portes de Normandie,1982_1990,1986,8,86436,99446,5630,12621,13010,6991,6019,0.0176808030328568,0.00950088347445825,0.00817991955839854,EPCI
200071454,CA Evreux Portes de Normandie,1990_1999,1994.5,9,99446,104325,6729,14013,4879,7284,-2405,0.00533599075732494,0.00796625469898644,-0.0026302639416615,EPCI
200071454,CA Evreux Portes de Normandie,1999_2006,2002.5,7,104325,108212,5379,10382,3887,5003,-1116,0.00523957014715215,0.0067439077556476,-0.00150433760849545,EPCI
200071470,CC Entr'Allier Besbre et Loire,2006_2011,2008.5,5,26168,25599,1633,1217,-569,-416,-153,-0.00438714862664025,-0.00320747597307969,-0.00117967265356056,EPCI
200071470,CC Entr'Allier Besbre et Loire,2011_2016,2013.5,5,25599,25151,1683,1054,-448,-629,181,-0.00352489911273546,-0.0049490212989076,0.00142412218617214,EPCI
200071470,CC Entr'Allier Besbre et Loire,1968_1975,1971.5,7,34363,32558,3306,3202,-1805,-104,-1701,-0.00767855241025972,-0.000442420748291973,-0.00723613166196775,EPCI
200071470,CC Entr'Allier Besbre et Loire,1975_1982,1978.5,7,32558,30883,3033,2464,-1675,-569,-1106,-0.00751692602779008,-0.00255351099093287,-0.00496341503685721,EPCI
200071470,CC Entr'Allier Besbre et Loire,1982_1990,1986,8,30883,28990,3351,2303,-1893,-1048,-845,-0.00787568893068102,-0.00436012783906694,-0.00351556109161409,EPCI
200071470,CC Entr'Allier Besbre et Loire,1990_1999,1994.5,9,28990,26908,3371,2296,-2082,-1075,-1007,-0.0082466199428467,-0.00425798099834784,-0.00398863894449886,EPCI
200071470,CC Entr'Allier Besbre et Loire,1999_2006,2002.5,7,26908,26168,2368,1857,-740,-511,-229,-0.00397583961324577,-0.00274547843563323,-0.00123036117761254,EPCI
200071496,CC du Bocage Bourbonnais,2006_2011,2008.5,5,13925,14077,984,647,152,-337,489,0.00217365377409351,-0.00481921922282574,0.00699287299691925,EPCI
200071496,CC du Bocage Bourbonnais,2011_2016,2013.5,5,14077,13797,965,589,-280,-376,96,-0.0040101542941795,-0.00538506433789819,0.00137491004371869,EPCI
200071496,CC du Bocage Bourbonnais,1968_1975,1971.5,7,18769,16251,2031,1418,-2518,-613,-1905,-0.0203685753275937,-0.00495867223026805,-0.0154099030973257,EPCI
200071496,CC du Bocage Bourbonnais,1975_1982,1978.5,7,16251,15575,1822,1091,-676,-731,55,-0.00605124284269587,-0.00654357768936491,0.000492334846669043,EPCI
200071496,CC du Bocage Bourbonnais,1982_1990,1986,8,15575,14787,1896,1166,-788,-730,-58,-0.00646881756437001,-0.00599268632232247,-0.000476131242047539,EPCI
200071496,CC du Bocage Bourbonnais,1990_1999,1994.5,9,14787,14156,1938,1173,-631,-765,134,-0.00483381863611831,-0.00586033479656182,0.00102651616044351,EPCI
200071496,CC du Bocage Bourbonnais,1999_2006,2002.5,7,14156,13925,1514,882,-231,-632,401,-0.00234763664768145,-0.00642297126118908,0.00407533461350763,EPCI
200071504,CC des Collines du Perche Normand,2006_2011,2008.5,5,13420,13236,760,703,-184,-57,-127,-0.00275733983292636,-0.000854175926504363,-0.001903163906422,EPCI
200071504,CC des Collines du Perche Normand,2011_2016,2013.5,5,13236,12690,869,590,-546,-279,-267,-0.00838982895344709,-0.0042871103992889,-0.00410271855415819,EPCI
200071504,CC des Collines du Perche Normand,1968_1975,1971.5,7,13006,12858,1177,1355,-148,178,-326,-0.00163360759777476,0.00196474427299937,-0.00359835187077412,EPCI
200071504,CC des Collines du Perche Normand,1975_1982,1978.5,7,12858,13047,1141,1051,189,-90,279,0.00208675089245336,-0.000993690901168267,0.00308044179362163,EPCI
200071504,CC des Collines du Perche Normand,1982_1990,1986,8,13047,13053,1221,1231,6,10,-4,5.74729168849597e-05,9.57881948082662e-05,-3.83152779233065e-05,EPCI
200071504,CC des Collines du Perche Normand,1990_1999,1994.5,9,13053,13265,1429,1332,212,-97,309,0.0017917137803265,-0.000819793569300332,0.00261150734962683,EPCI
200071504,CC des Collines du Perche Normand,1999_2006,2002.5,7,13265,13420,1086,1127,155,41,114,0.00166096987833386,0.000439353322656054,0.00122161655567781,EPCI
200071512,CC Commentry Montmarault Néris Communauté,2006_2011,2008.5,5,26848,26617,1657,1310,-231,-347,116,-0.00172675162374225,-0.00259386499324052,0.000867113369498273,EPCI
200071512,CC Commentry Montmarault Néris Communauté,2011_2016,2013.5,5,26617,26180,1640,1176,-437,-464,27,-0.00330539489737169,-0.00350961838073333,0.000204223483361638,EPCI
200071512,CC Commentry Montmarault Néris Communauté,1968_1975,1971.5,7,31729,30094,3391,2566,-1635,-825,-810,-0.00752940704168659,-0.0037992420852547,-0.00373016495643189,EPCI
200071512,CC Commentry Montmarault Néris Communauté,1975_1982,1978.5,7,30094,29200,3254,2152,-894,-1102,208,-0.00429889135083916,-0.00529908083738787,0.00100018948654871,EPCI
200071512,CC Commentry Montmarault Néris Communauté,1982_1990,1986,8,29200,28281,3492,2220,-919,-1272,353,-0.00398933490086928,-0.00552169096181254,0.00153235606094326,EPCI
200071512,CC Commentry Montmarault Néris Communauté,1990_1999,1994.5,9,28281,27188,3307,2238,-1093,-1069,-24,-0.00436981352555665,-0.00427386153597444,-9.59519895822143e-05,EPCI
200071512,CC Commentry Montmarault Néris Communauté,1999_2006,2002.5,7,27188,26848,2473,1869,-340,-604,264,-0.00179615201332128,-0.00319081122366487,0.00139465921034358,EPCI
200071520,CC Domfront Tinchebray Interco,2006_2011,2008.5,5,16791,16773,966,903,-18,-63,45,-0.000214492566122493,-0.000750723981428725,0.000536231415306232,EPCI
200071520,CC Domfront Tinchebray Interco,2011_2016,2013.5,5,16773,16155,1078,784,-618,-294,-324,-0.00748005438702726,-0.0035584724753819,-0.00392158191164536,EPCI
200071520,CC Domfront Tinchebray Interco,1968_1975,1971.5,7,17873,17374,1479,1777,-499,298,-797,-0.00403702327663902,0.0024108876481732,-0.00644791092481222,EPCI
200071520,CC Domfront Tinchebray Interco,1975_1982,1978.5,7,17374,17550,1424,1716,176,292,-116,0.00144091055463602,0.00239060160200976,-0.000949691047373741,EPCI
200071520,CC Domfront Tinchebray Interco,1982_1990,1986,8,17550,17009,1473,1719,-541,246,-787,-0.00390626738318423,0.00177623248847194,-0.00568249987165617,EPCI
200071520,CC Domfront Tinchebray Interco,1990_1999,1994.5,9,17009,16808,1821,1527,-201,-294,93,-0.00131997830451047,-0.00193071453495562,0.000610736230445144,EPCI
200071520,CC Domfront Tinchebray Interco,1999_2006,2002.5,7,16808,16791,1337,1309,-17,-28,11,-0.000144551689307271,-0.000238085135329622,9.35334460223516e-05,EPCI
200071538,CC Terres de Bresse,2006_2011,2008.5,5,20272,21731,1095,1118,1459,23,1436,0.0139968896842608,0.000220650077270733,0.0137762396069901,EPCI
200071538,CC Terres de Bresse,2011_2016,2013.5,5,21731,22184,1212,1143,453,-69,522,0.00413482404892207,-0.000629807636590779,0.00476463168551285,EPCI
200071538,CC Terres de Bresse,1968_1975,1971.5,7,17335,16929,1812,1421,-406,-391,-15,-0.00337991112319203,-0.0032550375595273,-0.00012487356366473,EPCI
200071538,CC Terres de Bresse,1975_1982,1978.5,7,16929,17846,1841,1110,917,-731,1648,0.0075643614366312,-0.00603004166867765,0.0135944031053088,EPCI
200071538,CC Terres de Bresse,1982_1990,1986,8,17846,18199,1953,1484,353,-469,822,0.00245140655059806,-0.00325696791000138,0.00570837446059944,EPCI
200071538,CC Terres de Bresse,1990_1999,1994.5,9,18199,18684,2055,1551,485,-504,989,0.00292659582463894,-0.00304124597034645,0.00596784179498539,EPCI
200071538,CC Terres de Bresse,1999_2006,2002.5,7,18684,20272,1575,1482,1588,-93,1681,0.0117214614675651,-0.000686458385694936,0.0124079198532601,EPCI
200071546,CC Sud Retz Atlantique,2006_2011,2008.5,5,25388,27780,1406,2146,2392,740,1652,0.0181710638700339,0.00562148296982653,0.0125495809002073,EPCI
200071546,CC Sud Retz Atlantique,2011_2016,2013.5,5,27780,29286,1429,1919,1506,490,1016,0.0106145890113933,0.00345361793863396,0.00716097107275938,EPCI
200071546,CC Sud Retz Atlantique,1968_1975,1971.5,7,19542,19244,2034,2333,-298,299,-597,-0.00219283103761603,0.00220018953103085,-0.00439302056864687,EPCI
200071546,CC Sud Retz Atlantique,1975_1982,1978.5,7,19244,20381,1887,2156,1137,269,868,0.00823425515664567,0.00194812193239902,0.00628613322424665,EPCI
200071546,CC Sud Retz Atlantique,1982_1990,1986,8,20381,20898,1981,2307,517,326,191,0.00313620341619147,0.00197756733786929,0.00115863607832219,EPCI
200071546,CC Sud Retz Atlantique,1990_1999,1994.5,9,20898,21618,2256,2066,720,-190,910,0.00377074035173064,-0.000995056481706697,0.00476579683343734,EPCI
200071546,CC Sud Retz Atlantique,1999_2006,2002.5,7,21618,25388,1892,2307,3770,415,3355,0.0232300418082874,0.00255715314335259,0.0206728886649348,EPCI
200071553,CC Loire Layon Aubance,2006_2011,2008.5,5,51193,54607,2078,3786,3414,1708,1706,0.0129955730740927,0.00650159309037796,0.00649397998371476,EPCI
200071553,CC Loire Layon Aubance,2011_2016,2013.5,5,54607,56223,2242,3547,1616,1305,311,0.00584981295696818,0.00472401355745265,0.00112579939951553,EPCI
200071553,CC Loire Layon Aubance,1968_1975,1971.5,7,33678,34896,2835,3887,1218,1052,166,0.00508824484002846,0.0043947730473809,0.000693471792647556,EPCI
200071553,CC Loire Layon Aubance,1975_1982,1978.5,7,34896,39527,3092,3745,4631,653,3978,0.0179610762552189,0.00253262422687496,0.015428452028344,EPCI
200071553,CC Loire Layon Aubance,1982_1990,1986,8,39527,43167,3184,4474,3640,1290,2350,0.0110723916376048,0.00392400692651378,0.00714838471109099,EPCI
200071553,CC Loire Layon Aubance,1990_1999,1994.5,9,43167,46365,3664,4888,3198,1224,1974,0.00797256294495874,0.00305141245923374,0.004921150485725,EPCI
200071553,CC Loire Layon Aubance,1999_2006,2002.5,7,46365,51193,2944,4758,4828,1814,3014,0.0142517355231253,0.0053547324438586,0.00889700307926671,EPCI
200071579,CC Bresse Louhannaise Intercom',2006_2011,2008.5,5,26963,28367,1620,1426,1404,-194,1598,0.0102038966816007,-0.00140994013976534,0.0116138368213661,EPCI
200071579,CC Bresse Louhannaise Intercom',2011_2016,2013.5,5,28367,28446,1854,1247,79,-607,686,0.000556365798977332,-0.00427486126556001,0.00483122706453734,EPCI
200071579,CC Bresse Louhannaise Intercom',1968_1975,1971.5,7,27012,26245,2444,2490,-767,46,-813,-0.00410664699805685,0.000246291736519707,-0.00435293873457656,EPCI
200071579,CC Bresse Louhannaise Intercom',1975_1982,1978.5,7,26245,25962,2464,1856,-283,-608,325,-0.00154759612664757,-0.00332487083039477,0.0017772747037472,EPCI
200071579,CC Bresse Louhannaise Intercom',1982_1990,1986,8,25962,25427,2757,1980,-535,-777,242,-0.00259940678812964,-0.00377521322313408,0.00117580643500444,EPCI
200071579,CC Bresse Louhannaise Intercom',1990_1999,1994.5,9,25427,25113,3076,2113,-314,-963,649,-0.00137970968292545,-0.00423140262629683,0.00285169294337138,EPCI
200071579,CC Bresse Louhannaise Intercom',1999_2006,2002.5,7,25113,26963,2382,1773,1850,-609,2459,0.0102060032192322,-0.00335970592460129,0.0135657091438334,EPCI
200071587,CC Loches Sud Touraine,2006_2011,2008.5,5,51287,52624,3000,2676,1337,-324,1661,0.00516026467724662,-0.00125050542664765,0.00641077010389426,EPCI
200071587,CC Loches Sud Touraine,2011_2016,2013.5,5,52624,52070,3211,2366,-554,-845,291,-0.00211442589987398,-0.00322507199529516,0.00111064609542117,EPCI
200071587,CC Loches Sud Touraine,1968_1975,1971.5,7,55336,51932,4644,5249,-3404,605,-4009,-0.00902878221932435,0.00160470424285876,-0.0106334864621831,EPCI
200071587,CC Loches Sud Touraine,1975_1982,1978.5,7,51932,50754,4689,3769,-1178,-920,-258,-0.00327245352058403,-0.00255573619604186,-0.000716717324542173,EPCI
200071587,CC Loches Sud Touraine,1982_1990,1986,8,50754,50319,5140,4374,-435,-766,331,-0.00107538300696841,-0.00189366295020185,0.000818279943233435,EPCI
200071587,CC Loches Sud Touraine,1990_1999,1994.5,9,50319,50315,5901,4662,-4,-1239,1235,-8.83284937136519e-06,-0.00273597509278037,0.002727142243409,EPCI
200071587,CC Loches Sud Touraine,1999_2006,2002.5,7,50315,51287,4431,3594,972,-837,1809,0.00273717715781641,-0.00235701366367524,0.00509419082149164,EPCI
200071595,"CC Arbois, Poligny, Salins, Coeur du Jura",2006_2011,2008.5,5,22430,22541,1311,1115,111,-196,307,0.000987792479496097,-0.00174421014397509,0.00273200262347119,EPCI
200071595,"CC Arbois, Poligny, Salins, Coeur du Jura",2011_2016,2013.5,5,22541,22036,1370,966,-505,-404,-101,-0.00452142615482365,-0.00361714092385892,-0.00090428523096473,EPCI
200071595,"CC Arbois, Poligny, Salins, Coeur du Jura",1968_1975,1971.5,7,23173,22652,2112,2418,-521,306,-827,-0.00324325205647613,0.00190486589113569,-0.00514811794761183,EPCI
200071595,"CC Arbois, Poligny, Salins, Coeur du Jura",1975_1982,1978.5,7,22652,23003,2203,2230,351,27,324,0.00219905637902174,0.000169158183001672,0.00202989819602006,EPCI
200071595,"CC Arbois, Poligny, Salins, Coeur du Jura",1982_1990,1986,8,23003,23063,2280,2323,60,43,17,0.000325672967011359,0.000233398959691474,9.2274007319885e-05,EPCI
200071595,"CC Arbois, Poligny, Salins, Coeur du Jura",1990_1999,1994.5,9,23063,22405,2393,2203,-658,-190,-468,-0.0032109951975674,-0.000927187063127365,-0.00228380813444004,EPCI
200071595,"CC Arbois, Poligny, Salins, Coeur du Jura",1999_2006,2002.5,7,22405,22430,1854,1622,25,-232,257,0.000159327018917299,-0.00147855473555254,0.00163788175446983,EPCI
200071629,CC Challans-Gois Communauté,2006_2011,2008.5,5,39112,43205,1969,2395,4093,426,3667,0.0201048139622773,0.00209251178791354,0.0180123021743637,EPCI
200071629,CC Challans-Gois Communauté,2011_2016,2013.5,5,43205,46206,2172,2347,3001,175,2826,0.0135212829009483,0.000788478676329877,0.0127328042246185,EPCI
200071629,CC Challans-Gois Communauté,1968_1975,1971.5,7,23872,27688,1939,3436,3816,1497,2319,0.0214106861895653,0.00839931793128388,0.0130113682582814,EPCI
200071629,CC Challans-Gois Communauté,1975_1982,1978.5,7,27688,29762,1933,3146,2074,1213,861,0.0103724686055635,0.00606644378907837,0.00430602481648514,EPCI
200071629,CC Challans-Gois Communauté,1982_1990,1986,8,29762,31603,2409,3084,1841,675,1166,0.00753066902848953,0.00276110895938644,0.00476956006910309,EPCI
200071629,CC Challans-Gois Communauté,1990_1999,1994.5,9,31603,34351,3029,3331,2748,302,2446,0.00930738879458537,0.00102286441628995,0.00828452437829542,EPCI
200071629,CC Challans-Gois Communauté,1999_2006,2002.5,7,34351,39112,2473,3043,4761,570,4191,0.0187155807941009,0.00224068075039645,0.0164749000437044,EPCI
200071645,CC Saint Cyr Mère Boitier entre Charolais et Mâconnais,2006_2011,2008.5,5,7650,7853,434,461,203,27,176,0.00525173759182107,0.000698506970340734,0.00455323062148034,EPCI
200071645,CC Saint Cyr Mère Boitier entre Charolais et Mâconnais,2011_2016,2013.5,5,7853,7932,419,403,79,-16,95,0.00200392242714731,-0.000405857706764012,0.00240978013391132,EPCI
200071645,CC Saint Cyr Mère Boitier entre Charolais et Mâconnais,1968_1975,1971.5,7,8064,7563,813,704,-501,-109,-392,-0.009121257271404,-0.00198446515485636,-0.00713679211654764,EPCI
200071645,CC Saint Cyr Mère Boitier entre Charolais et Mâconnais,1975_1982,1978.5,7,7563,7398,735,596,-165,-139,-26,-0.00314621788846081,-0.0026504502211882,-0.000495767667272613,EPCI
200071645,CC Saint Cyr Mère Boitier entre Charolais et Mâconnais,1982_1990,1986,8,7398,6952,783,616,-446,-167,-279,-0.00774241011372612,-0.00289906387666426,-0.00484334623706185,EPCI
200071645,CC Saint Cyr Mère Boitier entre Charolais et Mâconnais,1990_1999,1994.5,9,6952,7142,830,671,190,-159,349,0.0030004324481101,-0.00251088820657635,0.00551132065468645,EPCI
200071645,CC Saint Cyr Mère Boitier entre Charolais et Mâconnais,1999_2006,2002.5,7,7142,7650,610,589,508,-21,529,0.00986445017115445,-0.000407782388965046,0.0102722325601195,EPCI
200071652,CC du Pays Fertois et du Bocage Carrougien,2006_2011,2008.5,5,4980,5070,289,265,90,-24,114,0.00358860900711244,-0.000956962401896651,0.00454557140900909,EPCI
200071652,CC du Pays Fertois et du Bocage Carrougien,2011_2016,2013.5,5,5070,5001,248,243,-69,-5,-64,-0.00273683305842076,-0.000198321236117447,-0.00253851182230332,EPCI
200071652,CC du Pays Fertois et du Bocage Carrougien,1968_1975,1971.5,7,5275,4789,474,430,-486,-44,-442,-0.0137132559021678,-0.001241529340937,-0.0124717265612308,EPCI
200071652,CC du Pays Fertois et du Bocage Carrougien,1975_1982,1978.5,7,4789,4572,477,319,-217,-158,-59,-0.00660251773585885,-0.00480736314408156,-0.00179515459177729,EPCI
200071652,CC du Pays Fertois et du Bocage Carrougien,1982_1990,1986,8,4572,4527,525,431,-45,-94,49,-0.00123564564530954,-0.00258112645909103,0.00134548081378149,EPCI
200071652,CC du Pays Fertois et du Bocage Carrougien,1990_1999,1994.5,9,4527,4697,488,450,170,-38,208,0.00410446016205568,-0.000917467565635975,0.00502192772769165,EPCI
200071652,CC du Pays Fertois et du Bocage Carrougien,1999_2006,2002.5,7,4697,4980,421,353,283,-68,351,0.00839300888359729,-0.00201669471407991,0.0104097035976772,EPCI
200071678,CA du Choletais,2006_2011,2008.5,5,100535,102696,3696,6425,2161,2729,-568,0.00426250719191268,0.0053828700262516,-0.00112036283433892,EPCI
200071678,CA du Choletais,2011_2016,2013.5,5,102696,103493,4069,6075,797,2006,-1209,0.0015473578817542,0.00389460465595849,-0.0023472467742043,EPCI
200071678,CA du Choletais,1968_1975,1971.5,7,74842,87893,4303,12344,13051,8041,5010,0.0232286707385241,0.0143116804389297,0.00891699029959433,EPCI
200071678,CA du Choletais,1975_1982,1978.5,7,87893,96585,4625,12797,8692,8172,520,0.0135630526242514,0.0127516412845585,0.000811411339692904,EPCI
200071678,CA du Choletais,1982_1990,1986,8,96585,99243,5190,12271,2658,7081,-4423,0.0033992567204848,0.00905573244460228,-0.00565647572411748,EPCI
200071678,CA du Choletais,1990_1999,1994.5,9,99243,98688,6013,11386,-555,5373,-5928,-0.000622920305865971,0.00603054198814029,-0.00665346229400626,EPCI
200071678,CA du Choletais,1999_2006,2002.5,7,98688,100535,5024,9139,1847,4115,-2268,0.00265244969042988,0.0059094913243741,-0.00325704163394422,EPCI
200071751,CA du Bassin de Bourg-en-Bresse,2006_2011,2008.5,5,119633,126062,5149,7294,6429,2145,4284,0.0105240172273855,0.00351127966289343,0.00701273756449206,EPCI
200071751,CA du Bassin de Bourg-en-Bresse,2011_2016,2013.5,5,126062,131727,5539,7414,5665,1875,3790,0.00883030911769178,0.00292265306190152,0.00590765605579026,EPCI
200071751,CA du Bassin de Bourg-en-Bresse,1968_1975,1971.5,7,87147,93701,6626,10507,6554,3881,2673,0.0104127699779948,0.00616599943310921,0.00424677054488557,EPCI
200071751,CA du Bassin de Bourg-en-Bresse,1975_1982,1978.5,7,93701,100418,6434,9751,6717,3317,3400,0.00993944460169649,0.00490831289918524,0.00503113170251125,EPCI
200071751,CA du Bassin de Bourg-en-Bresse,1982_1990,1986,8,100418,105910,7362,10979,5492,3617,1875,0.00667822591507217,0.00439824164872834,0.00227998426634383,EPCI
200071751,CA du Bassin de Bourg-en-Bresse,1990_1999,1994.5,9,105910,111693,8414,11723,5783,3309,2474,0.00592463266591747,0.00339004141302454,0.00253459125289293,EPCI
200071751,CA du Bassin de Bourg-en-Bresse,1999_2006,2002.5,7,111693,119633,6868,9765,7940,2897,5043,0.00985895194635056,0.00359715161065209,0.00626180033569847,EPCI
200071769,CC Picardie des Châteaux,2006_2011,2008.5,5,17028,17336,801,1027,308,226,82,0.00359167792588133,0.00263545198457526,0.000956225941306069,EPCI
200071769,CC Picardie des Châteaux,2011_2016,2013.5,5,17336,17362,809,1040,26,231,-205,0.000299774070380732,0.00266337731761342,-0.00236360324723269,EPCI
200071769,CC Picardie des Châteaux,1968_1975,1971.5,7,17047,17220,1281,1818,173,537,-364,0.00144350711640606,0.00448071284109859,-0.00303720572469252,EPCI
200071769,CC Picardie des Châteaux,1975_1982,1978.5,7,17220,17117,1330,1514,-103,184,-287,-0.000856686732217282,0.00153039183231048,-0.00238707856452777,EPCI
200071769,CC Picardie des Châteaux,1982_1990,1986,8,17117,16926,1435,1742,-191,307,-498,-0.00140166930087859,0.00225294489722371,-0.0036546141981023,EPCI
200071769,CC Picardie des Châteaux,1990_1999,1994.5,9,16926,16533,1498,1859,-393,361,-754,-0.00260687592419562,0.00239461121789979,-0.00500148714209541,EPCI
200071769,CC Picardie des Châteaux,1999_2006,2002.5,7,16533,17028,1087,1468,495,381,114,0.00422327361856589,0.00325064090641132,0.000972632712154569,EPCI
200071777,"CC d'Arcis, Mailly, Ramerupt",2006_2011,2008.5,5,11181,11801,508,812,620,304,316,0.0108521347329511,0.00532104670776957,0.00553108802518153,EPCI
200071777,"CC d'Arcis, Mailly, Ramerupt",2011_2016,2013.5,5,11801,11490,585,651,-311,66,-377,-0.00532719625090139,0.00113053039408197,-0.00645772664498336,EPCI
200071777,"CC d'Arcis, Mailly, Ramerupt",1968_1975,1971.5,7,11070,11055,874,1401,-15,527,-542,-0.000193685870631732,0.00680483025486153,-0.00699851612549326,EPCI
200071777,"CC d'Arcis, Mailly, Ramerupt",1975_1982,1978.5,7,11055,10957,840,1039,-98,199,-297,-0.00127123313859401,0.00258138157734906,-0.00385261471594307,EPCI
200071777,"CC d'Arcis, Mailly, Ramerupt",1982_1990,1986,8,10957,10379,929,1094,-578,165,-743,-0.00675135493369772,0.00192728990321821,-0.00867864483691593,EPCI
200071777,"CC d'Arcis, Mailly, Ramerupt",1990_1999,1994.5,9,10379,10334,927,1111,-45,184,-229,-0.000482672822438524,0.00197359554063752,-0.00245626836307604,EPCI
200071777,"CC d'Arcis, Mailly, Ramerupt",1999_2006,2002.5,7,10334,11181,725,1049,847,324,523,0.01131734478432,0.00432918501785086,0.00698815976646914,EPCI
200071785,CA Chauny-Tergnier-La Fère,2006_2011,2008.5,5,56834,56463,3069,3524,-371,455,-826,-0.00130897890185089,0.00160535148340203,-0.00291433038525292,EPCI
200071785,CA Chauny-Tergnier-La Fère,2011_2016,2013.5,5,56463,55732,3217,3387,-731,170,-901,-0.00260282039877291,0.000605307069482072,-0.00320812746825498,EPCI
200071785,CA Chauny-Tergnier-La Fère,1968_1975,1971.5,7,60378,58652,4463,7040,-1726,2577,-4303,-0.00413473194073899,0.00617335122322386,-0.0103080831639628,EPCI
200071785,CA Chauny-Tergnier-La Fère,1975_1982,1978.5,7,58652,58220,4498,6299,-432,1801,-2233,-0.00105554777387917,0.00440055912212127,-0.00545610689600045,EPCI
200071785,CA Chauny-Tergnier-La Fère,1982_1990,1986,8,58220,57363,5005,6847,-857,1842,-2699,-0.00185196326314085,0.00398053247456879,-0.00583249573770965,EPCI
200071785,CA Chauny-Tergnier-La Fère,1990_1999,1994.5,9,57363,56702,5259,6489,-661,1230,-1891,-0.00128695035694837,0.00239477903032752,-0.00368172938727589,EPCI
200071785,CA Chauny-Tergnier-La Fère,1999_2006,2002.5,7,56702,56834,4387,5151,132,764,-632,0.000332234422166122,0.00192293256465846,-0.00159069814249234,EPCI
200071819,CC du Périgord Nontronnais,2006_2011,2008.5,5,16202,15993,1160,531,-209,-629,420,-0.0025933444371069,-0.00780485000449877,0.00521150556739186,EPCI
200071819,CC du Périgord Nontronnais,2011_2016,2013.5,5,15993,15319,1106,483,-674,-623,-51,-0.00857447538441847,-0.00792566493248176,-0.000648810451936708,EPCI
200071819,CC du Périgord Nontronnais,1968_1975,1971.5,7,19355,18458,1870,1437,-897,-433,-464,-0.00675606067583767,-0.0032612868145348,-0.00349477386130288,EPCI
200071819,CC du Périgord Nontronnais,1975_1982,1978.5,7,18458,17670,1969,1071,-788,-898,110,-0.00621341561520739,-0.00708077058687339,0.000867354971666005,EPCI
200071819,CC du Périgord Nontronnais,1982_1990,1986,8,17670,17092,2212,1161,-578,-1051,473,-0.0041485917873062,-0.00754354665823325,0.00339495487092705,EPCI
200071819,CC du Périgord Nontronnais,1990_1999,1994.5,9,17092,16327,2275,1081,-765,-1194,429,-0.00507489439392705,-0.00792081556385478,0.00284592116992772,EPCI
200071819,CC du Périgord Nontronnais,1999_2006,2002.5,7,16327,16202,1661,782,-125,-879,754,-0.00109732431826026,-0.00771638460600616,0.0066190602877459,EPCI
200071827,CA du Grand Angoulême,2006_2011,2008.5,5,137248,139950,6062,7735,2702,1673,1029,0.00390675306732713,0.00241894814272327,0.00148780492460385,EPCI
200071827,CA du Grand Angoulême,2011_2016,2013.5,5,139950,141498,6538,7595,1548,1057,491,0.00220249528645611,0.00150390020528689,0.000698595081169218,EPCI
200071827,CA du Grand Angoulême,1968_1975,1971.5,7,112529,122133,8184,13614,9604,5430,4174,0.0117686619370461,0.00665387695940859,0.00511478497763747,EPCI
200071827,CA du Grand Angoulême,1975_1982,1978.5,7,122133,128967,8014,12802,6834,4788,2046,0.0078083189858329,0.00547062208138249,0.00233769690445041,EPCI
200071827,CA du Grand Angoulême,1982_1990,1986,8,128967,131788,9505,13899,2821,4394,-1573,0.00270841279084921,0.00421863374795868,-0.00151022095710947,EPCI
200071827,CA du Grand Angoulême,1990_1999,1994.5,9,131788,133639,10493,13702,1851,3209,-1358,0.00155093076086943,0.00268878271833063,-0.0011378519574612,EPCI
200071827,CA du Grand Angoulême,1999_2006,2002.5,7,133639,137248,8421,10556,3609,2135,1474,0.00381402260928554,0.00225628658099879,0.00155773602828675,EPCI
200071843,CC du Vexin Normand,2006_2011,2008.5,5,30085,31484,1391,1930,1399,539,860,0.00913199890005134,0.00351833267128497,0.00561366622876637,EPCI
200071843,CC du Vexin Normand,2011_2016,2013.5,5,31484,32342,1404,1832,858,428,430,0.00539192737295413,0.00268967938883959,0.00270224798411454,EPCI
200071843,CC du Vexin Normand,1968_1975,1971.5,7,20484,21282,1731,2507,798,776,22,0.0054745812533199,0.00532365294809053,0.00015092830522937,EPCI
200071843,CC du Vexin Normand,1975_1982,1978.5,7,21282,22428,1674,2210,1146,536,610,0.00752078772749076,0.00351757610989097,0.0040032116175998,EPCI
200071843,CC du Vexin Normand,1982_1990,1986,8,22428,25408,2032,2746,2980,714,2266,0.0157164629921902,0.00376562234108181,0.0119508406511084,EPCI
200071843,CC du Vexin Normand,1990_1999,1994.5,9,25408,28326,2302,3246,2918,944,1974,0.0121528109354612,0.00393154678652342,0.00822126414893775,EPCI
200071843,CC du Vexin Normand,1999_2006,2002.5,7,28326,30085,1947,2611,1759,664,1095,0.00864380059571124,0.00326292415892681,0.00538087643678443,EPCI
200071850,CC du Pithiverais-Gâtinais,2006_2011,2008.5,5,24708,25621,1344,1540,913,196,717,0.00728344617728349,0.00156358756927444,0.00571985860800905,EPCI
200071850,CC du Pithiverais-Gâtinais,2011_2016,2013.5,5,25621,26089,1464,1428,468,-36,504,0.00362684952717296,-0.000278988425167151,0.00390583795234011,EPCI
200071850,CC du Pithiverais-Gâtinais,1968_1975,1971.5,7,16997,17706,1869,1485,709,-384,1093,0.00585517596604213,-0.00317120955001435,0.00902638551605648,EPCI
200071850,CC du Pithiverais-Gâtinais,1975_1982,1978.5,7,17706,19174,1860,1396,1468,-464,1932,0.0114437890514028,-0.00361711043586572,0.0150608994872685,EPCI
200071850,CC du Pithiverais-Gâtinais,1982_1990,1986,8,19174,21446,2092,2023,2272,-69,2341,0.0140962980418868,-0.000428100600743922,0.0145243986426308,EPCI
200071850,CC du Pithiverais-Gâtinais,1990_1999,1994.5,9,21446,23140,2379,2335,1694,-44,1738,0.00848295293725676,-0.000220336439928747,0.00870328937718551,EPCI
200071850,CC du Pithiverais-Gâtinais,1999_2006,2002.5,7,23140,24708,1943,1868,1568,-75,1643,0.00941033798165147,-0.000450111829479503,0.00986044981113097,EPCI
200071868,CC des Vallées du Haut-Anjou,2006_2011,2008.5,5,30678,33989,1265,2687,3311,1422,1889,0.0207097631228217,0.00889437727594456,0.0118153858468771,EPCI
200071868,CC des Vallées du Haut-Anjou,2011_2016,2013.5,5,33989,36126,1292,2739,2137,1447,690,0.012269841347647,0.00830812373890743,0.00396171760873954,EPCI
200071868,CC des Vallées du Haut-Anjou,1968_1975,1971.5,7,22020,21689,1785,2656,-331,871,-1202,-0.00216136255832511,0.00568745253263193,-0.00784881509095704,EPCI
200071868,CC des Vallées du Haut-Anjou,1975_1982,1978.5,7,21689,24279,1770,2509,2590,739,1851,0.0162457733440329,0.00463537702750591,0.011610396316527,EPCI
200071868,CC des Vallées du Haut-Anjou,1982_1990,1986,8,24279,25516,2013,3024,1237,1011,226,0.006231073771791,0.00509265608996014,0.00113841768183085,EPCI
200071868,CC des Vallées du Haut-Anjou,1990_1999,1994.5,9,25516,26830,2155,3034,1314,879,435,0.0055950338469104,0.00374279661448573,0.00185223723242468,EPCI
200071868,CC des Vallées du Haut-Anjou,1999_2006,2002.5,7,26830,30678,1850,3141,3848,1291,2557,0.0193309144606872,0.00648550170705489,0.0128454127536323,EPCI
200071876,CA Saumur Val de Loire,2006_2011,2008.5,5,98102,99850,4519,6221,1748,1702,46,0.00353850701413938,0.00344538840850413,9.31186056352469e-05,EPCI
200071876,CA Saumur Val de Loire,2011_2016,2013.5,5,99850,99961,4964,5613,111,649,-538,0.000222234701771074,0.00129937226531015,-0.00107713756353908,EPCI
200071876,CA Saumur Val de Loire,1968_1975,1971.5,7,90303,92204,6850,12408,1901,5558,-3657,0.00298055176757406,0.0087143117959898,-0.00573376002841575,EPCI
200071876,CA Saumur Val de Loire,1975_1982,1978.5,7,92204,95207,6733,10261,3003,3528,-525,0.00458906263488346,0.00539134631231063,-0.000802283677427177,EPCI
200071876,CA Saumur Val de Loire,1982_1990,1986,8,95207,95852,7554,11012,645,3458,-2813,0.000844339592203536,0.00452670745711601,-0.00368236786491247,EPCI
200071876,CA Saumur Val de Loire,1990_1999,1994.5,9,95852,96268,8396,11112,416,2716,-2300,0.00048129728192392,0.0031423159079456,-0.00266101862602168,EPCI
200071876,CA Saumur Val de Loire,1999_2006,2002.5,7,96268,98102,6957,8926,1834,1969,-135,0.00269960668655855,0.0028983236454928,-0.000198716958934245,EPCI
200071884,CC Le Grand Charolais,2006_2011,2008.5,5,40298,40464,2266,2034,166,-232,398,0.000822508074006301,-0.00114952935644254,0.00197203743044884,EPCI
200071884,CC Le Grand Charolais,2011_2016,2013.5,5,40464,40144,2427,1851,-320,-576,256,-0.0015866799509715,-0.00285602391174871,0.0012693439607772,EPCI
200071884,CC Le Grand Charolais,1968_1975,1971.5,7,45366,46375,3643,5465,1009,1822,-813,0.00314745646121217,0.00568351404591534,-0.00253605758470317,EPCI
200071884,CC Le Grand Charolais,1975_1982,1978.5,7,46375,44870,3687,4413,-1505,726,-2231,-0.00470192559493399,0.00226817141655952,-0.00697009701149351,EPCI
200071884,CC Le Grand Charolais,1982_1990,1986,8,44870,42869,3933,3985,-2001,52,-2053,-0.00568632952596604,0.00014777068233395,-0.00583410020829999,EPCI
200071884,CC Le Grand Charolais,1990_1999,1994.5,9,42869,40540,4203,3738,-2329,-465,-1864,-0.00618742444737219,-0.00123535953972867,-0.00495206490764352,EPCI
200071884,CC Le Grand Charolais,1999_2006,2002.5,7,40540,40298,3174,2781,-242,-393,151,-0.000854963038406931,-0.00138843171113192,0.000533468672724986,EPCI
200071892,CA du Saint-Quentinois,2006_2011,2008.5,5,83303,83358,4322,5704,55,1382,-1327,0.000132013205921044,0.0033171318287797,-0.00318511862285865,EPCI
200071892,CA du Saint-Quentinois,2011_2016,2013.5,5,83358,81489,4222,5295,-1869,1073,-2942,-0.0045250397340828,0.0025978425011615,-0.00712288223524431,EPCI
200071892,CA du Saint-Quentinois,1968_1975,1971.5,7,86480,91400,6362,11776,4920,5414,-494,0.00793593896793676,0.00873275885618082,-0.000796819888244057,EPCI
200071892,CA du Saint-Quentinois,1975_1982,1978.5,7,91400,89121,6163,10767,-2279,4604,-6883,-0.00360071347330948,0.0072741047964532,-0.0108748182697627,EPCI
200071892,CA du Saint-Quentinois,1982_1990,1986,8,89121,87569,6804,10929,-1552,4125,-5677,-0.00219358343529286,0.00583023947846845,-0.0080238229137613,EPCI
200071892,CA du Saint-Quentinois,1990_1999,1994.5,9,87569,85389,7584,11138,-2180,3554,-5734,-0.00279716586057632,0.00456015021490287,-0.00735731607547919,EPCI
200071892,CA du Saint-Quentinois,1999_2006,2002.5,7,85389,83303,5957,8307,-2086,2350,-4436,-0.00352701170853009,0.00397338327662786,-0.00750039498515795,EPCI
200071900,CC Vendée Grand Littoral,2006_2011,2008.5,5,27738,31266,1774,1611,3528,-163,3691,0.0242345838623002,-0.00111968173740219,0.0253542655997023,EPCI
200071900,CC Vendée Grand Littoral,2011_2016,2013.5,5,31266,33551,1951,1511,2285,-440,2725,0.0142070592995232,-0.00273571382572875,0.0169427731252519,EPCI
200071900,CC Vendée Grand Littoral,1968_1975,1971.5,7,17602,17519,1547,1641,-83,94,-177,-0.000674990048502022,0.000764446560954097,-0.00143943660945612,EPCI
200071900,CC Vendée Grand Littoral,1975_1982,1978.5,7,17519,19077,1709,1543,1558,-166,1724,0.0122454279935857,-0.00130471184013815,0.0135501398337239,EPCI
200071900,CC Vendée Grand Littoral,1982_1990,1986,8,19077,20717,2096,1691,1640,-405,2045,0.010362219561445,-0.00255896275755197,0.012921182318997,EPCI
200071900,CC Vendée Grand Littoral,1990_1999,1994.5,9,20717,23026,2512,1850,2309,-662,2971,0.0118102402667406,-0.00338604549873637,0.015196285765477,EPCI
200071900,CC Vendée Grand Littoral,1999_2006,2002.5,7,23026,27738,2169,1900,4712,-269,4981,0.0269539012578408,-0.00153875200304736,0.0284926532608882,EPCI
200071918,CC du Pays de Saint-Fulgent - Les Essarts,2006_2011,2008.5,5,23230,25807,945,2033,2577,1088,1489,0.0212631517859567,0.00897722512344622,0.0122859266625105,EPCI
200071918,CC du Pays de Saint-Fulgent - Les Essarts,2011_2016,2013.5,5,25807,27571,1084,1984,1764,900,864,0.0133115649338058,0.00679161476214582,0.00651995017165999,EPCI
200071918,CC du Pays de Saint-Fulgent - Les Essarts,1968_1975,1971.5,7,17290,17782,1309,2058,492,749,-257,0.00401638844253327,0.00611437996637687,-0.0020979915238436,EPCI
200071918,CC du Pays de Saint-Fulgent - Les Essarts,1975_1982,1978.5,7,17782,18799,1259,2115,1017,856,161,0.00797692853920196,0.00671411094351708,0.00126281759568487,EPCI
200071918,CC du Pays de Saint-Fulgent - Les Essarts,1982_1990,1986,8,18799,19740,1441,2304,941,863,78,0.00612409569769934,0.00561646608620035,0.000507629611498989,EPCI
200071918,CC du Pays de Saint-Fulgent - Les Essarts,1990_1999,1994.5,9,19740,20580,1577,2232,840,655,185,0.00464103600177923,0.00361890307281595,0.00102213292896328,EPCI
200071918,CC du Pays de Saint-Fulgent - Les Essarts,1999_2006,2002.5,7,20580,23230,1209,2159,2650,950,1700,0.0174541187665751,0.00625713691631937,0.0111969818502557,EPCI
200071926,CC du Limouxin,2006_2011,2008.5,5,26820,28237,1592,1198,1417,-394,1811,0.010350256517188,-0.0028779118332901,0.0132281683504781,EPCI
200071926,CC du Limouxin,2011_2016,2013.5,5,28237,28466,1752,1145,229,-607,836,0.00161674912412146,-0.00428544418489838,0.00590219330901984,EPCI
200071926,CC du Limouxin,1968_1975,1971.5,7,25780,25204,2173,2093,-576,-80,-496,-0.0032228362539074,-0.000447616146376028,-0.00277522010753137,EPCI
200071926,CC du Limouxin,1975_1982,1978.5,7,25204,24858,2286,1715,-346,-571,225,-0.00197277719153122,-0.00325565253284487,0.00128287534131365,EPCI
200071926,CC du Limouxin,1982_1990,1986,8,24858,25412,2599,1962,554,-637,1191,0.00275903303037839,-0.00317238996453255,0.00593142299491094,EPCI
200071926,CC du Limouxin,1990_1999,1994.5,9,25412,25316,2886,1894,-96,-992,896,-0.000420455638324713,-0.0043447082626887,0.00392425262436398,EPCI
200071926,CC du Limouxin,1999_2006,2002.5,7,25316,26820,2257,1501,1504,-756,2260,0.00827854648815296,-0.00416129065494923,0.0124398371431022,EPCI
200071934,CC Pays de Fontenay-Vendée,2006_2011,2008.5,5,35019,35720,1938,1855,701,-83,784,0.00397186396130134,-0.000470277758613425,0.00444214171991476,EPCI
200071934,CC Pays de Fontenay-Vendée,2011_2016,2013.5,5,35720,35161,1976,1734,-559,-242,-317,-0.00314967776191943,-0.00136354565006172,-0.00178613211185771,EPCI
200071934,CC Pays de Fontenay-Vendée,1968_1975,1971.5,7,30799,32560,2540,3885,1761,1345,416,0.00797481927502108,0.00609093238211434,0.00188388689290674,EPCI
200071934,CC Pays de Fontenay-Vendée,1975_1982,1978.5,7,32560,33958,2843,3526,1398,683,715,0.00602377407530597,0.00294294541733475,0.00308082865797122,EPCI
200071934,CC Pays de Fontenay-Vendée,1982_1990,1986,8,33958,33792,3111,3395,-166,284,-450,-0.000612359782424465,0.00104765167595511,-0.00166001145837957,EPCI
200071934,CC Pays de Fontenay-Vendée,1990_1999,1994.5,9,33792,33470,3291,3228,-322,-63,-259,-0.00106327575027354,-0.00020803221201004,-0.0008552435382635,EPCI
200071934,CC Pays de Fontenay-Vendée,1999_2006,2002.5,7,33470,35019,2552,2682,1549,130,1419,0.00648396707609034,0.000544167669394283,0.00593979940669605,EPCI
200071942,CC Haut Limousin en Marche,2006_2011,2008.5,5,25191,24426,1957,952,-765,-1005,240,-0.00614874842263735,-0.00807776753562162,0.00192901911298427,EPCI
200071942,CC Haut Limousin en Marche,2011_2016,2013.5,5,24426,23435,1956,823,-991,-1133,142,-0.00824928781132328,-0.00943132501536759,0.0011820372040443,EPCI
200071942,CC Haut Limousin en Marche,1968_1975,1971.5,7,34336,32129,3436,2684,-2207,-752,-1455,-0.00944586450636076,-0.00321852746206764,-0.00622733704429311,EPCI
200071942,CC Haut Limousin en Marche,1975_1982,1978.5,7,32129,29623,3410,1895,-2506,-1515,-991,-0.0115341037708965,-0.00697293184872632,-0.00456117192217015,EPCI
200071942,CC Haut Limousin en Marche,1982_1990,1986,8,29623,27615,3689,1999,-2008,-1690,-318,-0.0087356187180162,-0.00735218906048177,-0.00138342965753444,EPCI
200071942,CC Haut Limousin en Marche,1990_1999,1994.5,9,27615,25370,3827,1877,-2245,-1950,-295,-0.0093770618730108,-0.00814488670484234,-0.00123217516816846,EPCI
200071942,CC Haut Limousin en Marche,1999_2006,2002.5,7,25370,25191,2923,1406,-179,-1517,1338,-0.00101100084273875,-0.0085680909409759,0.00755709009823715,EPCI
200071967,CC Pays d'Évian Vallée d'Abondance,2006_2011,2008.5,5,34780,37045,1304,2055,2265,751,1514,0.0126981212735084,0.00421028215293812,0.00848783912057033,EPCI
200071967,CC Pays d'Évian Vallée d'Abondance,2011_2016,2013.5,5,37045,40181,1430,2269,3136,839,2297,0.0163849563531981,0.00438360279985116,0.012001353553347,EPCI
200071967,CC Pays d'Évian Vallée d'Abondance,1968_1975,1971.5,7,20834,21894,1732,2310,1060,578,482,0.00711466972921682,0.00387950858819558,0.00323516114102123,EPCI
200071967,CC Pays d'Évian Vallée d'Abondance,1975_1982,1978.5,7,21894,23913,1741,2022,2019,281,1738,0.0126811057894933,0.00176492854227223,0.0109161772472211,EPCI
200071967,CC Pays d'Évian Vallée d'Abondance,1982_1990,1986,8,23913,28686,1944,2819,4773,875,3898,0.0230090867102633,0.00421809152974656,0.0187909951805167,EPCI
200071967,CC Pays d'Évian Vallée d'Abondance,1990_1999,1994.5,9,28686,30883,2213,3833,2197,1620,577,0.00823333924138514,0.00607101027357484,0.0021623289678103,EPCI
200071967,CC Pays d'Évian Vallée d'Abondance,1999_2006,2002.5,7,30883,34780,1774,2836,3897,1062,2835,0.0171215850792332,0.004665928497343,0.0124556565818902,EPCI
200071983,CC Thiérache Sambre et Oise,2006_2011,2008.5,5,18007,17551,1068,1091,-456,23,-479,-0.0051167929559881,0.000258083855236242,-0.00537487681122435,EPCI
200071983,CC Thiérache Sambre et Oise,2011_2016,2013.5,5,17551,17060,1163,1081,-491,-82,-409,-0.00565880555647957,-0.000945055103118788,-0.00471375045336079,EPCI
200071983,CC Thiérache Sambre et Oise,1968_1975,1971.5,7,21641,20006,2052,2314,-1635,262,-1897,-0.0111597534837299,0.00178829077231635,-0.0129480442560462,EPCI
200071983,CC Thiérache Sambre et Oise,1975_1982,1978.5,7,20006,19095,2051,1924,-911,-127,-784,-0.00663584317288257,-0.000925084613563213,-0.00571075855931936,EPCI
200071983,CC Thiérache Sambre et Oise,1982_1990,1986,8,19095,18457,1986,2193,-638,207,-845,-0.00423884293081389,0.00137529856846156,-0.00561414149927545,EPCI
200071983,CC Thiérache Sambre et Oise,1990_1999,1994.5,9,18457,18242,1883,2157,-215,274,-489,-0.00130105007365844,0.00165808241945308,-0.00295913249311152,EPCI
200071983,CC Thiérache Sambre et Oise,1999_2006,2002.5,7,18242,18007,1523,1711,-235,188,-423,-0.00185057935835742,0.00148046348668593,-0.00333104284504335,EPCI
200071991,CC Retz-en-Valois,2006_2011,2008.5,5,29196,29763,1225,1840,567,615,-48,0.00385426821047408,0.00418055546638723,-0.00032628725591315,EPCI
200071991,CC Retz-en-Valois,2011_2016,2013.5,5,29763,29594,1277,1695,-169,418,-587,-0.00113822637949446,0.00281525814573185,-0.00395348452522631,EPCI
200071991,CC Retz-en-Valois,1968_1975,1971.5,7,23116,24144,2015,2773,1028,758,270,0.00623519893546098,0.00459754940961034,0.00163764952585065,EPCI
200071991,CC Retz-en-Valois,1975_1982,1978.5,7,24144,24357,2074,2368,213,294,-81,0.00125555619767392,0.00173302123059218,-0.000477465032918253,EPCI
200071991,CC Retz-en-Valois,1982_1990,1986,8,24357,26584,2036,3062,2227,1026,1201,0.0109963007826888,0.00506609995646101,0.00593020082622775,EPCI
200071991,CC Retz-en-Valois,1990_1999,1994.5,9,26584,28254,2189,3307,1670,1118,552,0.0067924659117744,0.00454729155051724,0.00224517436125717,EPCI
200071991,CC Retz-en-Valois,1999_2006,2002.5,7,28254,29196,1750,2619,942,869,73,0.00469623190799018,0.0043322988620419,0.000363933045948283,EPCI
200072007,CC de la Montagne d'Ardèche,2006_2011,2008.5,5,5319,5218,401,157,-101,-244,143,-0.00382688455102864,-0.0092451468361484,0.00541826228511976,EPCI
200072007,CC de la Montagne d'Ardèche,2011_2016,2013.5,5,5218,4957,363,135,-261,-228,-33,-0.0102102117840678,-0.00891926546654197,-0.00129094631752581,EPCI
200072007,CC de la Montagne d'Ardèche,1968_1975,1971.5,7,8895,7360,898,561,-1535,-337,-1198,-0.0266984637878391,-0.00586148683811191,-0.0208369769497272,EPCI
200072007,CC de la Montagne d'Ardèche,1975_1982,1978.5,7,7360,6362,825,341,-998,-484,-514,-0.0206015616403571,-0.00999113811015314,-0.010610423530204,EPCI
200072007,CC de la Montagne d'Ardèche,1982_1990,1986,8,6362,5753,832,358,-609,-474,-135,-0.012498898664202,-0.00972820684208822,-0.00277069182211373,EPCI
200072007,CC de la Montagne d'Ardèche,1990_1999,1994.5,9,5753,5286,770,305,-467,-465,-2,-0.00936252293908213,-0.00932242648109891,-4.00964579832224e-05,EPCI
200072007,CC de la Montagne d'Ardèche,1999_2006,2002.5,7,5286,5319,522,258,33,-264,297,0.000889466709399933,-0.00711573367519947,0.0080052003845994,EPCI
200072015,CA Annonay Rhône Agglo,2006_2011,2008.5,5,45287,46539,2001,2751,1252,750,502,0.00546903188357484,0.00327617724655042,0.00219285463702442,EPCI
200072015,CA Annonay Rhône Agglo,2011_2016,2013.5,5,46539,48528,2161,2654,1989,493,1496,0.00840518289441938,0.0020833359310954,0.00632184696332398,EPCI
200072015,CA Annonay Rhône Agglo,1968_1975,1971.5,7,36284,37718,2781,4912,1434,2131,-697,0.00555258180295137,0.00825143083827711,-0.00269884903532574,EPCI
200072015,CA Annonay Rhône Agglo,1975_1982,1978.5,7,37718,39735,2716,3929,2017,1213,804,0.00746990116129198,0.00449231041578938,0.0029775907455026,EPCI
200072015,CA Annonay Rhône Agglo,1982_1990,1986,8,39735,41516,2965,4312,1781,1347,434,0.00549585758310878,0.004156608739162,0.00133924884394678,EPCI
200072015,CA Annonay Rhône Agglo,1990_1999,1994.5,9,41516,42728,3352,4549,1212,1197,15,0.00320239986523974,0.00316276620354122,3.96336616985118e-05,EPCI
200072015,CA Annonay Rhône Agglo,1999_2006,2002.5,7,42728,45287,2671,3950,2559,1279,1280,0.00834398612096465,0.00417036273884869,0.00417362338211596,EPCI
200072023,CC Coeur de Charente,2006_2011,2008.5,5,21377,22042,1423,1135,665,-288,953,0.0061456367234749,-0.00266156898700868,0.00880720571048358,EPCI
200072023,CC Coeur de Charente,2011_2016,2013.5,5,22042,22139,1587,1077,97,-510,607,0.000878592711203163,-0.004619404976429,0.00549799768763217,EPCI
200072023,CC Coeur de Charente,1968_1975,1971.5,7,20632,20254,2148,1706,-378,-442,64,-0.00263808037238311,-0.00308473948305115,0.00044665911066804,EPCI
200072023,CC Coeur de Charente,1975_1982,1978.5,7,20254,20440,2117,1520,186,-597,783,0.00130677600656504,-0.00419432944042649,0.00550110544699152,EPCI
200072023,CC Coeur de Charente,1982_1990,1986,8,20440,20356,2322,1635,-84,-687,603,-0.000514624611421044,-0.00420889414340782,0.00369426953198678,EPCI
200072023,CC Coeur de Charente,1990_1999,1994.5,9,20356,20541,2660,1735,185,-925,1110,0.00100574765647687,-0.00502873828238437,0.00603448593886125,EPCI
200072023,CC Coeur de Charente,1999_2006,2002.5,7,20541,21377,2029,1447,836,-582,1418,0.0057152254954802,-0.00397878138560942,0.00969400688108963,EPCI
200072031,CA de la Région de Château-Thierry,2006_2011,2008.5,5,51844,53275,2421,3326,1431,905,526,0.00546044788106559,0.00345332308341325,0.00200712479765234,EPCI
200072031,CA de la Région de Château-Thierry,2011_2016,2013.5,5,53275,54092,2590,3284,817,694,123,0.00304846166284101,0.0025895133341636,0.00045894832867741,EPCI
200072031,CA de la Région de Château-Thierry,1968_1975,1971.5,7,40519,42601,3768,4756,2082,988,1094,0.00718378435975109,0.00340901966735546,0.00377476469239562,EPCI
200072031,CA de la Région de Château-Thierry,1975_1982,1978.5,7,42601,45895,3500,4573,3294,1073,2221,0.0106965825119318,0.00348434518375922,0.00721223732817262,EPCI
200072031,CA de la Région de Château-Thierry,1982_1990,1986,8,45895,49583,3934,5438,3688,1504,2184,0.00970830458313277,0.00395913505776347,0.0057491695253693,EPCI
200072031,CA de la Région de Château-Thierry,1990_1999,1994.5,9,49583,50674,4502,5819,1091,1317,-226,0.00242125156230433,0.00292281238089349,-0.000501560818589164,EPCI
200072031,CA de la Région de Château-Thierry,1999_2006,2002.5,7,50674,51844,3534,4483,1170,949,221,0.00326621549740747,0.0026492636812305,0.000616951816176966,EPCI
200072049,CC de Charente Limousine,2006_2011,2008.5,5,36322,36461,2482,1583,139,-899,1038,0.00076420743695893,-0.0049426078116984,0.00570681524865733,EPCI
200072049,CC de Charente Limousine,2011_2016,2013.5,5,36461,35630,2465,1494,-831,-971,140,-0.00460042877559319,-0.00537547092791936,0.00077504215232617,EPCI
200072049,CC de Charente Limousine,1968_1975,1971.5,7,44072,41021,4241,3835,-3051,-406,-2645,-0.0101963086359442,-0.00135683425309517,-0.00883947438284906,EPCI
200072049,CC de Charente Limousine,1975_1982,1978.5,7,41021,39489,3887,3077,-1532,-810,-722,-0.00542266947150294,-0.00286707720099046,-0.00255559227051248,EPCI
200072049,CC de Charente Limousine,1982_1990,1986,8,39489,38034,4370,3227,-1455,-1143,-312,-0.00468171340163304,-0.00367779960004575,-0.00100391380158729,EPCI
200072049,CC de Charente Limousine,1990_1999,1994.5,9,38034,36468,4639,3000,-1566,-1639,73,-0.0046608082111449,-0.00487807449429533,0.000217266283150433,EPCI
200072049,CC de Charente Limousine,1999_2006,2002.5,7,36468,36322,3589,2286,-146,-1303,1157,-0.000572913740263581,-0.00511305892851675,0.00454014518825317,EPCI
200072056,CC Porte du Jura,2006_2011,2008.5,5,9819,10409,615,534,590,-81,671,0.0117386701787561,-0.00161158014318516,0.0133502503219412,EPCI
200072056,CC Porte du Jura,2011_2016,2013.5,5,10409,10566,672,536,157,-136,293,0.00299858322534652,-0.00259749884488616,0.00559608207023267,EPCI
200072056,CC Porte du Jura,1968_1975,1971.5,7,9955,9770,1012,956,-185,-56,-129,-0.00267619422774756,-0.00081009122569656,-0.001866103002051,EPCI
200072056,CC Porte du Jura,1975_1982,1978.5,7,9770,9788,1003,769,18,-234,252,0.000262988793452879,-0.00341885431488742,0.0036818431083403,EPCI
200072056,CC Porte du Jura,1982_1990,1986,8,9788,9565,1090,816,-223,-274,51,-0.00287667226216048,-0.00353456591852903,0.000657893656368541,EPCI
200072056,CC Porte du Jura,1990_1999,1994.5,9,9565,9462,1108,824,-103,-284,181,-0.00120225734033763,-0.00331496198695036,0.00211270464661273,EPCI
200072056,CC Porte du Jura,1999_2006,2002.5,7,9462,9819,907,737,357,-170,527,0.00530480763952368,-0.00252609887596366,0.00783090651548734,EPCI
200072064,CC Val-de-Cher-Controis,2006_2011,2008.5,5,46366,47829,3049,2551,1463,-498,1961,0.0062324852295832,-0.0021215158197761,0.00835400104935929,EPCI
200072064,CC Val-de-Cher-Controis,2011_2016,2013.5,5,47829,47912,3133,2313,83,-820,903,0.000346829105075663,-0.00342650441159089,0.00377333351666655,EPCI
200072064,CC Val-de-Cher-Controis,1968_1975,1971.5,7,41032,42087,3910,4122,1055,212,843,0.00363324920898211,0.000730093679909202,0.00290315552907291,EPCI
200072064,CC Val-de-Cher-Controis,1975_1982,1978.5,7,42087,43443,4024,3364,1356,-660,2016,0.00454039501463255,-0.00220992677703354,0.00675032179166609,EPCI
200072064,CC Val-de-Cher-Controis,1982_1990,1986,8,43443,43408,4789,3556,-35,-1233,1198,-0.000100742187414959,-0.00354900334521843,0.00344826115780347,EPCI
200072064,CC Val-de-Cher-Controis,1990_1999,1994.5,9,43408,44454,5366,3771,1046,-1595,2641,0.00264919078132486,-0.0040396360384447,0.00668882681976956,EPCI
200072064,CC Val-de-Cher-Controis,1999_2006,2002.5,7,44454,46366,4439,3277,1912,-1162,3074,0.00603405850636696,-0.0036671422512544,0.00970120075762135,EPCI
200072072,CA Territoires Vendômois,2006_2011,2008.5,5,54490,55154,3299,2914,664,-385,1049,0.00242535120519016,-0.00140626538252743,0.00383161658771759,EPCI
200072072,CA Territoires Vendômois,2011_2016,2013.5,5,55154,54450,3259,2607,-704,-652,-52,-0.00256598684426501,-0.00237645372508635,-0.000189533119178666,EPCI
200072072,CA Territoires Vendômois,1968_1975,1971.5,7,48098,49152,4048,5184,1054,1136,-82,0.0031015056497059,0.00334279925812705,-0.000241293608421143,EPCI
200072072,CA Territoires Vendômois,1975_1982,1978.5,7,49152,50675,3992,4394,1523,402,1121,0.00436882343491352,0.00115316285018728,0.00321566058472623,EPCI
200072072,CA Territoires Vendômois,1982_1990,1986,8,50675,51677,4775,4716,1002,-59,1061,0.00245051209812019,-0.000144291630528035,0.00259480372864823,EPCI
200072072,CA Territoires Vendômois,1990_1999,1994.5,9,51677,53250,5431,5223,1573,-208,1781,0.00333722242827794,-0.000441285610350802,0.00377850803862874,EPCI
200072072,CA Territoires Vendômois,1999_2006,2002.5,7,53250,54490,4425,4170,1240,-255,1495,0.00329389785614964,-0.000677374155901741,0.00397127201205138,EPCI
200072080,CC du Pays de Saint-Éloy,2006_2011,2008.5,5,16524,16173,1324,651,-351,-673,322,-0.00428493025648657,-0.0082158349362264,0.00393090467973982,EPCI
200072080,CC du Pays de Saint-Éloy,2011_2016,2013.5,5,16173,16050,1325,611,-123,-714,591,-0.00152570204377767,-0.0088565143029045,0.00733081225912683,EPCI
200072080,CC du Pays de Saint-Éloy,1968_1975,1971.5,7,25493,22248,2833,1737,-3245,-1096,-2149,-0.0192623196132939,-0.00650585586938988,-0.0127564637439041,EPCI
200072080,CC du Pays de Saint-Éloy,1975_1982,1978.5,7,22248,20306,2476,1271,-1942,-1205,-737,-0.0129632027149781,-0.00804359385764603,-0.00491960885733205,EPCI
200072080,CC du Pays de Saint-Éloy,1982_1990,1986,8,20306,17976,2744,1254,-2330,-1490,-840,-0.0151193958810439,-0.00966862655053883,-0.00545076933050511,EPCI
200072080,CC du Pays de Saint-Éloy,1990_1999,1994.5,9,17976,16669,2736,1205,-1307,-1531,224,-0.00835234900805437,-0.00978381509665742,0.00143146608860304,EPCI
200072080,CC du Pays de Saint-Éloy,1999_2006,2002.5,7,16669,16524,2006,856,-145,-1150,1005,-0.00124734105499214,-0.00989270491890314,0.008645363863911,EPCI
200072098,CC Combrailles Sioule et Morge,2006_2011,2008.5,5,17109,18055,848,1005,946,157,789,0.0108217387466896,0.00179599681102565,0.00902574193566392,EPCI
200072098,CC Combrailles Sioule et Morge,2011_2016,2013.5,5,18055,18705,940,1003,650,63,587,0.00709871991847866,0.000688029776714085,0.00641069014176457,EPCI
200072098,CC Combrailles Sioule et Morge,1968_1975,1971.5,7,16016,15573,1580,1305,-443,-275,-168,-0.0039990647949586,-0.00248248943253637,-0.00151657536242222,EPCI
200072098,CC Combrailles Sioule et Morge,1975_1982,1978.5,7,15573,16178,1620,1246,605,-374,979,0.00545965691287398,-0.00337506063704937,0.00883471754992335,EPCI
200072098,CC Combrailles Sioule et Morge,1982_1990,1986,8,16178,16209,1549,1471,31,-78,109,0.000239322249786067,-0.000602165660752039,0.000841487910538107,EPCI
200072098,CC Combrailles Sioule et Morge,1990_1999,1994.5,9,16209,16006,1693,1344,-203,-349,146,-0.00139935239043987,-0.00240578317371189,0.00100643078327202,EPCI
200072098,CC Combrailles Sioule et Morge,1999_2006,2002.5,7,16006,17109,1211,1186,1103,-25,1128,0.00956560196555878,-0.000216808748086101,0.00978241071364488,EPCI
200072106,CC Adour Madiran,2006_2011,2008.5,5,23797,24539,1451,1044,742,-407,1149,0.00615972683970401,-0.00337871809132012,0.00953844493102413,EPCI
200072106,CC Adour Madiran,2011_2016,2013.5,5,24539,24463,1671,996,-76,-675,599,-0.000620190940999632,-0.00550827480493094,0.00488808386393131,EPCI
200072106,CC Adour Madiran,1968_1975,1971.5,7,21768,21728,2202,1737,-40,-465,425,-0.000262715499189214,-0.00305406767807462,0.0027913521788854,EPCI
200072106,CC Adour Madiran,1975_1982,1978.5,7,21728,22378,2273,1405,650,-868,1518,0.00421981875394217,-0.00563508104372586,0.00985489979766803,EPCI
200072106,CC Adour Madiran,1982_1990,1986,8,22378,22986,2541,1626,608,-915,1523,0.00335649565348106,-0.00505130513640653,0.0084078007898876,EPCI
200072106,CC Adour Madiran,1990_1999,1994.5,9,22986,22623,2738,1721,-363,-1017,654,-0.0017671308998628,-0.00495088739713628,0.00318375649727348,EPCI
200072106,CC Adour Madiran,1999_2006,2002.5,7,22623,23797,2239,1495,1174,-744,1918,0.00725367197950333,-0.00459687559859495,0.0118505475780983,EPCI
200072130,CA du Pays de Meaux,2006_2011,2008.5,5,86193,91086,2613,7413,4893,4800,93,0.0111042287782466,0.0108931735408918,0.000211055237354778,EPCI
200072130,CA du Pays de Meaux,2011_2016,2013.5,5,91086,96291,2745,7809,5205,5064,141,0.0111761398570065,0.0108733856360962,0.000302754220910263,EPCI
200072130,CA du Pays de Meaux,1968_1975,1971.5,7,44358,58868,3160,7808,14510,4648,9862,0.0412576118637804,0.0132160840760063,0.0280415277877741,EPCI
200072130,CA du Pays de Meaux,1975_1982,1978.5,7,58868,65405,3214,8055,6537,4841,1696,0.0151567239488573,0.011224369073951,0.00393235487490621,EPCI
200072130,CA du Pays de Meaux,1982_1990,1986,8,65405,75833,3758,10429,10428,6671,3757,0.0186638888784225,0.0119396627069387,0.00672422617148383,EPCI
200072130,CA du Pays de Meaux,1990_1999,1994.5,9,75833,82536,4535,12809,6703,8274,-1571,0.00945564789105946,0.0116717933239782,-0.00221614543291876,EPCI
200072130,CA du Pays de Meaux,1999_2006,2002.5,7,82536,86193,3685,9765,3657,6080,-2423,0.00621270587820466,0.0103290270001324,-0.00411632112192778,EPCI
200072304,CC Vallée de l'Ubaye - Serre-Ponçon,2006_2011,2008.5,5,7903,8056,425,355,153,-70,223,0.00384230704631849,-0.00175791825648559,0.00560022530280408,EPCI
200072304,CC Vallée de l'Ubaye - Serre-Ponçon,2011_2016,2013.5,5,8056,7790,520,334,-266,-186,-80,-0.00669276214010672,-0.00467990134608966,-0.00201286079401706,EPCI
200072304,CC Vallée de l'Ubaye - Serre-Ponçon,1968_1975,1971.5,7,5789,6273,570,574,484,4,480,0.0115367760107379,9.53452562870899e-05,0.0114414307544508,EPCI
200072304,CC Vallée de l'Ubaye - Serre-Ponçon,1975_1982,1978.5,7,6273,6629,557,617,356,60,296,0.00791678102586535,0.0013342889369436,0.00658249208892175,EPCI
200072304,CC Vallée de l'Ubaye - Serre-Ponçon,1982_1990,1986,8,6629,7204,587,862,575,275,300,0.0104520530593402,0.00499880798490182,0.00545324507443834,EPCI
200072304,CC Vallée de l'Ubaye - Serre-Ponçon,1990_1999,1994.5,9,7204,7524,638,818,320,180,140,0.00484073246334682,0.00272291201063259,0.00211782045271423,EPCI
200072304,CC Vallée de l'Ubaye - Serre-Ponçon,1999_2006,2002.5,7,7524,7903,588,561,379,-27,406,0.00704534862328199,-0.000501911379495023,0.00754726000277701,EPCI
200072312,CA Seine Normandie Agglomération,2006_2011,2008.5,5,81939,83446,3338,5267,1507,1929,-422,0.00365158044861325,0.00467411989739546,-0.00102253944878221,EPCI
200072312,CA Seine Normandie Agglomération,2011_2016,2013.5,5,83446,82771,3530,4988,-675,1458,-2133,-0.00162307290391173,0.00350583747244933,-0.00512891037636106,EPCI
200072312,CA Seine Normandie Agglomération,1968_1975,1971.5,7,53873,62006,4298,7715,8133,3417,4716,0.0202890417303878,0.00852424143523118,0.0117648002951566,EPCI
200072312,CA Seine Normandie Agglomération,1975_1982,1978.5,7,62006,66715,4333,7353,4709,3020,1689,0.0105118165106848,0.00674149200727714,0.00377032450340764,EPCI
200072312,CA Seine Normandie Agglomération,1982_1990,1986,8,66715,75420,4924,9148,8705,4224,4481,0.015448446954184,0.00749617919982462,0.0079522677543594,EPCI
200072312,CA Seine Normandie Agglomération,1990_1999,1994.5,9,75420,80048,5809,10222,4628,4413,215,0.00663904841263618,0.00633062243841043,0.000308425974225752,EPCI
200072312,CA Seine Normandie Agglomération,1999_2006,2002.5,7,80048,81939,4737,7496,1891,2759,-868,0.0033410852023168,0.00487469808206877,-0.00153361287975197,EPCI
200072320,CC Val de Gers,2006_2011,2008.5,5,9814,10126,494,358,312,-136,448,0.00627891744977815,-0.00273696401656997,0.00901588146634812,EPCI
200072320,CC Val de Gers,2011_2016,2013.5,5,10126,10136,541,353,10,-188,198,0.000197433381629253,-0.00371174757462995,0.00390918095625921,EPCI
200072320,CC Val de Gers,1968_1975,1971.5,7,9490,8674,885,715,-816,-170,-646,-0.0127619478388988,-0.00265873913310392,-0.0101032087057949,EPCI
200072320,CC Val de Gers,1975_1982,1978.5,7,8674,8897,790,537,223,-253,476,0.00363288238563841,-0.00412161095769739,0.00775449334333581,EPCI
200072320,CC Val de Gers,1982_1990,1986,8,8897,8851,910,607,-46,-303,257,-0.000647751902583482,-0.0042667136191912,0.00361896171660772,EPCI
200072320,CC Val de Gers,1990_1999,1994.5,9,8851,9079,973,698,228,-275,503,0.00282995315684387,-0.00341332069356168,0.00624327385040555,EPCI
200072320,CC Val de Gers,1999_2006,2002.5,7,9079,9814,628,629,735,1,734,0.0111829068781617,1.52148392900159e-05,0.0111676920388717,EPCI
200072346,CA du Pays de Fontainebleau,2006_2011,2008.5,5,69491,68631,3073,3777,-860,704,-1564,-0.00248748508502517,0.00203626686029967,-0.00452375194532484,EPCI
200072346,CA du Pays de Fontainebleau,2011_2016,2013.5,5,68631,68352,3102,3459,-279,357,-636,-0.000814368982257618,0.00104204203106082,-0.00185641101331844,EPCI
200072346,CA du Pays de Fontainebleau,1968_1975,1971.5,7,50824,54567,4165,6440,3743,2275,1468,0.0102032186609109,0.00620152884145666,0.00400168981945423,EPCI
200072346,CA du Pays de Fontainebleau,1975_1982,1978.5,7,54567,57729,4109,5105,3162,996,2166,0.00807965745816297,0.0025450154422297,0.00553464201593327,EPCI
200072346,CA du Pays de Fontainebleau,1982_1990,1986,8,57729,63228,4933,6284,5499,1351,4148,0.01143837283919,0.00281019125399995,0.00862818158519008,EPCI
200072346,CA du Pays de Fontainebleau,1990_1999,1994.5,9,63228,67884,5529,7581,4656,2052,2604,0.0079260377222572,0.00349317641882985,0.00443286130342735,EPCI
200072346,CA du Pays de Fontainebleau,1999_2006,2002.5,7,67884,69491,4383,5569,1607,1186,421,0.00334800374839861,0.00247089760149393,0.000877106146904676,EPCI
200072452,CA Fougères Agglomération,2006_2011,2008.5,5,53428,54274,2595,3491,846,896,-50,0.00314700902652576,0.00333300246780979,-0.000185993441284028,EPCI
200072452,CA Fougères Agglomération,2011_2016,2013.5,5,54274,55391,2775,3071,1117,296,821,0.00408267847263377,0.00108189152005335,0.00300078695258042,EPCI
200072452,CA Fougères Agglomération,1968_1975,1971.5,7,52699,52966,4337,6535,267,2198,-1931,0.000722220422484599,0.00594546999483576,-0.00522324957235116,EPCI
200072452,CA Fougères Agglomération,1975_1982,1978.5,7,52966,53418,3999,5894,452,1895,-1443,0.00121467562968691,0.00509250070410774,-0.00387782507442083,EPCI
200072452,CA Fougères Agglomération,1982_1990,1986,8,53418,52072,4342,5511,-1346,1169,-2515,-0.00318496614378627,0.0027661407296331,-0.00595110687341937,EPCI
200072452,CA Fougères Agglomération,1990_1999,1994.5,9,52072,51709,4678,5379,-363,701,-1064,-0.000776978958535013,0.00150044696951252,-0.00227742592804753,EPCI
200072452,CA Fougères Agglomération,1999_2006,2002.5,7,51709,53428,3625,4440,1719,815,904,0.00468280242602259,0.00222017683374544,0.00246262559227715,EPCI
200072460,"CA de Béthune-Bruay, Artois-Lys Romane",2006_2011,2008.5,5,275963,277224,14331,18413,1261,4082,-2821,0.000912224803166772,0.0029529751360244,-0.00204075033285762,EPCI
200072460,"CA de Béthune-Bruay, Artois-Lys Romane",2011_2016,2013.5,5,277224,277812,13992,17515,588,3523,-2935,0.000423846252867843,0.00253947338240376,-0.00211562712953592,EPCI
200072460,"CA de Béthune-Bruay, Artois-Lys Romane",1968_1975,1971.5,7,289809,279330,22972,34869,-10479,11897,-22376,-0.00524735666304954,0.00595741981298792,-0.0112047764760375,EPCI
200072460,"CA de Béthune-Bruay, Artois-Lys Romane",1975_1982,1978.5,7,279330,274466,22802,28965,-4864,6163,-11027,-0.00250635196431415,0.00317570870807321,-0.00568206067238736,EPCI
200072460,"CA de Béthune-Bruay, Artois-Lys Romane",1982_1990,1986,8,274466,277070,24582,31591,2604,7009,-4405,0.00118104565223764,0.00317893585888389,-0.00199789020664625,EPCI
200072460,"CA de Béthune-Bruay, Artois-Lys Romane",1990_1999,1994.5,9,277070,273369,26079,30438,-3701,4359,-8060,-0.00149306770382096,0.00175851989217929,-0.00325158759600025,EPCI
200072460,"CA de Béthune-Bruay, Artois-Lys Romane",1999_2006,2002.5,7,273369,275963,20264,25057,2594,4793,-2199,0.00135009167963629,0.00249459885138656,-0.00114450717175027,EPCI
200072478,CC Pays d'Opale,2006_2011,2008.5,5,25457,27239,1197,1834,1782,637,1145,0.013623772334965,0.004870001670804,0.00875377066416104,EPCI
200072478,CC Pays d'Opale,2011_2016,2013.5,5,27239,27827,1229,1693,588,464,124,0.00428053593317945,0.00337783787924365,0.000902698053935803,EPCI
200072478,CC Pays d'Opale,1968_1975,1971.5,7,19602,19523,1610,2625,-79,1015,-1094,-0.000576739928170755,0.00741001300118122,-0.00798675292935198,EPCI
200072478,CC Pays d'Opale,1975_1982,1978.5,7,19523,21050,1680,2268,1527,588,939,0.010816263426952,0.00416500517029977,0.00665125825665219,EPCI
200072478,CC Pays d'Opale,1982_1990,1986,8,21050,22856,1901,2842,1806,941,865,0.0103422532949848,0.00538873773564825,0.00495351555933659,EPCI
200072478,CC Pays d'Opale,1990_1999,1994.5,9,22856,24089,2052,2757,1233,705,528,0.005855034079981,0.00334776887784802,0.00250726520213298,EPCI
200072478,CC Pays d'Opale,1999_2006,2002.5,7,24089,25457,1719,2417,1368,698,670,0.00792199274432415,0.00404206939732329,0.00387992334700086,EPCI
200072544,CC des Deux Morin,2006_2011,2008.5,5,24461,26050,1105,1623,1589,518,1071,0.0126671078196594,0.00412936554473478,0.00853774227492462,EPCI
200072544,CC des Deux Morin,2011_2016,2013.5,5,26050,26463,1142,1603,413,461,-48,0.00315090625113501,0.00351711327305869,-0.000366207021923682,EPCI
200072544,CC des Deux Morin,1968_1975,1971.5,7,15842,16894,1653,1555,1052,-98,1150,0.00922715127216334,-0.000859563521551337,0.0100867147937147,EPCI
200072544,CC des Deux Morin,1975_1982,1978.5,7,16894,18344,1535,1493,1450,-42,1492,0.0118328921464304,-0.00034274584148281,0.0121756379879132,EPCI
200072544,CC des Deux Morin,1982_1990,1986,8,18344,21010,1890,2078,2666,188,2478,0.0171066676343812,0.00120632164863603,0.0159003459857451,EPCI
200072544,CC des Deux Morin,1990_1999,1994.5,9,21010,23045,2102,2638,2035,536,1499,0.0103251975612288,0.00271956063529173,0.00760563692593712,EPCI
200072544,CC des Deux Morin,1999_2006,2002.5,7,23045,24461,1656,2058,1416,402,1014,0.00855512862937879,0.00242878651766262,0.00612634211171617,EPCI
200072635,CC Pyrénées Haut Garonnaises,2006_2011,2008.5,5,16142,16230,1148,626,88,-522,610,0.00108795351739222,-0.00645354245544018,0.0075414959728324,EPCI
200072635,CC Pyrénées Haut Garonnaises,2011_2016,2013.5,5,16230,15516,1147,528,-714,-619,-95,-0.00895756619350385,-0.00776573315655306,-0.00119183303695079,EPCI
200072635,CC Pyrénées Haut Garonnaises,1968_1975,1971.5,7,18647,17164,2044,1252,-1483,-792,-691,-0.0117689276969103,-0.00628522638971878,-0.00548370130719151,EPCI
200072635,CC Pyrénées Haut Garonnaises,1975_1982,1978.5,7,17164,16439,1932,925,-725,-1007,282,-0.00614640546283041,-0.00853714524285548,0.00239073978002507,EPCI
200072635,CC Pyrénées Haut Garonnaises,1982_1990,1986,8,16439,16152,2112,1106,-287,-1006,719,-0.00219916322900804,-0.0077085651860003,0.00550940195699226,EPCI
200072635,CC Pyrénées Haut Garonnaises,1990_1999,1994.5,9,16152,15790,2200,1165,-362,-1035,673,-0.00251539250101163,-0.00719179900151114,0.00467640650049952,EPCI
200072635,CC Pyrénées Haut Garonnaises,1999_2006,2002.5,7,15790,16142,1640,942,352,-698,1050,0.00315464296528645,-0.00625551360730097,0.00941015657258741,EPCI
200072643,CC Coeur et Coteaux du Comminges,2006_2011,2008.5,5,42298,43845,2906,1950,1547,-956,2503,0.00721004483166832,-0.00445559331549768,0.011665638147166,EPCI
200072643,CC Coeur et Coteaux du Comminges,2011_2016,2013.5,5,43845,44182,2907,1927,337,-980,1317,0.00153252894180222,-0.00445661235301537,0.0059891412948176,EPCI
200072643,CC Coeur et Coteaux du Comminges,1968_1975,1971.5,7,43923,43008,4082,3399,-915,-683,-232,-0.00300290451836482,-0.00224151233447342,-0.000761392183891409,EPCI
200072643,CC Coeur et Coteaux du Comminges,1975_1982,1978.5,7,43008,42316,4113,2666,-692,-1447,755,-0.00231458574536048,-0.00483989244730724,0.00252530670194676,EPCI
200072643,CC Coeur et Coteaux du Comminges,1982_1990,1986,8,42316,41582,4648,2999,-734,-1649,915,-0.00218484521890616,-0.00490846017162978,0.00272361495272362,EPCI
200072643,CC Coeur et Coteaux du Comminges,1990_1999,1994.5,9,41582,40090,5067,3109,-1492,-1958,466,-0.0040518196564312,-0.00531733437486078,0.00126551471842958,EPCI
200072643,CC Coeur et Coteaux du Comminges,1999_2006,2002.5,7,40090,42298,3853,2434,2208,-1419,3627,0.00768838745110667,-0.00494104247876828,0.012629429929875,EPCI
200072650,CC Touraine Vallée de l'Indre,2006_2011,2008.5,5,45488,47961,1464,2713,2473,1249,1224,0.0106441755777427,0.00537588972769939,0.00526828585004328,EPCI
200072650,CC Touraine Vallée de l'Indre,2011_2016,2013.5,5,47961,51878,1658,2913,3917,1255,2662,0.0158252390079481,0.00507037910517611,0.010754859902772,EPCI
200072650,CC Touraine Vallée de l'Indre,1968_1975,1971.5,7,26758,30340,2057,3330,3582,1273,2309,0.0181096667529488,0.00643595917825344,0.0116737075746954,EPCI
200072650,CC Touraine Vallée de l'Indre,1975_1982,1978.5,7,30340,34745,2047,2641,4405,594,3811,0.0195557136463889,0.00263702472325879,0.0169186889231301,EPCI
200072650,CC Touraine Vallée de l'Indre,1982_1990,1986,8,34745,38716,2414,3526,3971,1112,2859,0.013619065275926,0.00381374983299667,0.00980531544292938,EPCI
200072650,CC Touraine Vallée de l'Indre,1990_1999,1994.5,9,38716,41344,2655,3978,2628,1323,1305,0.00732383984692597,0.00368700156677438,0.0036368382801516,EPCI
200072650,CC Touraine Vallée de l'Indre,1999_2006,2002.5,7,41344,45488,2175,3591,4144,1416,2728,0.0137394225320873,0.00469474476482519,0.00904467776726208,EPCI
200072668,CC Touraine Val de Vienne,2006_2011,2008.5,5,24847,25586,1672,1335,739,-337,1076,0.0058788743493261,-0.00268089398609323,0.00855976833541933,EPCI
200072668,CC Touraine Val de Vienne,2011_2016,2013.5,5,25586,25435,1565,1216,-151,-349,198,-0.00118312927404696,-0.00273451732875754,0.00155138805471058,EPCI
200072668,CC Touraine Val de Vienne,1968_1975,1971.5,7,25970,24740,2101,2686,-1230,585,-1815,-0.0069075550788994,0.00328530058630581,-0.0101928556652052,EPCI
200072668,CC Touraine Val de Vienne,1975_1982,1978.5,7,24740,24742,2107,1969,2,-138,140,1.1548277580653e-05,-0.000796831153065059,0.000808379430645712,EPCI
200072668,CC Touraine Val de Vienne,1982_1990,1986,8,24742,24484,2406,2265,-258,-141,-117,-0.00130943711955811,-0.000715622611851525,-0.000593814507706585,EPCI
200072668,CC Touraine Val de Vienne,1990_1999,1994.5,9,24484,24336,2727,2195,-148,-532,384,-0.000673451737502773,-0.0024207859753478,0.00174733423784503,EPCI
200072668,CC Touraine Val de Vienne,1999_2006,2002.5,7,24336,24847,2243,1823,511,-420,931,0.00297302289149526,-0.00244358045876323,0.00541660335025849,EPCI
200072676,CC Maine Saosnois,2006_2011,2008.5,5,28238,28460,1609,1646,222,37,185,0.00156742794793274,0.000261237991322124,0.00130618995661062,EPCI
200072676,CC Maine Saosnois,2011_2016,2013.5,5,28460,28298,1819,1492,-162,-327,165,-0.00114104089480116,-0.00230321217654308,0.00116217128174192,EPCI
200072676,CC Maine Saosnois,1968_1975,1971.5,7,29235,27938,2292,2978,-1297,686,-1983,-0.00646172586611193,0.00341769001091194,-0.00987941587702387,EPCI
200072676,CC Maine Saosnois,1975_1982,1978.5,7,27938,27039,2308,2461,-899,153,-1052,-0.00466160100504875,0.000793353674941557,-0.00545495467999031,EPCI
200072676,CC Maine Saosnois,1982_1990,1986,8,27039,26589,2556,2622,-450,66,-516,-0.00209563506147559,0.000307359809016419,-0.00240299487049201,EPCI
200072676,CC Maine Saosnois,1990_1999,1994.5,9,26589,27272,2845,2885,683,40,643,0.00282207885647168,0.000165275482077404,0.00265680337439427,EPCI
200072676,CC Maine Saosnois,1999_2006,2002.5,7,27272,28238,2228,2351,966,123,843,0.00498496289682882,0.000634731300527893,0.00435023159630092,EPCI
200072684,CC Le Gesnois Bilurien,2006_2011,2008.5,5,28682,30195,1156,2098,1513,942,571,0.0103343542585193,0.00643421130966632,0.00390014294885294,EPCI
200072684,CC Le Gesnois Bilurien,2011_2016,2013.5,5,30195,30806,1237,1990,611,753,-142,0.00401466294369013,0.00494769426611893,-0.000933031322428802,EPCI
200072684,CC Le Gesnois Bilurien,1968_1975,1971.5,7,21018,21115,1615,2261,97,646,-549,0.000657998520753766,0.00438213447842199,-0.00372413595766822,EPCI
200072684,CC Le Gesnois Bilurien,1975_1982,1978.5,7,21115,22960,1570,1812,1845,242,1603,0.0120390187025616,0.0015791016401192,0.0104599170624424,EPCI
200072684,CC Le Gesnois Bilurien,1982_1990,1986,8,22960,24675,1872,2362,1715,490,1225,0.00904529034673818,0.00258436867049662,0.00646092167624156,EPCI
200072684,CC Le Gesnois Bilurien,1990_1999,1994.5,9,24675,26069,2034,2637,1394,603,791,0.0061249349079755,0.00264945175718022,0.00347548315079528,EPCI
200072684,CC Le Gesnois Bilurien,1999_2006,2002.5,7,26069,28682,1640,2629,2613,989,1624,0.0137396589672854,0.00520035312615584,0.00853930584112951,EPCI
200072692,CC des Vallées de la Braye et de l'Anille,2006_2011,2008.5,5,16320,16051,1044,766,-269,-278,9,-0.00331852081853878,-0.00342954939611071,0.00011102857757193,EPCI
200072692,CC des Vallées de la Braye et de l'Anille,2011_2016,2013.5,5,16051,15605,1131,641,-446,-490,44,-0.00562010323954731,-0.00617455288649817,0.000554449646950856,EPCI
200072692,CC des Vallées de la Braye et de l'Anille,1968_1975,1971.5,7,17819,17363,1436,1824,-456,388,-844,-0.00369655064174246,0.00314531063376332,-0.00684186127550578,EPCI
200072692,CC des Vallées de la Braye et de l'Anille,1975_1982,1978.5,7,17363,17120,1519,1494,-243,-25,-218,-0.00201142218060502,-0.000206936438333849,-0.00180448574227117,EPCI
200072692,CC des Vallées de la Braye et de l'Anille,1982_1990,1986,8,17120,16713,1757,1539,-407,-218,-189,-0.00300304568633358,-0.00160851095729907,-0.00139453472903451,EPCI
200072692,CC des Vallées de la Braye et de l'Anille,1990_1999,1994.5,9,16713,16278,1874,1514,-435,-360,-75,-0.00292597283992457,-0.00242149476407551,-0.000504478075849065,EPCI
200072692,CC des Vallées de la Braye et de l'Anille,1999_2006,2002.5,7,16278,16320,1519,1185,42,-334,376,0.000368188712132511,-0.00292797690124426,0.00329616561337677,EPCI
200072700,CC Haute Sarthe Alpes Mancelles,2006_2011,2008.5,5,22564,23401,1160,1457,837,297,540,0.0073112054252793,0.00259429869929265,0.00471690672598665,EPCI
200072700,CC Haute Sarthe Alpes Mancelles,2011_2016,2013.5,5,23401,23156,1214,1336,-245,122,-367,-0.00210275216791467,0.00104708475300241,-0.00314983692091707,EPCI
200072700,CC Haute Sarthe Alpes Mancelles,1968_1975,1971.5,7,21987,21472,1765,2343,-515,578,-1093,-0.00338021827301016,0.00379372070252402,-0.00717393897553419,EPCI
200072700,CC Haute Sarthe Alpes Mancelles,1975_1982,1978.5,7,21472,21189,1696,1808,-283,112,-395,-0.00189357373630294,0.000749400206593392,-0.00264297394289634,EPCI
200072700,CC Haute Sarthe Alpes Mancelles,1982_1990,1986,8,21189,20318,2004,1779,-871,-225,-646,-0.00523313250604085,-0.00135184249581997,-0.00388129001022088,EPCI
200072700,CC Haute Sarthe Alpes Mancelles,1990_1999,1994.5,9,20318,20877,2083,2044,559,-39,598,0.00302020519755764,-0.000210711990527277,0.00323091718808491,EPCI
200072700,CC Haute Sarthe Alpes Mancelles,1999_2006,2002.5,7,20877,22564,1682,1878,1687,196,1491,0.0111629373785171,0.00129693878256631,0.00986599859595084,EPCI
200072718,CC de la Champagne Conlinoise et du Pays de Sillé,2006_2011,2008.5,5,17734,18491,830,1227,757,397,360,0.00839512835248968,0.00440272913598204,0.00399239921650764,EPCI
200072718,CC de la Champagne Conlinoise et du Pays de Sillé,2011_2016,2013.5,5,18491,18681,907,1142,190,235,-45,0.00204665901997569,0.00253139405102257,-0.000484735031046875,EPCI
200072718,CC de la Champagne Conlinoise et du Pays de Sillé,1968_1975,1971.5,7,16606,15694,1327,1769,-912,442,-1354,-0.0080369017495765,0.00389507738301843,-0.0119319791325949,EPCI
200072718,CC de la Champagne Conlinoise et du Pays de Sillé,1975_1982,1978.5,7,15694,15549,1252,1307,-145,55,-200,-0.00132514205564438,0.000502640090072006,-0.00182778214571639,EPCI
200072718,CC de la Champagne Conlinoise et du Pays de Sillé,1982_1990,1986,8,15549,15831,1411,1621,282,210,72,0.00224924015599237,0.00167496607361134,0.000574274082381031,EPCI
200072718,CC de la Champagne Conlinoise et du Pays de Sillé,1990_1999,1994.5,9,15831,16511,1519,1761,680,242,438,0.00468391119600864,0.00166692133740307,0.00301698985860556,EPCI
200072718,CC de la Champagne Conlinoise et du Pays de Sillé,1999_2006,2002.5,7,16511,17734,1259,1682,1223,423,800,0.0102604057257178,0.00354877483399726,0.00671163089172059,EPCI
200072726,CC Châteaubriant-Derval,2006_2011,2008.5,5,41843,43621,2090,2839,1778,749,1029,0.00835756443789304,0.00352070627895494,0.0048368581589381,EPCI
200072726,CC Châteaubriant-Derval,2011_2016,2013.5,5,43621,44200,2178,2704,579,526,53,0.00264070118723669,0.00239897897147928,0.000241722215757417,EPCI
200072726,CC Châteaubriant-Derval,1968_1975,1971.5,7,41455,41394,3396,5213,-61,1817,-1878,-0.000210343414172143,0.00626547514017678,-0.00647581855434892,EPCI
200072726,CC Châteaubriant-Derval,1975_1982,1978.5,7,41394,42338,3327,4647,944,1320,-376,0.00322649183322654,0.00451161993629135,-0.00128512810306481,EPCI
200072726,CC Châteaubriant-Derval,1982_1990,1986,8,42338,41162,3671,4634,-1176,963,-2139,-0.00351499878793959,0.00287835359930768,-0.00639335238724727,EPCI
200072726,CC Châteaubriant-Derval,1990_1999,1994.5,9,41162,39485,3841,4264,-1677,423,-2100,-0.00461096423539675,0.00116305180177271,-0.00577401603716946,EPCI
200072726,CC Châteaubriant-Derval,1999_2006,2002.5,7,39485,41843,3019,3580,2358,561,1797,0.0083206638853246,0.00197959815083422,0.00634106573449037,EPCI
200072734,CC Estuaire et Sillon,2006_2011,2008.5,5,32488,35385,1196,2576,2897,1380,1517,0.0172301987389878,0.0082076887331043,0.00902251000588349,EPCI
200072734,CC Estuaire et Sillon,2011_2016,2013.5,5,35385,38027,1231,2481,2642,1250,1392,0.0145058903646851,0.00686311996815153,0.00764277039653355,EPCI
200072734,CC Estuaire et Sillon,1968_1975,1971.5,7,17555,19548,1705,2137,1993,432,1561,0.0154806266962215,0.00335555982577406,0.0121250668704475,EPCI
200072734,CC Estuaire et Sillon,1975_1982,1978.5,7,19548,24309,1511,2405,4761,894,3867,0.0316289894819481,0.00593915492477665,0.0256898345571715,EPCI
200072734,CC Estuaire et Sillon,1982_1990,1986,8,24309,27183,1685,3062,2874,1377,1497,0.0140661510065672,0.00673941890606924,0.00732673210049793,EPCI
200072734,CC Estuaire et Sillon,1990_1999,1994.5,9,27183,28556,1983,2968,1373,985,388,0.00549004801882447,0.0039385996347721,0.00155144838405236,EPCI
200072734,CC Estuaire et Sillon,1999_2006,2002.5,7,28556,32488,1566,3116,3932,1550,2382,0.0185999665994099,0.00733213332377551,0.0112678332756344,EPCI
200072825,CC Mirebellois et Fontenois,2006_2011,2008.5,5,11198,12121,500,771,923,271,652,0.0159669904483883,0.00468803294855172,0.0112789574998366,EPCI
200072825,CC Mirebellois et Fontenois,2011_2016,2013.5,5,12121,12617,559,675,496,116,380,0.00805338049918869,0.00188345189093929,0.0061699286082494,EPCI
200072825,CC Mirebellois et Fontenois,1968_1975,1971.5,7,7629,8170,773,791,541,18,523,0.00983550139304246,0.000327244038955202,0.00950825735408726,EPCI
200072825,CC Mirebellois et Fontenois,1975_1982,1978.5,7,8170,9483,712,794,1313,82,1231,0.021518513556634,0.00134388279637775,0.0201746307602563,EPCI
200072825,CC Mirebellois et Fontenois,1982_1990,1986,8,9483,9644,914,910,161,-4,165,0.00210662061600297,-5.23384003975894e-05,0.00215895901640056,EPCI
200072825,CC Mirebellois et Fontenois,1990_1999,1994.5,9,9644,10175,916,990,531,74,457,0.00597307598999342,0.000832406070168574,0.00514066991982484,EPCI
200072825,CC Mirebellois et Fontenois,1999_2006,2002.5,7,10175,11198,732,926,1023,194,829,0.0137800037460765,0.00261321674168019,0.0111667870043963,EPCI
200072874,CC Val Briard,2006_2011,2008.5,5,25609,26729,818,1579,1120,761,359,0.00859780383603392,0.00584190064216234,0.00275590319387159,EPCI
200072874,CC Val Briard,2011_2016,2013.5,5,26729,27633,861,1494,904,633,271,0.00667449429114542,0.00467362266183081,0.00200087162931461,EPCI
200072874,CC Val Briard,1968_1975,1971.5,7,11367,14032,1127,1309,2665,182,2483,0.0305466923483577,0.0020861155750098,0.0284605767733479,EPCI
200072874,CC Val Briard,1975_1982,1978.5,7,14032,16684,1148,1286,2652,138,2514,0.025038284841626,0.00130289717501674,0.0237353876666092,EPCI
200072874,CC Val Briard,1982_1990,1986,8,16684,20600,1340,1917,3916,577,3339,0.0267054796252775,0.00393489830025156,0.0227705813250259,EPCI
200072874,CC Val Briard,1990_1999,1994.5,9,20600,23257,1478,2469,2657,991,1666,0.013570711434123,0.00506156380550091,0.00850914762862212,EPCI
200072874,CC Val Briard,1999_2006,2002.5,7,23257,25609,1230,2268,2352,1038,1314,0.0138576667029329,0.00611575596838619,0.00774191073454668,EPCI
200072882,CC de Vie et Boulogne,2006_2011,2008.5,5,35259,40138,1277,2991,4879,1714,3165,0.0262593988048903,0.0092249660896868,0.0170344327152035,EPCI
200072882,CC de Vie et Boulogne,2011_2016,2013.5,5,40138,43349,1412,2853,3211,1441,1770,0.0155110909863365,0.00696091003155121,0.00855018095478531,EPCI
200072882,CC de Vie et Boulogne,1968_1975,1971.5,7,21995,22610,1653,2440,615,787,-172,0.00394736059895928,0.00505133787216415,-0.00110397727320487,EPCI
200072882,CC de Vie et Boulogne,1975_1982,1978.5,7,22610,25490,1631,2814,2880,1183,1697,0.0172752247413606,0.00709603849619081,0.0101791862451697,EPCI
200072882,CC de Vie et Boulogne,1982_1990,1986,8,25490,27428,1895,3048,1938,1153,785,0.00920185046526201,0.00547457873397683,0.00372727173128518,EPCI
200072882,CC de Vie et Boulogne,1990_1999,1994.5,9,27428,29679,1866,3117,2251,1251,1000,0.00880244181119272,0.00489198343216441,0.00391045837902831,EPCI
200072882,CC de Vie et Boulogne,1999_2006,2002.5,7,29679,35259,1637,3292,5580,1655,3925,0.024916949471042,0.00739024218182337,0.0175267072892186,EPCI
200072981,CC Touraine Ouest Val de Loire,2006_2011,2008.5,5,30905,32830,1639,2005,1925,366,1559,0.0121582677354992,0.00231164986555466,0.00984661786994456,EPCI
200072981,CC Touraine Ouest Val de Loire,2011_2016,2013.5,5,32830,33454,1668,1883,624,215,409,0.00377282512943156,0.00129993173530094,0.00247289339413062,EPCI
200072981,CC Touraine Ouest Val de Loire,1968_1975,1971.5,7,28557,26936,2597,2873,-1621,276,-1897,-0.00831359335805793,0.00141551620408636,-0.00972910956214428,EPCI
200072981,CC Touraine Ouest Val de Loire,1975_1982,1978.5,7,26936,27968,2370,2028,1032,-342,1374,0.00538549529649468,-0.001784728092443,0.00717022338893768,EPCI
200072981,CC Touraine Ouest Val de Loire,1982_1990,1986,8,27968,28145,2762,2600,177,-162,339,0.000788900949147298,-0.000722044936507696,0.00151094588565499,EPCI
200072981,CC Touraine Ouest Val de Loire,1990_1999,1994.5,9,28145,29049,3012,3008,904,-4,908,0.00351888126352029,-1.55702710775234e-05,0.00353445153459781,EPCI
200072981,CC Touraine Ouest Val de Loire,1999_2006,2002.5,7,29049,30905,2369,2526,1856,157,1699,0.00888696002126754,0.000751752544902481,0.00813520747636506,EPCI
200072999,CC du Grand Langres,2006_2011,2008.5,5,22259,21813,1097,1220,-446,123,-569,-0.00403987742512313,0.00111413659930526,-0.00515401402442839,EPCI
200072999,CC du Grand Langres,2011_2016,2013.5,5,21813,21156,1133,1057,-657,-76,-581,-0.00609784603575647,-0.000705382494242758,-0.00539246354151371,EPCI
200072999,CC du Grand Langres,1968_1975,1971.5,7,24575,24278,1890,3240,-297,1350,-1647,-0.00173550306380388,0.00788865029001763,-0.00962415335382151,EPCI
200072999,CC du Grand Langres,1975_1982,1978.5,7,24278,23852,1759,2501,-426,742,-1168,-0.0025257362635156,0.00439928710687459,-0.00692502337039019,EPCI
200072999,CC du Grand Langres,1982_1990,1986,8,23852,23591,1923,2747,-261,824,-1085,-0.00137440312873882,0.00433911179341298,-0.00571351492215181,EPCI
200072999,CC du Grand Langres,1990_1999,1994.5,9,23591,23025,2042,2829,-566,787,-1353,-0.00269466299621346,0.00374681939579504,-0.0064414823920085,EPCI
200072999,CC du Grand Langres,1999_2006,2002.5,7,23025,22259,1499,1764,-766,265,-1031,-0.00482178923217658,0.00166811246282871,-0.00648990169500529,EPCI
200073013,CC Carnelle Pays-De-France,2006_2011,2008.5,5,29323,30762,1062,1621,1439,559,880,0.00962764463695431,0.00373999538016502,0.00588764925678929,EPCI
200073013,CC Carnelle Pays-De-France,2011_2016,2013.5,5,30762,31724,1100,1730,962,630,332,0.00617766961417221,0.00404566721094438,0.00213200240322783,EPCI
200073013,CC Carnelle Pays-De-France,1968_1975,1971.5,7,14082,18726,1180,1710,4644,530,4114,0.0415567892445732,0.00474269989225318,0.03681408935232,EPCI
200073013,CC Carnelle Pays-De-France,1975_1982,1978.5,7,18726,23140,1284,1755,4414,471,3943,0.0306974244053291,0.00327559739350023,0.0274218270118289,EPCI
200073013,CC Carnelle Pays-De-France,1982_1990,1986,8,23140,25937,1577,1992,2797,415,2382,0.0143656835964154,0.00213148326510991,0.0122342003313055,EPCI
200073013,CC Carnelle Pays-De-France,1990_1999,1994.5,9,25937,28253,1846,2559,2316,713,1603,0.00954853534811728,0.00293959659033144,0.00660893875778584,EPCI
200073013,CC Carnelle Pays-De-France,1999_2006,2002.5,7,28253,29323,1462,2286,1070,824,246,0.00532448845425049,0.00410035372551626,0.00122413472873422,EPCI
200073096,CA Arche Agglo,2006_2011,2008.5,5,52102,55056,2133,3219,2954,1086,1868,0.011090551868844,0.00407729835124055,0.00701325351760345,EPCI
200073096,CA Arche Agglo,2011_2016,2013.5,5,55056,57085,2302,3328,2029,1026,1003,0.00726436562816413,0.00367335590660246,0.00359100972156167,EPCI
200073096,CA Arche Agglo,1968_1975,1971.5,7,35615,36494,2894,3855,879,961,-82,0.00348906783080549,0.00381455538726289,-0.000325487556457395,EPCI
200073096,CA Arche Agglo,1975_1982,1978.5,7,36494,40571,2898,3487,4077,589,3488,0.0152444087530867,0.00220234406562867,0.0130420646874581,EPCI
200073096,CA Arche Agglo,1982_1990,1986,8,40571,44476,3178,4496,3905,1318,2587,0.0115532532310689,0.00389940787670905,0.00765384535435988,EPCI
200073096,CA Arche Agglo,1990_1999,1994.5,9,44476,47388,3546,5010,2912,1464,1448,0.00707147610965708,0.00355516518699793,0.00351631092265915,EPCI
200073096,CA Arche Agglo,1999_2006,2002.5,7,47388,52102,2862,4239,4714,1377,3337,0.0136399443698556,0.00398434522640882,0.00965559914344679,EPCI
200073104,CC de l'Île-Rousse - Balagne,2006_2011,2008.5,5,9218,10444,508,422,1226,-86,1312,0.0252883717426744,-0.00177389883349918,0.0270622705761736,EPCI
200073104,CC de l'Île-Rousse - Balagne,2011_2016,2013.5,5,10444,10457,565,444,13,-121,134,0.000248822907199298,-0.00231596705931654,0.00256478996651584,EPCI
200073104,CC de l'Île-Rousse - Balagne,1968_1975,1971.5,7,6361,6509,702,496,148,-206,354,0.00329115211512687,-0.00458092794402794,0.00787208005915482,EPCI
200073104,CC de l'Île-Rousse - Balagne,1975_1982,1978.5,7,6509,7132,712,435,623,-277,900,0.0131436085063938,-0.0058439479233886,0.0189875564297824,EPCI
200073104,CC de l'Île-Rousse - Balagne,1982_1990,1986,8,7132,7025,797,543,-107,-254,147,-0.00188777650190541,-0.00448126384564463,0.00259348734373921,EPCI
200073104,CC de l'Île-Rousse - Balagne,1990_1999,1994.5,9,7025,8136,899,726,1111,-173,1284,0.0164475111870515,-0.00256113360518443,0.0190086447922359,EPCI
200073104,CC de l'Île-Rousse - Balagne,1999_2006,2002.5,7,8136,9218,727,594,1082,-133,1215,0.0179970926912241,-0.00221221194818189,0.020209304639406,EPCI
200073112,CC Sud Sarthe,2006_2011,2008.5,5,23535,23843,1422,1395,308,-27,335,0.00260378364244707,-0.000228253760863866,0.00283203740331093,EPCI
200073112,CC Sud Sarthe,2011_2016,2013.5,5,23843,23320,1465,1205,-523,-260,-263,-0.00442603843862444,-0.00220032503640985,-0.00222571340221458,EPCI
200073112,CC Sud Sarthe,1968_1975,1971.5,7,21415,21361,1817,2292,-54,475,-529,-0.000360618046218231,0.00317210318432703,-0.00353272123054526,EPCI
200073112,CC Sud Sarthe,1975_1982,1978.5,7,21361,22252,1924,1876,891,-48,939,0.00585493965388428,-0.000315417624451679,0.00617035727833596,EPCI
200073112,CC Sud Sarthe,1982_1990,1986,8,22252,22036,2101,2083,-216,-18,-198,-0.00121855852918606,-0.000101546544098839,-0.00111701198508723,EPCI
200073112,CC Sud Sarthe,1990_1999,1994.5,9,22036,22334,2390,2225,298,-165,463,0.00149363674509928,-0.000827013634031481,0.00232065037913076,EPCI
200073112,CC Sud Sarthe,1999_2006,2002.5,7,22334,23535,1889,1891,1201,2,1199,0.00751070689736144,1.2507421977288e-05,0.00749819947538415,EPCI
200073120,CC Nebbiu - Conca d'Oro,2006_2011,2008.5,5,6252,6750,360,291,498,-69,567,0.0154462981513392,-0.00214014974386026,0.0175864478951995,EPCI
200073120,CC Nebbiu - Conca d'Oro,2011_2016,2013.5,5,6750,7192,351,288,442,-63,505,0.0127661589160166,-0.00181961088621956,0.0145857698022362,EPCI
200073120,CC Nebbiu - Conca d'Oro,1968_1975,1971.5,7,4240,4230,390,268,-10,-122,112,-0.000337268281644598,-0.0041146730360641,0.0037774047544195,EPCI
200073120,CC Nebbiu - Conca d'Oro,1975_1982,1978.5,7,4230,4585,482,252,355,-230,585,0.0115791124032478,-0.0075019601485831,0.0190810725518309,EPCI
200073120,CC Nebbiu - Conca d'Oro,1982_1990,1986,8,4585,4941,559,372,356,-187,543,0.00939102581311291,-0.00493292648048347,0.0143239522935964,EPCI
200073120,CC Nebbiu - Conca d'Oro,1990_1999,1994.5,9,4941,5386,557,411,445,-146,591,0.00962774635232955,-0.00315876621896655,0.0127865125712961,EPCI
200073120,CC Nebbiu - Conca d'Oro,1999_2006,2002.5,7,5386,6252,524,339,866,-185,1051,0.021528233371984,-0.00459898749863399,0.0261272208706179,EPCI
200073138,CC Pasquale Paoli,2006_2011,2008.5,5,6059,6285,457,194,226,-263,489,0.0073511020778585,-0.00855460109060524,0.0159057031684637,EPCI
200073138,CC Pasquale Paoli,2011_2016,2013.5,5,6285,6231,366,186,-54,-180,126,-0.00172431335659418,-0.00574771118864725,0.00402339783205308,EPCI
200073138,CC Pasquale Paoli,1968_1975,1971.5,7,7443,6477,814,380,-966,-434,-532,-0.0196636065518432,-0.00883437395807447,-0.0108292325937687,EPCI
200073138,CC Pasquale Paoli,1975_1982,1978.5,7,6477,5976,755,252,-501,-503,2,-0.0114349740164015,-0.0114806226152694,4.56485988678708e-05,EPCI
200073138,CC Pasquale Paoli,1982_1990,1986,8,5976,4889,779,336,-1087,-443,-644,-0.0247831846902932,-0.0101002307431462,-0.014682953947147,EPCI
200073138,CC Pasquale Paoli,1990_1999,1994.5,9,4889,5520,811,352,631,-459,1090,0.0135791568220129,-0.00987770678495077,0.0234568636069637,EPCI
200073138,CC Pasquale Paoli,1999_2006,2002.5,7,5520,6059,611,278,539,-333,872,0.0133985249620698,-0.00827775289864426,0.0216762778607141,EPCI
200073146,CC Cagire Garonne Salat,2006_2011,2008.5,5,16769,17394,1079,789,625,-290,915,0.0073455220377423,-0.00340832222551243,0.0107538442632547,EPCI
200073146,CC Cagire Garonne Salat,2011_2016,2013.5,5,17394,17746,1050,672,352,-378,730,0.00401500246198294,-0.00431156514383395,0.0083265676058169,EPCI
200073146,CC Cagire Garonne Salat,1968_1975,1971.5,7,17736,17147,1882,1234,-589,-648,59,-0.00481312832690506,-0.00529525832909079,0.000482130002185736,EPCI
200073146,CC Cagire Garonne Salat,1975_1982,1978.5,7,17147,16789,1847,911,-358,-936,578,-0.00300965062848668,-0.00786880722978641,0.00485915660129973,EPCI
200073146,CC Cagire Garonne Salat,1982_1990,1986,8,16789,16428,1971,1046,-361,-925,564,-0.00271340129892672,-0.00695262105680669,0.00423921975787997,EPCI
200073146,CC Cagire Garonne Salat,1990_1999,1994.5,9,16428,16079,2043,1196,-349,-847,498,-0.00238305858914623,-0.00578352614615144,0.00340046755700522,EPCI
200073146,CC Cagire Garonne Salat,1999_2006,2002.5,7,16079,16769,1553,993,690,-560,1250,0.00602060442177721,-0.00488628764665976,0.010906892068437,EPCI
200073161,CC Touraine-Est Vallées,2006_2011,2008.5,5,35877,37625,1349,2240,1748,891,857,0.00955986665153574,0.00487290685727594,0.0046869597942598,EPCI
200073161,CC Touraine-Est Vallées,2011_2016,2013.5,5,37625,39116,1384,2195,1491,811,680,0.00780285833834293,0.00424421067229787,0.00355864766604507,EPCI
200073161,CC Touraine-Est Vallées,1968_1975,1971.5,7,17105,19770,1336,1882,2665,546,2119,0.0209003909177254,0.00428203130997302,0.0166183596077524,EPCI
200073161,CC Touraine-Est Vallées,1975_1982,1978.5,7,19770,24732,1479,1900,4962,421,4541,0.0325075215749067,0.00275809483737116,0.0297494267375355,EPCI
200073161,CC Touraine-Est Vallées,1982_1990,1986,8,24732,29512,1709,2607,4780,898,3882,0.0223331080220834,0.00419563410121986,0.0181374739208636,EPCI
200073161,CC Touraine-Est Vallées,1990_1999,1994.5,9,29512,33228,2248,3124,3716,876,2840,0.0132645295401677,0.00312694506921068,0.010137584470957,EPCI
200073161,CC Touraine-Est Vallées,1999_2006,2002.5,7,33228,35877,1908,3055,2649,1147,1502,0.0110179017057932,0.00477068073104749,0.00624722097474571,EPCI
200073237,CC de Gâtine et Choisilles - Pays de Racan,2006_2011,2008.5,5,19542,20339,717,1339,797,622,175,0.00802689005602275,0.00626439851298137,0.00176249154304138,EPCI
200073237,CC de Gâtine et Choisilles - Pays de Racan,2011_2016,2013.5,5,20339,21411,738,1268,1072,530,542,0.0103258642527146,0.0051051381100175,0.00522072614269714,EPCI
200073237,CC de Gâtine et Choisilles - Pays de Racan,1968_1975,1971.5,7,13731,13452,1100,1328,-279,228,-507,-0.00292831217132528,0.00239302930129808,-0.00532134147262335,EPCI
200073237,CC de Gâtine et Choisilles - Pays de Racan,1975_1982,1978.5,7,13452,14120,1062,1068,668,6,662,0.0069475139430546,6.24028198477958e-05,0.0068851111232068,EPCI
200073237,CC de Gâtine et Choisilles - Pays de Racan,1982_1990,1986,8,14120,15436,1174,1475,1316,301,1015,0.0112010436002243,0.00256194082345557,0.00863910277676877,EPCI
200073237,CC de Gâtine et Choisilles - Pays de Racan,1990_1999,1994.5,9,15436,17293,1264,1728,1857,464,1393,0.012702145740682,0.00317382639939495,0.009528319341287,EPCI
200073237,CC de Gâtine et Choisilles - Pays de Racan,1999_2006,2002.5,7,17293,19542,1025,1720,2249,695,1554,0.0176197423514333,0.00544496262082976,0.0121747797306035,EPCI
200073245,CC du Bassin d'Aubenas,2006_2011,2008.5,5,36682,37733,2009,1989,1051,-20,1071,0.00566576439636979,-0.000107816639321975,0.00577358103569176,EPCI
200073245,CC du Bassin d'Aubenas,2011_2016,2013.5,5,37733,39708,2296,1946,1975,-350,2325,0.0102557606044809,-0.00181747656281939,0.0120732371673002,EPCI
200073245,CC du Bassin d'Aubenas,1968_1975,1971.5,7,27737,30348,2812,3006,2611,194,2417,0.0129348486343659,0.000961072629286474,0.0119737760050794,EPCI
200073245,CC du Bassin d'Aubenas,1975_1982,1978.5,7,30348,31317,2643,2544,969,-99,1068,0.00450016168267964,-0.000459768840645288,0.00495993052332493,EPCI
200073245,CC du Bassin d'Aubenas,1982_1990,1986,8,31317,32500,2960,2775,1183,-185,1368,0.00464563368179105,-0.000726493855563267,0.00537212753735432,EPCI
200073245,CC du Bassin d'Aubenas,1990_1999,1994.5,9,32500,33608,3495,3011,1108,-484,1592,0.0037318398756101,-0.00163015388068167,0.00536199375629177,EPCI
200073245,CC du Bassin d'Aubenas,1999_2006,2002.5,7,33608,36682,2791,2643,3074,-148,3222,0.0125816393829983,-0.000605752319025291,0.0131873917020236,EPCI
200073252,CC de la Castagniccia-Casinca,2006_2011,2008.5,5,11035,11811,540,577,776,37,739,0.0136846413225953,0.000652489341412404,0.0130321519811829,EPCI
200073252,CC de la Castagniccia-Casinca,2011_2016,2013.5,5,11811,12433,579,638,622,59,563,0.0103174470381864,0.000978664590438901,0.00933878244774748,EPCI
200073252,CC de la Castagniccia-Casinca,1968_1975,1971.5,7,8648,8471,780,595,-177,-185,8,-0.00294985700912342,-0.00308318387959228,0.000133326870468855,EPCI
200073252,CC de la Castagniccia-Casinca,1975_1982,1978.5,7,8471,8440,765,471,-31,-294,263,-0.000523613843763204,-0.00496588613117361,0.00444227228741041,EPCI
200073252,CC de la Castagniccia-Casinca,1982_1990,1986,8,8440,8729,873,740,289,-133,422,0.00421743183285117,-0.00194089423449552,0.00615832606734669,EPCI
200073252,CC de la Castagniccia-Casinca,1990_1999,1994.5,9,8729,10001,959,955,1272,-4,1276,0.0152297272372386,-4.78922240164735e-05,0.0152776194612551,EPCI
200073252,CC de la Castagniccia-Casinca,1999_2006,2002.5,7,10001,11035,736,713,1034,-23,1057,0.0141545186503891,-0.000314849060888732,0.0144693677112778,EPCI
200073260,CC Sud Vendée Littoral,2006_2011,2008.5,5,50766,53467,3054,2919,2701,-135,2836,0.010421489762837,-0.000520881569042203,0.0109423713318792,EPCI
200073260,CC Sud Vendée Littoral,2011_2016,2013.5,5,53467,54824,3057,2717,1357,-340,1697,0.00502526713708851,-0.00125909419794406,0.00628436133503257,EPCI
200073260,CC Sud Vendée Littoral,1968_1975,1971.5,7,43736,43057,3785,4674,-679,889,-1568,-0.00223275259307076,0.00292329463216481,-0.00515604722523558,EPCI
200073260,CC Sud Vendée Littoral,1975_1982,1978.5,7,43057,43993,3891,4032,936,141,795,0.00307696861841245,0.000463517708542901,0.00261345090986955,EPCI
200073260,CC Sud Vendée Littoral,1982_1990,1986,8,43993,45068,4415,4175,1075,-240,1315,0.00302229920850428,-0.000674745869805606,0.00369704507830988,EPCI
200073260,CC Sud Vendée Littoral,1990_1999,1994.5,9,45068,46498,4953,4126,1430,-827,2257,0.00347679013019708,-0.00201070310326782,0.00548749323346491,EPCI
200073260,CC Sud Vendée Littoral,1999_2006,2002.5,7,46498,50766,4155,3523,4268,-632,4900,0.0126243857816657,-0.00186940295548564,0.0144937887371513,EPCI
200073344,CA Rambouillet Territoires,2006_2011,2008.5,5,75405,77546,2329,4249,2141,1920,221,0.00561525132361762,0.00503562939810641,0.000579621925511207,EPCI
200073344,CA Rambouillet Territoires,2011_2016,2013.5,5,77546,78443,2510,3906,897,1396,-499,0.00230283500557293,0.00358389929518374,-0.00128106428961081,EPCI
200073344,CA Rambouillet Territoires,1968_1975,1971.5,7,34360,45609,2665,4463,11249,1798,9451,0.0412884625305414,0.00659940044714316,0.0346890620833983,EPCI
200073344,CA Rambouillet Territoires,1975_1982,1978.5,7,45609,57037,2840,5099,11428,2259,9169,0.0324577854211241,0.0064160078111935,0.0260417776099306,EPCI
200073344,CA Rambouillet Territoires,1982_1990,1986,8,57037,67692,3340,6200,10655,2860,7795,0.021639283650976,0.00580838585094241,0.0158308978000336,EPCI
200073344,CA Rambouillet Territoires,1990_1999,1994.5,9,67692,72203,4061,7562,4511,3501,1010,0.00719392973627864,0.00558322944063656,0.00161070029564208,EPCI
200073344,CA Rambouillet Territoires,1999_2006,2002.5,7,72203,75405,3200,5958,3202,2758,444,0.00621810831383218,0.0053558846750622,0.000862223638769984,EPCI
200073393,CC des Rives du Haut-Allier,2006_2011,2008.5,5,17845,17802,1295,750,-43,-545,502,-0.000482392892193984,-0.00611404944757491,0.00563165655538092,EPCI
200073393,CC des Rives du Haut-Allier,2011_2016,2013.5,5,17802,17143,1364,657,-659,-707,48,-0.00751579082875786,-0.00806322324117118,0.000547432412413319,EPCI
200073393,CC des Rives du Haut-Allier,1968_1975,1971.5,7,23943,21766,2485,1843,-2177,-642,-1535,-0.0135258194184748,-0.00398878092175507,-0.00953703849671968,EPCI
200073393,CC des Rives du Haut-Allier,1975_1982,1978.5,7,21766,20500,2336,1382,-1266,-954,-312,-0.00852406709186115,-0.0064233491355731,-0.00210071795628806,EPCI
200073393,CC des Rives du Haut-Allier,1982_1990,1986,8,20500,18714,2495,1397,-1786,-1098,-688,-0.0113294552401533,-0.00696514101550296,-0.00436431422465031,EPCI
200073393,CC des Rives du Haut-Allier,1990_1999,1994.5,9,18714,17838,2620,1467,-876,-1153,277,-0.00531260389600796,-0.00699250261654929,0.00167989872054133,EPCI
200073393,CC des Rives du Haut-Allier,1999_2006,2002.5,7,17838,17845,1851,1159,7,-692,699,5.6050670509844e-05,-0.0055410091418303,0.00559705981234014,EPCI
200073401,CC Mézenc-Loire-Meygal,2006_2011,2008.5,5,10966,11019,699,557,53,-142,195,0.000964760787340202,-0.00258483078872281,0.00354959157606301,EPCI
200073401,CC Mézenc-Loire-Meygal,2011_2016,2013.5,5,11019,11024,732,490,5,-242,247,9.07358693824634e-05,-0.00439161607811123,0.00448235194749369,EPCI
200073401,CC Mézenc-Loire-Meygal,1968_1975,1971.5,7,13332,11740,1416,1016,-1592,-400,-1192,-0.018002462242929,-0.0045232317193289,-0.0134792305236001,EPCI
200073401,CC Mézenc-Loire-Meygal,1975_1982,1978.5,7,11740,10966,1269,776,-774,-493,-281,-0.00969586580490833,-0.00617579049330724,-0.00352007531160109,EPCI
200073401,CC Mézenc-Loire-Meygal,1982_1990,1986,8,10966,10633,1212,870,-333,-342,9,-0.00384723091014461,-0.0039512101239323,0.000103979213787692,EPCI
200073401,CC Mézenc-Loire-Meygal,1990_1999,1994.5,9,10633,10491,1338,879,-142,-459,317,-0.00149273208988487,-0.00482509879758561,0.00333236670770074,EPCI
200073401,CC Mézenc-Loire-Meygal,1999_2006,2002.5,7,10491,10966,969,771,475,-198,673,0.00634602699100828,-0.00264529125098871,0.008991318241997,EPCI
200073419,CA du Puy-en-Velay,2006_2011,2008.5,5,80683,81635,4222,4160,952,-62,1014,0.00234879315231029,-0.000152967621263906,0.0025017607735742,EPCI
200073419,CA du Puy-en-Velay,2011_2016,2013.5,5,81635,82657,4492,4091,1022,-401,1423,0.00249138306922592,-0.000977538758081793,0.00346892182730771,EPCI
200073419,CA du Puy-en-Velay,1968_1975,1971.5,7,75775,78175,6837,8061,2400,1224,1176,0.00446443322050483,0.00227686094245746,0.00218757227804737,EPCI
200073419,CA du Puy-en-Velay,1975_1982,1978.5,7,78175,79602,6660,7066,1427,406,1021,0.00258752972272114,0.000736185751524024,0.00185134397119711,EPCI
200073419,CA du Puy-en-Velay,1982_1990,1986,8,79602,79594,7506,7482,-8,-24,16,-1.25630508216457e-05,-3.7689152464937e-05,2.51261016432913e-05,EPCI
200073419,CA du Puy-en-Velay,1990_1999,1994.5,9,79594,79189,7747,7505,-405,-242,-163,-0.000566651929830853,-0.000338592017331028,-0.000228059912499825,EPCI
200073419,CA du Puy-en-Velay,1999_2006,2002.5,7,79189,80683,5909,6092,1494,183,1311,0.00267363867761317,0.000327493894245789,0.00234614478336738,EPCI
200073427,CC Marches du Velay-Rochebaron,2006_2011,2008.5,5,27870,29537,1267,1734,1667,467,1200,0.0116863324488181,0.00327385558104263,0.00841247686777549,EPCI
200073427,CC Marches du Velay-Rochebaron,2011_2016,2013.5,5,29537,30399,1271,1725,862,454,408,0.00576978111657911,0.00303884063448598,0.00273094048209313,EPCI
200073427,CC Marches du Velay-Rochebaron,1968_1975,1971.5,7,17724,18004,1890,1655,280,-235,515,0.00224169486259407,-0.00188142247396288,0.00412311733655695,EPCI
200073427,CC Marches du Velay-Rochebaron,1975_1982,1978.5,7,18004,19638,1911,1636,1634,-275,1909,0.0124876865310317,-0.002101660829886,0.0145893473609177,EPCI
200073427,CC Marches du Velay-Rochebaron,1982_1990,1986,8,19638,21602,1954,2004,1964,50,1914,0.0119861953170204,0.000305147538620682,0.0116810477783997,EPCI
200073427,CC Marches du Velay-Rochebaron,1990_1999,1994.5,9,21602,24436,2121,2517,2834,396,2438,0.0137910705211677,0.00192705149131348,0.0118640190298542,EPCI
200073427,CC Marches du Velay-Rochebaron,1999_2006,2002.5,7,24436,27870,1617,2521,3434,904,2530,0.0189623132762984,0.00499182620901973,0.0139704870672787,EPCI
200077014,CA Vienne Condrieu,2006_2011,2008.5,5,83931,85485,2973,5835,1554,2862,-1308,0.00367591752164009,0.00676993304178504,-0.00309401552014494,EPCI
200077014,CA Vienne Condrieu,2011_2016,2013.5,5,85485,89210,3288,5578,3725,2290,1435,0.00856693170869116,0.00526665063433631,0.00330028107435485,EPCI
200077014,CA Vienne Condrieu,1968_1975,1971.5,7,57371,61962,4507,7206,4591,2699,1892,0.0110581723711694,0.00650098175338403,0.00455719061778532,EPCI
200077014,CA Vienne Condrieu,1975_1982,1978.5,7,61962,68708,4311,7067,6746,2756,3990,0.014872996559588,0.00607619011536087,0.00879680644422709,EPCI
200077014,CA Vienne Condrieu,1982_1990,1986,8,68708,74155,4620,8414,5447,3794,1653,0.00958209919105646,0.00667422146702188,0.00290787772403458,EPCI
200077014,CA Vienne Condrieu,1990_1999,1994.5,9,74155,79411,5278,9204,5256,3926,1330,0.00763784292433312,0.00570513152985765,0.00193271139447546,EPCI
200077014,CA Vienne Condrieu,1999_2006,2002.5,7,79411,83931,4181,7818,4520,3637,883,0.00793965824187692,0.00638861438621822,0.0015510438556587,EPCI
200077055,CA Coulommiers Pays de Brie,2006_2011,2008.5,5,69236,72446,2851,4660,3210,1809,1401,0.00910530298512491,0.00513130626171058,0.00397399672341433,EPCI
200077055,CA Coulommiers Pays de Brie,2011_2016,2013.5,5,72446,75370,2898,4903,2924,2005,919,0.00794496729429706,0.00544789994017291,0.00249706735412414,EPCI
200077055,CA Coulommiers Pays de Brie,1968_1975,1971.5,7,39726,43106,3962,4309,3380,347,3033,0.0117334912610654,0.00120459215017446,0.0105288991108909,EPCI
200077055,CA Coulommiers Pays de Brie,1975_1982,1978.5,7,43106,48067,3999,4001,4961,2,4959,0.0156836709647639,6.322786117623e-06,0.0156773481786462,EPCI
200077055,CA Coulommiers Pays de Brie,1982_1990,1986,8,48067,57727,4678,5587,9660,909,8751,0.0231551541833712,0.00217888562657189,0.0209762685567993,EPCI
200077055,CA Coulommiers Pays de Brie,1990_1999,1994.5,9,57727,64287,5270,7649,6560,2379,4181,0.0120309557597111,0.00436305545005378,0.00766790030965736,EPCI
200077055,CA Coulommiers Pays de Brie,1999_2006,2002.5,7,64287,69236,4361,6173,4949,1812,3137,0.010651112809859,0.00389974063678813,0.00675137217307085,EPCI
200083392,CA de Laval Agglomération,2006_2011,2008.5,5,108842,112395,3658,7502,3553,3844,-291,0.00644511355951871,0.00697298523016885,-0.000527871670650139,EPCI
200083392,CA de Laval Agglomération,2011_2016,2013.5,5,112395,112937,3928,7036,542,3108,-2566,0.000962600729143892,0.00551985805568121,-0.00455725732653732,EPCI
200083392,CA de Laval Agglomération,1968_1975,1971.5,7,73044,85979,4954,12417,12935,7463,5472,0.0235649501912429,0.0135960744706027,0.00996887572064023,EPCI
200083392,CA de Laval Agglomération,1975_1982,1978.5,7,85979,92715,4700,11552,6736,6852,-116,0.0108335758199913,0.0110201397741361,-0.000186563954144743,EPCI
200083392,CA de Laval Agglomération,1982_1990,1986,8,92715,98079,5235,11653,5364,6418,-1054,0.00705514668114771,0.0084414488067871,-0.00138630212563939,EPCI
200083392,CA de Laval Agglomération,1990_1999,1994.5,9,98079,102679,6037,12262,4600,6225,-1625,0.00510569437066977,0.0069093364037868,-0.00180364203311704,EPCI
200083392,CA de Laval Agglomération,1999_2006,2002.5,7,102679,108842,4995,10643,6163,5648,515,0.00836186275392303,0.00766311874641527,0.000698744007507766,EPCI
200084952,CU du Havre Seine Métropole,2006_2011,2008.5,5,278441,272235,12334,18451,-6206,6117,-12323,-0.00449795851931212,0.00443345347448151,-0.00893141199379362,EPCI
200084952,CU du Havre Seine Métropole,2011_2016,2013.5,5,272235,269321,12649,17694,-2914,5045,-7959,-0.00215002281294052,0.00372232844587678,-0.0058723512588173,EPCI
200084952,CU du Havre Seine Métropole,1968_1975,1971.5,7,270931,289601,19155,37422,18670,18267,403,0.00956545034790013,0.00935897597777674,0.000206474370123392,EPCI
200084952,CU du Havre Seine Métropole,1975_1982,1978.5,7,289601,285189,19405,34512,-4412,15107,-19519,-0.00219073898843492,0.00750124521719997,-0.00969198420563488,EPCI
200084952,CU du Havre Seine Métropole,1982_1990,1986,8,285189,288391,21956,38083,3202,16127,-12925,0.0013966093386204,0.00703407832727396,-0.00563746898865356,EPCI
200084952,CU du Havre Seine Métropole,1990_1999,1994.5,9,288391,285764,22835,36198,-2627,13363,-15990,-0.00101625025824714,0.00516945268403371,-0.00618570294228085,EPCI
200084952,CU du Havre Seine Métropole,1999_2006,2002.5,7,285764,278441,17499,26344,-7323,8845,-16168,-0.00370171848780998,0.004471077430654,-0.00817279591846398,EPCI
200085728,CC de Brioude Sud Auvergne,2006_2011,2008.5,5,16587,16711,893,830,124,-63,187,0.00149069582352501,-0.000757369652274805,0.00224806547579982,EPCI
200085728,CC de Brioude Sud Auvergne,2011_2016,2013.5,5,16711,16937,972,752,226,-220,446,0.00269029089268447,-0.00261886724066629,0.00530915813335076,EPCI
200085728,CC de Brioude Sud Auvergne,1968_1975,1971.5,7,15614,15838,1463,1647,224,184,40,0.00203695293142481,0.00167321133652752,0.000363741594897287,EPCI
200085728,CC de Brioude Sud Auvergne,1975_1982,1978.5,7,15838,15933,1386,1357,95,-29,124,0.00085469566151497,-0.000260907096672991,0.00111560275818796,EPCI
200085728,CC de Brioude Sud Auvergne,1982_1990,1986,8,15933,16110,1529,1520,177,-9,186,0.00138192486444533,-7.02673659887455e-05,0.00145219223043407,EPCI
200085728,CC de Brioude Sud Auvergne,1990_1999,1994.5,9,16110,15886,1632,1452,-224,-180,-44,-0.00155456585074609,-0.0012492047014924,-0.000305361149253697,EPCI
200085728,CC de Brioude Sud Auvergne,1999_2006,2002.5,7,15886,16587,1237,1182,701,-55,756,0.00618778542242171,-0.00048548958378487,0.00667327500620658,EPCI
200085751,CC d'Entre Bièvre et Rhône,2006_2011,2008.5,5,61673,65576,2388,4090,3903,1702,2201,0.0123483270189908,0.00538479441104851,0.00696353260794229,EPCI
200085751,CC d'Entre Bièvre et Rhône,2011_2016,2013.5,5,65576,67546,2617,4070,1970,1453,517,0.00593737110948256,0.00437918792998891,0.00155818317949365,EPCI
200085751,CC d'Entre Bièvre et Rhône,1968_1975,1971.5,7,41995,43601,2826,4512,1606,1686,-80,0.00537575813914226,0.00564354185715682,-0.000267783718014558,EPCI
200085751,CC d'Entre Bièvre et Rhône,1975_1982,1978.5,7,43601,46704,2874,3789,3103,915,2188,0.00986977788002608,0.00291035989694614,0.00695941798307994,EPCI
200085751,CC d'Entre Bièvre et Rhône,1982_1990,1986,8,46704,51659,3410,5220,4955,1810,3145,0.0126840963275237,0.00463334295717817,0.00805075337034549,EPCI
200085751,CC d'Entre Bièvre et Rhône,1990_1999,1994.5,9,51659,55918,4008,5913,4259,1905,2354,0.00884128887074298,0.00395460326338703,0.00488668560735595,EPCI
200085751,CC d'Entre Bièvre et Rhône,1999_2006,2002.5,7,55918,61673,3090,5258,5755,2168,3587,0.0140926498996379,0.00530892527930754,0.00878372462033033,EPCI
240100610,CC de la Côtière à Montluel,2006_2011,2008.5,5,21717,23288,553,1629,1571,1076,495,0.0140665847964496,0.00963440180838943,0.00443218298806019,EPCI
240100610,CC de la Côtière à Montluel,2011_2016,2013.5,5,23288,24732,676,1675,1444,999,445,0.0121046241313834,0.00837432098840164,0.00373030314298171,EPCI
240100610,CC de la Côtière à Montluel,1968_1975,1971.5,7,9278,11949,734,1526,2671,792,1879,0.0368041857517785,0.0109131093655592,0.0258910763862193,EPCI
240100610,CC de la Côtière à Montluel,1975_1982,1978.5,7,11949,14053,704,1550,2104,846,1258,0.0234402615714857,0.00942512418701374,0.014015137384472,EPCI
240100610,CC de la Côtière à Montluel,1982_1990,1986,8,14053,18016,875,2051,3963,1176,2787,0.0315402199497123,0.00935939910695476,0.0221808208427576,EPCI
240100610,CC de la Côtière à Montluel,1990_1999,1994.5,9,18016,20103,921,2538,2087,1617,470,0.0122532192222538,0.00949374963219181,0.00275946959006194,EPCI
240100610,CC de la Côtière à Montluel,1999_2006,2002.5,7,20103,21717,727,2046,1614,1319,295,0.0110934100347264,0.00906580411140281,0.0020276059233236,EPCI
240100750,CA du Pays de Gex,2006_2011,2008.5,5,68243,80155,1380,3245,11912,1865,10047,0.0327007718326435,0.00511979008293151,0.027580981749712,EPCI
240100750,CA du Pays de Gex,2011_2016,2013.5,5,80155,93027,1530,4265,12872,2735,10137,0.0302335279327575,0.00642392005097045,0.023809607881787,EPCI
240100750,CA du Pays de Gex,1968_1975,1971.5,7,22157,33281,1561,2497,11124,936,10188,0.0598411380542017,0.00503517666475483,0.0548059613894468,EPCI
240100750,CA du Pays de Gex,1975_1982,1978.5,7,33281,39677,1453,2696,6396,1243,5153,0.0254301103710348,0.00494209305678491,0.0204880173142499,EPCI
240100750,CA du Pays de Gex,1982_1990,1986,8,39677,50936,1880,3654,11259,1774,9485,0.031717390868842,0.0049974821388512,0.0267199087299908,EPCI
240100750,CA du Pays de Gex,1990_1999,1994.5,9,50936,57902,2210,4994,6966,2784,4182,0.0143443494320028,0.00573279770581335,0.00861155172618945,EPCI
240100750,CA du Pays de Gex,1999_2006,2002.5,7,57902,68243,1866,3943,10341,2077,8264,0.0237524051001246,0.00477069387805422,0.0189817112220703,EPCI
240100800,CC de Miribel et du Plateau,2006_2011,2008.5,5,21873,22562,740,1338,689,598,91,0.00622209243310512,0.0054003066400535,0.000821785793051619,EPCI
240100800,CC de Miribel et du Plateau,2011_2016,2013.5,5,22562,23507,773,1389,945,616,329,0.00823999822895716,0.0053712581048017,0.00286874012415545,EPCI
240100800,CC de Miribel et du Plateau,1968_1975,1971.5,7,11869,13528,855,1458,1659,603,1056,0.0188659918012659,0.00685725922613824,0.0120087325751277,EPCI
240100800,CC de Miribel et du Plateau,1975_1982,1978.5,7,13528,15972,918,1520,2444,602,1842,0.0240087612766642,0.00591377835047129,0.0180949829261929,EPCI
240100800,CC de Miribel et du Plateau,1982_1990,1986,8,15972,17920,1099,1848,1948,749,1199,0.0144889897008789,0.00557097191270958,0.00891801778816928,EPCI
240100800,CC de Miribel et du Plateau,1990_1999,1994.5,9,17920,20722,1273,2524,2802,1251,1551,0.0162730458036364,0.00726537483952504,0.00900767096411138,EPCI
240100800,CC de Miribel et du Plateau,1999_2006,2002.5,7,20722,21873,1017,1908,1151,891,260,0.00775233230429784,0.00600115385154594,0.0017511784527519,EPCI
240100883,CC de la Plaine de l'Ain,2006_2011,2008.5,5,69003,73303,2706,4883,4300,2177,2123,0.0121636940184251,0.00615822369258406,0.00600547032584104,EPCI
240100883,CC de la Plaine de l'Ain,2011_2016,2013.5,5,73303,77249,2836,4981,3946,2145,1801,0.0105416628953396,0.0057303261303861,0.00481133676495355,EPCI
240100883,CC de la Plaine de l'Ain,1968_1975,1971.5,7,40313,44609,3632,4717,4296,1085,3211,0.0145710860161474,0.00368008108182494,0.0108910049343225,EPCI
240100883,CC de la Plaine de l'Ain,1975_1982,1978.5,7,44609,48594,3449,4622,3985,1173,2812,0.0122985027727545,0.0036201113556941,0.00867839141706036,EPCI
240100883,CC de la Plaine de l'Ain,1982_1990,1986,8,48594,56073,4053,6207,7479,2154,5325,0.0180553554751874,0.00520005825558948,0.012855297219598,EPCI
240100883,CC de la Plaine de l'Ain,1990_1999,1994.5,9,56073,61664,4687,6819,5591,2132,3459,0.010616613737916,0.0040484028777029,0.0065682108602131,EPCI
240100883,CC de la Plaine de l'Ain,1999_2006,2002.5,7,61664,69003,3595,6126,7339,2531,4808,0.0161939650149581,0.00558481066260511,0.010609154352353,EPCI
240100891,CC du Pays Bellegardien (CCPB),2006_2011,2008.5,5,20056,20886,786,1360,830,574,256,0.00814311974081039,0.00563150690509056,0.00251161283571983,EPCI
240100891,CC du Pays Bellegardien (CCPB),2011_2016,2013.5,5,20886,21684,910,1440,798,530,268,0.00752730546317926,0.00499933821489349,0.00252796724828577,EPCI
240100891,CC du Pays Bellegardien (CCPB),1968_1975,1971.5,7,16777,17669,1309,2178,892,869,23,0.00742784931613039,0.00723632405349474,0.000191525262635649,EPCI
240100891,CC du Pays Bellegardien (CCPB),1975_1982,1978.5,7,17669,17232,1233,1774,-437,541,-978,-0.00357126085615767,0.00442117190659336,-0.00799243276275102,EPCI
240100891,CC du Pays Bellegardien (CCPB),1982_1990,1986,8,17232,18015,1309,1921,783,612,171,0.00557003324406846,0.00435358920226041,0.00121644404180806,EPCI
240100891,CC du Pays Bellegardien (CCPB),1990_1999,1994.5,9,18015,18795,1435,2300,780,865,-85,0.00472067776943463,0.00523511060328328,-0.000514432833848645,EPCI
240100891,CC du Pays Bellegardien (CCPB),1999_2006,2002.5,7,18795,20056,1188,1782,1261,594,667,0.00931994612803466,0.00439020459956589,0.00492974152846877,EPCI
240200444,CC de la Thiérache du Centre,2006_2011,2008.5,5,27092,27368,1565,1782,276,217,59,0.00202924940996185,0.00159546058681783,0.000433788823144019,EPCI
240200444,CC de la Thiérache du Centre,2011_2016,2013.5,5,27368,26531,1631,1554,-837,-77,-760,-0.00619286210304137,-0.00056971371796199,-0.00562314838507938,EPCI
240200444,CC de la Thiérache du Centre,1968_1975,1971.5,7,32783,30697,2878,3793,-2086,915,-3001,-0.00934819686045818,0.00410047944742053,-0.0134486763078787,EPCI
240200444,CC de la Thiérache du Centre,1975_1982,1978.5,7,30697,29338,2824,2957,-1359,133,-1492,-0.00644788344822878,0.000631029064469777,-0.00707891251269855,EPCI
240200444,CC de la Thiérache du Centre,1982_1990,1986,8,29338,28360,3055,3159,-978,104,-1082,-0.00422902020257065,0.000449711759782565,-0.00467873196235322,EPCI
240200444,CC de la Thiérache du Centre,1990_1999,1994.5,9,28360,27374,2997,3032,-986,35,-1021,-0.00392406331557971,0.000139292308362363,-0.00406335562394207,EPCI
240200444,CC de la Thiérache du Centre,1999_2006,2002.5,7,27374,27092,2107,2286,-282,179,-461,-0.00147821727843478,0.000938301038439097,-0.00241651831687388,EPCI
240200469,CC du Pays de la Serre,2006_2011,2008.5,5,15256,15328,826,923,72,97,-25,0.000942114097026492,0.00126923704738291,-0.000327122950356421,EPCI
240200469,CC du Pays de la Serre,2011_2016,2013.5,5,15328,14621,837,871,-707,34,-741,-0.00940001498841292,0.000452051640178273,-0.00985206662859119,EPCI
240200469,CC du Pays de la Serre,1968_1975,1971.5,7,16651,15820,1376,1951,-831,575,-1406,-0.00728693663981717,0.00504210417315869,-0.0123290408129759,EPCI
240200469,CC du Pays de la Serre,1975_1982,1978.5,7,15820,15495,1449,1467,-325,18,-343,-0.00296097494108416,0.00016399245827543,-0.00312496739935959,EPCI
240200469,CC du Pays de la Serre,1982_1990,1986,8,15495,15387,1549,1802,-108,253,-361,-0.000873917182312778,0.0020472319178253,-0.00292114910013808,EPCI
240200469,CC du Pays de la Serre,1990_1999,1994.5,9,15387,15061,1580,1633,-326,53,-379,-0.00237654662480336,0.000386371077038582,-0.00276291770184194,EPCI
240200469,CC du Pays de la Serre,1999_2006,2002.5,7,15061,15256,1136,1274,195,138,57,0.00183943927788377,0.00130175702742544,0.000537682250458333,EPCI
240200477,CA GrandSoissons Agglomération,2006_2011,2008.5,5,51472,51817,2677,3353,345,676,-331,0.00133695497971265,0.00261965671387174,-0.00128270173415909,EPCI
240200477,CA GrandSoissons Agglomération,2011_2016,2013.5,5,51817,52143,2723,3165,326,442,-116,0.00125511970365211,0.00170172671476758,-0.000446607011115474,EPCI
240200477,CA GrandSoissons Agglomération,1968_1975,1971.5,7,47584,53179,3320,7205,5595,3885,1710,0.0160077749268766,0.0111153182468124,0.00489245668006415,EPCI
240200477,CA GrandSoissons Agglomération,1975_1982,1978.5,7,53179,54661,3344,6809,1482,3465,-1983,0.00393441867948896,0.00919889387613309,-0.00526447519664414,EPCI
240200477,CA GrandSoissons Agglomération,1982_1990,1986,8,54661,53764,3616,7073,-897,3457,-4354,-0.00206615967708512,0.00796289186586763,-0.0100290515429528,EPCI
240200477,CA GrandSoissons Agglomération,1990_1999,1994.5,9,53764,52452,4519,6548,-1312,2029,-3341,-0.00274130602193856,0.00423941304764736,-0.00698071906958592,EPCI
240200477,CA GrandSoissons Agglomération,1999_2006,2002.5,7,52452,51472,3650,4623,-980,973,-1953,-0.00269072993264441,0.00267151043312552,-0.00536224036576993,EPCI
240200493,CC du Pays du Vermandois,2006_2011,2008.5,5,31759,31918,1615,2039,159,424,-265,0.00099929180765268,0.00266477815374048,-0.0016654863460878,EPCI
240200493,CC du Pays du Vermandois,2011_2016,2013.5,5,31918,31298,1666,1845,-620,179,-799,-0.00391549761780319,0.00113044205417221,-0.0050459396719754,EPCI
240200493,CC du Pays du Vermandois,1968_1975,1971.5,7,31644,33569,3009,3964,1925,955,970,0.00847203842886346,0.00420301127250109,0.00426902715636237,EPCI
240200493,CC du Pays du Vermandois,1975_1982,1978.5,7,33569,33270,2760,3472,-299,712,-1011,-0.00127731668089492,0.00304163704614444,-0.00431895372703936,EPCI
240200493,CC du Pays du Vermandois,1982_1990,1986,8,33270,32898,2976,3802,-372,826,-1198,-0.0014045407556158,0.00311868458101788,-0.00452322533663369,EPCI
240200493,CC du Pays du Vermandois,1990_1999,1994.5,9,32898,32604,3043,3829,-294,786,-1080,-0.000996934443417419,0.00266527371607514,-0.00366220815949256,EPCI
240200493,CC du Pays du Vermandois,1999_2006,2002.5,7,32604,31759,2381,2920,-845,539,-1384,-0.00374423430756854,0.00238833407311177,-0.00613256838068031,EPCI
240200501,CC du Val de l'Aisne,2006_2011,2008.5,5,19428,20210,836,1250,782,414,368,0.00792366880137818,0.00419488348308257,0.00372878531829562,EPCI
240200501,CC du Val de l'Aisne,2011_2016,2013.5,5,20210,20302,885,1210,92,325,-233,0.000908787086309149,0.0032103891635921,-0.00230160207728295,EPCI
240200501,CC du Val de l'Aisne,1968_1975,1971.5,7,16111,16176,1354,1847,65,493,-428,0.000575364568625503,0.00436391895895958,-0.00378855439033408,EPCI
240200501,CC du Val de l'Aisne,1975_1982,1978.5,7,16176,16434,1310,1423,258,113,145,0.0022630850959573,0.00099119618543866,0.00127188891051864,EPCI
240200501,CC du Val de l'Aisne,1982_1990,1986,8,16434,17634,1442,1943,1200,501,699,0.00884848053778775,0.00369424062452639,0.00515423991326137,EPCI
240200501,CC du Val de l'Aisne,1990_1999,1994.5,9,17634,18472,1447,1925,838,478,360,0.00517190786729538,0.00295008587179856,0.00222182199549682,EPCI
240200501,CC du Val de l'Aisne,1999_2006,2002.5,7,18472,19428,1143,1647,956,504,452,0.00723450815455196,0.00381400848315291,0.00342049967139904,EPCI
240200519,CC du Canton d'Oulchy-le-Château,2006_2011,2008.5,5,5654,5704,223,362,50,139,-89,0.00176243603610371,0.00489957218036831,-0.0031371361442646,EPCI
240200519,CC du Canton d'Oulchy-le-Château,2011_2016,2013.5,5,5704,5705,232,382,1,150,-149,3.50606550192367e-05,0.00525909825288551,-0.00522403759786627,EPCI
240200519,CC du Canton d'Oulchy-le-Château,1968_1975,1971.5,7,5562,5052,445,646,-510,201,-711,-0.0136451283739978,0.0053777858885756,-0.0190229142625734,EPCI
240200519,CC du Canton d'Oulchy-le-Château,1975_1982,1978.5,7,5052,5042,398,511,-10,113,-123,-0.000283013618733285,0.00319805389168613,-0.00348106751041941,EPCI
240200519,CC du Canton d'Oulchy-le-Château,1982_1990,1986,8,5042,5347,456,666,305,210,95,0.00736861904259389,0.00507347540637612,0.00229514363621777,EPCI
240200519,CC du Canton d'Oulchy-le-Château,1990_1999,1994.5,9,5347,5468,411,620,121,209,-88,0.00248945610662554,0.00429996963871685,-0.0018105135320913,EPCI
240200519,CC du Canton d'Oulchy-le-Château,1999_2006,2002.5,7,5468,5654,314,452,186,138,48,0.00479005587190606,0.0035539124210916,0.00123614345081447,EPCI
240200576,CC de la Champagne Picarde,2006_2011,2008.5,5,20130,20674,770,1343,544,573,-29,0.00534737293279708,0.00563243509281751,-0.000285062160020433,EPCI
240200576,CC de la Champagne Picarde,2011_2016,2013.5,5,20674,20940,902,1346,266,444,-178,0.00256013823050583,0.00427331343738567,-0.00171317520687984,EPCI
240200576,CC de la Champagne Picarde,1968_1975,1971.5,7,18265,17928,1470,2119,-337,649,-986,-0.00265688190350355,0.00511666574294897,-0.00777354764645252,EPCI
240200576,CC de la Champagne Picarde,1975_1982,1978.5,7,17928,18479,1414,1919,551,505,46,0.00433382335289179,0.00397201595863948,0.000361807394252309,EPCI
240200576,CC de la Champagne Picarde,1982_1990,1986,8,18479,19143,1629,2086,664,457,207,0.00442252077728567,0.00304381324581257,0.00137870753147309,EPCI
240200576,CC de la Champagne Picarde,1990_1999,1994.5,9,19143,19509,1588,2190,366,602,-236,0.00210652494614716,0.00346483064912729,-0.00135830570298014,EPCI
240200576,CC de la Champagne Picarde,1999_2006,2002.5,7,19509,20130,1143,1748,621,605,16,0.00448651183483739,0.0043709173270155,0.000115594507821897,EPCI
240200584,CC du Canton de Charly-sur-Marne,2006_2011,2008.5,5,15064,15481,705,986,417,281,136,0.00547607402014649,0.00369011222940327,0.00178596179074322,EPCI
240200584,CC du Canton de Charly-sur-Marne,2011_2016,2013.5,5,15481,15744,782,968,263,186,77,0.00337485699971762,0.00238678099599802,0.000988076003719608,EPCI
240200584,CC du Canton de Charly-sur-Marne,1968_1975,1971.5,7,10012,10243,1023,1096,231,73,158,0.00326391097901779,0.00103145238730865,0.00223245859170914,EPCI
240200584,CC du Canton de Charly-sur-Marne,1975_1982,1978.5,7,10243,11275,1003,943,1032,-60,1092,0.0138077933338165,-0.000802778682198636,0.0146105720160152,EPCI
240200584,CC du Canton de Charly-sur-Marne,1982_1990,1986,8,11275,12849,1074,1313,1574,239,1335,0.0164689043712134,0.00250067861799238,0.013968225753221,EPCI
240200584,CC du Canton de Charly-sur-Marne,1990_1999,1994.5,9,12849,14255,1265,1634,1406,369,1037,0.0116047896833413,0.00304563825971049,0.00855915142363084,EPCI
240200584,CC du Canton de Charly-sur-Marne,1999_2006,2002.5,7,14255,15064,947,1370,809,423,386,0.0079168983539466,0.00413949073389297,0.00377740762005363,EPCI
240200592,CC du Chemin des Dames,2006_2011,2008.5,5,5008,5358,300,342,350,42,308,0.013602511136428,0.00163230133637136,0.0119702098000566,EPCI
240200592,CC du Chemin des Dames,2011_2016,2013.5,5,5358,5457,307,328,99,21,78,0.00366839556914877,0.000778144514667922,0.00289025105448085,EPCI
240200592,CC du Chemin des Dames,1968_1975,1971.5,7,4484,4175,428,414,-309,-14,-295,-0.0101483185990493,-0.000459794370183464,-0.00968852422886584,EPCI
240200592,CC du Chemin des Dames,1975_1982,1978.5,7,4175,4230,392,383,55,-9,64,0.00187141101589439,-0.000306230893509991,0.00217764190940438,EPCI
240200592,CC du Chemin des Dames,1982_1990,1986,8,4230,4309,464,455,79,-9,88,0.00231566020613516,-0.00026380939057236,0.00257946959670752,EPCI
240200592,CC du Chemin des Dames,1990_1999,1994.5,9,4309,4616,560,477,307,-83,390,0.00767627609155963,-0.0020753450019526,0.00975162109351223,EPCI
240200592,CC du Chemin des Dames,1999_2006,2002.5,7,4616,5008,422,435,392,13,379,0.0117120703733409,0.00038841049707508,0.0113236598762658,EPCI
240200600,CC des Trois Rivières,2006_2011,2008.5,5,22396,22125,1227,1532,-271,305,-576,-0.00243187430939629,0.00273698031131316,-0.00516885462070945,EPCI
240200600,CC des Trois Rivières,2011_2016,2013.5,5,22125,21510,1346,1401,-615,55,-670,-0.0056221855496178,0.000502797081673136,-0.00612498263129093,EPCI
240200600,CC des Trois Rivières,1968_1975,1971.5,7,27513,26227,2369,3698,-1286,1329,-2615,-0.00681512892094793,0.00704300648206828,-0.0138581354030162,EPCI
240200600,CC des Trois Rivières,1975_1982,1978.5,7,26227,25187,2278,2887,-1040,609,-1649,-0.00576353048980205,0.00337499045027832,-0.00913852094008037,EPCI
240200600,CC des Trois Rivières,1982_1990,1986,8,25187,23757,2405,2961,-1430,556,-1986,-0.00727971910619696,0.00283043623989196,-0.0101101553460889,EPCI
240200600,CC des Trois Rivières,1990_1999,1994.5,9,23757,23206,2383,2815,-551,432,-983,-0.00260397686303093,0.00204159347518941,-0.00464557033822034,EPCI
240200600,CC des Trois Rivières,1999_2006,2002.5,7,23206,22396,1900,2174,-810,274,-1084,-0.00506264062320982,0.00171254756883888,-0.0067751881920487,EPCI
240200634,CC des Portes de la Thiérache,2006_2011,2008.5,5,7589,7420,364,467,-169,103,-272,-0.00449402615641958,0.00273896268704862,-0.00723298884346821,EPCI
240200634,CC des Portes de la Thiérache,2011_2016,2013.5,5,7420,7056,389,368,-364,-21,-343,-0.0100097136753892,-0.000577483481272452,-0.00943223019411671,EPCI
240200634,CC des Portes de la Thiérache,1968_1975,1971.5,7,9750,9085,757,1117,-665,360,-1025,-0.0100410462726749,0.00543575437317738,-0.0154768006458523,EPCI
240200634,CC des Portes de la Thiérache,1975_1982,1978.5,7,9085,8734,678,932,-351,254,-605,-0.00561293781065131,0.00406178405671063,-0.00967472186736194,EPCI
240200634,CC des Portes de la Thiérache,1982_1990,1986,8,8734,8022,762,942,-712,180,-892,-0.0105731678758535,0.00267299187872701,-0.0132461597545805,EPCI
240200634,CC des Portes de la Thiérache,1990_1999,1994.5,9,8022,7670,732,891,-352,159,-511,-0.00497327566100725,0.00224645122187543,-0.00721972688288268,EPCI
240200634,CC des Portes de la Thiérache,1999_2006,2002.5,7,7670,7589,529,597,-81,68,-149,-0.00151553398208071,0.00127230013310479,-0.0027878341151855,EPCI
240300491,CC du Pays de Lapalisse,2006_2011,2008.5,5,8482,8608,599,434,126,-165,291,0.00295349948403678,-0.00386767789576245,0.00682117737979923,EPCI
240300491,CC du Pays de Lapalisse,2011_2016,2013.5,5,8608,8471,613,389,-137,-224,87,-0.00320354525748579,-0.00523791341369939,0.0020343681562136,EPCI
240300491,CC du Pays de Lapalisse,1968_1975,1971.5,7,10262,9628,1047,840,-634,-207,-427,-0.00906894572349004,-0.0029609964743887,-0.00610794924910134,EPCI
240300491,CC du Pays de Lapalisse,1975_1982,1978.5,7,9628,9187,969,726,-441,-243,-198,-0.00667562955462264,-0.00367840812193493,-0.00299722143268772,EPCI
240300491,CC du Pays de Lapalisse,1982_1990,1986,8,9187,9118,1002,768,-69,-234,165,-0.00094192604615817,-0.00319435789566684,0.00225243184950867,EPCI
240300491,CC du Pays de Lapalisse,1990_1999,1994.5,9,9118,8613,1071,793,-505,-278,-227,-0.00631086806847536,-0.00347410162977456,-0.00283676643870081,EPCI
240300491,CC du Pays de Lapalisse,1999_2006,2002.5,7,8613,8482,904,554,-131,-350,219,-0.00218709321219979,-0.0058433788112208,0.00365628559902102,EPCI
240300558,CC du Pays de Tronçais,2006_2011,2008.5,5,7924,7647,780,307,-277,-473,196,-0.00709128032607964,-0.0121089371633057,0.00501765683722603,EPCI
240300558,CC du Pays de Tronçais,2011_2016,2013.5,5,7647,7458,762,254,-189,-508,319,-0.00499272118773619,-0.0134195892241798,0.00842686803644363,EPCI
240300558,CC du Pays de Tronçais,1968_1975,1971.5,7,12194,11053,1391,866,-1141,-525,-616,-0.0139365661146331,-0.00641253042084346,-0.00752403569378966,EPCI
240300558,CC du Pays de Tronçais,1975_1982,1978.5,7,11053,10011,1426,599,-1042,-827,-215,-0.0140457669780272,-0.0111476480718124,-0.00289811890621482,EPCI
240300558,CC du Pays de Tronçais,1982_1990,1986,8,10011,9238,1514,577,-773,-937,164,-0.00999460319840428,-0.012115062350459,0.00212045915205473,EPCI
240300558,CC du Pays de Tronçais,1990_1999,1994.5,9,9238,8342,1477,581,-896,-896,0,-0.0112718156636021,-0.0112718156636021,0,EPCI
240300558,CC du Pays de Tronçais,1999_2006,2002.5,7,8342,7924,1041,462,-418,-579,161,-0.00731693804504052,-0.0101351845169341,0.0028182464718936,EPCI
240300566,CC du Val de Cher,2006_2011,2008.5,5,5548,5741,360,273,193,-87,280,0.00686262235779434,-0.00309351370532698,0.00995613606312132,EPCI
240300566,CC du Val de Cher,2011_2016,2013.5,5,5741,5542,350,229,-199,-121,-78,-0.00703076068943931,-0.00427498514282491,-0.0027557755466144,EPCI
240300566,CC du Val de Cher,1968_1975,1971.5,7,5381,5100,521,419,-281,-102,-179,-0.00763267786495081,-0.00277058057731311,-0.0048620972876377,EPCI
240300566,CC du Val de Cher,1975_1982,1978.5,7,5100,5454,496,298,354,-198,552,0.0096330656711745,-0.00538798588387726,0.0150210515550518,EPCI
240300566,CC du Val de Cher,1982_1990,1986,8,5454,5538,575,356,84,-219,303,0.00191234374211979,-0.00498575332766946,0.00689809706978925,EPCI
240300566,CC du Val de Cher,1990_1999,1994.5,9,5538,5421,607,476,-117,-131,14,-0.00236975706745368,-0.00265331774219173,0.000283560674738048,EPCI
240300566,CC du Val de Cher,1999_2006,2002.5,7,5421,5548,450,397,127,-53,180,0.00331364977842497,-0.0013828617185553,0.00469651149698027,EPCI
240300657,CC du Pays d'Huriel,2006_2011,2008.5,5,7310,7621,399,411,311,12,299,0.00836767913277403,0.00032286864820993,0.0080448104845641,EPCI
240300657,CC du Pays d'Huriel,2011_2016,2013.5,5,7621,7596,409,366,-25,-43,18,-0.000656944464219933,-0.00112994447845828,0.000473000014238352,EPCI
240300657,CC du Pays d'Huriel,1968_1975,1971.5,7,8856,7706,972,539,-1150,-433,-717,-0.0196747257478089,-0.00740796195547936,-0.0122667637923296,EPCI
240300657,CC du Pays d'Huriel,1975_1982,1978.5,7,7706,7425,922,418,-281,-504,223,-0.00529259624255374,-0.00949277048486507,0.00420017424231133,EPCI
240300657,CC du Pays d'Huriel,1982_1990,1986,8,7425,7554,886,504,129,-382,511,0.00215538696430162,-0.00638261876250557,0.00853800572680719,EPCI
240300657,CC du Pays d'Huriel,1990_1999,1994.5,9,7554,7153,877,482,-401,-395,-6,-0.00604226886664783,-0.00595186085368053,-9.04080129672993e-05,EPCI
240300657,CC du Pays d'Huriel,1999_2006,2002.5,7,7153,7310,633,512,157,-121,278,0.00310644712846209,-0.00239414078053447,0.00550058790899656,EPCI
240400440,CC Pays Forcalquier et Montagne de Lure,2006_2011,2008.5,5,9057,9262,665,390,205,-275,480,0.00448644783978902,-0.00601840563874137,0.0105048534785304,EPCI
240400440,CC Pays Forcalquier et Montagne de Lure,2011_2016,2013.5,5,9262,9698,602,424,436,-178,614,0.00924238359645568,-0.00377326669763558,0.0130156502940913,EPCI
240400440,CC Pays Forcalquier et Montagne de Lure,1968_1975,1971.5,7,5160,5484,554,415,324,-139,463,0.00873769303577143,-0.00374857818509947,0.0124862712208709,EPCI
240400440,CC Pays Forcalquier et Montagne de Lure,1975_1982,1978.5,7,5484,6276,661,413,792,-248,1040,0.0194580405656288,-0.00609292179327771,0.0255509623589066,EPCI
240400440,CC Pays Forcalquier et Montagne de Lure,1982_1990,1986,8,6276,7461,766,669,1185,-97,1282,0.0218549737187252,-0.00178897253225008,0.0236439462509753,EPCI
240400440,CC Pays Forcalquier et Montagne de Lure,1990_1999,1994.5,9,7461,8018,1016,750,557,-266,823,0.00803203630457361,-0.00383576599105311,0.0118678022956267,EPCI
240400440,CC Pays Forcalquier et Montagne de Lure,1999_2006,2002.5,7,8018,9057,927,557,1039,-370,1409,0.0175593738500632,-0.00625309752119672,0.02381247137126,EPCI
240500439,CC du Briançonnais,2006_2011,2008.5,5,19755,20267,722,1235,512,513,-1,0.00513058132243338,0.00514060198907876,-1.00206666453773e-05,EPCI
240500439,CC du Briançonnais,2011_2016,2013.5,5,20267,20590,730,1062,323,332,-9,0.00316732009245446,0.00325557359348261,-8.8253501028143e-05,EPCI
240500439,CC du Briançonnais,1968_1975,1971.5,7,13273,14643,865,1713,1370,848,522,0.0141318535954336,0.0087473079189253,0.00538454567650826,EPCI
240500439,CC du Briançonnais,1975_1982,1978.5,7,14643,16072,953,1753,1429,800,629,0.0133911868636079,0.00749681559894072,0.00589437126466714,EPCI
240500439,CC du Briançonnais,1982_1990,1986,8,16072,18347,1059,2146,2275,1087,1188,0.0166861144500268,0.0079726621570018,0.00871345229302497,EPCI
240500439,CC du Briançonnais,1990_1999,1994.5,9,18347,18613,1269,2330,266,1061,-795,0.00160063386235332,0.00638448318780778,-0.00478384932545447,EPCI
240500439,CC du Briançonnais,1999_2006,2002.5,7,18613,19755,1018,1734,1142,716,426,0.00854290735250474,0.00535614856777004,0.00318675878473469,EPCI
240500462,CC du Pays des Ecrins,2006_2011,2008.5,5,6431,6624,251,357,193,106,87,0.00593139546171217,0.00325765761109581,0.00267373785061637,EPCI
240500462,CC du Pays des Ecrins,2011_2016,2013.5,5,6624,6689,255,358,65,103,-38,0.00195490214519434,0.00309776801469257,-0.00114286586949823,EPCI
240500462,CC du Pays des Ecrins,1968_1975,1971.5,7,4946,5012,386,497,66,111,-45,0.0018954895927592,0.00318786886054957,-0.00129237926779037,EPCI
240500462,CC du Pays des Ecrins,1975_1982,1978.5,7,5012,5468,411,490,456,79,377,0.0125173922723703,0.00216858331034485,0.0103488089620254,EPCI
240500462,CC du Pays des Ecrins,1982_1990,1986,8,5468,5462,396,621,-6,225,-231,-0.000137227559710684,0.00514603348915066,-0.00528326104886134,EPCI
240500462,CC du Pays des Ecrins,1990_1999,1994.5,9,5462,5912,495,651,450,156,294,0.00883537694712566,0.00306293067500356,0.0057724462721221,EPCI
240500462,CC du Pays des Ecrins,1999_2006,2002.5,7,5912,6431,370,466,519,96,423,0.0120933782876917,0.00223692546361928,0.00985645282407246,EPCI
240600551,CA de la Riviera Française,2006_2011,2008.5,5,70148,71672,3265,1066,1524,-2199,3723,0.00430782401003249,-0.00621581692786184,0.0105236409378943,EPCI
240600551,CA de la Riviera Française,2011_2016,2013.5,5,71672,72506,3345,1084,834,-2261,3095,0.00231651132825972,-0.00628013442829163,0.00859664575655135,EPCI
240600551,CA de la Riviera Française,1968_1975,1971.5,7,59119,58648,4919,3360,-471,-1559,1088,-0.0011420456298018,-0.00378014678739068,0.00263810115758888,EPCI
240600551,CA de la Riviera Française,1975_1982,1978.5,7,58648,60266,5140,3517,1618,-1623,3241,0.00389537064818324,-0.0039074082583445,0.00780277890652774,EPCI
240600551,CA de la Riviera Française,1982_1990,1986,8,60266,67293,7201,4822,7027,-2379,9406,0.0138814805582821,-0.00469959331836532,0.0185810738766474,EPCI
240600551,CA de la Riviera Française,1990_1999,1994.5,9,67293,67882,6529,2925,589,-3604,4193,0.000968767211837918,-0.00592773689552437,0.00689650410736229,EPCI
240600551,CA de la Riviera Française,1999_2006,2002.5,7,67882,70148,4890,2157,2266,-2733,4999,0.00470193271634778,-0.00567095415435944,0.0103728868707072,EPCI
240600585,CA de Sophia Antipolis,2006_2011,2008.5,5,177180,176933,7651,9571,-247,1920,-2167,-0.000278968110053457,0.00216849704980825,-0.00244746515986171,EPCI
240600585,CA de Sophia Antipolis,2011_2016,2013.5,5,176933,175868,8318,9648,-1065,1330,-2395,-0.00120675452384034,0.00150702677625131,-0.00271378130009165,EPCI
240600585,CA de Sophia Antipolis,1968_1975,1971.5,7,82327,101874,7141,7148,19547,7,19540,0.0309017943266485,1.10662792390924e-05,0.0308907280474094,EPCI
240600585,CA de Sophia Antipolis,1975_1982,1978.5,7,101874,122565,8954,8710,20691,-244,20935,0.0267669310947158,-0.000315650823406827,0.0270825819181227,EPCI
240600585,CA de Sophia Antipolis,1982_1990,1986,8,122565,149858,11600,12993,27293,1393,25900,0.0254492760905047,0.00129889867709937,0.0241503774134054,EPCI
240600585,CA de Sophia Antipolis,1990_1999,1994.5,9,149858,161120,13989,16372,11262,2383,8879,0.00808374846271209,0.00171049303735064,0.00637325542536145,EPCI
240600585,CA de Sophia Antipolis,1999_2006,2002.5,7,161120,177180,11183,13012,16060,1829,14231,0.0136663619619601,0.00155639950363793,0.0121099624583222,EPCI
240600593,CC du Pays des Paillons,2006_2011,2008.5,5,24858,25691,1692,1164,833,-528,1361,0.00661399725127221,-0.00419230558063833,0.0108063028319105,EPCI
240600593,CC du Pays des Paillons,2011_2016,2013.5,5,25691,26649,1709,1341,958,-368,1326,0.00734905078271253,-0.0028230174196641,0.0101720682023766,EPCI
240600593,CC du Pays des Paillons,1968_1975,1971.5,7,12337,13343,1483,957,1006,-526,1532,0.0112613693940973,-0.00588815139293754,0.0171495207870348,EPCI
240600593,CC du Pays des Paillons,1975_1982,1978.5,7,13343,17224,1661,934,3881,-727,4608,0.0371464277106481,-0.00695837488936903,0.0441048026000172,EPCI
240600593,CC du Pays des Paillons,1982_1990,1986,8,17224,21119,2006,1658,3895,-348,4243,0.0258111532488432,-0.00230610560477469,0.0281172588536179,EPCI
240600593,CC du Pays des Paillons,1990_1999,1994.5,9,21119,23415,2784,2077,2296,-707,3003,0.0115330804989473,-0.00355134490973682,0.0150844254086841,EPCI
240600593,CC du Pays des Paillons,1999_2006,2002.5,7,23415,24858,2496,1697,1443,-799,2242,0.0085798534254935,-0.00475072965139938,0.0133305830768929,EPCI
240700302,CC du Pays Beaume-Drobie,2006_2011,2008.5,5,7668,8417,493,383,749,-110,859,0.0188143294066714,-0.00276311913849646,0.0215774485451678,EPCI
240700302,CC du Pays Beaume-Drobie,2011_2016,2013.5,5,8417,8730,584,354,313,-230,543,0.00732910731894876,-0.0053856060171189,0.0127147133360677,EPCI
240700302,CC du Pays Beaume-Drobie,1968_1975,1971.5,7,6535,6161,797,385,-374,-412,38,-0.00838369417912876,-0.0092355133737996,0.000851819194670837,EPCI
240700302,CC du Pays Beaume-Drobie,1975_1982,1978.5,7,6161,6479,828,377,318,-451,769,0.0072154893010461,-0.0102332882854459,0.017448777586492,EPCI
240700302,CC du Pays Beaume-Drobie,1982_1990,1986,8,6479,6951,905,474,472,-431,903,0.00882866436240692,-0.00806176766990971,0.0168904320323166,EPCI
240700302,CC du Pays Beaume-Drobie,1990_1999,1994.5,9,6951,7057,994,515,106,-479,585,0.00168302557826894,-0.0076053703018002,0.00928839588006914,EPCI
240700302,CC du Pays Beaume-Drobie,1999_2006,2002.5,7,7057,7668,750,440,611,-310,921,0.0119328917498822,-0.00605433132972747,0.0179872230796097,EPCI
240700617,CC Val de Ligne,2006_2011,2008.5,5,5955,6167,383,294,212,-89,301,0.00702078963292041,-0.00294740696853734,0.00996819660145775,EPCI
240700617,CC Val de Ligne,2011_2016,2013.5,5,6167,6138,389,282,-29,-107,78,-0.000942263752808703,-0.00347662832932866,0.00253436457651996,EPCI
240700617,CC Val de Ligne,1968_1975,1971.5,7,6104,5729,566,638,-375,72,-447,-0.00901671746138621,0.00173120975258615,-0.0107479272139724,EPCI
240700617,CC Val de Ligne,1975_1982,1978.5,7,5729,5818,541,457,89,-84,173,0.00220465019619009,-0.00208079344359515,0.00428544363978524,EPCI
240700617,CC Val de Ligne,1982_1990,1986,8,5818,5630,585,514,-188,-71,-117,-0.00409747209947275,-0.00154744956948173,-0.00255002252999102,EPCI
240700617,CC Val de Ligne,1990_1999,1994.5,9,5630,5640,629,537,10,-92,102,0.000197199814479632,-0.00181423829321261,0.00201143810769224,EPCI
240700617,CC Val de Ligne,1999_2006,2002.5,7,5640,5955,540,363,315,-177,492,0.00779409379774321,-0.00437953841968428,0.0121736322174275,EPCI
240700716,CC du Val d'Ay,2006_2011,2008.5,5,5501,5793,348,330,292,-18,310,0.0103977645834987,-0.00064095809076362,0.0110387226742623,EPCI
240700716,CC du Val d'Ay,2011_2016,2013.5,5,5793,5906,314,320,113,6,107,0.00387117194577868,0.000205548952873205,0.00366562299290548,EPCI
240700716,CC du Val d'Ay,1968_1975,1971.5,7,5103,4919,482,491,-184,9,-193,-0.00523245480614232,0.000255935289430874,-0.00548839009557319,EPCI
240700716,CC du Val d'Ay,1975_1982,1978.5,7,4919,4939,460,397,20,-63,83,0.000579828570675067,-0.00182645999762646,0.00240628856830153,EPCI
240700716,CC du Val d'Ay,1982_1990,1986,8,4939,5126,498,449,187,-49,236,0.0046561496316655,-0.00122006059867171,0.0058762102303372,EPCI
240700716,CC du Val d'Ay,1990_1999,1994.5,9,5126,5089,509,452,-37,-57,20,-0.000804596176009476,-0.00123951302790649,0.000434916851897014,EPCI
240700716,CC du Val d'Ay,1999_2006,2002.5,7,5089,5501,499,396,412,-103,515,0.0111832915623364,-0.00279582289058411,0.0139791144529206,EPCI
240700815,CC Berg et Coiron,2006_2011,2008.5,5,6533,7015,359,371,482,12,470,0.0143387187399258,0.00035698054954172,0.013981738190384,EPCI
240700815,CC Berg et Coiron,2011_2016,2013.5,5,7015,7587,398,386,572,-12,584,0.0158006391164658,-0.000331481939506275,0.0161321210559721,EPCI
240700815,CC Berg et Coiron,1968_1975,1971.5,7,4346,4157,469,347,-189,-122,-67,-0.00633161624156975,-0.00408707503424079,-0.00224454120732896,EPCI
240700815,CC Berg et Coiron,1975_1982,1978.5,7,4157,4720,494,267,563,-227,790,0.01831064099363,-0.00738279841128599,0.025693439404916,EPCI
240700815,CC Berg et Coiron,1982_1990,1986,8,4720,5099,570,416,379,-154,533,0.0097012099053595,-0.00394191642592444,0.0136431263312839,EPCI
240700815,CC Berg et Coiron,1990_1999,1994.5,9,5099,5733,661,487,634,-174,808,0.0131067628203072,-0.00359712418096759,0.0167038870012748,EPCI
240700815,CC Berg et Coiron,1999_2006,2002.5,7,5733,6533,435,483,800,48,752,0.0188362485402589,0.00113017491241553,0.0177060736278434,EPCI
240700864,CC du Rhône aux Gorges de l'Ardèche,2006_2011,2008.5,5,18206,18862,1039,1132,656,93,563,0.00710474097042035,0.00100722699733093,0.00609751397308942,EPCI
240700864,CC du Rhône aux Gorges de l'Ardèche,2011_2016,2013.5,5,18862,18955,1149,1160,93,11,82,0.000984170547635665,0.000116407269075186,0.000867763278560479,EPCI
240700864,CC du Rhône aux Gorges de l'Ardèche,1968_1975,1971.5,7,13846,13445,980,1463,-401,483,-884,-0.00418964065530647,0.00504637515339907,-0.00923601580870554,EPCI
240700864,CC du Rhône aux Gorges de l'Ardèche,1975_1982,1978.5,7,13445,14937,1105,1292,1492,187,1305,0.0151470086219541,0.00189845215301971,0.0132485564689344,EPCI
240700864,CC du Rhône aux Gorges de l'Ardèche,1982_1990,1986,8,14937,16261,1167,1661,1324,494,830,0.0106725808045429,0.00398206564761647,0.00669051515692645,EPCI
240700864,CC du Rhône aux Gorges de l'Ardèche,1990_1999,1994.5,9,16261,17031,1628,1800,770,172,598,0.0051538590090785,0.00115125162280715,0.00400260738627135,EPCI
240700864,CC du Rhône aux Gorges de l'Ardèche,1999_2006,2002.5,7,17031,18206,1467,1472,1175,5,1170,0.00957641999902714,4.07507234001155e-05,0.00953566927562703,EPCI
240800821,"CC Ardenne, Rives de Meuse",2006_2011,2008.5,5,29861,28654,1262,1161,-1207,-101,-1106,-0.00821809166776932,-0.000687677927460399,-0.00753041374030892,EPCI
240800821,"CC Ardenne, Rives de Meuse",2011_2016,2013.5,5,28654,27333,1231,812,-1321,-419,-902,-0.00939524351001986,-0.00298002046230002,-0.00641522304771984,EPCI
240800821,"CC Ardenne, Rives de Meuse",1968_1975,1971.5,7,38474,37697,2529,5386,-777,2857,-3634,-0.00291035280156926,0.0107012586281639,-0.0136116114297332,EPCI
240800821,"CC Ardenne, Rives de Meuse",1975_1982,1978.5,7,37697,35783,2457,4101,-1914,1644,-3558,-0.00741630468232102,0.00637011750142934,-0.0137864221837504,EPCI
240800821,"CC Ardenne, Rives de Meuse",1982_1990,1986,8,35783,34724,2517,4258,-1059,1741,-2800,-0.00374818666623178,0.00616203303674176,-0.00991021970297354,EPCI
240800821,"CC Ardenne, Rives de Meuse",1990_1999,1994.5,9,34724,32616,2788,3945,-2108,1157,-3265,-0.00693452500214919,0.00380609365630295,-0.0107406186584521,EPCI
240800821,"CC Ardenne, Rives de Meuse",1999_2006,2002.5,7,32616,29861,2101,2479,-2755,378,-3133,-0.0125279612168692,0.00171889994191526,-0.0142468611587844,EPCI
240800847,CC des Portes du Luxembourg,2006_2011,2008.5,5,20409,20521,1029,1185,112,156,-44,0.00109515364880686,0.00152539258226669,-0.000430238933459837,EPCI
240800847,CC des Portes du Luxembourg,2011_2016,2013.5,5,20521,20384,1062,1081,-137,19,-156,-0.00133879754366195,0.000185672652040709,-0.00152447019570266,EPCI
240800847,CC des Portes du Luxembourg,1968_1975,1971.5,7,24257,23541,1972,2710,-716,738,-1454,-0.00427108908839713,0.00440232366932553,-0.00867341275772266,EPCI
240800847,CC des Portes du Luxembourg,1975_1982,1978.5,7,23541,22117,1887,2106,-1424,219,-1643,-0.00887425191270441,0.00136479014668698,-0.0102390420593914,EPCI
240800847,CC des Portes du Luxembourg,1982_1990,1986,8,22117,20703,1834,2199,-1414,365,-1779,-0.00822448313166813,0.00212301014360599,-0.0103474932752741,EPCI
240800847,CC des Portes du Luxembourg,1990_1999,1994.5,9,20703,20171,2060,2021,-532,-39,-493,-0.00288834157949391,-0.000211739326316283,-0.00267660225317763,EPCI
240800847,CC des Portes du Luxembourg,1999_2006,2002.5,7,20171,20409,1591,1717,238,126,112,0.00167712633616435,0.000887890413263478,0.000789235922900869,EPCI
240800862,CC des Crêtes Préardennaises,2006_2011,2008.5,5,21087,21739,908,1344,652,436,216,0.00610881227407845,0.00408503397469049,0.00202377829938795,EPCI
240800862,CC des Crêtes Préardennaises,2011_2016,2013.5,5,21739,21968,970,1274,229,304,-75,0.002097991019961,0.00278510598283032,-0.000687114962869323,EPCI
240800862,CC des Crêtes Préardennaises,1968_1975,1971.5,7,23047,21028,2247,2211,-2019,-36,-1983,-0.0130118508844622,-0.000232009228251927,-0.0127798416562103,EPCI
240800862,CC des Crêtes Préardennaises,1975_1982,1978.5,7,21028,20005,2119,1717,-1023,-402,-621,-0.00709934270705792,-0.00278977103444505,-0.00430957167261287,EPCI
240800862,CC des Crêtes Préardennaises,1982_1990,1986,8,20005,20207,1995,1988,202,-7,209,0.00125664350586585,-4.35470521834701e-05,0.00130019055804932,EPCI
240800862,CC des Crêtes Préardennaises,1990_1999,1994.5,9,20207,20243,1967,1899,36,-68,104,0.000197794641901172,-0.000373612101368881,0.000571406743270053,EPCI
240800862,CC des Crêtes Préardennaises,1999_2006,2002.5,7,20243,21087,1449,1759,844,310,534,0.00585244216873382,0.00214959368756811,0.00370284848116571,EPCI
240800920,CC de l'Argonne Ardennaise,2006_2011,2008.5,5,18067,17943,1056,1000,-124,-56,-68,-0.00137645243142037,-0.000621623678705974,-0.000754828752714398,EPCI
240800920,CC de l'Argonne Ardennaise,2011_2016,2013.5,5,17943,17397,1111,947,-546,-164,-382,-0.00616139809030181,-0.00185067634946794,-0.00431072174083386,EPCI
240800920,CC de l'Argonne Ardennaise,1968_1975,1971.5,7,22602,20886,2107,2357,-1716,250,-1966,-0.011216523265031,0.00163410886728307,-0.012850632132314,EPCI
240800920,CC de l'Argonne Ardennaise,1975_1982,1978.5,7,20886,19636,1903,1782,-1250,-121,-1129,-0.00877760162759589,-0.000849671837551282,-0.00792792979004461,EPCI
240800920,CC de l'Argonne Ardennaise,1982_1990,1986,8,19636,18878,2027,1934,-758,-93,-665,-0.00490883625035588,-0.000602271466072687,-0.00430656478428319,EPCI
240800920,CC de l'Argonne Ardennaise,1990_1999,1994.5,9,18878,18220,2045,1911,-658,-134,-524,-0.00393416648426914,-0.000801182840261497,-0.00313298364400765,EPCI
240800920,CC de l'Argonne Ardennaise,1999_2006,2002.5,7,18220,18067,1510,1397,-153,-113,-40,-0.00120396351653362,-0.000889201812864702,-0.000314761703668921,EPCI
240900431,CC du Pays de Tarascon,2006_2011,2008.5,5,8707,8871,504,366,164,-138,302,0.00373901869335302,-0.00314624743708974,0.00688526613044277,EPCI
240900431,CC du Pays de Tarascon,2011_2016,2013.5,5,8871,8498,517,316,-373,-201,-172,-0.0085545374912579,-0.00460981779019527,-0.00394471970106262,EPCI
240900431,CC du Pays de Tarascon,1968_1975,1971.5,7,8875,9134,862,777,259,-85,344,0.00411779482914754,-0.00135139984740363,0.00546919467655117,EPCI
240900431,CC du Pays de Tarascon,1975_1982,1978.5,7,9134,8947,888,663,-187,-225,38,-0.00295070013001508,-0.00355030764306628,0.000599607513051193,EPCI
240900431,CC du Pays de Tarascon,1982_1990,1986,8,8947,8574,931,695,-373,-236,-137,-0.00530884704620438,-0.00335894880135183,-0.00194989824485255,EPCI
240900431,CC du Pays de Tarascon,1990_1999,1994.5,9,8574,8406,995,711,-168,-284,116,-0.00219632139243553,-0.00371282902054578,0.00151650762811025,EPCI
240900431,CC du Pays de Tarascon,1999_2006,2002.5,7,8406,8707,749,492,301,-257,558,0.00503858881935559,-0.00430205091885179,0.00934063973820738,EPCI
240900464,CC du Pays d'Olmes,2006_2011,2008.5,5,16334,15768,958,641,-566,-317,-249,-0.00702843522046881,-0.00393642043266539,-0.00309201478780342,EPCI
240900464,CC du Pays d'Olmes,2011_2016,2013.5,5,15768,15046,1013,557,-722,-456,-266,-0.00933027923196095,-0.00589280793597534,-0.00343747129598561,EPCI
240900464,CC du Pays d'Olmes,1968_1975,1971.5,7,17769,19224,1442,1904,1455,462,993,0.0113068926093307,0.00359022981822047,0.00771666279111024,EPCI
240900464,CC du Pays d'Olmes,1975_1982,1978.5,7,19224,19093,1543,1696,-131,153,-284,-0.000976340598038861,0.00114030619465607,-0.00211664679269493,EPCI
240900464,CC du Pays d'Olmes,1982_1990,1986,8,19093,18661,1718,1638,-432,-80,-352,-0.00285666085458902,-0.000529011269368337,-0.00232764958522068,EPCI
240900464,CC du Pays d'Olmes,1990_1999,1994.5,9,18661,16550,1904,1439,-2111,-465,-1646,-0.0132502853653876,-0.00291870331355057,-0.0103315820518371,EPCI
240900464,CC du Pays d'Olmes,1999_2006,2002.5,7,16550,16334,1433,953,-216,-480,264,-0.00187499383971035,-0.00416665297713411,0.00229165913742376,EPCI
241000223,"CC Forêts, Lacs, Terres en Champagne",2006_2011,2008.5,5,6163,6782,232,434,619,202,417,0.0193260507383701,0.00630672415048589,0.0130193265878842,EPCI
241000223,"CC Forêts, Lacs, Terres en Champagne",2011_2016,2013.5,5,6782,6894,267,399,112,132,-20,0.0032812564530651,0.00386719510539815,-0.000585938652333053,EPCI
241000223,"CC Forêts, Lacs, Terres en Champagne",1968_1975,1971.5,7,4992,4950,425,550,-42,125,-167,-0.00120627964288134,0.00359011798476588,-0.00479639762764722,EPCI
241000223,"CC Forêts, Lacs, Terres en Champagne",1975_1982,1978.5,7,4950,5259,404,431,309,27,282,0.00868799747460702,0.000759145410402555,0.00792885206420447,EPCI
241000223,"CC Forêts, Lacs, Terres en Champagne",1982_1990,1986,8,5259,5342,439,455,83,16,67,0.00195931947291528,0.000377700139357162,0.00158161933355812,EPCI
241000223,"CC Forêts, Lacs, Terres en Champagne",1990_1999,1994.5,9,5342,5552,478,558,210,80,130,0.00429342473131422,0.00163559037383399,0.00265783435748023,EPCI
241000223,"CC Forêts, Lacs, Terres en Champagne",1999_2006,2002.5,7,5552,6163,343,504,611,161,450,0.0150268487464003,0.00395961153546717,0.0110672372109331,EPCI
241000405,CC de la Région de Bar-sur-Aube,2006_2011,2008.5,5,12654,11966,679,586,-688,-93,-595,-0.0111185421413998,-0.00150294246969504,-0.00961559967170481,EPCI
241000405,CC de la Région de Bar-sur-Aube,2011_2016,2013.5,5,11966,11440,724,460,-526,-264,-262,-0.00895036665384952,-0.00449219923311078,-0.00445816742073873,EPCI
241000405,CC de la Région de Bar-sur-Aube,1968_1975,1971.5,7,14413,15228,1102,1985,815,883,-68,0.00788884876672946,0.00854705946137683,-0.000658210694647367,EPCI
241000405,CC de la Région de Bar-sur-Aube,1975_1982,1978.5,7,15228,14911,1062,1502,-317,440,-757,-0.0030007235040348,0.00416504208761928,-0.00716576559165407,EPCI
241000405,CC de la Région de Bar-sur-Aube,1982_1990,1986,8,14911,14262,1188,1565,-649,377,-1026,-0.00554712481957953,0.00322228976422416,-0.0087694145838037,EPCI
241000405,CC de la Région de Bar-sur-Aube,1990_1999,1994.5,9,14262,13292,1323,1431,-970,108,-1078,-0.0077957109391148,0.000867976063324122,-0.00866368700243892,EPCI
241000405,CC de la Région de Bar-sur-Aube,1999_2006,2002.5,7,13292,12654,955,950,-638,-5,-633,-0.00700236549467415,-5.48774725287942e-05,-0.00694748802214535,EPCI
241000447,CC du Pays d'Othe,2006_2011,2008.5,5,7573,7962,473,451,389,-22,411,0.0100685369217768,-0.000569428823339561,0.0106379657451163,EPCI
241000447,CC du Pays d'Othe,2011_2016,2013.5,5,7962,7905,512,352,-57,-160,103,-0.00143591886389283,-0.00403064944250618,0.00259473057861335,EPCI
241000447,CC du Pays d'Othe,1968_1975,1971.5,7,7264,6781,879,648,-483,-231,-252,-0.00978128578065718,-0.004678006242923,-0.00510327953773418,EPCI
241000447,CC du Pays d'Othe,1975_1982,1978.5,7,6781,6756,838,512,-25,-326,301,-0.000527515779765064,-0.00687880576813644,0.00635128998837137,EPCI
241000447,CC du Pays d'Othe,1982_1990,1986,8,6756,6711,900,587,-45,-313,268,-0.000835029639728591,-0.00580809504966775,0.00497306540993916,EPCI
241000447,CC du Pays d'Othe,1990_1999,1994.5,9,6711,6878,878,557,167,-321,488,0.00273483740061087,-0.00525678326704245,0.00799162066765331,EPCI
241000447,CC du Pays d'Othe,1999_2006,2002.5,7,6878,7573,607,589,695,-18,713,0.0138466139632214,-0.000358617340054655,0.0142052313032761,EPCI
241000488,CC de l'Orvin et de l'Ardusson,2006_2011,2008.5,5,7877,8336,367,496,459,129,330,0.0113916693289424,0.00320158026891846,0.00819008906002396,EPCI
241000488,CC de l'Orvin et de l'Ardusson,2011_2016,2013.5,5,8336,8492,411,499,156,88,68,0.00371509568963591,0.00209569500441,0.00161940068522591,EPCI
241000488,CC de l'Orvin et de l'Ardusson,1968_1975,1971.5,7,6485,6289,534,630,-196,96,-292,-0.00437465209759635,0.00214268674167985,-0.0065173388392762,EPCI
241000488,CC de l'Orvin et de l'Ardusson,1975_1982,1978.5,7,6289,6765,514,578,476,64,412,0.0104773911859897,0.00140872486534315,0.00906866632064652,EPCI
241000488,CC de l'Orvin et de l'Ardusson,1982_1990,1986,8,6765,7301,614,700,536,86,450,0.00957669882869827,0.00153655988669413,0.00804013894200415,EPCI
241000488,CC de l'Orvin et de l'Ardusson,1990_1999,1994.5,9,7301,7435,647,693,134,46,88,0.00202284929783803,0.000694410952989173,0.00132843834484885,EPCI
241000488,CC de l'Orvin et de l'Ardusson,1999_2006,2002.5,7,7435,7877,510,593,442,83,359,0.00828391484657765,0.00155557676983245,0.00672833807674519,EPCI
241100593,CA Le Grand Narbonne,2006_2011,2008.5,5,115134,122298,6175,6421,7164,246,6918,0.0121459748467139,0.000417072838119991,0.0117289020085939,EPCI
241100593,CA Le Grand Narbonne,2011_2016,2013.5,5,122298,127530,6790,6295,5232,-495,5727,0.00841338358390331,-0.000795990992743146,0.00920937457664646,EPCI
241100593,CA Le Grand Narbonne,1968_1975,1971.5,7,77535,78510,7070,6802,975,-268,1243,0.0017868170147608,-0.000491145599954763,0.00227796261471556,EPCI
241100593,CA Le Grand Narbonne,1975_1982,1978.5,7,78510,83903,7405,6088,5393,-1317,6710,0.00953594649514056,-0.00232873011943262,0.0118646766145732,EPCI
241100593,CA Le Grand Narbonne,1982_1990,1986,8,83903,94545,8635,7905,10642,-730,11372,0.0150387790690047,-0.00103160202221138,0.0160703810912161,EPCI
241100593,CA Le Grand Narbonne,1990_1999,1994.5,9,94545,100566,9607,9294,6021,-313,6334,0.00688339538091021,-0.000357831382531954,0.00724122676344216,EPCI
241100593,CA Le Grand Narbonne,1999_2006,2002.5,7,100566,115134,8044,8089,14568,45,14523,0.0195140199422963,6.02780681907834e-05,0.0194537418741055,EPCI
241200187,CA Rodez Agglomération,2006_2011,2008.5,5,51817,53266,2135,2959,1449,824,625,0.00553123071888906,0.00314543417002387,0.00238579654886519,EPCI
241200187,CA Rodez Agglomération,2011_2016,2013.5,5,53266,55345,2388,2975,2079,587,1492,0.00768701292172658,0.00217040720781794,0.00551660571390864,EPCI
241200187,CA Rodez Agglomération,1968_1975,1971.5,7,35398,41902,2116,5042,6504,2926,3578,0.0243895672290775,0.0109723053063162,0.0134172619227613,EPCI
241200187,CA Rodez Agglomération,1975_1982,1978.5,7,41902,46618,2267,5090,4716,2823,1893,0.0153528298822345,0.00919021178065056,0.00616261810158396,EPCI
241200187,CA Rodez Agglomération,1982_1990,1986,8,46618,48813,2758,4939,2195,2181,14,0.00576781241751623,0.00573102454788287,3.67878696333609e-05,EPCI
241200187,CA Rodez Agglomération,1990_1999,1994.5,9,48813,49433,3482,5027,620,1545,-925,0.00140337787432943,0.00349712712232091,-0.00209374924799148,EPCI
241200187,CA Rodez Agglomération,1999_2006,2002.5,7,49433,51817,2902,3865,2384,963,1421,0.00675126823856487,0.00272712722891693,0.00402414100964793,EPCI
241200542,CC du Réquistanais,2006_2011,2008.5,5,5720,5566,380,216,-154,-164,10,-0.00544355830517829,-0.00579703611720285,0.000353477812024564,EPCI
241200542,CC du Réquistanais,2011_2016,2013.5,5,5566,5376,375,182,-190,-193,3,-0.00692234142380277,-0.00703164155154703,0.000109300127744255,EPCI
241200542,CC du Réquistanais,1968_1975,1971.5,7,8253,7588,687,656,-665,-31,-634,-0.0119295177859541,-0.000556112859194852,-0.0113734049267592,EPCI
241200542,CC du Réquistanais,1975_1982,1978.5,7,7588,7051,663,475,-537,-188,-349,-0.0104307331071022,-0.00365172779168568,-0.00677900531541651,EPCI
241200542,CC du Réquistanais,1982_1990,1986,8,7051,6274,714,511,-777,-203,-574,-0.0144884353179762,-0.00378526688487666,-0.0107031684330995,EPCI
241200542,CC du Réquistanais,1990_1999,1994.5,9,6274,5680,714,441,-594,-273,-321,-0.0109905880598593,-0.00505122986589493,-0.00593935819396437,EPCI
241200542,CC du Réquistanais,1999_2006,2002.5,7,5680,5720,516,351,40,-165,205,0.00100301306130457,-0.00413742887788135,0.00514044193918592,EPCI
241200567,CC de Millau Grands Causses,2006_2011,2008.5,5,29459,28978,1562,1648,-481,86,-567,-0.00328709458203857,0.000587713376414381,-0.00387480795845296,EPCI
241200567,CC de Millau Grands Causses,2011_2016,2013.5,5,28978,29820,1625,1392,842,-233,1075,0.00574491669070221,-0.00158974535502805,0.00733466204573025,EPCI
241200567,CC de Millau Grands Causses,1968_1975,1971.5,7,27490,26967,2464,2701,-523,237,-760,-0.00274029650249819,0.00124177872101734,-0.00398207522351553,EPCI
241200567,CC de Millau Grands Causses,1975_1982,1978.5,7,26967,27167,2237,2216,200,-21,221,0.0010561437821397,-0.000110895097124668,0.00116703887926436,EPCI
241200567,CC de Millau Grands Causses,1982_1990,1986,8,27167,27916,2653,2412,749,-241,990,0.0034054102431198,-0.00109573280185831,0.00450114304497811,EPCI
241200567,CC de Millau Grands Causses,1990_1999,1994.5,9,27916,28112,2872,2676,196,-196,392,0.000777694502101411,-0.000777694502101411,0.00155538900420282,EPCI
241200567,CC de Millau Grands Causses,1999_2006,2002.5,7,28112,29459,2329,2139,1347,-190,1537,0.00670853561676932,-0.00094626708774029,0.00765480270450961,EPCI
241200625,CC du Pays Rignacois,2006_2011,2008.5,5,4982,5390,314,285,408,-29,437,0.0158673642296072,-0.00112782735945738,0.0169951915890646,EPCI
241200625,CC du Pays Rignacois,2011_2016,2013.5,5,5390,5492,325,273,102,-52,154,0.0037564584676002,-0.00191505725799226,0.00567151572559246,EPCI
241200625,CC du Pays Rignacois,1968_1975,1971.5,7,5696,5230,521,393,-466,-128,-338,-0.012119234156727,-0.00332888835206235,-0.00879034580466465,EPCI
241200625,CC du Pays Rignacois,1975_1982,1978.5,7,5230,4977,494,310,-253,-184,-69,-0.00705839712939638,-0.00513337973047009,-0.00192501739892628,EPCI
241200625,CC du Pays Rignacois,1982_1990,1986,8,4977,4760,536,327,-217,-209,-8,-0.00555695663200106,-0.0053520918713743,-0.000204864760626767,EPCI
241200625,CC du Pays Rignacois,1990_1999,1994.5,9,4760,4618,611,301,-142,-310,168,-0.00335945074316291,-0.00733401218577818,0.00397456144261527,EPCI
241200625,CC du Pays Rignacois,1999_2006,2002.5,7,4618,4982,428,350,364,-78,442,0.0108974790586409,-0.00233517408399448,0.0132326531426354,EPCI
241200641,CC Conques-Marcillac,2006_2011,2008.5,5,11278,11893,664,577,615,-87,702,0.0106757972322915,-0.00151023473042173,0.0121860319627132,EPCI
241200641,CC Conques-Marcillac,2011_2016,2013.5,5,11893,11855,665,522,-38,-143,105,-0.000639849654396119,-0.00240785527838539,0.00176800562398927,EPCI
241200641,CC Conques-Marcillac,1968_1975,1971.5,7,10327,10101,1049,792,-226,-257,31,-0.00315606566983784,-0.00358897733251471,0.000432911662676872,EPCI
241200641,CC Conques-Marcillac,1975_1982,1978.5,7,10101,10382,1071,692,281,-379,660,0.00392756540019001,-0.00529732130488262,0.00922488670507263,EPCI
241200641,CC Conques-Marcillac,1982_1990,1986,8,10382,10183,1214,789,-199,-425,226,-0.00241631028810851,-0.00516046167058351,0.002744151382475,EPCI
241200641,CC Conques-Marcillac,1990_1999,1994.5,9,10183,10578,1231,910,395,-321,716,0.00423747609184955,-0.00344361981135115,0.0076810959032007,EPCI
241200641,CC Conques-Marcillac,1999_2006,2002.5,7,10578,11278,971,801,700,-170,870,0.00919596151375512,-0.00223330493905482,0.0114292664528099,EPCI
241200658,CC du Pays de Salars,2006_2011,2008.5,5,7352,7666,335,401,314,66,248,0.00839959668986312,0.00176552032334703,0.0066340763665161,EPCI
241200658,CC du Pays de Salars,2011_2016,2013.5,5,7666,7849,360,388,183,28,155,0.00472938202826567,0.000723621293942289,0.00400576073432338,EPCI
241200658,CC du Pays de Salars,1968_1975,1971.5,7,6278,6224,535,570,-54,35,-89,-0.00123333475157861,0.000799383635282431,-0.00203271838686104,EPCI
241200658,CC du Pays de Salars,1975_1982,1978.5,7,6224,6495,544,505,271,-39,310,0.00610712479932918,-0.000878885118722649,0.00698600991805183,EPCI
241200658,CC du Pays de Salars,1982_1990,1986,8,6495,6709,606,575,214,-31,245,0.00406037839732765,-0.00058818565568765,0.0046485640530153,EPCI
241200658,CC du Pays de Salars,1990_1999,1994.5,9,6709,6885,672,611,176,-61,237,0.00288139031475643,-0.000998663688637171,0.0038800540033936,EPCI
241200658,CC du Pays de Salars,1999_2006,2002.5,7,6885,7352,531,629,467,98,369,0.009419407834518,0.00197666374257551,0.00744274409194249,EPCI
241200674,CC du Plateau de Montbazens,2006_2011,2008.5,5,5882,6085,405,316,203,-89,292,0.00680905417550681,-0.00298525035280841,0.00979430452831522,EPCI
241200674,CC du Plateau de Montbazens,2011_2016,2013.5,5,6085,6208,454,311,123,-143,266,0.0040104316330154,-0.00466253433757075,0.00867296597058615,EPCI
241200674,CC du Plateau de Montbazens,1968_1975,1971.5,7,6814,6515,636,466,-299,-170,-129,-0.00638979908815618,-0.00363299613707876,-0.00275680295107741,EPCI
241200674,CC du Plateau de Montbazens,1975_1982,1978.5,7,6515,6364,606,434,-151,-172,21,-0.00334440926300728,-0.00380952578302815,0.000465116520020879,EPCI
241200674,CC du Plateau de Montbazens,1982_1990,1986,8,6364,5894,684,377,-470,-307,-163,-0.00954443820804474,-0.00623434580823348,-0.00331009239981126,EPCI
241200674,CC du Plateau de Montbazens,1990_1999,1994.5,9,5894,5594,695,416,-300,-279,-21,-0.0057876631874727,-0.00538252676434961,-0.000405136423123089,EPCI
241200674,CC du Plateau de Montbazens,1999_2006,2002.5,7,5594,5882,546,354,288,-192,480,0.00719752791927197,-0.00479835194618132,0.0119958798654533,EPCI
241200765,CC de Lévézou Pareloup,2006_2011,2008.5,5,5504,5533,308,259,29,-49,78,0.00105156516433569,-0.00177678251904996,0.00282834768338564,EPCI
241200765,CC de Lévézou Pareloup,2011_2016,2013.5,5,5533,5426,289,230,-107,-59,-48,-0.0038979730388583,-0.00214934961955738,-0.00174862341930092,EPCI
241200765,CC de Lévézou Pareloup,1968_1975,1971.5,7,7610,6987,613,681,-623,68,-691,-0.0121275600189019,0.00132371441618833,-0.0134512744350902,EPCI
241200765,CC de Lévézou Pareloup,1975_1982,1978.5,7,6987,6797,597,560,-190,-37,-153,-0.00393081706269638,-0.000765474901682979,-0.0031653421610134,EPCI
241200765,CC de Lévézou Pareloup,1982_1990,1986,8,6797,5951,596,471,-846,-125,-721,-0.0164779861318483,-0.002434690622318,-0.0140432955095303,EPCI
241200765,CC de Lévézou Pareloup,1990_1999,1994.5,9,5951,5538,698,449,-413,-249,-164,-0.00795991165861054,-0.00479907506778214,-0.0031608365908284,EPCI
241200765,CC de Lévézou Pareloup,1999_2006,2002.5,7,5538,5504,456,357,-34,-99,65,-0.000879373712361464,-0.00256052933893485,0.00168115562657339,EPCI
241200807,CC Aveyron Bas Ségala Viaur,2006_2011,2008.5,5,5898,5860,378,204,-38,-174,136,-0.00129190613067065,-0.0059155701772814,0.00462366404661075,EPCI
241200807,CC Aveyron Bas Ségala Viaur,2011_2016,2013.5,5,5860,5623,434,203,-237,-231,-6,-0.00822286065578348,-0.00801468696829529,-0.000208173687488189,EPCI
241200807,CC Aveyron Bas Ségala Viaur,1968_1975,1971.5,7,8200,7651,652,567,-549,-85,-464,-0.00985084456445651,-0.00152517629868634,-0.00832566826577016,EPCI
241200807,CC Aveyron Bas Ségala Viaur,1975_1982,1978.5,7,7651,7358,648,471,-293,-177,-116,-0.00556278460352522,-0.00336045349769271,-0.00220233110583251,EPCI
241200807,CC Aveyron Bas Ségala Viaur,1982_1990,1986,8,7358,6615,679,391,-743,-288,-455,-0.0132179108125511,-0.00512349705789329,-0.0080944137546578,EPCI
241200807,CC Aveyron Bas Ségala Viaur,1990_1999,1994.5,9,6615,6037,763,456,-578,-307,-271,-0.0101077473940131,-0.00536864783730454,-0.00473909955670856,EPCI
241200807,CC Aveyron Bas Ségala Viaur,1999_2006,2002.5,7,6037,5898,538,331,-139,-207,68,-0.00332216783660932,-0.00494740102286425,0.00162523318625492,EPCI
241200906,CC Larzac et Vallées,2006_2011,2008.5,5,5154,5294,422,230,140,-192,332,0.00537458988032635,-0.00737086612159043,0.0127454560019168,EPCI
241200906,CC Larzac et Vallées,2011_2016,2013.5,5,5294,5403,414,220,109,-194,303,0.00408436860228645,-0.00726942668663827,0.0113537952889247,EPCI
241200906,CC Larzac et Vallées,1968_1975,1971.5,7,5316,5069,576,283,-247,-293,46,-0.00677375135275538,-0.00803525970185152,0.00126150834909614,EPCI
241200906,CC Larzac et Vallées,1975_1982,1978.5,7,5069,5092,580,300,23,-280,303,0.000646940776679594,-0.00787580075957767,0.00852274153625726,EPCI
241200906,CC Larzac et Vallées,1982_1990,1986,8,5092,4531,587,342,-561,-245,-316,-0.0144850690562421,-0.00632592142384906,-0.00815914763239308,EPCI
241200906,CC Larzac et Vallées,1990_1999,1994.5,9,4531,4561,686,350,30,-336,366,0.000733516896987307,-0.00821538924625784,0.00894890614324515,EPCI
241200906,CC Larzac et Vallées,1999_2006,2002.5,7,4561,5154,500,321,593,-179,772,0.017614947094603,-0.00531715940966937,0.0229321065042724,EPCI
241200914,CC de la Muse et des Raspes du Tarn,2006_2011,2008.5,5,5301,5415,336,210,114,-126,240,0.0042645471006495,-0.00471344679545471,0.0089779938961042,EPCI
241200914,CC de la Muse et des Raspes du Tarn,2011_2016,2013.5,5,5415,5485,362,237,70,-125,195,0.00257214495823455,-0.0045931159968474,0.00716526095508195,EPCI
241200914,CC de la Muse et des Raspes du Tarn,1968_1975,1971.5,7,6666,5825,636,407,-841,-229,-612,-0.0190814538854165,-0.00519578233027393,-0.0138856715551426,EPCI
241200914,CC de la Muse et des Raspes du Tarn,1975_1982,1978.5,7,5825,5592,602,352,-233,-250,17,-0.00581474206857779,-0.00623899363581308,0.00042425156723529,EPCI
241200914,CC de la Muse et des Raspes du Tarn,1982_1990,1986,8,5592,5234,687,362,-358,-325,-33,-0.00823604649033694,-0.00747685784737292,-0.000759188642964019,EPCI
241200914,CC de la Muse et des Raspes du Tarn,1990_1999,1994.5,9,5234,5170,708,410,-64,-298,234,-0.0013660789066281,-0.00636080490898709,0.00499472600235899,EPCI
241200914,CC de la Muse et des Raspes du Tarn,1999_2006,2002.5,7,5170,5301,456,292,131,-164,295,0.00358108158918657,-0.00448318611165342,0.00806426770084,EPCI
241300375,CC Vallée des Baux-Alpilles (CC VBA),2006_2011,2008.5,5,26421,28329,1488,1305,1908,-183,2091,0.0140430635906543,-0.0013468976085376,0.0153899611991919,EPCI
241300375,CC Vallée des Baux-Alpilles (CC VBA),2011_2016,2013.5,5,28329,27649,1653,1324,-680,-329,-351,-0.00484750354675256,-0.00234533627482587,-0.00250216727192669,EPCI
241300375,CC Vallée des Baux-Alpilles (CC VBA),1968_1975,1971.5,7,17495,18562,1614,1456,1067,-158,1225,0.00849320063936765,-0.0012576623252297,0.00975086296459735,EPCI
241300375,CC Vallée des Baux-Alpilles (CC VBA),1975_1982,1978.5,7,18562,20926,1766,1419,2364,-347,2711,0.0172726078314607,-0.00253536164023556,0.0198079694716962,EPCI
241300375,CC Vallée des Baux-Alpilles (CC VBA),1982_1990,1986,8,20926,23781,2091,1964,2855,-127,2982,0.0161152900686172,-0.000716862290267737,0.016832152358885,EPCI
241300375,CC Vallée des Baux-Alpilles (CC VBA),1990_1999,1994.5,9,23781,25267,2319,2416,1486,97,1389,0.00675742394028545,0.000441096986680813,0.00631632695360463,EPCI
241300375,CC Vallée des Baux-Alpilles (CC VBA),1999_2006,2002.5,7,25267,26421,2082,1867,1154,-215,1369,0.00640038864843917,-0.00119244675859135,0.00759283540703052,EPCI
241300417,CA d'Arles-Crau-Camargue-Montagnette,2006_2011,2008.5,5,80790,81139,3621,5135,349,1514,-1165,0.000862479288165741,0.00374152906098261,-0.00287904977281687,EPCI
241300417,CA d'Arles-Crau-Camargue-Montagnette,2011_2016,2013.5,5,81139,85180,3963,5223,4041,1260,2781,0.00976798458787376,0.0030456967534573,0.00672228783441646,EPCI
241300417,CA d'Arles-Crau-Camargue-Montagnette,1968_1975,1971.5,7,62998,69113,4967,6651,6115,1684,4431,0.0133222271324829,0.0036687866706625,0.00965344046182038,EPCI
241300417,CA d'Arles-Crau-Camargue-Montagnette,1975_1982,1978.5,7,69113,74692,5106,6428,5579,1322,4257,0.0111517429698282,0.00264251733395105,0.00850922563587718,EPCI
241300417,CA d'Arles-Crau-Camargue-Montagnette,1982_1990,1986,8,74692,77702,5740,7686,3010,1946,1064,0.00495071520737289,0.00320069494802247,0.00175002025935042,EPCI
241300417,CA d'Arles-Crau-Camargue-Montagnette,1990_1999,1994.5,9,77702,78417,6551,8260,715,1709,-994,0.00101826736224231,0.00243387261828267,-0.00141560525604036,EPCI
241300417,CA d'Arles-Crau-Camargue-Montagnette,1999_2006,2002.5,7,78417,80790,5116,6610,2373,1494,879,0.00426800422705465,0.00268706207973858,0.00158094214731607,EPCI
241400415,CC Coeur Côte Fleurie,2006_2011,2008.5,5,21663,21918,1506,1047,255,-459,714,0.00234323728008912,-0.00421782710416041,0.00656106438424953,EPCI
241400415,CC Coeur Côte Fleurie,2011_2016,2013.5,5,21918,20997,1614,772,-921,-842,-79,-0.00854897721550318,-0.00781567732405394,-0.000733299891449241,EPCI
241400415,CC Coeur Côte Fleurie,1968_1975,1971.5,7,19144,19957,1723,2141,813,418,395,0.00595920129543504,0.0030638943929789,0.00289530690245614,EPCI
241400415,CC Coeur Côte Fleurie,1975_1982,1978.5,7,19957,19574,1738,1837,-383,99,-482,-0.00276442961956314,0.000714565358581594,-0.00347899497814473,EPCI
241400415,CC Coeur Côte Fleurie,1982_1990,1986,8,19574,20211,2035,2084,637,49,588,0.00401113009027365,0.000308548468482589,0.00370258162179106,EPCI
241400415,CC Coeur Côte Fleurie,1990_1999,1994.5,9,20211,21435,2337,2448,1224,111,1113,0.00655450843019634,0.000594403950777609,0.00596010447941873,EPCI
241400415,CC Coeur Côte Fleurie,1999_2006,2002.5,7,21435,21663,2010,1684,228,-326,554,0.00151266236231762,-0.00216284179875238,0.00367550416107,EPCI
241400514,CC du Pays de Falaise,2006_2011,2008.5,5,26464,27642,1249,1897,1178,648,530,0.00874825150093295,0.00481228096146396,0.00393597053946898,EPCI
241400514,CC du Pays de Falaise,2011_2016,2013.5,5,27642,28224,1290,1677,582,387,195,0.00417596005109888,0.00277679817830802,0.00139916187279086,EPCI
241400514,CC du Pays de Falaise,1968_1975,1971.5,7,25394,25209,2006,3165,-185,1159,-1344,-0.0010440049377316,0.00654054985314014,-0.00758455479087175,EPCI
241400514,CC du Pays de Falaise,1975_1982,1978.5,7,25209,25414,1874,2802,205,928,-723,0.0011576881281774,0.00524065650218844,-0.00408296837401104,EPCI
241400514,CC du Pays de Falaise,1982_1990,1986,8,25414,24981,1984,2796,-433,812,-1245,-0.0021457779399624,0.00402395308833596,-0.00616973102829836,EPCI
241400514,CC du Pays de Falaise,1990_1999,1994.5,9,24981,25389,2080,2821,408,741,-333,0.00180167367102069,0.0032721573289861,-0.00147048365796541,EPCI
241400514,CC du Pays de Falaise,1999_2006,2002.5,7,25389,26464,1588,2435,1075,847,228,0.00594176976945104,0.00468156185555817,0.00126020791389287,EPCI
241400555,CC de Bayeux Intercom,2006_2011,2008.5,5,29253,29424,1466,1638,171,172,-1,0.00116638676874414,0.00117320774399996,-6.82097525581365e-06,EPCI
241400555,CC de Bayeux Intercom,2011_2016,2013.5,5,29424,30121,1588,1496,697,-92,789,0.00469336651409136,-0.000619497445188529,0.00531286395927989,EPCI
241400555,CC de Bayeux Intercom,1968_1975,1971.5,7,22350,24984,2048,3426,2634,1378,1256,0.0160429421223822,0.00839300464868743,0.00764993747369479,EPCI
241400555,CC de Bayeux Intercom,1975_1982,1978.5,7,24984,27633,2032,3340,2649,1308,1341,0.014500569382097,0.00715996404370814,0.00734060533838885,EPCI
241400555,CC de Bayeux Intercom,1982_1990,1986,8,27633,28903,2377,3622,1270,1245,25,0.00563263965768113,0.00552176092426221,0.00011087873341892,EPCI
241400555,CC de Bayeux Intercom,1990_1999,1994.5,9,28903,29142,2433,3451,239,1018,-779,0.000915422814198319,0.00389916495754765,-0.00298374214334933,EPCI
241400555,CC de Bayeux Intercom,1999_2006,2002.5,7,29142,29253,2040,2342,111,302,-191,0.000543247495420118,0.00147802471726915,-0.000934777221849032,EPCI
241400860,CC Coeur de Nacre,2006_2011,2008.5,5,22839,23463,970,1316,624,346,278,0.00540557996813318,0.00299732479002256,0.00240825517811061,EPCI
241400860,CC Coeur de Nacre,2011_2016,2013.5,5,23463,23878,1310,1092,415,-218,633,0.00351271931552954,-0.00184523568863962,0.00535795500416916,EPCI
241400860,CC Coeur de Nacre,1968_1975,1971.5,7,10649,12771,853,1216,2122,363,1759,0.0262985738536541,0.00449876640380605,0.021799807449848,EPCI
241400860,CC Coeur de Nacre,1975_1982,1978.5,7,12771,15979,979,1411,3208,432,2776,0.0325320173879988,0.00438087017194997,0.0281511472160489,EPCI
241400860,CC Coeur de Nacre,1982_1990,1986,8,15979,18167,1221,1719,2188,498,1690,0.0161707795737998,0.00368055220646813,0.0124902273673316,EPCI
241400860,CC Coeur de Nacre,1990_1999,1994.5,9,18167,21404,1600,2225,3237,625,2612,0.0183859851746944,0.00354996624472783,0.0148360189299665,EPCI
241400860,CC Coeur de Nacre,1999_2006,2002.5,7,21404,22839,1355,1869,1435,514,921,0.00931335625683505,0.00333593387875485,0.00597742237808019,EPCI
241400878,CC Terre d'Auge,2006_2011,2008.5,5,18377,19150,857,1045,773,188,585,0.00827461350920555,0.00201245451452865,0.00626215899467691,EPCI
241400878,CC Terre d'Auge,2011_2016,2013.5,5,19150,19231,942,1000,81,58,23,0.000844525351294312,0.000604721856482347,0.000239803494811965,EPCI
241400878,CC Terre d'Auge,1968_1975,1971.5,7,13661,13472,1246,1482,-189,236,-425,-0.00198824943757381,0.00248268183739375,-0.00447093127496756,EPCI
241400878,CC Terre d'Auge,1975_1982,1978.5,7,13472,14413,1290,1243,941,-47,988,0.00969196864793398,-0.000484083450003079,0.0101760520979371,EPCI
241400878,CC Terre d'Auge,1982_1990,1986,8,14413,15816,1473,1675,1403,202,1201,0.011679113027909,0.00168152589567899,0.00999758713223004,EPCI
241400878,CC Terre d'Auge,1990_1999,1994.5,9,15816,17147,1475,1788,1331,313,1018,0.00901832730444707,0.00212076367114345,0.00689756363330362,EPCI
241400878,CC Terre d'Auge,1999_2006,2002.5,7,17147,18377,1249,1519,1230,270,960,0.00994579844010435,0.00218322404782778,0.00776257439227656,EPCI
241500230,CA du Bassin d'Aurillac,2006_2011,2008.5,5,54641,53716,2705,2674,-925,-31,-894,-0.00340889806600653,-0.0001142441514013,-0.00329465391460523,EPCI
241500230,CA du Bassin d'Aurillac,2011_2016,2013.5,5,53716,53535,3057,2514,-181,-543,362,-0.000674824824979159,-0.00202447447493748,0.00134964964995832,EPCI
241500230,CA du Bassin d'Aurillac,1968_1975,1971.5,7,43748,49290,3102,6247,5542,3145,2397,0.0171853293620223,0.00975241083427647,0.00743291852774585,EPCI
241500230,CA du Bassin d'Aurillac,1975_1982,1978.5,7,49290,52025,3289,5322,2735,2033,702,0.00774457118712024,0.0057567507215413,0.00198782046557894,EPCI
241500230,CA du Bassin d'Aurillac,1982_1990,1986,8,52025,54019,3876,5374,1994,1498,496,0.00471250210770147,0.0035402849334688,0.00117221717423266,EPCI
241500230,CA du Bassin d'Aurillac,1990_1999,1994.5,9,54019,53954,4396,5083,-65,687,-752,-0.000133769368782954,0.00141383932852138,-0.00154760869730433,EPCI
241500230,CA du Bassin d'Aurillac,1999_2006,2002.5,7,53954,54641,3621,3925,687,304,383,0.00180916099275463,0.000800560322849212,0.00100860066990542,EPCI
241500255,CC du Pays Gentiane,2006_2011,2008.5,5,7431,7068,668,264,-363,-404,41,-0.00996657811503421,-0.01109227977541,0.00112570166037576,EPCI
241500255,CC du Pays Gentiane,2011_2016,2013.5,5,7068,6853,609,225,-215,-384,169,-0.00615916248475301,-0.0110005506704426,0.00484138818568958,EPCI
241500255,CC du Pays Gentiane,1968_1975,1971.5,7,12995,11515,1165,1172,-1480,7,-1487,-0.0171251171204461,8.09971755696773e-05,-0.0172061142960157,EPCI
241500255,CC du Pays Gentiane,1975_1982,1978.5,7,11515,10473,1142,733,-1042,-409,-633,-0.0134586143076968,-0.00528269985781957,-0.00817591444987723,EPCI
241500255,CC du Pays Gentiane,1982_1990,1986,8,10473,9203,1206,703,-1270,-503,-767,-0.0160290206219582,-0.00634850186838187,-0.00968051875357634,EPCI
241500255,CC du Pays Gentiane,1990_1999,1994.5,9,9203,8041,1169,564,-1162,-605,-557,-0.0148854404653416,-0.00775016478617182,-0.00713527567916975,EPCI
241500255,CC du Pays Gentiane,1999_2006,2002.5,7,8041,7431,887,426,-610,-461,-149,-0.0112071572531224,-0.00846967130113019,-0.00273748595199219,EPCI
241500271,CC du Pays de Mauriac,2006_2011,2008.5,5,7109,6973,487,270,-136,-217,81,-0.00385575515471948,-0.00615219756304505,0.00229644240832557,EPCI
241500271,CC du Pays de Mauriac,2011_2016,2013.5,5,6973,6792,522,235,-181,-287,106,-0.00524621016525007,-0.00831857633937441,0.00307236617412435,EPCI
241500271,CC du Pays de Mauriac,1968_1975,1971.5,7,8578,8088,794,808,-490,14,-504,-0.00836755327297523,0.000239072950656435,-0.00860662622363166,EPCI
241500271,CC du Pays de Mauriac,1975_1982,1978.5,7,8088,8048,763,655,-40,-108,68,-0.000708016146882429,-0.00191164359658256,0.00120362744970013,EPCI
241500271,CC du Pays de Mauriac,1982_1990,1986,8,8048,7700,871,655,-348,-216,-132,-0.00551017355776318,-0.00342010772550818,-0.002090065832255,EPCI
241500271,CC du Pays de Mauriac,1990_1999,1994.5,9,7700,7342,959,569,-358,-390,32,-0.00527592690449386,-0.00574751813618046,0.000471591231686603,EPCI
241500271,CC du Pays de Mauriac,1999_2006,2002.5,7,7342,7109,683,397,-233,-286,53,-0.00459650332764205,-0.00564205987856493,0.00104555655092287,EPCI
241501055,CC Sumène - Artense,2006_2011,2008.5,5,8740,8613,691,329,-127,-362,235,-0.00292321902255033,-0.00833232508789936,0.00540910606534903,EPCI
241501055,CC Sumène - Artense,2011_2016,2013.5,5,8613,8486,729,285,-127,-444,317,-0.00296657958619684,-0.0103713491044992,0.00740476951830234,EPCI
241501055,CC Sumène - Artense,1968_1975,1971.5,7,10529,9843,1041,883,-686,-158,-528,-0.00957851839638113,-0.00220613105922481,-0.00737238733715632,EPCI
241501055,CC Sumène - Artense,1975_1982,1978.5,7,9843,9663,1107,725,-180,-382,202,-0.00263315338676695,-0.00558813663191653,0.00295498324514958,EPCI
241501055,CC Sumène - Artense,1982_1990,1986,8,9663,9492,1140,670,-171,-470,299,-0.00222936382437999,-0.00612749121320817,0.00389812738882817,EPCI
241501055,CC Sumène - Artense,1990_1999,1994.5,9,9492,9023,1113,632,-469,-481,12,-0.00561445366363278,-0.00575810706227584,0.000143653398643057,EPCI
241501055,CC Sumène - Artense,1999_2006,2002.5,7,9023,8740,910,504,-283,-406,123,-0.00454203694417421,-0.0065161378068365,0.00197410086266229,EPCI
241501089,CC Cère et Goul en Carladès,2006_2011,2008.5,5,5067,5045,307,245,-22,-62,40,-0.00086987597598287,-0.00245146865958809,0.00158159268360522,EPCI
241501089,CC Cère et Goul en Carladès,2011_2016,2013.5,5,5045,4936,330,211,-109,-119,10,-0.00435894553957361,-0.00475884880008495,0.000399903260511341,EPCI
241501089,CC Cère et Goul en Carladès,1968_1975,1971.5,7,6131,5803,518,564,-328,46,-374,-0.00782392445521107,0.00109725769798692,-0.00892118215319799,EPCI
241501089,CC Cère et Goul en Carladès,1975_1982,1978.5,7,5803,5688,551,443,-115,-108,-7,-0.00285539169330595,-0.00268158524240907,-0.000173806450896884,EPCI
241501089,CC Cère et Goul en Carladès,1982_1990,1986,8,5688,5340,607,416,-348,-191,-157,-0.00786057278044594,-0.00431427988811832,-0.00354629289232762,EPCI
241501089,CC Cère et Goul en Carladès,1990_1999,1994.5,9,5340,5060,636,356,-280,-280,0,-0.00596648161601487,-0.00596648161601487,0,EPCI
241501089,CC Cère et Goul en Carladès,1999_2006,2002.5,7,5060,5067,466,289,7,-177,184,0.000197511387720173,-0.00499421651806723,0.0051917279057874,EPCI
241501139,CC du Pays de Salers,2006_2011,2008.5,5,9205,8955,660,307,-250,-353,103,-0.00549182034941986,-0.00775445033338085,0.00226262998396098,EPCI
241501139,CC du Pays de Salers,2011_2016,2013.5,5,8955,8616,755,300,-339,-455,116,-0.00768851016101912,-0.0103193867942882,0.00263087663326908,EPCI
241501139,CC du Pays de Salers,1968_1975,1971.5,7,15446,13398,1526,1162,-2048,-364,-1684,-0.0201155879402161,-0.00357523145031184,-0.0165403564899042,EPCI
241501139,CC du Pays de Salers,1975_1982,1978.5,7,13398,11698,1433,766,-1700,-667,-1033,-0.0191972759592749,-0.00753210768519786,-0.011665168274077,EPCI
241501139,CC du Pays de Salers,1982_1990,1986,8,11698,10798,1414,753,-900,-661,-239,-0.00995721478958922,-0.00731302108435386,-0.00264419370523536,EPCI
241501139,CC du Pays de Salers,1990_1999,1994.5,9,10798,9676,1456,596,-1122,-860,-262,-0.0121162596752925,-0.00928697265664132,-0.00282928701865119,EPCI
241501139,CC du Pays de Salers,1999_2006,2002.5,7,9676,9205,1034,510,-471,-524,53,-0.0071034756353483,-0.00790280516544057,0.000799329530092272,EPCI
241600303,CC du Rouillacais,2006_2011,2008.5,5,9253,9961,570,526,708,-44,752,0.0148551865642492,-0.00092320368478385,0.0157783902490331,EPCI
241600303,CC du Rouillacais,2011_2016,2013.5,5,9961,10141,590,543,180,-47,227,0.00358825130818441,-0.000936932286025929,0.00452518359421034,EPCI
241600303,CC du Rouillacais,1968_1975,1971.5,7,8714,8742,858,791,28,-67,95,0.000458400568568163,-0.0010968870747881,0.00155528764335627,EPCI
241600303,CC du Rouillacais,1975_1982,1978.5,7,8742,8739,800,598,-3,-202,199,-4.90316258698886e-05,-0.0033014628085725,0.00325243118270261,EPCI
241600303,CC du Rouillacais,1982_1990,1986,8,8739,8963,948,764,224,-184,408,0.00316866284858364,-0.00260283019705084,0.00577149304563448,EPCI
241600303,CC du Rouillacais,1990_1999,1994.5,9,8963,8980,1063,795,17,-268,285,0.000210565492344328,-0.00331950305578117,0.0035300685481255,EPCI
241600303,CC du Rouillacais,1999_2006,2002.5,7,8980,9253,835,653,273,-182,455,0.00428744217253141,-0.00285829478168761,0.00714573695421901,EPCI
241700434,CA de la Rochelle,2006_2011,2008.5,5,159484,162781,7252,7936,3297,684,2613,0.00410081250018757,0.000850760009138094,0.00325005249104947,EPCI
241700434,CA de la Rochelle,2011_2016,2013.5,5,162781,168692,8082,7756,5911,-326,6237,0.00715927148626827,-0.000394843935801634,0.00755411542206991,EPCI
241700434,CA de la Rochelle,1968_1975,1971.5,7,111169,125038,7308,15233,13869,7925,5944,0.0169369923608083,0.00967810689014388,0.00725888547066438,EPCI
241700434,CA de la Rochelle,1975_1982,1978.5,7,125038,133128,7630,13203,8090,5573,2517,0.00899642392541278,0.00619741292167187,0.00279901100374091,EPCI
241700434,CA de la Rochelle,1982_1990,1986,8,133128,136228,9091,13769,3100,4678,-1578,0.00288150372332874,0.00434828207023608,-0.00146677834690734,EPCI
241700434,CA de la Rochelle,1990_1999,1994.5,9,136228,151364,11067,14470,15136,3403,11733,0.0117751857427122,0.00264739409899905,0.00912779164371314,EPCI
241700434,CA de la Rochelle,1999_2006,2002.5,7,151364,159484,9680,11919,8120,2239,5881,0.00749308682166783,0.00206613563961998,0.00542695118204784,EPCI
241700459,CC de l'Île de Ré,2006_2011,2008.5,5,17640,17828,1009,720,188,-289,477,0.00212249020127731,-0.00326276419238905,0.00538525439366635,EPCI
241700459,CC de l'Île de Ré,2011_2016,2013.5,5,17828,17455,1114,566,-373,-548,175,-0.00421989402453205,-0.00619973706553233,0.00197984304100029,EPCI
241700459,CC de l'Île de Ré,1968_1975,1971.5,7,9805,10274,906,875,469,-31,500,0.00669717967983829,-0.000442670725106582,0.00713985040494488,EPCI
241700459,CC de l'Île de Ré,1975_1982,1978.5,7,10274,11396,963,746,1122,-217,1339,0.0149167295004167,-0.00288496461817328,0.0178016941185899,EPCI
241700459,CC de l'Île de Ré,1982_1990,1986,8,11396,13969,1178,1003,2573,-175,2748,0.0257738173437883,-0.00175298019244576,0.027526797536234,EPCI
241700459,CC de l'Île de Ré,1990_1999,1994.5,9,13969,16499,1538,1294,2530,-244,2774,0.0186675654183741,-0.00180035018264161,0.0204679156010157,EPCI
241700459,CC de l'Île de Ré,1999_2006,2002.5,7,16499,17640,1427,1028,1141,-399,1540,0.00959852712962284,-0.00335654016189265,0.0129550672915155,EPCI
241700517,CC Charente-Arnoult-Coeur de Saintonge,2006_2011,2008.5,5,14906,16194,628,998,1288,370,918,0.0167135314132847,0.00480124737803986,0.0119122840352448,EPCI
241700517,CC Charente-Arnoult-Coeur de Saintonge,2011_2016,2013.5,5,16194,17241,655,899,1047,244,803,0.0126087209864878,0.00293842208281091,0.00967029890367689,EPCI
241700517,CC Charente-Arnoult-Coeur de Saintonge,1968_1975,1971.5,7,10701,10316,897,983,-385,86,-471,-0.00522076803174909,0.00116619753436473,-0.00638696556611382,EPCI
241700517,CC Charente-Arnoult-Coeur de Saintonge,1975_1982,1978.5,7,10316,11116,891,866,800,-25,825,0.0107270442640666,-0.00033522013325208,0.0110622643973186,EPCI
241700517,CC Charente-Arnoult-Coeur de Saintonge,1982_1990,1986,8,11116,12117,1076,1095,1001,19,982,0.010836280930848,0.00020568365403208,0.0106305972768159,EPCI
241700517,CC Charente-Arnoult-Coeur de Saintonge,1990_1999,1994.5,9,12117,13107,1066,1105,990,39,951,0.00876452027278885,0.000345268980443197,0.00841925129234565,EPCI
241700517,CC Charente-Arnoult-Coeur de Saintonge,1999_2006,2002.5,7,13107,14906,834,1110,1799,276,1523,0.0185437500293459,0.00284495553535268,0.0156987944939933,EPCI
241700624,CC de l'Île d'Oléron,2006_2011,2008.5,5,20991,21889,1564,787,898,-777,1675,0.00841328503973315,-0.00727964640965775,0.0156929314493909,EPCI
241700624,CC de l'Île d'Oléron,2011_2016,2013.5,5,21889,22324,1636,771,435,-865,1300,0.00394337580555715,-0.00784142545242973,0.0117848012579869,EPCI
241700624,CC de l'Île d'Oléron,1968_1975,1971.5,7,15751,16360,1556,1517,609,-39,648,0.00543406495396837,-0.000347994307396989,0.00578205926136535,EPCI
241700624,CC de l'Île d'Oléron,1975_1982,1978.5,7,16360,16841,1574,1180,481,-394,875,0.00414815965229609,-0.00339786882121551,0.0075460284735116,EPCI
241700624,CC de l'Île d'Oléron,1982_1990,1986,8,16841,18452,1828,1424,1611,-404,2015,0.011484998961405,-0.0028801611299861,0.0143651600913911,EPCI
241700624,CC de l'Île d'Oléron,1990_1999,1994.5,9,18452,20009,2263,1635,1557,-628,2185,0.00904167640560183,-0.00364686755473214,0.012688543960334,EPCI
241700624,CC de l'Île d'Oléron,1999_2006,2002.5,7,20009,20991,2005,1276,982,-729,1711,0.00686799180814646,-0.00509853974352217,0.0119665315516686,EPCI
241700632,CC de Gémozac et de la Saintonge Viticole,2006_2011,2008.5,5,12086,13559,650,700,1473,50,1423,0.0232671075709823,0.000789786407704761,0.0224773211632775,EPCI
241700632,CC de Gémozac et de la Saintonge Viticole,2011_2016,2013.5,5,13559,14187,669,719,628,50,578,0.00909622524811171,0.000724221755422907,0.00837200349268881,EPCI
241700632,CC de Gémozac et de la Saintonge Viticole,1968_1975,1971.5,7,9937,9726,915,942,-211,27,-238,-0.00306136903377208,0.000391739165458986,-0.00345310819923106,EPCI
241700632,CC de Gémozac et de la Saintonge Viticole,1975_1982,1978.5,7,9726,9908,866,781,182,-85,267,0.00265205329454354,-0.00123859631888023,0.00389064961342377,EPCI
241700632,CC de Gémozac et de la Saintonge Viticole,1982_1990,1986,8,9908,10173,1034,847,265,-187,452,0.00330477880315616,-0.00233205145732152,0.00563683026047768,EPCI
241700632,CC de Gémozac et de la Saintonge Viticole,1990_1999,1994.5,9,10173,10739,1209,950,566,-259,825,0.00603422447485569,-0.00276124406181559,0.00879546853667128,EPCI
241700632,CC de Gémozac et de la Saintonge Viticole,1999_2006,2002.5,7,10739,12086,841,880,1347,39,1308,0.0170241124257691,0.000492903032371933,0.0165312093933971,EPCI
241700640,CA Royan Atlantique,2006_2011,2008.5,5,75753,79441,5262,2985,3688,-2277,5965,0.00955265010001449,-0.00589788076945038,0.0154505308694649,EPCI
241700640,CA Royan Atlantique,2011_2016,2013.5,5,79441,82277,5894,2768,2836,-3126,5962,0.00704006465411999,-0.00775995843045808,0.0148000230845781,EPCI
241700640,CA Royan Atlantique,1968_1975,1971.5,7,55905,58781,5309,5698,2876,389,2487,0.00719214755409037,0.00097279047237175,0.00621935708171862,EPCI
241700640,CA Royan Atlantique,1975_1982,1978.5,7,58781,60815,5625,4475,2034,-1150,3184,0.00487151251172735,-0.00275429665117328,0.00762580916290063,EPCI
241700640,CA Royan Atlantique,1982_1990,1986,8,60815,64174,6722,4962,3359,-1760,5119,0.00674284067108633,-0.00353301565379933,0.0102758563248857,EPCI
241700640,CA Royan Atlantique,1990_1999,1994.5,9,64174,68821,8292,5464,4647,-2828,7475,0.00779811332181635,-0.00474565622425148,0.0125437695460678,EPCI
241700640,CA Royan Atlantique,1999_2006,2002.5,7,68821,75753,7358,4389,6932,-2969,9901,0.0138042850881217,-0.00591242389305155,0.0197167089811733,EPCI
241700699,CC du Bassin de Marennes,2006_2011,2008.5,5,13870,15038,963,704,1168,-259,1427,0.0163018681280294,-0.003614883429075,0.0199167515571044,EPCI
241700699,CC du Bassin de Marennes,2011_2016,2013.5,5,15038,15403,1002,655,365,-347,712,0.00480791404245262,-0.00457081143213989,0.00937872547459251,EPCI
241700699,CC du Bassin de Marennes,1968_1975,1971.5,7,11575,11097,1072,1178,-478,106,-584,-0.00600657346710432,0.00133200164751686,-0.00733857511462117,EPCI
241700699,CC du Bassin de Marennes,1975_1982,1978.5,7,11097,11448,1057,819,351,-238,589,0.00445851555564469,-0.00302315299784455,0.00748166855348924,EPCI
241700699,CC du Bassin de Marennes,1982_1990,1986,8,11448,11932,1273,975,484,-298,782,0.00518952221418734,-0.00319520169385915,0.00838472390804648,EPCI
241700699,CC du Bassin de Marennes,1990_1999,1994.5,9,11932,12470,1470,1120,538,-350,888,0.0049122360031324,-0.00319569256709357,0.00810792857022596,EPCI
241700699,CC du Bassin de Marennes,1999_2006,2002.5,7,12470,13870,1326,931,1400,-395,1795,0.0153164664661158,-0.00432143161008268,0.0196378980761985,EPCI
241800325,CC Les Villages de la Forêt,2006_2011,2008.5,5,5033,5254,273,237,221,-36,257,0.00863173310601528,-0.00140607417111561,0.0100378072771309,EPCI
241800325,CC Les Villages de la Forêt,2011_2016,2013.5,5,5254,5238,298,257,-16,-41,25,-0.000609803030076184,-0.00156262026457022,0.000952817234494037,EPCI
241800325,CC Les Villages de la Forêt,1968_1975,1971.5,7,3650,3526,404,274,-124,-130,6,-0.00492541354739851,-0.0051637400093694,0.000238326461970895,EPCI
241800325,CC Les Villages de la Forêt,1975_1982,1978.5,7,3526,4117,362,285,591,-77,668,0.0223840837401494,-0.00291636962435111,0.0253004533645006,EPCI
241800325,CC Les Villages de la Forêt,1982_1990,1986,8,4117,4644,425,398,527,-27,554,0.0151703339676372,-0.000777227736482363,0.0159475617041196,EPCI
241800325,CC Les Villages de la Forêt,1990_1999,1994.5,9,4644,4582,427,412,-62,-15,-47,-0.00149227209797675,-0.00036103357209115,-0.0011312385258856,EPCI
241800325,CC Les Villages de la Forêt,1999_2006,2002.5,7,4582,5033,385,315,451,-70,521,0.0135018583833191,-0.00209563212157946,0.0155974905048985,EPCI
241800374,CC La Septaine,2006_2011,2008.5,5,9990,10878,382,644,888,262,626,0.0171774256348884,0.00506811432020357,0.0121093113146849,EPCI
241800374,CC La Septaine,2011_2016,2013.5,5,10878,10757,426,632,-121,206,-327,-0.0022346385795069,0.00380442601139191,-0.00603906459089881,EPCI
241800374,CC La Septaine,1968_1975,1971.5,7,8690,8426,662,1015,-264,353,-617,-0.00439755598383695,0.00588006538747896,-0.0102776213713159,EPCI
241800374,CC La Septaine,1975_1982,1978.5,7,8426,8559,637,720,133,83,50,0.00223981856040067,0.00139778150761847,0.000842037052782209,EPCI
241800374,CC La Septaine,1982_1990,1986,8,8559,8688,675,956,129,281,-152,0.00187167468704819,0.00407705881442279,-0.00220538412737461,EPCI
241800374,CC La Septaine,1990_1999,1994.5,9,8688,9189,776,1076,501,300,201,0.00624881548472667,0.00374180567947705,0.00250700980524962,EPCI
241800374,CC La Septaine,1999_2006,2002.5,7,9189,9990,557,928,801,371,430,0.0120112014685372,0.00556324063024631,0.00644796083829087,EPCI
241800424,CC Le Dunois,2006_2011,2008.5,5,7434,8320,506,454,886,-52,938,0.0227751177845565,-0.00133668862843898,0.0241118064129955,EPCI
241800424,CC Le Dunois,2011_2016,2013.5,5,8320,7769,525,394,-551,-131,-420,-0.0136106852591722,-0.00323593424492116,-0.010374751014251,EPCI
241800424,CC Le Dunois,1968_1975,1971.5,7,8495,8177,788,731,-318,-57,-261,-0.00543551952031063,-0.00097429123477266,-0.00446122828553797,EPCI
241800424,CC Le Dunois,1975_1982,1978.5,7,8177,7958,882,488,-219,-394,175,-0.00387072125334886,-0.00696376335077375,0.00309304209742489,EPCI
241800424,CC Le Dunois,1982_1990,1986,8,7958,7962,945,569,4,-376,380,6.28160445186321e-05,-0.00590470818475142,0.00596752422927005,EPCI
241800424,CC Le Dunois,1990_1999,1994.5,9,7962,7547,998,634,-415,-364,-51,-0.00593013484517502,-0.00520137128588845,-0.000728763559286568,EPCI
241800424,CC Le Dunois,1999_2006,2002.5,7,7547,7434,779,590,-113,-189,76,-0.00215283096067742,-0.00360075266874365,0.00144792170806623,EPCI
241800432,CC Les Trois Provinces,2006_2011,2008.5,5,5596,5594,419,258,-2,-161,159,-7.14898491722682e-05,-0.00575493285836759,0.00568344300919532,EPCI
241800432,CC Les Trois Provinces,2011_2016,2013.5,5,5594,5237,426,247,-357,-179,-178,-0.0131025601063781,-0.00656963097770779,-0.00653292912867032,EPCI
241800432,CC Les Trois Provinces,1968_1975,1971.5,7,6544,6253,778,572,-291,-206,-85,-0.00647711116874583,-0.00458517148028055,-0.00189193968846528,EPCI
241800432,CC Les Trois Provinces,1975_1982,1978.5,7,6253,6171,689,480,-82,-209,127,-0.00188400150070189,-0.00480190626398409,0.0029179047632822,EPCI
241800432,CC Les Trois Provinces,1982_1990,1986,8,6171,5878,786,505,-293,-281,-12,-0.00606209233821309,-0.00581381551890061,-0.000248276819312481,EPCI
241800432,CC Les Trois Provinces,1990_1999,1994.5,9,5878,5744,852,480,-134,-372,238,-0.00255902412886555,-0.00710415653685063,0.00454513240798508,EPCI
241800432,CC Les Trois Provinces,1999_2006,2002.5,7,5744,5596,653,364,-148,-289,141,-0.00372216620771881,-0.0072682840137212,0.00354611780600238,EPCI
241800457,CC Fercher Pays Florentais,2006_2011,2008.5,5,11625,11600,598,678,-25,80,-105,-0.000430477989970868,0.00137752956790678,-0.00180800755787764,EPCI
241800457,CC Fercher Pays Florentais,2011_2016,2013.5,5,11600,11745,593,559,145,-34,179,0.0024875929374033,-0.000583297654287672,0.00307089059169098,EPCI
241800457,CC Fercher Pays Florentais,1968_1975,1971.5,7,11965,11960,974,1266,-5,292,-297,-5.97086227764887e-05,0.00348698357014694,-0.00354669219292343,EPCI
241800457,CC Fercher Pays Florentais,1975_1982,1978.5,7,11960,12523,994,1040,563,46,517,0.00659295347070787,0.000538678258707926,0.00605427521199995,EPCI
241800457,CC Fercher Pays Florentais,1982_1990,1986,8,12523,12283,1097,1139,-240,42,-282,-0.00241592207951602,0.000422786363915303,-0.00283870844343132,EPCI
241800457,CC Fercher Pays Florentais,1990_1999,1994.5,9,12283,11757,1196,1053,-526,-143,-383,-0.0048512372934616,-0.00131887249613119,-0.0035323647973304,EPCI
241800457,CC Fercher Pays Florentais,1999_2006,2002.5,7,11757,11625,939,871,-132,-68,-64,-0.00161167933517503,-0.000830259051453804,-0.000781420283721227,EPCI
241800507,CA Bourges Plus,2006_2011,2008.5,5,106968,103674,4930,5582,-3294,652,-3946,-0.00623614676715423,0.00123435570497406,-0.00747050247212829,EPCI
241800507,CA Bourges Plus,2011_2016,2013.5,5,103674,103304,5130,5504,-370,374,-744,-0.00071479701374888,0.000722524549032652,-0.00143732156278153,EPCI
241800507,CA Bourges Plus,1968_1975,1971.5,7,90626,104542,6657,12923,13916,6266,7650,0.0206164652398975,0.00928303903371641,0.0113334262061811,EPCI
241800507,CA Bourges Plus,1975_1982,1978.5,7,104542,108169,6812,10757,3627,3945,-318,0.0048841623047442,0.00531238497166139,-0.000428222666917191,EPCI
241800507,CA Bourges Plus,1982_1990,1986,8,108169,110143,7769,11975,1974,4206,-2232,0.00226314488411616,0.00482208074092836,-0.0025589358568122,EPCI
241800507,CA Bourges Plus,1990_1999,1994.5,9,110143,107675,8575,12030,-2468,3455,-5923,-0.00251484253671053,0.00352057575540311,-0.00603541829211364,EPCI
241800507,CA Bourges Plus,1999_2006,2002.5,7,107675,106968,7229,8451,-707,1222,-1929,-0.000940658250218829,0.0016258619261208,-0.00256652017633963,EPCI
241900133,CC de Ventadour - Egletons - Monédières,2006_2011,2008.5,5,10269,10463,643,441,194,-202,396,0.00375012944131581,-0.00390477395435976,0.00765490339567557,EPCI
241900133,CC de Ventadour - Egletons - Monédières,2011_2016,2013.5,5,10463,10215,682,448,-248,-234,-14,-0.0047861091290029,-0.00451592554913984,-0.000270183579863067,EPCI
241900133,CC de Ventadour - Egletons - Monédières,1968_1975,1971.5,7,10668,10894,1205,789,226,-416,642,0.00299928497346569,-0.0055208077387687,0.00852009271223439,EPCI
241900133,CC de Ventadour - Egletons - Monédières,1975_1982,1978.5,7,10894,10645,1210,708,-249,-502,253,-0.00329767648383783,-0.00664832769030759,0.00335065120646976,EPCI
241900133,CC de Ventadour - Egletons - Monédières,1982_1990,1986,8,10645,10450,1230,827,-195,-403,208,-0.00230837159489239,-0.00477063462944427,0.00246226303455188,EPCI
241900133,CC de Ventadour - Egletons - Monédières,1990_1999,1994.5,9,10450,9979,1252,809,-471,-443,-28,-0.00511123667178881,-0.00480738396093937,-0.00030385271084944,EPCI
241900133,CC de Ventadour - Egletons - Monédières,1999_2006,2002.5,7,9979,10269,951,660,290,-291,581,0.00410078004129888,-0.00411492066213094,0.00821570070342983,EPCI
241927201,CA Tulle Agglo,2006_2011,2008.5,5,44661,44136,2714,1957,-525,-757,232,-0.00236217797482885,-0.00340603567037227,0.00104385769554342,EPCI
241927201,CA Tulle Agglo,2011_2016,2013.5,5,44136,44358,2793,1853,222,-940,1162,0.00100396360097488,-0.00425101704917291,0.00525498065014778,EPCI
241927201,CA Tulle Agglo,1968_1975,1971.5,7,47452,46454,4681,4045,-998,-636,-362,-0.00303197968686164,-0.00193220348781964,-0.001099776199042,EPCI
241927201,CA Tulle Agglo,1975_1982,1978.5,7,46454,46139,4602,3378,-315,-1224,909,-0.000971527234572833,-0.00377507725434015,0.00280355001976732,EPCI
241927201,CA Tulle Agglo,1982_1990,1986,8,46139,45003,4984,3525,-1136,-1459,323,-0.00311132789718716,-0.00399597482570076,0.000884646928513601,EPCI
241927201,CA Tulle Agglo,1990_1999,1994.5,9,45003,42882,5011,3219,-2121,-1792,-329,-0.0053497495975614,-0.00451992045206508,-0.000829829145496323,EPCI
241927201,CA Tulle Agglo,1999_2006,2002.5,7,42882,44661,3855,2697,1779,-1158,2937,0.00582381860409731,-0.00379088361076149,0.00961470221485879,EPCI
241927243,CC du Pays d'Uzerche,2006_2011,2008.5,5,9761,9825,686,437,64,-249,313,0.00130791528863949,-0.00508860791986303,0.00639652320850253,EPCI
241927243,CC du Pays d'Uzerche,2011_2016,2013.5,5,9825,9730,770,375,-95,-395,300,-0.00194136541914303,-0.00807199305854206,0.00613062763939903,EPCI
241927243,CC du Pays d'Uzerche,1968_1975,1971.5,7,11830,10717,1378,666,-1113,-712,-401,-0.0140161902128594,-0.00896633192412927,-0.00504985828873011,EPCI
241927243,CC du Pays d'Uzerche,1975_1982,1978.5,7,10717,10237,1426,558,-480,-868,388,-0.00652471497240592,-0.0117988595751007,0.00527414460269479,EPCI
241927243,CC du Pays d'Uzerche,1982_1990,1986,8,10237,9481,1520,560,-756,-960,204,-0.00954401551145412,-0.0121193847764497,0.00257536926499556,EPCI
241927243,CC du Pays d'Uzerche,1990_1999,1994.5,9,9481,9471,1601,558,-10,-1043,1033,-0.000117248424961414,-0.0122290107234754,0.012111762298514,EPCI
241927243,CC du Pays d'Uzerche,1999_2006,2002.5,7,9471,9761,1102,491,290,-611,901,0.00431791773678958,-0.00909740599027046,0.01341532372706,EPCI
242000354,CA de Bastia,2006_2011,2008.5,5,55863,56717,2481,2667,854,186,668,0.00303895321664749,0.00066187974039395,0.00237707347625354,EPCI
242000354,CA de Bastia,2011_2016,2013.5,5,56717,58427,2518,2397,1710,-121,1831,0.00595850616125349,-0.000421625289772907,0.00638013145102639,EPCI
242000354,CA de Bastia,1968_1975,1971.5,7,43358,48825,2773,4893,5467,2120,3347,0.0171091774234133,0.00663461791432893,0.0104745595090844,EPCI
242000354,CA de Bastia,1975_1982,1978.5,7,48825,51919,3002,4632,3094,1630,1464,0.00881611143811445,0.00464455773889029,0.00417155369922416,EPCI
242000354,CA de Bastia,1982_1990,1986,8,51919,48373,3636,4875,-3546,1239,-4785,-0.00880389239090629,0.0030761485257566,-0.0118800409166629,EPCI
242000354,CA de Bastia,1990_1999,1994.5,9,48373,49057,4104,4942,684,838,-154,0.00156133767841427,0.00191286692179993,-0.000351529243385668,EPCI
242000354,CA de Bastia,1999_2006,2002.5,7,49057,55863,3249,3495,6806,246,6560,0.01873321672817,0.000677104219090481,0.0180561125090795,EPCI
242000495,CC de l'Alta Rocca,2006_2011,2008.5,5,7391,8197,366,355,806,-11,817,0.0209167906565904,-0.000285464884891432,0.0212022555414818,EPCI
242000495,CC de l'Alta Rocca,2011_2016,2013.5,5,8197,8467,398,329,270,-69,339,0.00650265525129345,-0.00166178967533055,0.008164444926624,EPCI
242000495,CC de l'Alta Rocca,1968_1975,1971.5,7,5841,6090,649,433,249,-216,465,0.00598154221366332,-0.00518880770341878,0.0111703499170821,EPCI
242000495,CC de l'Alta Rocca,1975_1982,1978.5,7,6090,6214,625,454,124,-171,295,0.00288368258653393,-0.00397669130884921,0.00686037389538314,EPCI
242000495,CC de l'Alta Rocca,1982_1990,1986,8,6214,6348,729,537,134,-192,326,0.00267043323336669,-0.00382629239407764,0.00649672562744433,EPCI
242000495,CC de l'Alta Rocca,1990_1999,1994.5,9,6348,6469,757,524,121,-233,354,0.00210017276855412,-0.00404413433944719,0.00614430710800131,EPCI
242000495,CC de l'Alta Rocca,1999_2006,2002.5,7,6469,7391,514,389,922,-125,1047,0.0192168119723242,-0.00260531615676846,0.0218221281290926,EPCI
242000503,CC Celavu-Prunelli,2006_2011,2008.5,5,7141,7774,281,322,633,41,592,0.0171314912493277,0.00110962265595961,0.0160218685933681,EPCI
242000503,CC Celavu-Prunelli,2011_2016,2013.5,5,7774,8580,357,369,806,12,794,0.0199257353998197,0.000296661072950169,0.0196290743268695,EPCI
242000503,CC Celavu-Prunelli,1968_1975,1971.5,7,4008,3748,503,194,-260,-309,49,-0.00953567285209178,-0.0113327804280629,0.00179710757597114,EPCI
242000503,CC Celavu-Prunelli,1975_1982,1978.5,7,3748,4441,469,240,693,-229,922,0.0245328417602315,-0.00810681206795529,0.0326396538281868,EPCI
242000503,CC Celavu-Prunelli,1982_1990,1986,8,4441,4786,558,417,345,-141,486,0.00939579254996725,-0.00384001956389966,0.0132358121138669,EPCI
242000503,CC Celavu-Prunelli,1990_1999,1994.5,9,4786,6078,563,495,1292,-68,1360,0.026909094724147,-0.00141626814337616,0.0283253628675232,EPCI
242000503,CC Celavu-Prunelli,1999_2006,2002.5,7,6078,7141,416,414,1063,-2,1065,0.0232924326219115,-4.38239560148852e-05,0.0233362565779264,EPCI
242010056,CA du Pays Ajaccien,2006_2011,2008.5,5,76331,81098,3235,3619,4767,384,4383,0.0121895246308679,0.000981912619730073,0.0112076120111378,EPCI
242010056,CA du Pays Ajaccien,2011_2016,2013.5,5,81098,85103,3558,3585,4005,27,3978,0.00968741973261089,6.5308447635579e-05,0.00962211128497531,EPCI
242010056,CA du Pays Ajaccien,1968_1975,1971.5,7,46471,52263,3317,5787,5792,2470,3322,0.0169216042549345,0.00721622280899313,0.00970538144594137,EPCI
242010056,CA du Pays Ajaccien,1975_1982,1978.5,7,52263,59496,3817,5256,7233,1439,5794,0.0186897093450693,0.00371830385006978,0.0149714054949995,EPCI
242010056,CA du Pays Ajaccien,1982_1990,1986,8,59496,67686,4860,6797,8190,1937,6253,0.0162519341048026,0.00384371139938983,0.0124082227054128,EPCI
242010056,CA du Pays Ajaccien,1990_1999,1994.5,9,67686,63707,5632,6952,-3979,1320,-5299,-0.00670905061621119,0.00222567147861241,-0.0089347220948236,EPCI
242010056,CA du Pays Ajaccien,1999_2006,2002.5,7,63707,76331,4270,4999,12624,729,11895,0.026162776501961,0.00151082573431001,0.024651950767651,EPCI
242010130,CC du Sartenais Valinco Taravo,2006_2011,2008.5,5,10410,11125,677,524,715,-153,868,0.0133742346582963,-0.00286189916464244,0.0162361338229388,EPCI
242010130,CC du Sartenais Valinco Taravo,2011_2016,2013.5,5,11125,11515,681,504,390,-177,567,0.0069149395914887,-0.00313831873767564,0.0100532583291643,EPCI
242010130,CC du Sartenais Valinco Taravo,1968_1975,1971.5,7,8251,10002,968,658,1751,-310,2061,0.0278743711920884,-0.00493492579642912,0.0328092969885175,EPCI
242010130,CC du Sartenais Valinco Taravo,1975_1982,1978.5,7,10002,9298,950,634,-704,-316,-388,-0.0103723677770156,-0.00465577871809221,-0.00571658905892335,EPCI
242010130,CC du Sartenais Valinco Taravo,1982_1990,1986,8,9298,10250,994,942,952,-52,1004,0.0122593348701892,-0.000669627534926298,0.0129289624051155,EPCI
242010130,CC du Sartenais Valinco Taravo,1990_1999,1994.5,9,10250,10293,1235,985,43,-250,293,0.000465257861102408,-0.00270498756454889,0.00317024542565129,EPCI
242010130,CC du Sartenais Valinco Taravo,1999_2006,2002.5,7,10293,10410,1050,725,117,-325,442,0.00161599432562265,-0.00448887312672958,0.00610486745235223,EPCI
242020071,CC du Centre Corse,2006_2011,2008.5,5,9021,9518,421,343,497,-78,575,0.0107836387909055,-0.00169240206376384,0.0124760408546693,EPCI
242020071,CC du Centre Corse,2011_2016,2013.5,5,9518,9736,471,331,218,-140,358,0.0045393945748391,-0.00291520752512602,0.00745460209996512,EPCI
242020071,CC du Centre Corse,1968_1975,1971.5,7,7327,7429,736,627,102,-109,211,0.00197696662557667,-0.0021126408057633,0.00408960743133998,EPCI
242020071,CC du Centre Corse,1975_1982,1978.5,7,7429,7294,741,484,-135,-257,122,-0.00261645221844742,-0.00498094977882212,0.0023644975603747,EPCI
242020071,CC du Centre Corse,1982_1990,1986,8,7294,7546,808,584,252,-224,476,0.00425471686004708,-0.00378197054226407,0.00803668740231115,EPCI
242020071,CC du Centre Corse,1990_1999,1994.5,9,7546,8451,896,568,905,-328,1233,0.0126647669587763,-0.00459010338395428,0.0172548703427306,EPCI
242020071,CC du Centre Corse,1999_2006,2002.5,7,8451,9021,505,464,570,-41,611,0.009367952151623,-0.000673835154765865,0.0100417873063889,EPCI
242020105,CC de Calvi Balagne,2006_2011,2008.5,5,10932,11976,545,758,1044,213,831,0.0184094788522597,0.00375595689227138,0.0146535219599884,EPCI
242020105,CC de Calvi Balagne,2011_2016,2013.5,5,11976,11927,544,771,-49,227,-276,-0.000819645810867242,0.00379713467483396,-0.0046167804857012,EPCI
242020105,CC de Calvi Balagne,1968_1975,1971.5,7,6464,7963,621,675,1499,54,1445,0.0302422074243716,0.00108944576445368,0.0291527616599179,EPCI
242020105,CC de Calvi Balagne,1975_1982,1978.5,7,7963,8440,646,652,477,6,471,0.00834555953982741,0.000104975591695942,0.00824058394813147,EPCI
242020105,CC de Calvi Balagne,1982_1990,1986,8,8440,9590,821,987,1150,166,984,0.0160954814400058,0.0023233477556878,0.013772133684318,EPCI
242020105,CC de Calvi Balagne,1990_1999,1994.5,9,9590,10355,909,1216,765,307,458,0.00856408663560981,0.00343682953873492,0.0051272570968749,EPCI
242020105,CC de Calvi Balagne,1999_2006,2002.5,7,10355,10932,764,912,577,148,429,0.00777647712369989,0.00199465964351401,0.00578181748018588,EPCI
242100154,CC des Vallées de la Tille et de l'Ignon,2006_2011,2008.5,5,11988,13158,472,809,1170,337,833,0.018799280440879,0.00541483547741557,0.0133844449634634,EPCI
242100154,CC des Vallées de la Tille et de l'Ignon,2011_2016,2013.5,5,13158,13519,485,765,361,280,81,0.00542791096237005,0.0042100140428355,0.00121789691953455,EPCI
242100154,CC des Vallées de la Tille et de l'Ignon,1968_1975,1971.5,7,8954,9742,714,1261,788,547,241,0.0121223263158023,0.00841486357201,0.00370746274379234,EPCI
242100154,CC des Vallées de la Tille et de l'Ignon,1975_1982,1978.5,7,9742,10809,748,1077,1067,329,738,0.0149582985077326,0.00461225886508342,0.0103460396426491,EPCI
242100154,CC des Vallées de la Tille et de l'Ignon,1982_1990,1986,8,10809,11111,769,1160,302,391,-89,0.00345050033877903,0.00446736964391589,-0.00101686930513687,EPCI
242100154,CC des Vallées de la Tille et de l'Ignon,1990_1999,1994.5,9,11111,11417,865,1228,306,363,-57,0.0030232122823679,0.00358635966829918,-0.000563147385931277,EPCI
242100154,CC des Vallées de la Tille et de l'Ignon,1999_2006,2002.5,7,11417,11988,647,1096,571,449,122,0.0069961706172077,0.00550136708778679,0.00149480352942091,EPCI
242100410,Dijon Métropole,2006_2011,2008.5,5,245353,245697,8815,14265,344,5450,-5106,0.000280255173949584,0.00444008923844544,-0.00415983406449586,EPCI
242100410,Dijon Métropole,2011_2016,2013.5,5,245697,251897,9492,14238,6200,4746,1454,0.00499668286311406,0.00382488014005473,0.00117180272305933,EPCI
242100410,Dijon Métropole,1968_1975,1971.5,7,192337,221542,11227,28616,29205,17389,11816,0.0204000284227224,0.0121464165123342,0.00825361191038821,EPCI
242100410,Dijon Métropole,1975_1982,1978.5,7,221542,224605,11421,25758,3063,14337,-11274,0.00196351318552823,0.00919062636007779,-0.00722711317454955,EPCI
242100410,Dijon Métropole,1982_1990,1986,8,224605,237246,12940,27567,12641,14627,-1986,0.00686775984557952,0.00794673864894326,-0.00107897880336373,EPCI
242100410,Dijon Métropole,1990_1999,1994.5,9,237246,244027,15219,28005,6781,12786,-6005,0.00313616276882844,0.00591343122876279,-0.00277726845993435,EPCI
242100410,Dijon Métropole,1999_2006,2002.5,7,244027,245353,12268,20385,1326,8117,-6791,0.000774459021833929,0.00474078723998944,-0.00396632821815551,EPCI
242101434,CC du Pays Châtillonnais,2006_2011,2008.5,5,21581,20976,1348,1001,-605,-347,-258,-0.00567073452781552,-0.00325247087793717,-0.00241826364987836,EPCI
242101434,CC du Pays Châtillonnais,2011_2016,2013.5,5,20976,20165,1340,894,-811,-446,-365,-0.00785508603392704,-0.00431981303468737,-0.00353527299923967,EPCI
242101434,CC du Pays Châtillonnais,1968_1975,1971.5,7,27654,26429,2477,3146,-1225,669,-1894,-0.00645173912919117,0.00352343957341134,-0.00997517870260251,EPCI
242101434,CC du Pays Châtillonnais,1975_1982,1978.5,7,26429,25530,2271,2343,-899,72,-971,-0.00493175033783755,0.000394978892463074,-0.00532672923030062,EPCI
242101434,CC du Pays Châtillonnais,1982_1990,1986,8,25530,23891,2502,2401,-1639,-101,-1538,-0.00825975078499786,-0.000508990133791814,-0.00775076065120604,EPCI
242101434,CC du Pays Châtillonnais,1990_1999,1994.5,9,23891,22625,2680,2242,-1266,-438,-828,-0.00603133021657398,-0.00208666874791422,-0.00394466146865976,EPCI
242101434,CC du Pays Châtillonnais,1999_2006,2002.5,7,22625,21581,2034,1528,-1044,-506,-538,-0.0067261619430562,-0.00325999802987207,-0.00346616391318413,EPCI
242101442,CC de Saulieu,2006_2011,2008.5,5,5839,5690,405,232,-149,-173,24,-0.00515651950501994,-0.00598709982797617,0.000830580322956232,EPCI
242101442,CC de Saulieu,2011_2016,2013.5,5,5690,5410,464,210,-280,-254,-26,-0.0100414753816279,-0.00910905266761961,-0.000932422714008308,EPCI
242101442,CC de Saulieu,1968_1975,1971.5,7,7140,6344,721,625,-796,-96,-700,-0.0167444120798981,-0.00201942658250027,-0.0147249854973978,EPCI
242101442,CC de Saulieu,1975_1982,1978.5,7,6344,6382,666,526,38,-140,178,0.000853513109976278,-0.00314452198412313,0.00399803509409941,EPCI
242101442,CC de Saulieu,1982_1990,1986,8,6382,5973,701,599,-409,-102,-307,-0.00824485000296815,-0.00205617286137592,-0.00618867714159223,EPCI
242101442,CC de Saulieu,1990_1999,1994.5,9,5973,5880,757,557,-93,-200,107,-0.00174209765427946,-0.00374644656834293,0.00200434891406347,EPCI
242101442,CC de Saulieu,1999_2006,2002.5,7,5880,5839,675,379,-41,-296,255,-0.000999102365850435,-0.00721303171443241,0.00621392934858197,EPCI
242101459,CC du Pays d'Alésia et de la Seine,2006_2011,2008.5,5,7816,7719,514,390,-97,-124,27,-0.00249450210044211,-0.00318884804592599,0.000694345945483886,EPCI
242101459,CC du Pays d'Alésia et de la Seine,2011_2016,2013.5,5,7719,7610,444,344,-109,-100,-9,-0.0028402887446769,-0.00260576949052927,-0.000234519254147634,EPCI
242101459,CC du Pays d'Alésia et de la Seine,1968_1975,1971.5,7,9381,8676,743,942,-705,199,-904,-0.0110987739378292,0.00313284540940144,-0.0142316193472306,EPCI
242101459,CC du Pays d'Alésia et de la Seine,1975_1982,1978.5,7,8676,8613,752,706,-63,-46,-17,-0.00104058723573186,-0.000759793854661358,-0.000280793381070502,EPCI
242101459,CC du Pays d'Alésia et de la Seine,1982_1990,1986,8,8613,8580,866,994,-33,128,-161,-0.000479731930217775,0.00186077839599622,-0.00234051032621399,EPCI
242101459,CC du Pays d'Alésia et de la Seine,1990_1999,1994.5,9,8580,8072,900,848,-508,-52,-456,-0.00675846155580617,-0.000691811025397482,-0.00606665053040869,EPCI
242101459,CC du Pays d'Alésia et de la Seine,1999_2006,2002.5,7,8072,7816,776,550,-256,-226,-30,-0.00459347021246415,-0.004055172921941,-0.000538297290523142,EPCI
242101491,CC du Montbardois,2006_2011,2008.5,5,11359,11205,650,549,-154,-101,-53,-0.00272633158863567,-0.00178804863930002,-0.000938282949335651,EPCI
242101491,CC du Montbardois,2011_2016,2013.5,5,11205,10986,651,501,-219,-150,-69,-0.00393989264304873,-0.00269855660482789,-0.00124133603822083,EPCI
242101491,CC du Montbardois,1968_1975,1971.5,7,13185,13239,1034,1486,54,452,-398,0.000584056087269858,0.00488876576751807,-0.00430470968024821,EPCI
242101491,CC du Montbardois,1975_1982,1978.5,7,13239,13630,977,1349,391,372,19,0.00416668900396355,0.00396421562525433,0.000202473378709226,EPCI
242101491,CC du Montbardois,1982_1990,1986,8,13630,13121,1075,1448,-509,373,-882,-0.00474610716795121,0.00347799208967741,-0.00822409925762861,EPCI
242101491,CC du Montbardois,1990_1999,1994.5,9,13121,12144,1215,1212,-977,-3,-974,-0.00856078813286765,-2.62869645840358e-05,-0.00853450116828361,EPCI
242101491,CC du Montbardois,1999_2006,2002.5,7,12144,11359,924,925,-785,1,-786,-0.00950098335365846,1.21031635078452e-05,-0.0095130865171663,EPCI
242101509,CC Rives de Saône,2006_2011,2008.5,5,19474,20410,985,1213,936,228,708,0.00943316128184857,0.00229782133788619,0.00713533994396238,EPCI
242101509,CC Rives de Saône,2011_2016,2013.5,5,20410,20705,1122,1179,295,57,238,0.00287417056602779,0.000555348211062997,0.00231882235496479,EPCI
242101509,CC Rives de Saône,1968_1975,1971.5,7,16743,16945,1629,1798,202,169,33,0.00171468905589545,0.00143456658636797,0.000280122469527474,EPCI
242101509,CC Rives de Saône,1975_1982,1978.5,7,16945,17746,1571,1639,801,68,733,0.0066200064936397,0.000561998054391385,0.00605800843924831,EPCI
242101509,CC Rives de Saône,1982_1990,1986,8,17746,18369,1604,1873,623,269,354,0.00432235488887311,0.00186631374816512,0.002456041140708,EPCI
242101509,CC Rives de Saône,1990_1999,1994.5,9,18369,18366,1713,1887,-3,174,-177,-1.81478322812678e-05,0.00105257427231353,-0.0010707221045948,EPCI
242101509,CC Rives de Saône,1999_2006,2002.5,7,18366,19474,1433,1619,1108,186,922,0.00840355807996418,0.00141070559826113,0.00699285248170305,EPCI
242200715,CC du Kreiz-Breizh (CCKB),2006_2011,2008.5,5,19533,19153,1597,806,-380,-791,411,-0.00392148712888074,-0.00816288504985439,0.00424139792097364,EPCI
242200715,CC du Kreiz-Breizh (CCKB),2011_2016,2013.5,5,19153,18520,1576,743,-633,-833,200,-0.0066990868188318,-0.00881570192746744,0.00211661510863564,EPCI
242200715,CC du Kreiz-Breizh (CCKB),1968_1975,1971.5,7,26082,24698,2500,1839,-1384,-661,-723,-0.00775876596645275,-0.00370559559524947,-0.00405317037120328,EPCI
242200715,CC du Kreiz-Breizh (CCKB),1975_1982,1978.5,7,24698,23431,2660,1382,-1267,-1278,11,-0.00749496259838334,-0.00756003330760371,6.50707092203755e-05,EPCI
242200715,CC du Kreiz-Breizh (CCKB),1982_1990,1986,8,23431,21599,3011,1735,-1832,-1276,-556,-0.0101250077951042,-0.00705213425030181,-0.00307287354480236,EPCI
242200715,CC du Kreiz-Breizh (CCKB),1990_1999,1994.5,9,21599,20142,3139,1732,-1457,-1407,-50,-0.00772995019829725,-0.00746468080233647,-0.000265269395960784,EPCI
242200715,CC du Kreiz-Breizh (CCKB),1999_2006,2002.5,7,20142,19533,2245,1299,-609,-946,337,-0.00437637340376795,-0.00679811041045071,0.00242173700668276,EPCI
242400752,CC Périgord-Limousin,2006_2011,2008.5,5,14795,14638,1172,532,-157,-640,483,-0.00213140505812059,-0.00868853017323045,0.00655712511510985,EPCI
242400752,CC Périgord-Limousin,2011_2016,2013.5,5,14638,14291,1101,452,-347,-649,302,-0.00478669084131467,-0.00895262926804962,0.00416593842673495,EPCI
242400752,CC Périgord-Limousin,1968_1975,1971.5,7,17538,17014,1816,1224,-524,-592,68,-0.00432397043319654,-0.00488509636727549,0.000561125934078941,EPCI
242400752,CC Périgord-Limousin,1975_1982,1978.5,7,17014,16078,1822,1003,-936,-819,-117,-0.00805093856768613,-0.00704457124672536,-0.00100636732096077,EPCI
242400752,CC Périgord-Limousin,1982_1990,1986,8,16078,15439,1933,1082,-639,-851,212,-0.00505656011979483,-0.00673416692010235,0.00167760680030752,EPCI
242400752,CC Périgord-Limousin,1990_1999,1994.5,9,15439,14687,2092,1073,-752,-1019,267,-0.00553286223384419,-0.00749732262804153,0.00196446039419734,EPCI
242400752,CC Périgord-Limousin,1999_2006,2002.5,7,14687,14795,1650,773,108,-877,985,0.00104719608167492,-0.00850362003360095,0.00955081611527586,EPCI
242400935,CC du Pays de Saint-Aulaye,2006_2011,2008.5,5,6428,6598,584,268,170,-316,486,0.00523427619445571,-0.00972959574969415,0.0149638719441499,EPCI
242400935,CC du Pays de Saint-Aulaye,2011_2016,2013.5,5,6598,6644,606,236,46,-370,416,0.00139048962441035,-0.0111843730659093,0.0125748626903197,EPCI
242400935,CC du Pays de Saint-Aulaye,1968_1975,1971.5,7,7001,7004,740,680,3,-60,63,6.12045055685684e-05,-0.00122409011137137,0.00128529461693994,EPCI
242400935,CC du Pays de Saint-Aulaye,1975_1982,1978.5,7,7004,7019,779,477,15,-302,317,0.000305667181649483,-0.00615409925720959,0.00645976643885907,EPCI
242400935,CC du Pays de Saint-Aulaye,1982_1990,1986,8,7019,6813,858,522,-206,-336,130,-0.00371660201883173,-0.00606203047731777,0.00234542845848604,EPCI
242400935,CC du Pays de Saint-Aulaye,1990_1999,1994.5,9,6813,6576,919,483,-237,-436,199,-0.00392626023199083,-0.0072229935069536,0.00329673327496276,EPCI
242400935,CC du Pays de Saint-Aulaye,1999_2006,2002.5,7,6576,6428,722,380,-148,-342,194,-0.00324660546724753,-0.00750229101215308,0.00425568554490555,EPCI
242401024,CC Isle-Loue-Auvézère en Périgord,2006_2011,2008.5,5,14109,14015,1021,511,-94,-510,416,-0.001336048094841,-0.00724877157839267,0.00591272348355167,EPCI
242401024,CC Isle-Loue-Auvézère en Périgord,2011_2016,2013.5,5,14015,13811,1026,397,-204,-629,425,-0.00292826594533624,-0.00902881999812007,0.00610055405278383,EPCI
242401024,CC Isle-Loue-Auvézère en Périgord,1968_1975,1971.5,7,17008,15987,1890,1140,-1021,-750,-271,-0.00880499690221581,-0.00646792132875794,-0.00233707557345787,EPCI
242401024,CC Isle-Loue-Auvézère en Périgord,1975_1982,1978.5,7,15987,14918,1789,883,-1069,-906,-163,-0.00983805153254746,-0.00833795574227129,-0.00150009579027618,EPCI
242401024,CC Isle-Loue-Auvézère en Périgord,1982_1990,1986,8,14918,14320,1955,936,-598,-1019,421,-0.00510086816252964,-0.00869194758798946,0.00359107942545983,EPCI
242401024,CC Isle-Loue-Auvézère en Périgord,1990_1999,1994.5,9,14320,13722,2098,929,-598,-1169,571,-0.00472842753981861,-0.00924336420409358,0.00451493666427496,EPCI
242401024,CC Isle-Loue-Auvézère en Périgord,1999_2006,2002.5,7,13722,14109,1441,750,387,-691,1078,0.00398111902174647,-0.00710840631531476,0.0110895253370612,EPCI
242500320,CC de Montbenoît,2006_2011,2008.5,5,6339,6909,211,544,570,333,237,0.0173699088402015,0.0101476835855914,0.0072222252546101,EPCI
242500320,CC de Montbenoît,2011_2016,2013.5,5,6909,7586,206,547,677,341,336,0.0188717694780529,0.00950557369574009,0.00936619578231282,EPCI
242500320,CC de Montbenoît,1968_1975,1971.5,7,4826,4637,368,544,-189,176,-365,-0.00569093944552868,0.0052994991662066,-0.0109904386117353,EPCI
242500320,CC de Montbenoît,1975_1982,1978.5,7,4637,4805,313,527,168,214,-46,0.00509715179085912,0.00649280049549912,-0.00139564870464,EPCI
242500320,CC de Montbenoît,1982_1990,1986,8,4805,5080,327,569,275,242,33,0.00698103198385325,0.00614330814579086,0.00083772383806239,EPCI
242500320,CC de Montbenoît,1990_1999,1994.5,9,5080,5574,352,702,494,350,144,0.0103646409950964,0.00734336912608043,0.00302127186901595,EPCI
242500320,CC de Montbenoît,1999_2006,2002.5,7,5574,6339,256,625,765,369,396,0.0185423997933796,0.00894398107680662,0.00959841871657295,EPCI
242500338,CC du Grand Pontarlier,2006_2011,2008.5,5,26532,26743,1102,1768,211,666,-455,0.00158549661097784,0.00500445849720969,-0.00341896188623184,EPCI
242500338,CC du Grand Pontarlier,2011_2016,2013.5,5,26743,26976,1228,1834,233,606,-373,0.00173647091558382,0.00451631491349269,-0.00277984399790886,EPCI
242500338,CC du Grand Pontarlier,1968_1975,1971.5,7,19903,22302,1393,2942,2399,1549,850,0.016390863934945,0.0105833464923843,0.00580751744256077,EPCI
242500338,CC du Grand Pontarlier,1975_1982,1978.5,7,22302,22875,1350,2706,573,1356,-783,0.00363061056036673,0.00859181137845949,-0.00496120081809276,EPCI
242500338,CC du Grand Pontarlier,1982_1990,1986,8,22875,24227,1594,2937,1352,1343,9,0.00720371060250824,0.00715575690766906,4.79536948391826e-05,EPCI
242500338,CC du Grand Pontarlier,1990_1999,1994.5,9,24227,25492,1790,3425,1265,1635,-370,0.00567123912652012,0.00733002053111494,-0.00165878140459482,EPCI
242500338,CC du Grand Pontarlier,1999_2006,2002.5,7,25492,26532,1534,2494,1040,960,80,0.00572875753101743,0.00528808387478532,0.000440673656232109,EPCI
242500361,CA du Grand Besançon,2006_2011,2008.5,5,187670,189580,6619,12056,1910,5437,-3527,0.00202725164601136,0.00577076816720617,-0.00374351652119481,EPCI
242500361,CA du Grand Besançon,2011_2016,2013.5,5,189580,193187,7057,11517,3607,4460,-853,0.00377662006611645,0.00466973260185179,-0.000893112535735331,EPCI
242500361,CA du Grand Besançon,1968_1975,1971.5,7,140997,160107,8199,22241,19110,14042,5068,0.0183235283545418,0.0134641017872567,0.00485942656728507,EPCI
242500361,CA du Grand Besançon,1975_1982,1978.5,7,160107,162384,8219,19135,2277,10916,-8639,0.00201940182044513,0.00968106731312212,-0.00766166549267699,EPCI
242500361,CA du Grand Besançon,1982_1990,1986,8,162384,171606,9527,20450,9222,10923,-1701,0.00692854844327018,0.00820652078137499,-0.00127797233810481,EPCI
242500361,CA du Grand Besançon,1990_1999,1994.5,9,171606,181898,11027,20751,10292,9724,568,0.00649264632028723,0.00613432693533551,0.000358319384951724,EPCI
242500361,CA du Grand Besançon,1999_2006,2002.5,7,181898,187670,9078,16476,5772,7398,-1626,0.00447268858768268,0.0057326663499093,-0.00125997776222662,EPCI
242504116,CC du Val de Morteau,2006_2011,2008.5,5,18354,19294,685,1249,940,564,376,0.0100393863412538,0.00602363180475227,0.00401575453650151,EPCI
242504116,CC du Val de Morteau,2011_2016,2013.5,5,19294,20463,743,1311,1169,568,601,0.0118343200718842,0.00575012301183083,0.0060841970600534,EPCI
242504116,CC du Val de Morteau,1968_1975,1971.5,7,15600,17120,959,2100,1520,1141,379,0.0133709531931654,0.0100370115746064,0.003333941618559,EPCI
242504116,CC du Val de Morteau,1975_1982,1978.5,7,17120,16726,875,2143,-394,1268,-1662,-0.00332061391969662,0.0106866458126277,-0.0140072597323243,EPCI
242504116,CC du Val de Morteau,1982_1990,1986,8,16726,17348,1058,2006,622,948,-326,0.00457453526276064,0.00697212126864483,-0.00239758600588419,EPCI
242504116,CC du Val de Morteau,1990_1999,1994.5,9,17348,17662,1192,2249,314,1057,-743,0.00199512239938859,0.00671606489220937,-0.00472094249282078,EPCI
242504116,CC du Val de Morteau,1999_2006,2002.5,7,17662,18354,979,1582,692,603,89,0.0055053986497462,0.00479733437253895,0.000708064277207242,EPCI
242504181,CC des Portes du Haut-Doubs,2006_2011,2008.5,5,21989,24304,830,1809,2315,979,1336,0.0202214621738301,0.00855153843117914,0.011669923742651,EPCI
242504181,CC des Portes du Haut-Doubs,2011_2016,2013.5,5,24304,25869,896,1814,1565,918,647,0.0125590901696027,0.00736692956913434,0.00519216060046832,EPCI
242504181,CC des Portes du Haut-Doubs,1968_1975,1971.5,7,16293,16575,1069,2294,282,1225,-943,0.00245443124689793,0.0106619797072694,-0.00820754846037143,EPCI
242504181,CC des Portes du Haut-Doubs,1975_1982,1978.5,7,16575,17683,979,1985,1108,1006,102,0.00928688512020615,0.00843195526256984,0.000854929857636305,EPCI
242504181,CC des Portes du Haut-Doubs,1982_1990,1986,8,17683,18276,1187,2230,593,1043,-450,0.00413163647653003,0.00726694240307053,-0.0031353059265405,EPCI
242504181,CC des Portes du Haut-Doubs,1990_1999,1994.5,9,18276,19536,1369,2343,1260,974,286,0.00743530491833799,0.00574760872258826,0.00168769619574973,EPCI
242504181,CC des Portes du Haut-Doubs,1999_2006,2002.5,7,19536,21989,1082,2232,2453,1150,1303,0.0170412026258369,0.00798914921309107,0.00905205341274579,EPCI
242504355,CC du Plateau de Russey,2006_2011,2008.5,5,5403,6097,178,399,694,221,473,0.0244629237248775,0.00779006648875781,0.0166728572361197,EPCI
242504355,CC du Plateau de Russey,2011_2016,2013.5,5,6097,6478,167,445,381,278,103,0.0121967761145807,0.00889948493399852,0.00329729118058218,EPCI
242504355,CC du Plateau de Russey,1968_1975,1971.5,7,4261,4229,263,534,-32,271,-303,-0.00107632263845581,0.00911510734442261,-0.0101914299828784,EPCI
242504355,CC du Plateau de Russey,1975_1982,1978.5,7,4229,4297,246,455,68,209,-141,0.00228139074954759,0.00701192156846243,-0.00473053081891485,EPCI
242504355,CC du Plateau de Russey,1982_1990,1986,8,4297,4497,272,503,200,231,-31,0.00570287520604151,0.00658682086297795,-0.000883945656936435,EPCI
242504355,CC du Plateau de Russey,1990_1999,1994.5,9,4497,4904,355,643,407,288,119,0.00967322957208494,0.00684493886181932,0.00282829071026562,EPCI
242504355,CC du Plateau de Russey,1999_2006,2002.5,7,4904,5403,254,479,499,225,274,0.0139395703044092,0.00628537739176767,0.00765419291264151,EPCI
242504371,CC du Pays de Sancey-Belleherbe,2006_2011,2008.5,5,5161,5183,257,302,22,45,-23,0.000851097986715788,0.00174088224555502,-0.000889784258839232,EPCI
242504371,CC du Pays de Sancey-Belleherbe,2011_2016,2013.5,5,5183,5488,249,281,305,32,273,0.0115016109339243,0.00120672639306747,0.0102948845408569,EPCI
242504371,CC du Pays de Sancey-Belleherbe,1968_1975,1971.5,7,5359,5132,411,647,-227,236,-463,-0.00616405858188218,0.00640844856971011,-0.0125725071515923,EPCI
242504371,CC du Pays de Sancey-Belleherbe,1975_1982,1978.5,7,5132,5321,352,528,189,176,13,0.00517991372703119,0.00482362336485444,0.000356290362176749,EPCI
242504371,CC du Pays de Sancey-Belleherbe,1982_1990,1986,8,5321,5176,386,558,-145,172,-317,-0.00344763052871322,0.00408960310992189,-0.00753723363863511,EPCI
242504371,CC du Pays de Sancey-Belleherbe,1990_1999,1994.5,9,5176,5127,446,524,-49,78,-127,-0.00105631552745478,0.00168148186003005,-0.00273779738748483,EPCI
242504371,CC du Pays de Sancey-Belleherbe,1999_2006,2002.5,7,5127,5161,347,421,34,74,-40,0.000944683985240724,0.00205607690905334,-0.00111139292381262,EPCI
242504447,CC du Doubs Baumois,2006_2011,2008.5,5,15436,15906,696,1033,470,337,133,0.00601681934833298,0.00431418749018769,0.00170263185814529,EPCI
242504447,CC du Doubs Baumois,2011_2016,2013.5,5,15906,16167,738,973,261,235,26,0.00326044995860864,0.0029356541772913,0.000324795781317335,EPCI
242504447,CC du Doubs Baumois,1968_1975,1971.5,7,11483,12121,980,1448,638,468,170,0.00775445478144121,0.00568822074876879,0.00206623403267242,EPCI
242504447,CC du Doubs Baumois,1975_1982,1978.5,7,12121,12893,1021,1302,772,281,491,0.00885973760994308,0.00322485267926684,0.00563488493067623,EPCI
242504447,CC du Doubs Baumois,1982_1990,1986,8,12893,13494,1085,1562,601,477,124,0.00571132450097367,0.00453294806483268,0.00117837643614099,EPCI
242504447,CC du Doubs Baumois,1990_1999,1994.5,9,13494,14328,1161,1640,834,479,355,0.00668564117945802,0.00383983468220671,0.00284580649725132,EPCI
242504447,CC du Doubs Baumois,1999_2006,2002.5,7,14328,15436,951,1380,1108,429,679,0.0106977848696614,0.00414201237282018,0.00655577249684126,EPCI
242504488,CC Altitude 800,2006_2011,2008.5,5,5583,5964,256,408,381,152,229,0.0132905709253377,0.00530227501483289,0.00798829591050481,EPCI
242504488,CC Altitude 800,2011_2016,2013.5,5,5964,6278,281,418,314,137,177,0.0103148473282759,0.00450042701902485,0.00581442030925108,EPCI
242504488,CC Altitude 800,1968_1975,1971.5,7,4746,4603,325,516,-143,191,-334,-0.00436101918677223,0.00582485779491955,-0.0101858769816918,EPCI
242504488,CC Altitude 800,1975_1982,1978.5,7,4603,4877,329,509,274,180,94,0.00829449771810786,0.00544894010678619,0.00284555761132168,EPCI
242504488,CC Altitude 800,1982_1990,1986,8,4877,5115,384,529,238,145,93,0.00597366191363813,0.00363941587175432,0.00233424604188381,EPCI
242504488,CC Altitude 800,1990_1999,1994.5,9,5115,5102,425,539,-13,114,-127,-0.000282713327272477,0.00247917840838941,-0.00276189173566189,EPCI
242504488,CC Altitude 800,1999_2006,2002.5,7,5102,5583,372,489,481,117,364,0.012953702579352,0.00315090062740995,0.00980280195194207,EPCI
242504496,CC du Plateau de Frasne et du Val de Drugeon (CFD),2006_2011,2008.5,5,5244,5575,182,385,331,203,128,0.0123167847477241,0.00755379850087009,0.00476298624685404,EPCI
242504496,CC du Plateau de Frasne et du Val de Drugeon (CFD),2011_2016,2013.5,5,5575,5949,209,381,374,172,202,0.0130708505887183,0.00601119331887578,0.00705965726984249,EPCI
242504496,CC du Plateau de Frasne et du Val de Drugeon (CFD),1968_1975,1971.5,7,4151,3858,302,378,-293,76,-369,-0.0104027071545892,0.00269831311859653,-0.0131010202731858,EPCI
242504496,CC du Plateau de Frasne et du Val de Drugeon (CFD),1975_1982,1978.5,7,3858,4051,262,358,193,96,97,0.0069979217817322,0.00348083155982534,0.00351709022190686,EPCI
242504496,CC du Plateau de Frasne et du Val de Drugeon (CFD),1982_1990,1986,8,4051,4517,292,479,466,187,279,0.013703581560758,0.00549907672073337,0.00820450484002465,EPCI
242504496,CC du Plateau de Frasne et du Val de Drugeon (CFD),1990_1999,1994.5,9,4517,4791,345,592,274,247,27,0.00656491086972699,0.00591800359424295,0.000646907275484047,EPCI
242504496,CC du Plateau de Frasne et du Val de Drugeon (CFD),1999_2006,2002.5,7,4791,5244,271,467,453,196,257,0.0129901350393766,0.00562045577862653,0.0073696792607501,EPCI
242600252,CC du Val de Drôme,2006_2011,2008.5,5,28224,29292,1110,1733,1068,623,445,0.00745601092730386,0.00434933970759392,0.00310667121970994,EPCI
242600252,CC du Val de Drôme,2011_2016,2013.5,5,29292,30844,1143,1762,1552,619,933,0.0103790527056156,0.00413958352111858,0.00623946918449699,EPCI
242600252,CC du Val de Drôme,1968_1975,1971.5,7,18086,17683,1566,1652,-403,86,-489,-0.00321402852312358,0.000685872091783196,-0.00389990061490678,EPCI
242600252,CC du Val de Drôme,1975_1982,1978.5,7,17683,21193,1455,1820,3510,365,3145,0.0262041921413354,0.00272493735942662,0.0234792547819088,EPCI
242600252,CC du Val de Drôme,1982_1990,1986,8,21193,23905,1731,2523,2712,792,1920,0.0151659411518368,0.00442899166381074,0.010736949488026,EPCI
242600252,CC du Val de Drôme,1990_1999,1994.5,9,23905,25939,1920,2643,2034,723,1311,0.00911461918099832,0.00323985726050235,0.00587476192049597,EPCI
242600252,CC du Val de Drôme,1999_2006,2002.5,7,25939,28224,1487,2329,2285,842,1443,0.0121337455223698,0.00447116574609863,0.00766257977627116,EPCI
242600492,CC Dieulefit-Bourdeaux,2006_2011,2008.5,5,8813,9004,553,448,191,-105,296,0.00429741128775607,-0.00236245123148894,0.00665986251924501,EPCI
242600492,CC Dieulefit-Bourdeaux,2011_2016,2013.5,5,9004,9383,573,398,379,-175,554,0.00828021657739231,-0.00382331900011518,0.0121035355775075,EPCI
242600492,CC Dieulefit-Bourdeaux,1968_1975,1971.5,7,6673,6546,706,527,-127,-179,52,-0.00274128691262965,-0.00386370360126541,0.00112241668863576,EPCI
242600492,CC Dieulefit-Bourdeaux,1975_1982,1978.5,7,6546,6966,742,468,420,-274,694,0.00892343512236393,-0.00582147910363742,0.0147449142260014,EPCI
242600492,CC Dieulefit-Bourdeaux,1982_1990,1986,8,6966,7503,774,691,537,-83,620,0.00932593915638802,-0.001441439385438,0.010767378541826,EPCI
242600492,CC Dieulefit-Bourdeaux,1990_1999,1994.5,9,7503,8178,938,702,675,-236,911,0.00961758582987593,-0.0033625929716307,0.0129801788015066,EPCI
242600492,CC Dieulefit-Bourdeaux,1999_2006,2002.5,7,8178,8813,730,567,635,-163,798,0.0107401633427888,-0.00275692381870012,0.0134970871614889,EPCI
242600534,CC du Diois,2006_2011,2008.5,5,10857,11024,642,502,167,-140,307,0.00305760116011422,-0.00256325845758078,0.005620859617695,EPCI
242600534,CC du Diois,2011_2016,2013.5,5,11024,11507,693,498,483,-195,678,0.00861304698452159,-0.00347731710555219,0.0120903640900738,EPCI
242600534,CC du Diois,1968_1975,1971.5,7,10455,9717,1135,790,-738,-345,-393,-0.0104031382564298,-0.00486325568898141,-0.00553988256744839,EPCI
242600534,CC du Diois,1975_1982,1978.5,7,9717,9615,1064,753,-102,-311,209,-0.00150637139857057,-0.00459295593093576,0.00308658453236519,EPCI
242600534,CC du Diois,1982_1990,1986,8,9615,9860,1125,974,245,-151,396,0.00315017510250848,-0.00194153649175012,0.0050917115942586,EPCI
242600534,CC du Diois,1990_1999,1994.5,9,9860,10292,1132,961,432,-171,603,0.0047758934869373,-0.00189045783857935,0.00666635132551665,EPCI
242600534,CC du Diois,1999_2006,2002.5,7,10292,10857,978,714,565,-264,829,0.00766395301329714,-0.00358103291240787,0.011244985925705,EPCI
242700276,CC du Pays de Conches,2006_2011,2008.5,5,17919,18560,721,1180,641,459,182,0.00705418938827696,0.00505128382093467,0.00200290556734229,EPCI
242700276,CC du Pays de Conches,2011_2016,2013.5,5,18560,18724,745,1059,164,314,-150,0.00176102800773204,0.00337172435626743,-0.0016106963485354,EPCI
242700276,CC du Pays de Conches,1968_1975,1971.5,7,10237,11045,877,1128,808,251,557,0.0109118516717928,0.00338969649705443,0.00752215517473833,EPCI
242700276,CC du Pays de Conches,1975_1982,1978.5,7,11045,12525,895,1061,1480,166,1314,0.0181264410085495,0.0020331008158238,0.0160933401927257,EPCI
242700276,CC du Pays de Conches,1982_1990,1986,8,12525,14850,1054,1673,2325,619,1706,0.0215122754486372,0.00572735419471244,0.0157849212539248,EPCI
242700276,CC du Pays de Conches,1990_1999,1994.5,9,14850,16045,1281,1853,1195,572,623,0.00863679589736832,0.00413409811991187,0.00450269777745646,EPCI
242700276,CC du Pays de Conches,1999_2006,2002.5,7,16045,17919,892,1576,1874,684,1190,0.0159057897828272,0.00580552839458581,0.0101002613882414,EPCI
242700607,CC du Pays du Neubourg,2006_2011,2008.5,5,19618,21422,961,1251,1804,290,1514,0.0177498732281638,0.00285336099565826,0.0148965122325055,EPCI
242700607,CC du Pays du Neubourg,2011_2016,2013.5,5,21422,22380,919,1311,958,392,566,0.008788246176199,0.00359602557522965,0.00519222060096935,EPCI
242700607,CC du Pays du Neubourg,1968_1975,1971.5,7,12076,13409,1087,1533,1333,446,887,0.0150704469241161,0.00504232507738617,0.0100281218467299,EPCI
242700607,CC du Pays du Neubourg,1975_1982,1978.5,7,13409,15156,1070,1411,1747,341,1406,0.0176497145552617,0.00344507879985359,0.0142046357554081,EPCI
242700607,CC du Pays du Neubourg,1982_1990,1986,8,15156,17077,1237,1790,1921,553,1368,0.0150288182635672,0.0043263594480753,0.0107024588154919,EPCI
242700607,CC du Pays du Neubourg,1990_1999,1994.5,9,17077,17844,1502,1968,767,466,301,0.00489357778344335,0.00297315156073612,0.00192042622270723,EPCI
242700607,CC du Pays du Neubourg,1999_2006,2002.5,7,17844,19618,1253,1811,1774,558,1216,0.0136321091415017,0.00428789002308791,0.00934421911841379,EPCI
242700623,CC Eure-Madrie-Seine,2006_2011,2008.5,5,26026,28274,949,1917,2248,968,1280,0.0167073557688344,0.00719427063355503,0.00951308513527939,EPCI
242700623,CC Eure-Madrie-Seine,2011_2016,2013.5,5,28274,29093,1025,1844,819,819,0,0.00572732697533041,0.00572732697533041,0,EPCI
242700623,CC Eure-Madrie-Seine,1968_1975,1971.5,7,13171,15367,970,1698,2196,728,1468,0.0222737089129108,0.00738399821885203,0.0148897106940588,EPCI
242700623,CC Eure-Madrie-Seine,1975_1982,1978.5,7,15367,19215,974,1923,3848,949,2899,0.0324391654131559,0.00800019957824454,0.0244389658349114,EPCI
242700623,CC Eure-Madrie-Seine,1982_1990,1986,8,19215,22879,1224,2650,3664,1426,2238,0.0220557389718841,0.00858392024397016,0.0134718187279139,EPCI
242700623,CC Eure-Madrie-Seine,1990_1999,1994.5,9,22879,24305,1632,2797,1426,1165,261,0.0067406869892026,0.00550694273662064,0.00123374425258196,EPCI
242700623,CC Eure-Madrie-Seine,1999_2006,2002.5,7,24305,26026,1366,2419,1721,1053,668,0.00982133697605403,0.00600922012538344,0.00381211685067059,EPCI
242852465,CC du Bonnevalais,2006_2011,2008.5,5,11106,12131,642,761,1025,119,906,0.0178125151709614,0.00206798956618966,0.0157445256047717,EPCI
242852465,CC du Bonnevalais,2011_2016,2013.5,5,12131,12649,692,682,518,-10,528,0.00839786607024173,-0.000162120966606983,0.00855998703684872,EPCI
242852465,CC du Bonnevalais,1968_1975,1971.5,7,12004,11374,957,910,-630,-47,-583,-0.00767183135869609,-0.000572342974378915,-0.00709948838431718,EPCI
242852465,CC du Bonnevalais,1975_1982,1978.5,7,11374,11002,972,697,-372,-275,-97,-0.00473915949588333,-0.00350341091765569,-0.00123574857822764,EPCI
242852465,CC du Bonnevalais,1982_1990,1986,8,11002,10578,1043,776,-424,-267,-157,-0.00490054070252799,-0.00308595369711079,-0.0018145870054172,EPCI
242852465,CC du Bonnevalais,1990_1999,1994.5,9,10578,10577,1231,917,-1,-314,313,-1.0504422369495e-05,-0.00329838862402143,0.00328788420165194,EPCI
242852465,CC du Bonnevalais,1999_2006,2002.5,7,10577,11106,894,819,529,-75,604,0.00699631356942665,-0.000991915912489601,0.00798822948191625,EPCI
242900074,CC du Pays d'Iroise,2006_2011,2008.5,5,43267,46118,2024,2827,2851,803,2048,0.0128444117584119,0.00361769997965793,0.00922671177875396,EPCI
242900074,CC du Pays d'Iroise,2011_2016,2013.5,5,46118,48043,2177,2524,1925,347,1578,0.00821215907902961,0.00148032166255755,0.00673183741647207,EPCI
242900074,CC du Pays d'Iroise,1968_1975,1971.5,7,26325,27814,2242,2780,1489,538,951,0.00789103324105223,0.00285115908911088,0.00503987415194135,EPCI
242900074,CC du Pays d'Iroise,1975_1982,1978.5,7,27814,32085,2326,2712,4271,386,3885,0.0206166669149062,0.00186327169963797,0.0187533952152682,EPCI
242900074,CC du Pays d'Iroise,1982_1990,1986,8,32085,36031,2948,3548,3946,600,3346,0.0146044995856613,0.00222065376365859,0.0123838458220028,EPCI
242900074,CC du Pays d'Iroise,1990_1999,1994.5,9,36031,38923,3425,3860,2892,435,2457,0.00861530624549167,0.00129587075269325,0.00731943549279842,EPCI
242900074,CC du Pays d'Iroise,1999_2006,2002.5,7,38923,43267,2807,3491,4344,684,3660,0.015229792535034,0.0023980612555164,0.0128317312795176,EPCI
242900314,Brest Métropole,2006_2011,2008.5,5,210117,206893,9066,12383,-3224,3317,-6541,-0.0030877763860756,0.00317684685875086,-0.00626462324482646,EPCI
242900314,Brest Métropole,2011_2016,2013.5,5,206893,208930,9395,11998,2037,2603,-566,0.00196142432595803,0.00250642489959192,-0.000545000573633895,EPCI
242900314,Brest Métropole,1968_1975,1971.5,7,183595,206668,12597,29565,23073,16968,6105,0.0170554391686695,0.0125426555633851,0.00451278360528441,EPCI
242900314,Brest Métropole,1975_1982,1978.5,7,206668,207831,12786,25719,1163,12933,-11770,0.000801979768394245,0.00891831843907375,-0.00811633867067951,EPCI
242900314,Brest Métropole,1982_1990,1986,8,207831,208265,14190,26307,434,12117,-11683,0.000260791227650437,0.00728112282359525,-0.00702033159594482,EPCI
242900314,Brest Métropole,1990_1999,1994.5,9,208265,213545,16541,26176,5280,9635,-4355,0.0027856812670346,0.00508334072118909,-0.00229765945415449,EPCI
242900314,Brest Métropole,1999_2006,2002.5,7,213545,210117,12927,18527,-3428,5600,-9028,-0.00230919610429925,0.00377231568963705,-0.0060815117939363,EPCI
242900553,CC du Pays des Abers,2006_2011,2008.5,5,37226,39742,1780,2561,2516,781,1735,0.0131661445647597,0.00408694710058718,0.00907919746417255,EPCI
242900553,CC du Pays des Abers,2011_2016,2013.5,5,39742,40699,1808,2334,957,526,431,0.00477033381431236,0.00262193896168056,0.00214839485263179,EPCI
242900553,CC du Pays des Abers,1968_1975,1971.5,7,25227,26617,2090,2585,1390,495,895,0.00769160960048354,0.00273909838290601,0.00495251121757753,EPCI
242900553,CC du Pays des Abers,1975_1982,1978.5,7,26617,30287,2407,2635,3670,228,3442,0.0186239402728745,0.00115701863275624,0.0174669216401183,EPCI
242900553,CC du Pays des Abers,1982_1990,1986,8,30287,32083,2851,3053,1796,202,1594,0.007226953952433,0.000812831123825984,0.00641412282860702,EPCI
242900553,CC du Pays des Abers,1990_1999,1994.5,9,32083,33814,3001,3579,1731,578,1153,0.00585581453919404,0.00195532108818842,0.00390049345100562,EPCI
242900553,CC du Pays des Abers,1999_2006,2002.5,7,33814,37226,2394,3456,3412,1062,2350,0.0138279515129802,0.00430401069952667,0.00952394081345355,EPCI
242900561,CC de Haute-Cornouaille,2006_2011,2008.5,5,14934,15020,1102,736,86,-366,452,0.00114909044359868,-0.00489031514368739,0.00603940558728607,EPCI
242900561,CC de Haute-Cornouaille,2011_2016,2013.5,5,15020,14932,1141,666,-88,-475,387,-0.00117452675960783,-0.00633977512288317,0.00516524836327534,EPCI
242900561,CC de Haute-Cornouaille,1968_1975,1971.5,7,18238,16891,1828,1289,-1347,-539,-808,-0.010901061467479,-0.00436204315588063,-0.00653901831159842,EPCI
242900561,CC de Haute-Cornouaille,1975_1982,1978.5,7,16891,16342,1858,1070,-549,-788,239,-0.00470922733018708,-0.00675932811691698,0.0020501007867299,EPCI
242900561,CC de Haute-Cornouaille,1982_1990,1986,8,16342,15258,2103,1188,-1084,-915,-169,-0.00854261835411363,-0.00721078947787267,-0.00133182887624096,EPCI
242900561,CC de Haute-Cornouaille,1990_1999,1994.5,9,15258,14732,2172,1275,-526,-897,371,-0.00389040790992734,-0.00663440284259472,0.00274399493266738,EPCI
242900561,CC de Haute-Cornouaille,1999_2006,2002.5,7,14732,14934,1607,1069,202,-538,740,0.00194739285857959,-0.00518662058374168,0.00713401344232127,EPCI
242900629,CC Cap Sizun - Pointe du Raz,2006_2011,2008.5,5,16010,15921,1528,557,-89,-971,882,-0.00111428562116489,-0.0121569813275405,0.0110426957063757,EPCI
242900629,CC Cap Sizun - Pointe du Raz,2011_2016,2013.5,5,15921,15406,1434,420,-515,-1014,499,-0.0065548125915379,-0.0129059805200377,0.00635116792849982,EPCI
242900629,CC Cap Sizun - Pointe du Raz,1968_1975,1971.5,7,22760,21082,2518,1819,-1678,-699,-979,-0.0108810842383331,-0.00453270434004461,-0.00634837989828851,EPCI
242900629,CC Cap Sizun - Pointe du Raz,1975_1982,1978.5,7,21082,19588,2419,1237,-1494,-1182,-312,-0.0104454154716459,-0.00826404356592065,-0.00218137190572525,EPCI
242900629,CC Cap Sizun - Pointe du Raz,1982_1990,1986,8,19588,18150,2676,1173,-1438,-1503,65,-0.00948554730860174,-0.00991430987818388,0.000428762569582138,EPCI
242900629,CC Cap Sizun - Pointe du Raz,1990_1999,1994.5,9,18150,16256,2767,1089,-1894,-1678,-216,-0.01217071803875,-0.010782716403919,-0.00138800163483105,EPCI
242900629,CC Cap Sizun - Pointe du Raz,1999_2006,2002.5,7,16256,16010,2075,841,-246,-1234,988,-0.0021759925720688,-0.0109153448533858,0.00873935228131696,EPCI
242900645,CC Douarnenez Communauté,2006_2011,2008.5,5,19890,19155,1425,766,-735,-659,-76,-0.00750237854509805,-0.00672662239621717,-0.000775756148880888,EPCI
242900645,CC Douarnenez Communauté,2011_2016,2013.5,5,19155,18327,1348,662,-828,-686,-142,-0.00879874166700512,-0.00728977872411294,-0.00150896294289218,EPCI
242900645,CC Douarnenez Communauté,1968_1975,1971.5,7,23163,22732,2510,2229,-431,-281,-150,-0.00267962545718747,-0.00174704119134497,-0.000932584265842508,EPCI
242900645,CC Douarnenez Communauté,1975_1982,1978.5,7,22732,21908,2499,1778,-824,-721,-103,-0.00526065070106319,-0.00460306936343029,-0.000657581337632898,EPCI
242900645,CC Douarnenez Communauté,1982_1990,1986,8,21908,20875,2610,1957,-1033,-653,-380,-0.0060192607477112,-0.00380501187633631,-0.00221424887137488,EPCI
242900645,CC Douarnenez Communauté,1990_1999,1994.5,9,20875,20145,2663,1875,-730,-788,58,-0.00394731679312632,-0.00426093922326512,0.000313622430138803,EPCI
242900645,CC Douarnenez Communauté,1999_2006,2002.5,7,20145,19890,2017,1225,-255,-792,537,-0.00181820588270931,-0.00564713356512069,0.00382892768241137,EPCI
242900660,CC du Pays Fouesnantais,2006_2011,2008.5,5,26263,26832,1243,1202,569,-41,610,0.00429602166467125,-0.00030955516388668,0.00460557682855793,EPCI
242900660,CC du Pays Fouesnantais,2011_2016,2013.5,5,26832,27572,1390,1042,740,-348,1088,0.00545594172289454,-0.00256576718860446,0.008021708911499,EPCI
242900660,CC du Pays Fouesnantais,1968_1975,1971.5,7,11552,13984,1052,1155,2432,103,2329,0.0276694876318906,0.00117185741204142,0.0264976302198492,EPCI
242900660,CC du Pays Fouesnantais,1975_1982,1978.5,7,13984,16447,1166,1250,2463,84,2379,0.0234462512870277,0.000799628545720799,0.0226466227413069,EPCI
242900660,CC du Pays Fouesnantais,1982_1990,1986,8,16447,19336,1514,1666,2889,152,2737,0.0204341706250308,0.00107511039633253,0.0193590602286983,EPCI
242900660,CC du Pays Fouesnantais,1990_1999,1994.5,9,19336,22424,1713,1944,3088,231,2857,0.0165988293502291,0.001241687040124,0.0153571423101051,EPCI
242900660,CC du Pays Fouesnantais,1999_2006,2002.5,7,22424,26263,1523,1764,3839,241,3598,0.0228323706179405,0.00143334235970921,0.0213990282582313,EPCI
242900694,CA Quimperlé Communauté,2006_2011,2008.5,5,50958,54601,3046,2784,3643,-262,3905,0.0139058864555643,-0.00100009394766892,0.0149059804032333,EPCI
242900694,CA Quimperlé Communauté,2011_2016,2013.5,5,54601,55464,3184,2736,863,-448,1311,0.00314131643379834,-0.00163071814871571,0.00477203458251404,EPCI
242900694,CA Quimperlé Communauté,1968_1975,1971.5,7,48276,48012,4523,4640,-264,117,-381,-0.00078305940491652,0.000347037690815276,-0.0011300970957318,EPCI
242900694,CA Quimperlé Communauté,1975_1982,1978.5,7,48012,48826,4474,3742,814,-732,1546,0.00240459759012435,-0.0021623654004558,0.00456696299058015,EPCI
242900694,CA Quimperlé Communauté,1982_1990,1986,8,48826,49112,5078,4191,286,-887,1173,0.000730322338259315,-0.0022650206784476,0.00299534301670691,EPCI
242900694,CA Quimperlé Communauté,1990_1999,1994.5,9,49112,49266,5441,4447,154,-994,1148,0.000347925381946057,-0.00224570019256091,0.00259362557450697,EPCI
242900694,CA Quimperlé Communauté,1999_2006,2002.5,7,49266,50958,4149,3638,1692,-511,2203,0.00483559336634487,-0.00146039492328737,0.00629598828963224,EPCI
242900702,CC du Pays Bigouden Sud,2006_2011,2008.5,5,36274,37624,2486,1538,1350,-948,2298,0.00733495263008499,-0.00515076673579302,0.012485719365878,EPCI
242900702,CC du Pays Bigouden Sud,2011_2016,2013.5,5,37624,37332,2534,1275,-292,-1259,967,-0.00155704193829243,-0.00671341027503481,0.00515636833674238,EPCI
242900702,CC du Pays Bigouden Sud,1968_1975,1971.5,7,34239,34229,3471,3000,-10,-471,461,-4.17287384553156e-05,-0.00196542358124536,0.00192369484279005,EPCI
242900702,CC du Pays Bigouden Sud,1975_1982,1978.5,7,34229,34112,3645,2594,-117,-1051,934,-0.0004890245930953,-0.00439286194310393,0.00390383735000863,EPCI
242900702,CC du Pays Bigouden Sud,1982_1990,1986,8,34112,34210,3959,3018,98,-941,1039,0.000358660609108163,-0.00344387380786512,0.00380253441697328,EPCI
242900702,CC du Pays Bigouden Sud,1990_1999,1994.5,9,34210,34601,4308,3053,391,-1255,1646,0.00126352918017858,-0.00405557319980593,0.00531910237998451,EPCI
242900702,CC du Pays Bigouden Sud,1999_2006,2002.5,7,34601,36274,3482,2357,1673,-1125,2798,0.00676832338623878,-0.00455132325733331,0.0113196466435721,EPCI
242900710,CC du Haut Pays Bigouden,2006_2011,2008.5,5,16368,17561,955,967,1193,12,1181,0.0141699199009657,0.000142530627671072,0.0140273892732947,EPCI
242900710,CC du Haut Pays Bigouden,2011_2016,2013.5,5,17561,18028,1092,869,467,-223,690,0.00526291486314245,-0.00251312636933783,0.00777604123248029,EPCI
242900710,CC du Haut Pays Bigouden,1968_1975,1971.5,7,15928,15588,1596,1166,-340,-430,90,-0.00307770829931209,-0.00389239579030646,0.000814687490994376,EPCI
242900710,CC du Haut Pays Bigouden,1975_1982,1978.5,7,15588,15603,1643,968,15,-675,690,0.000137411723352132,-0.00618352755084595,0.00632093927419808,EPCI
242900710,CC du Haut Pays Bigouden,1982_1990,1986,8,15603,15312,1843,1178,-291,-665,374,-0.00235052926311985,-0.00537148439853849,0.00302095513541864,EPCI
242900710,CC du Haut Pays Bigouden,1990_1999,1994.5,9,15312,15123,2070,1241,-189,-829,640,-0.00137905610943456,-0.00604887573926588,0.00466981962983132,EPCI
242900710,CC du Haut Pays Bigouden,1999_2006,2002.5,7,15123,16368,1412,1156,1245,-256,1501,0.0113657398090363,-0.00233705171976972,0.013702791528806,EPCI
242900744,CC Poher communauté,2006_2011,2008.5,5,15819,16035,1030,739,216,-291,507,0.00271609871636924,-0.0036591885484419,0.00637528726481114,EPCI
242900744,CC Poher communauté,2011_2016,2013.5,5,16035,15597,1121,692,-438,-429,-9,-0.00552373676789786,-0.0054102353274616,-0.000113501440436257,EPCI
242900744,CC Poher communauté,1968_1975,1971.5,7,15592,15969,1577,1448,377,-129,506,0.00341888548123337,-0.00116985736625757,0.00458874284749094,EPCI
242900744,CC Poher communauté,1975_1982,1978.5,7,15969,16594,1532,1378,625,-154,779,0.005499616440517,-0.00135510549094339,0.00685472193146039,EPCI
242900744,CC Poher communauté,1982_1990,1986,8,16594,16427,1810,1518,-167,-292,125,-0.00126355874692963,-0.00220933625211647,0.000945777505186847,EPCI
242900744,CC Poher communauté,1990_1999,1994.5,9,16427,15703,1905,1493,-724,-412,-312,-0.00499576231298993,-0.00284289236595559,-0.00215286994703433,EPCI
242900744,CC Poher communauté,1999_2006,2002.5,7,15703,15819,1487,1108,116,-379,495,0.00105197755686892,-0.00343706460390794,0.00448904216077686,EPCI
242900751,CC du Pays de Landivisiau,2006_2011,2008.5,5,30255,32430,1452,2307,2175,855,1320,0.0139813292682107,0.00549610874681387,0.00848522052139685,EPCI
242900751,CC du Pays de Landivisiau,2011_2016,2013.5,5,32430,33066,1483,2209,636,726,-90,0.00389188254424222,0.00444262064012555,-0.000550738095883333,EPCI
242900751,CC du Pays de Landivisiau,1968_1975,1971.5,7,25709,26608,2397,2977,899,580,319,0.00492218826342916,0.00317560533124462,0.00174658293218454,EPCI
242900751,CC du Pays de Landivisiau,1975_1982,1978.5,7,26608,27598,2477,2703,990,226,764,0.00523241062141633,0.00119446949539403,0.0040379411260223,EPCI
242900751,CC du Pays de Landivisiau,1982_1990,1986,8,27598,27872,2716,2829,274,113,161,0.00123567461013074,0.000509603032645161,0.000726071577485583,EPCI
242900751,CC du Pays de Landivisiau,1990_1999,1994.5,9,27872,28502,2900,3234,630,334,296,0.00248660421595925,0.0013182949335403,0.00116830928241895,EPCI
242900751,CC du Pays de Landivisiau,1999_2006,2002.5,7,28502,30255,2178,2933,1753,755,998,0.0085631990474786,0.00368808629825804,0.00487511274922056,EPCI
242900769,CA Concarneau Cornouaille Agglomération,2006_2011,2008.5,5,48930,49020,3104,2394,90,-710,800,0.000367602108888532,-0.00289997219234286,0.00326757430123139,EPCI
242900769,CA Concarneau Cornouaille Agglomération,2011_2016,2013.5,5,49020,49955,3202,2181,935,-1021,1956,0.00378599325150852,-0.00413422364683444,0.00792021689834297,EPCI
242900769,CA Concarneau Cornouaille Agglomération,1968_1975,1971.5,7,42960,44547,3747,4547,1587,800,787,0.00519564527773131,0.00261910284951799,0.00257654242821332,EPCI
242900769,CA Concarneau Cornouaille Agglomération,1975_1982,1978.5,7,44547,44962,3936,3643,415,-293,708,0.00132557451250981,-0.000935887547386443,0.00226146205989625,EPCI
242900769,CA Concarneau Cornouaille Agglomération,1982_1990,1986,8,44962,45634,4379,4021,672,-358,1030,0.00185614101876985,-0.000988837030832749,0.0028449780496026,EPCI
242900769,CA Concarneau Cornouaille Agglomération,1990_1999,1994.5,9,45634,46564,5122,4311,930,-811,1741,0.00224414295701392,-0.00195698918079386,0.00420113213780777,EPCI
242900769,CA Concarneau Cornouaille Agglomération,1999_2006,2002.5,7,46564,48930,4236,3512,2366,-724,3090,0.00710555333898322,-0.00217431133449867,0.00927986467348189,EPCI
242900793,CC Communauté Lesneven Côte des Légendes,2006_2011,2008.5,5,25712,27298,1306,1558,1586,252,1334,0.0120430668015177,0.00191352637703812,0.0101295404244796,EPCI
242900793,CC Communauté Lesneven Côte des Légendes,2011_2016,2013.5,5,27298,27482,1389,1423,184,34,150,0.00134446407768274,0.00024843357957181,0.00109603049811093,EPCI
242900793,CC Communauté Lesneven Côte des Légendes,1968_1975,1971.5,7,22589,23318,1842,2640,729,798,-69,0.00454781468877075,0.00497826628482724,-0.000430451596056491,EPCI
242900793,CC Communauté Lesneven Côte des Légendes,1975_1982,1978.5,7,23318,24218,1972,2167,900,195,705,0.00542474145860639,0.00117536064936472,0.00424938080924167,EPCI
242900793,CC Communauté Lesneven Côte des Légendes,1982_1990,1986,8,24218,24844,2283,2461,626,178,448,0.00319510805669565,0.000908513153501319,0.00228659490319433,EPCI
242900793,CC Communauté Lesneven Côte des Légendes,1990_1999,1994.5,9,24844,24682,2443,2354,-162,-89,-73,-0.000726629395358391,-0.000399197630783314,-0.000327431764575078,EPCI
242900793,CC Communauté Lesneven Côte des Légendes,1999_2006,2002.5,7,24682,25712,1884,2138,1030,254,776,0.00585759988889945,0.00144449550658297,0.00441310438231648,EPCI
242900801,CC du Pays de Landerneau-Daoulas,2006_2011,2008.5,5,44392,46622,1797,3108,2230,1311,919,0.00985085531209351,0.00579124274177336,0.00405961257032015,EPCI
242900801,CC du Pays de Landerneau-Daoulas,2011_2016,2013.5,5,46622,48280,1943,2815,1658,872,786,0.00701345256597441,0.00368861920237014,0.00332483336360427,EPCI
242900801,CC du Pays de Landerneau-Daoulas,1968_1975,1971.5,7,29823,32329,2644,3628,2506,984,1522,0.0115930780265909,0.00455211044619532,0.00704096758039561,EPCI
242900801,CC du Pays de Landerneau-Daoulas,1975_1982,1978.5,7,32329,36732,2852,3403,4403,551,3852,0.0184078957860054,0.00230359994960004,0.0161042958364054,EPCI
242900801,CC du Pays de Landerneau-Daoulas,1982_1990,1986,8,36732,39485,3285,4176,2753,891,1862,0.00907499825421176,0.00293709533036785,0.00613790292384392,EPCI
242900801,CC du Pays de Landerneau-Daoulas,1990_1999,1994.5,9,39485,41355,3355,4457,1870,1102,768,0.00515462629705543,0.00303764608521662,0.00211698021183881,EPCI
242900801,CC du Pays de Landerneau-Daoulas,1999_2006,2002.5,7,41355,44392,2486,4057,3037,1571,1466,0.0101751237729653,0.00526345717725664,0.00491166659570861,EPCI
242900835,CA Morlaix Communauté,2006_2011,2008.5,5,63926,64833,4066,3452,907,-614,1521,0.00282168720689269,-0.00191016090962746,0.00473184811652015,EPCI
242900835,CA Morlaix Communauté,2011_2016,2013.5,5,64833,64247,4166,3198,-586,-968,382,-0.00181429275966283,-0.00299698872244645,0.00118269596278362,EPCI
242900835,CA Morlaix Communauté,1968_1975,1971.5,7,58426,61031,5779,5937,2605,158,2447,0.00625101880174084,0.00037914048778313,0.00587187831395771,EPCI
242900835,CA Morlaix Communauté,1975_1982,1978.5,7,61031,64076,5813,5793,3045,-20,3065,0.00697966612444234,-4.58434556613619e-05,0.0070255095801037,EPCI
242900835,CA Morlaix Communauté,1982_1990,1986,8,64076,63309,6640,6329,-767,-311,-456,-0.00150416507066031,-0.000609902655769697,-0.000894262414890616,EPCI
242900835,CA Morlaix Communauté,1990_1999,1994.5,9,63309,62179,7123,5811,-1130,-1312,182,-0.00199912984813688,-0.00232111359358902,0.000321983745452135,EPCI
242900835,CA Morlaix Communauté,1999_2006,2002.5,7,62179,63926,5703,4885,1747,-818,2565,0.00396625086922109,-0.00185712261649848,0.00582337348571957,EPCI
243000270,CC du Pays Viganais,2006_2011,2008.5,5,10265,10099,707,488,-166,-219,53,-0.00325541788431305,-0.00429479829315999,0.00103938040884694,EPCI
243000270,CC du Pays Viganais,2011_2016,2013.5,5,10099,10089,650,397,-10,-253,243,-0.000198117895692795,-0.00501238276102772,0.00481426486533493,EPCI
243000270,CC du Pays Viganais,1968_1975,1971.5,7,9452,9225,1019,722,-227,-297,70,-0.0034667155032424,-0.00453574671569601,0.0010690312124536,EPCI
243000270,CC du Pays Viganais,1975_1982,1978.5,7,9225,9593,965,610,368,-355,723,0.00560371036225726,-0.005405753202721,0.0110094635649783,EPCI
243000270,CC du Pays Viganais,1982_1990,1986,8,9593,9728,1192,860,135,-332,467,0.0017483590240337,-0.00429966811836435,0.00604802714239805,EPCI
243000270,CC du Pays Viganais,1990_1999,1994.5,9,9728,10111,1137,918,383,-219,602,0.00429984178159115,-0.00245865626675839,0.00675849804834954,EPCI
243000270,CC du Pays Viganais,1999_2006,2002.5,7,10111,10265,836,652,154,-184,338,0.00216177761652614,-0.00258290312623902,0.00474468074276516,EPCI
243000296,CC du Pays de Sommières,2006_2011,2008.5,5,19243,21380,898,1310,2137,412,1725,0.0212850726552958,0.00410362654842389,0.0171814461068719,EPCI
243000296,CC du Pays de Sommières,2011_2016,2013.5,5,21380,23087,909,1199,1707,290,1417,0.0154813703688017,0.00263010978731839,0.0128512605814833,EPCI
243000296,CC du Pays de Sommières,1968_1975,1971.5,7,9723,9671,988,887,-52,-101,49,-0.000765777513011212,-0.00148737555411793,0.000721598041106719,EPCI
243000296,CC du Pays de Sommières,1975_1982,1978.5,7,9671,10913,1155,773,1242,-382,1624,0.017410253779558,-0.00535484456021831,0.0227650983397763,EPCI
243000296,CC du Pays de Sommières,1982_1990,1986,8,10913,13032,1312,1162,2119,-150,2269,0.0224294832511773,-0.00158774067375016,0.0240172239249275,EPCI
243000296,CC du Pays de Sommières,1990_1999,1994.5,9,13032,15743,1441,1567,2711,126,2585,0.0212206844187302,0.000986280426691258,0.0202344039920389,EPCI
243000296,CC du Pays de Sommières,1999_2006,2002.5,7,15743,19243,1109,1553,3500,444,3056,0.029093987013695,0.00369078006688017,0.0254032069468149,EPCI
243000569,"CC Rhony, Vistre, Vidourle",2006_2011,2008.5,5,22570,24866,920,1403,2296,483,1813,0.0195648957971595,0.00411578600610977,0.0154491097910497,EPCI
243000569,"CC Rhony, Vistre, Vidourle",2011_2016,2013.5,5,24866,26414,983,1477,1548,494,1054,0.0121517931191641,0.00387789780417771,0.00827389531498644,EPCI
243000569,"CC Rhony, Vistre, Vidourle",1968_1975,1971.5,7,9381,10670,870,890,1289,20,1269,0.0185630036489211,0.00028802177888163,0.0182749818700394,EPCI
243000569,"CC Rhony, Vistre, Vidourle",1975_1982,1978.5,7,10670,13244,926,923,2574,-3,2577,0.0313541532156321,-3.65433021161213e-05,0.0313906965177482,EPCI
243000569,"CC Rhony, Vistre, Vidourle",1982_1990,1986,8,13244,16501,1203,1421,3257,218,3039,0.0278657300193259,0.00186513022542617,0.0260005997938997,EPCI
243000569,"CC Rhony, Vistre, Vidourle",1990_1999,1994.5,9,16501,19646,1502,1912,3145,410,2735,0.0195727236227552,0.00255161102872166,0.0170211125940335,EPCI
243000569,"CC Rhony, Vistre, Vidourle",1999_2006,2002.5,7,19646,22570,1286,1788,2924,502,2422,0.0200188620877675,0.00343689082354968,0.0165819712642178,EPCI
243000585,CC Beaucaire Terre d'Argence,2006_2011,2008.5,5,28161,29933,1160,2094,1772,934,838,0.0122794830299109,0.00647236859477244,0.00580711443513844,EPCI
243000585,CC Beaucaire Terre d'Argence,2011_2016,2013.5,5,29933,30894,1167,2132,961,965,-4,0.00634010181089795,0.00636649141260824,-2.63896017102935e-05,EPCI
243000585,CC Beaucaire Terre d'Argence,1968_1975,1971.5,7,19811,20023,1662,2098,212,436,-224,0.00152176725991993,0.00312967228926928,-0.00160790502934936,EPCI
243000585,CC Beaucaire Terre d'Argence,1975_1982,1978.5,7,20023,21596,1601,1936,1573,335,1238,0.0108623572832907,0.00231334373166076,0.0085490135516299,EPCI
243000585,CC Beaucaire Terre d'Argence,1982_1990,1986,8,21596,23435,1859,2444,1839,585,1254,0.0102676693268835,0.0032662243372631,0.0070014449896204,EPCI
243000585,CC Beaucaire Terre d'Argence,1990_1999,1994.5,9,23435,25147,2056,2883,1712,827,885,0.00786498709767747,0.00379926654776826,0.00406572054990921,EPCI
243000585,CC Beaucaire Terre d'Argence,1999_2006,2002.5,7,25147,28161,1688,2437,3014,749,2265,0.0163028120704638,0.00405136238910995,0.0122514496813539,EPCI
243000593,CC de Petite Camargue,2006_2011,2008.5,5,23006,24410,892,1498,1404,606,798,0.0119180269897146,0.00514410566650073,0.00677392132321383,EPCI
243000593,CC de Petite Camargue,2011_2016,2013.5,5,24410,26570,980,1662,2160,682,1478,0.0171025777658735,0.00539998057237303,0.0117025971935005,EPCI
243000593,CC de Petite Camargue,1968_1975,1971.5,7,11627,12897,958,1281,1270,323,947,0.0149194497571281,0.0037944742295688,0.0111249755275593,EPCI
243000593,CC de Petite Camargue,1975_1982,1978.5,7,12897,15754,970,1368,2857,398,2459,0.0289981444405902,0.00403964350274936,0.0249585009378409,EPCI
243000593,CC de Petite Camargue,1982_1990,1986,8,15754,19526,1302,1970,3772,668,3104,0.0271947841348152,0.00481604342578382,0.0223787407090314,EPCI
243000593,CC de Petite Camargue,1990_1999,1994.5,9,19526,21057,1532,2252,1531,720,811,0.00842262075290789,0.003960997349506,0.0044616234034019,EPCI
243000593,CC de Petite Camargue,1999_2006,2002.5,7,21057,23006,1232,1902,1949,670,1279,0.0127262995188295,0.00437486951134725,0.00835143000748228,EPCI
243000643,CA de Nîmes Métropole,2006_2011,2008.5,5,239825,247746,9892,16290,7921,6398,1523,0.00652007113456166,0.00526643291490032,0.00125363821966133,EPCI
243000643,CA de Nîmes Métropole,2011_2016,2013.5,5,247746,257788,10618,16037,10042,5419,4623,0.00797836163584864,0.00430539152605694,0.0036729701097917,EPCI
243000643,CA de Nîmes Métropole,1968_1975,1971.5,7,157991,170501,11868,17602,12510,5734,6776,0.0109456258615552,0.00501696392407336,0.00592866193748187,EPCI
243000643,CA de Nîmes Métropole,1975_1982,1978.5,7,170501,182352,12407,16214,11851,3807,8044,0.00964589943103467,0.00309863632891309,0.00654726310212158,EPCI
243000643,CA de Nîmes Métropole,1982_1990,1986,8,182352,203337,14689,21176,20985,6487,14498,0.0137088431468779,0.00423775389534416,0.00947108925153377,EPCI
243000643,CA de Nîmes Métropole,1990_1999,1994.5,9,203337,217970,17093,24630,14633,7537,7096,0.00775130228040633,0.00399245303679508,0.00375884924361124,EPCI
243000643,CA de Nîmes Métropole,1999_2006,2002.5,7,217970,239825,13679,20469,21855,6790,15065,0.0137438837650927,0.00427000552573688,0.00947387823935584,EPCI
243000650,CC Terre de Camargue,2006_2011,2008.5,5,18159,20191,969,1073,2032,104,1928,0.0214407503489944,0.00109736123833436,0.02034338911066,EPCI
243000650,CC Terre de Camargue,2011_2016,2013.5,5,20191,20258,1112,950,67,-162,229,0.000662782882847379,-0.00160254965703396,0.00226533253988134,EPCI
243000650,CC Terre de Camargue,1968_1975,1971.5,7,9413,10222,747,1035,809,288,521,0.0118482911360098,0.00421793306201586,0.00763035807399397,EPCI
243000650,CC Terre de Camargue,1975_1982,1978.5,7,10222,10354,879,842,132,-37,169,0.00183463204376144,-0.000514252921357374,0.00234888496511882,EPCI
243000650,CC Terre de Camargue,1982_1990,1986,8,10354,12575,1028,1222,2221,194,2027,0.0245896845484903,0.00214786078451469,0.0224418237639756,EPCI
243000650,CC Terre de Camargue,1990_1999,1994.5,9,12575,14625,1313,1491,2050,178,1872,0.0169217644687736,0.00146930442704473,0.0154524600417289,EPCI
243000650,CC Terre de Camargue,1999_2006,2002.5,7,14625,18159,1197,1285,3534,88,3446,0.0314020913890938,0.000781942286994978,0.0306201491020988,EPCI
243000684,CC du Pont du Gard,2006_2011,2008.5,5,22248,24192,863,1602,1944,739,1205,0.0168951115681755,0.00642257584819016,0.0104725357199853,EPCI
243000684,CC du Pont du Gard,2011_2016,2013.5,5,24192,25926,960,1483,1734,523,1211,0.0139411492159587,0.00420485642442122,0.00973629279153746,EPCI
243000684,CC du Pont du Gard,1968_1975,1971.5,7,12113,12979,985,1218,866,233,633,0.00991359021739657,0.0026672823564127,0.00724630786098387,EPCI
243000684,CC du Pont du Gard,1975_1982,1978.5,7,12979,15624,1111,1349,2645,238,2407,0.0268506572195633,0.00241605157590021,0.0244346056436631,EPCI
243000684,CC du Pont du Gard,1982_1990,1986,8,15624,17844,1284,1804,2220,520,1700,0.0167460597518854,0.0039225004824236,0.0128235592694618,EPCI
243000684,CC du Pont du Gard,1990_1999,1994.5,9,17844,20326,1503,2104,2482,601,1881,0.0145755960177276,0.0035293848536077,0.0110462111641199,EPCI
243000684,CC du Pont du Gard,1999_2006,2002.5,7,20326,22248,1286,1850,1922,564,1358,0.0129909822201126,0.00381213005834731,0.00917885216176533,EPCI
243100518,Toulouse Métropole,2006_2011,2008.5,5,687535,714332,20495,45965,26797,25470,1327,0.00767633371879084,0.00729619807506821,0.000380135643722634,EPCI
243100518,Toulouse Métropole,2011_2016,2013.5,5,714332,762956,21772,49798,48624,28026,20598,0.0132576175661825,0.00764145257300573,0.00561616499317676,EPCI
243100518,Toulouse Métropole,1968_1975,1971.5,7,436821,489266,28228,53969,52445,25741,26704,0.0163294354548227,0.00801479641610431,0.00831463903871837,EPCI
243100518,Toulouse Métropole,1975_1982,1978.5,7,489266,496256,27894,47142,6990,19248,-12258,0.00202857102182263,0.00558597067640087,-0.00355739965457823,EPCI
243100518,Toulouse Métropole,1982_1990,1986,8,496256,547254,31008,55216,50998,24208,26790,0.0123027036115464,0.00583991233045051,0.00646279128109589,EPCI
243100518,Toulouse Métropole,1990_1999,1994.5,9,547254,614970,35900,69806,67716,33906,33810,0.0130466455683691,0.00653257080514388,0.00651407476322522,EPCI
243100518,Toulouse Métropole,1999_2006,2002.5,7,614970,687535,29293,58986,72565,29693,42872,0.0160618047407137,0.00657235813637446,0.00948944660433926,EPCI
243100567,CC Lauragais Revel Sorezois,2006_2011,2008.5,5,19445,20753,1077,965,1308,-112,1420,0.0131053008659818,-0.00112216643500762,0.0142274673009894,EPCI
243100567,CC Lauragais Revel Sorezois,2011_2016,2013.5,5,20753,21428,1134,927,675,-207,882,0.00642206629839159,-0.00196943366484009,0.00839149996323168,EPCI
243100567,CC Lauragais Revel Sorezois,1968_1975,1971.5,7,14807,14689,1406,1218,-118,-188,70,-0.00114236522881672,-0.00182003951709783,0.000677674288281106,EPCI
243100567,CC Lauragais Revel Sorezois,1975_1982,1978.5,7,14689,15246,1466,1061,557,-405,962,0.00533105393985989,-0.00387626004603816,0.00920731398589805,EPCI
243100567,CC Lauragais Revel Sorezois,1982_1990,1986,8,15246,15872,1712,1213,626,-499,1125,0.0050425934166316,-0.0040195752634172,0.0090621686800488,EPCI
243100567,CC Lauragais Revel Sorezois,1990_1999,1994.5,9,15872,17085,1849,1542,1213,-307,1520,0.00821627371462963,-0.00207946910996809,0.0102957428245977,EPCI
243100567,CC Lauragais Revel Sorezois,1999_2006,2002.5,7,17085,19445,1523,1276,2360,-247,2607,0.0186560440059966,-0.00195256053791575,0.0206086045439124,EPCI
243100633,CA du Sicoval,2006_2011,2008.5,5,63754,68929,1914,3355,5175,1441,3734,0.0157314693794732,0.00438049224653545,0.0113509771329378,EPCI
243100633,CA du Sicoval,2011_2016,2013.5,5,68929,76777,2155,3833,7848,1678,6170,0.0217998441224474,0.00466107778255183,0.0171387663398956,EPCI
243100633,CA du Sicoval,1968_1975,1971.5,7,14952,28587,1161,2351,13635,1190,12445,0.0970082635486502,0.00846643444245646,0.0885418291061938,EPCI
243100633,CA du Sicoval,1975_1982,1978.5,7,28587,38258,1551,3018,9671,1467,8204,0.0425072821650252,0.00644795604757439,0.0360593261174508,EPCI
243100633,CA du Sicoval,1982_1990,1986,8,38258,48367,2046,4106,10109,2060,8049,0.029741844360057,0.00606075767946557,0.0236810866805914,EPCI
243100633,CA du Sicoval,1990_1999,1994.5,9,48367,57848,3086,5704,9481,2618,6863,0.0200881173231202,0.00554695613879641,0.0145411611843238,EPCI
243100633,CA du Sicoval,1999_2006,2002.5,7,57848,63754,2521,4798,5906,2277,3629,0.013984458412557,0.00539156989593504,0.00859288851662198,EPCI
243100732,CC des Coteaux du Girou,2006_2011,2008.5,5,18685,20052,467,1118,1367,651,716,0.0142217476365243,0.006772756189742,0.00744899144678229,EPCI
243100732,CC des Coteaux du Girou,2011_2016,2013.5,5,20052,21026,500,1069,974,569,405,0.00953130990566109,0.00556808556090468,0.00396322434475641,EPCI
243100732,CC des Coteaux du Girou,1968_1975,1971.5,7,7452,8749,594,662,1297,68,1229,0.0231871598571325,0.00121567222072861,0.0219714876364039,EPCI
243100732,CC des Coteaux du Girou,1975_1982,1978.5,7,8749,10976,663,766,2227,103,2124,0.0329264134567626,0.00152286510374789,0.0314035483530147,EPCI
243100732,CC des Coteaux du Girou,1982_1990,1986,8,10976,12978,748,1050,2002,302,1700,0.0211639132338191,0.00319255833996671,0.0179713548938523,EPCI
243100732,CC des Coteaux du Girou,1990_1999,1994.5,9,12978,15904,824,1554,2926,730,2196,0.0228476583400703,0.00570020184150763,0.0171474564985627,EPCI
243100732,CC des Coteaux du Girou,1999_2006,2002.5,7,15904,18685,646,1479,2781,833,1948,0.023288527299703,0.00697567178736159,0.0163128555123414,EPCI
243100773,CC de Val'Aïgo,2006_2011,2008.5,5,13603,15460,794,1074,1857,280,1577,0.0259234535629764,0.00390875982640463,0.0220146937365718,EPCI
243100773,CC de Val'Aïgo,2011_2016,2013.5,5,15460,17230,906,1112,1770,206,1564,0.0219159027681219,0.00255066438996222,0.0193652383781597,EPCI
243100773,CC de Val'Aïgo,1968_1975,1971.5,7,9209,9459,836,853,250,17,233,0.00383381641491898,0.000260699516214491,0.00357311689870449,EPCI
243100773,CC de Val'Aïgo,1975_1982,1978.5,7,9459,9985,874,675,526,-199,725,0.00776100419063597,-0.00293619740292121,0.0106972015935572,EPCI
243100773,CC de Val'Aïgo,1982_1990,1986,8,9985,10847,1005,894,862,-111,973,0.0104043246168826,-0.00133976801911133,0.0117440926359939,EPCI
243100773,CC de Val'Aïgo,1990_1999,1994.5,9,10847,11413,1440,1042,566,-398,964,0.0056676129920763,-0.00398535330538227,0.00965296629745857,EPCI
243100773,CC de Val'Aïgo,1999_2006,2002.5,7,11413,13603,1145,1048,2190,-97,2287,0.0253938238157831,-0.0011247492740324,0.0265185730898155,EPCI
243100781,CC de la Save au Touch,2006_2011,2008.5,5,32759,35387,898,2150,2628,1252,1376,0.0155530668214279,0.00740960413258284,0.00814346268884504,EPCI
243100781,CC de la Save au Touch,2011_2016,2013.5,5,35387,39883,987,2508,4496,1521,2975,0.0242095346610955,0.00819010280683415,0.0160194318542614,EPCI
243100781,CC de la Save au Touch,1968_1975,1971.5,7,6193,9828,483,808,3635,325,3310,0.0681986129032619,0.00609753760483084,0.0621010752984311,EPCI
243100781,CC de la Save au Touch,1975_1982,1978.5,7,9828,12975,677,898,3147,221,2926,0.0404820747819277,0.00284287846419003,0.0376391963177376,EPCI
243100781,CC de la Save au Touch,1982_1990,1986,8,12975,21189,888,1794,8214,906,7308,0.0632255068338181,0.00697374107516913,0.056251765758649,EPCI
243100781,CC de la Save au Touch,1990_1999,1994.5,9,21189,29284,1257,3044,8095,1787,6308,0.0366050645783205,0.00808069801129817,0.0285243665670223,EPCI
243100781,CC de la Save au Touch,1999_2006,2002.5,7,29284,32759,1128,2607,3475,1479,1996,0.0161484916461754,0.00687298392653047,0.00927550771964491,EPCI
243100815,CC des Coteaux Bellevue,2006_2011,2008.5,5,17037,18298,650,796,1261,146,1115,0.0143833216137013,0.00166531717335479,0.0127180044403465,EPCI
243100815,CC des Coteaux Bellevue,2011_2016,2013.5,5,18298,20038,706,952,1740,246,1494,0.0183337787122031,0.00259201699034596,0.0157417617218571,EPCI
243100815,CC des Coteaux Bellevue,1968_1975,1971.5,7,4022,6512,341,518,2490,177,2313,0.0712628552058061,0.0050656728399308,0.0661971823658753,EPCI
243100815,CC des Coteaux Bellevue,1975_1982,1978.5,7,6512,8164,379,476,1652,97,1555,0.0328254798437049,0.00192740408283255,0.0308980757608723,EPCI
243100815,CC des Coteaux Bellevue,1982_1990,1986,8,8164,11291,484,833,3127,349,2778,0.0413666769408503,0.00461687568031876,0.0367498012605315,EPCI
243100815,CC des Coteaux Bellevue,1990_1999,1994.5,9,11291,14856,822,1326,3565,504,3061,0.030958191568307,0.00437669805061059,0.0265814935176965,EPCI
243100815,CC des Coteaux Bellevue,1999_2006,2002.5,7,14856,17037,778,1331,2181,553,1628,0.0197618191172952,0.00501067674088229,0.014751142376413,EPCI
243200391,CC de la Lomagne Gersoise,2006_2011,2008.5,5,18941,19442,1174,826,501,-348,849,0.00523501298986351,-0.0036362964480489,0.00887130943791241,EPCI
243200391,CC de la Lomagne Gersoise,2011_2016,2013.5,5,19442,19299,1296,768,-143,-528,385,-0.00147538920201684,-0.00544759089975449,0.00397220169773765,EPCI
243200391,CC de la Lomagne Gersoise,1968_1975,1971.5,7,19182,18595,1863,1638,-587,-225,-362,-0.00443010257873311,-0.00169808020479548,-0.00273202237393762,EPCI
243200391,CC de la Lomagne Gersoise,1975_1982,1978.5,7,18595,18531,1711,1392,-64,-319,255,-0.000492410439761226,-0.00245435828568486,0.00196194784592364,EPCI
243200391,CC de la Lomagne Gersoise,1982_1990,1986,8,18531,18970,1948,1526,439,-422,861,0.00293100935370072,-0.00281750785253236,0.00574851720623308,EPCI
243200391,CC de la Lomagne Gersoise,1990_1999,1994.5,9,18970,18620,2111,1599,-350,-512,162,-0.00206702875850573,-0.00302376778387124,0.000956739025365509,EPCI
243200391,CC de la Lomagne Gersoise,1999_2006,2002.5,7,18620,18941,1661,1288,321,-373,694,0.00244478545831472,-0.00284082547025356,0.00528561092856828,EPCI
243200409,CC du Bas Armagnac,2006_2011,2008.5,5,8076,8397,524,336,321,-188,509,0.00782602423719947,-0.00458346590839097,0.0124094901455904,EPCI
243200409,CC du Bas Armagnac,2011_2016,2013.5,5,8397,8554,531,350,157,-181,338,0.00371177375414233,-0.00427917865923416,0.00799095241337649,EPCI
243200409,CC du Bas Armagnac,1968_1975,1971.5,7,9195,8580,823,711,-615,-112,-503,-0.00984068113137038,-0.00179212404343656,-0.00804855708793382,EPCI
243200409,CC du Bas Armagnac,1975_1982,1978.5,7,8580,8228,796,485,-352,-311,-41,-0.00596654926825091,-0.00527158188189214,-0.00069496738635877,EPCI
243200409,CC du Bas Armagnac,1982_1990,1986,8,8228,8102,982,609,-126,-373,247,-0.00192714404500793,-0.0057049581649838,0.00377781411997587,EPCI
243200409,CC du Bas Armagnac,1990_1999,1994.5,9,8102,7809,960,599,-293,-361,68,-0.00408430645085123,-0.00503220009814776,0.00094789364729653,EPCI
243200409,CC du Bas Armagnac,1999_2006,2002.5,7,7809,8076,760,429,267,-331,598,0.00481437859673162,-0.00596838694950624,0.0107827655462379,EPCI
243200417,CC de la Tenarèze,2006_2011,2008.5,5,15100,15023,950,619,-77,-331,254,-0.00102195419688222,-0.00439307583335086,0.00337112163646864,EPCI
243200417,CC de la Tenarèze,2011_2016,2013.5,5,15023,14708,973,582,-315,-391,76,-0.00422919100520713,-0.0052495672477333,0.00102037624252616,EPCI
243200417,CC de la Tenarèze,1968_1975,1971.5,7,16927,16295,1420,1397,-632,-23,-609,-0.0054212045048615,-0.000197290670271858,-0.00522391383458964,EPCI
243200417,CC de la Tenarèze,1975_1982,1978.5,7,16295,15664,1390,1031,-631,-359,-272,-0.00562600393054635,-0.00320084851199071,-0.00242515541855564,EPCI
243200417,CC de la Tenarèze,1982_1990,1986,8,15664,15593,1541,1230,-71,-311,240,-0.000567712563381728,-0.00248674094664391,0.00191902838326218,EPCI
243200417,CC de la Tenarèze,1990_1999,1994.5,9,15593,14980,1658,1198,-613,-460,-153,-0.00444632099512654,-0.00333655409095956,-0.00110976690416698,EPCI
243200417,CC de la Tenarèze,1999_2006,2002.5,7,14980,15100,1351,858,120,-493,613,0.00114047352185809,-0.00468544538563364,0.00582591890749173,EPCI
243200425,CC Coeur d'Astarac en Gascogne,2006_2011,2008.5,5,8074,8090,462,302,16,-160,176,0.000396020123202501,-0.00396020123202501,0.00435622135522751,EPCI
243200425,CC Coeur d'Astarac en Gascogne,2011_2016,2013.5,5,8090,7778,527,317,-312,-210,-102,-0.00783504383767641,-0.00527358719843605,-0.00256145663924037,EPCI
243200425,CC Coeur d'Astarac en Gascogne,1968_1975,1971.5,7,9083,8507,753,881,-576,128,-704,-0.00931564946954944,0.00207014432656654,-0.011385793796116,EPCI
243200425,CC Coeur d'Astarac en Gascogne,1975_1982,1978.5,7,8507,8419,721,605,-88,-116,28,-0.0014843683251029,-0.00195666733763564,0.000472299012532742,EPCI
243200425,CC Coeur d'Astarac en Gascogne,1982_1990,1986,8,8419,7996,852,609,-423,-243,-180,-0.00642298881796466,-0.00368980208691587,-0.00273318673104879,EPCI
243200425,CC Coeur d'Astarac en Gascogne,1990_1999,1994.5,9,7996,7829,914,673,-167,-241,74,-0.00234243317959548,-0.00338039758253001,0.00103796440293453,EPCI
243200425,CC Coeur d'Astarac en Gascogne,1999_2006,2002.5,7,7829,8074,703,531,245,-172,417,0.00441173668286732,-0.00309721922225787,0.00750895590512519,EPCI
243200458,CC du Grand Armagnac,2006_2011,2008.5,5,13054,13340,902,482,286,-420,706,0.00434389553553261,-0.00637914728994299,0.0107230428254756,EPCI
243200458,CC du Grand Armagnac,2011_2016,2013.5,5,13340,13228,837,469,-112,-368,256,-0.00168482815440396,-0.00553586393589873,0.00385103578149477,EPCI
243200458,CC du Grand Armagnac,1968_1975,1971.5,7,15200,14684,1455,1159,-516,-296,-220,-0.00492170029155936,-0.0028233009424449,-0.00209839934911446,EPCI
243200458,CC du Grand Armagnac,1975_1982,1978.5,7,14684,13968,1359,864,-716,-495,-221,-0.00711591349768104,-0.00491952120300574,-0.00219639229467529,EPCI
243200458,CC du Grand Armagnac,1982_1990,1986,8,13968,13416,1488,940,-552,-548,-4,-0.00502744172008252,-0.00499101098298047,-3.64307371020474e-05,EPCI
243200458,CC du Grand Armagnac,1990_1999,1994.5,9,13416,12786,1614,896,-630,-718,88,-0.0053298790972337,-0.00607437014573619,0.000744491048502485,EPCI
243200458,CC du Grand Armagnac,1999_2006,2002.5,7,12786,13054,1255,679,268,-576,844,0.002967792039269,-0.00637853811424979,0.00934633015351879,EPCI
243200508,CC Bastides et Vallons du Gers,2006_2011,2008.5,5,7203,7373,490,233,170,-257,427,0.00467631461124651,-0.00706948738288443,0.0117458019941309,EPCI
243200508,CC Bastides et Vallons du Gers,2011_2016,2013.5,5,7373,7235,540,177,-138,-363,225,-0.00377173286414834,-0.0099212973165641,0.00614956445241576,EPCI
243200508,CC Bastides et Vallons du Gers,1968_1975,1971.5,7,7687,7397,773,563,-290,-210,-80,-0.0054786624815707,-0.00396730731424085,-0.00151135516732985,EPCI
243200508,CC Bastides et Vallons du Gers,1975_1982,1978.5,7,7397,7339,827,462,-58,-365,307,-0.00112392778277448,-0.00707299380539113,0.00594906602261665,EPCI
243200508,CC Bastides et Vallons du Gers,1982_1990,1986,8,7339,7315,854,494,-24,-360,336,-0.00040936107523637,-0.00614041612854555,0.00573105505330918,EPCI
243200508,CC Bastides et Vallons du Gers,1990_1999,1994.5,9,7315,7084,927,520,-231,-407,176,-0.00355901990501184,-0.00627065411835419,0.00271163421334235,EPCI
243200508,CC Bastides et Vallons du Gers,1999_2006,2002.5,7,7084,7203,718,377,119,-341,460,0.00238267492424726,-0.00682766511906149,0.00921034004330875,EPCI
243200599,CC du Saves,2006_2011,2008.5,5,8521,9273,526,470,752,-56,808,0.0170585120607589,-0.00127031472792886,0.0183288267886878,EPCI
243200599,CC du Saves,2011_2016,2013.5,5,9273,9557,552,397,284,-155,439,0.00605162121212,-0.00330282143619225,0.00935444264831225,EPCI
243200599,CC du Saves,1968_1975,1971.5,7,8182,7540,816,520,-642,-296,-346,-0.0116056202260169,-0.00535087786121649,-0.00625474236480036,EPCI
243200599,CC du Saves,1975_1982,1978.5,7,7540,7347,798,373,-193,-425,232,-0.00369744973381425,-0.00814205252264796,0.00444460278883371,EPCI
243200599,CC du Saves,1982_1990,1986,8,7347,7116,882,440,-231,-442,211,-0.003985324535837,-0.00762559932831149,0.00364027479247449,EPCI
243200599,CC du Saves,1990_1999,1994.5,9,7116,7232,952,563,116,-389,505,0.0017982653084283,-0.00603038969809147,0.00782865500651977,EPCI
243200599,CC du Saves,1999_2006,2002.5,7,7232,8521,682,462,1289,-220,1509,0.0237078206812023,-0.0040463309153332,0.0277541515965355,EPCI
243200607,CC Artagnan de Fezensac,2006_2011,2008.5,5,7163,7217,463,289,54,-174,228,0.00150322199876318,-0.00484371532934803,0.00634693732811121,EPCI
243200607,CC Artagnan de Fezensac,2011_2016,2013.5,5,7217,7085,553,270,-132,-283,151,-0.00368508951984381,-0.00790060859178635,0.00421551907194254,EPCI
243200607,CC Artagnan de Fezensac,1968_1975,1971.5,7,8555,8058,745,754,-497,9,-506,-0.00851362643349696,0.000154170297588476,-0.00866779673108543,EPCI
243200607,CC Artagnan de Fezensac,1975_1982,1978.5,7,8058,7803,726,480,-255,-246,-9,-0.00458333739505124,-0.00442157254581413,-0.000161764849237103,EPCI
243200607,CC Artagnan de Fezensac,1982_1990,1986,8,7803,7307,870,517,-496,-353,-143,-0.00817582990010091,-0.00581868539261214,-0.00235714450748877,EPCI
243200607,CC Artagnan de Fezensac,1990_1999,1994.5,9,7307,7043,917,512,-264,-405,141,-0.00408038330390015,-0.00625967893211955,0.0021792956282194,EPCI
243200607,CC Artagnan de Fezensac,1999_2006,2002.5,7,7043,7163,690,417,120,-273,393,0.00241643944768866,-0.00549739974349169,0.00791383919118035,EPCI
243300316,Bordeaux Métropole,2006_2011,2008.5,5,709155,727256,25647,43285,18101,17638,463,0.00505361207629007,0.00492434726267081,0.000129264813619264,EPCI
243300316,Bordeaux Métropole,2011_2016,2013.5,5,727256,783081,27347,45073,55825,17726,38099,0.0149014541404218,0.00473162877014091,0.0101698253702809,EPCI
243300316,Bordeaux Métropole,1968_1975,1971.5,7,554930,586900,41515,66835,31970,25320,6650,0.00803388094041191,0.00636277339415795,0.00167110754625396,EPCI
243300316,Bordeaux Métropole,1975_1982,1978.5,7,586900,592473,40293,60842,5573,20549,-14976,0.00135103393751668,0.00498158915880678,-0.0036305552212901,EPCI
243300316,Bordeaux Métropole,1982_1990,1986,8,592473,630018,43595,65487,37545,21892,15653,0.0077099558255822,0.00449557472189761,0.0032143811036846,EPCI
243300316,Bordeaux Métropole,1990_1999,1994.5,9,630018,665572,48445,73215,35554,24770,10784,0.00611846747769307,0.00426265509991723,0.00185581237777584,EPCI
243300316,Bordeaux Métropole,1999_2006,2002.5,7,665572,709155,37093,58962,43583,21869,21714,0.00910221824604429,0.00456729483566397,0.00453492341038033,EPCI
243300563,CA Bassin d'Arcachon Sud-Pôle Atlantique (COBAS),2006_2011,2008.5,5,60143,61938,3443,2710,1795,-733,2528,0.00589909650093956,-0.00240893467141432,0.00830803117235388,EPCI
243300563,CA Bassin d'Arcachon Sud-Pôle Atlantique (COBAS),2011_2016,2013.5,5,61938,65952,3851,2527,4014,-1324,5338,0.0126378551846256,-0.00416854017549682,0.0168063953601224,EPCI
243300563,CA Bassin d'Arcachon Sud-Pôle Atlantique (COBAS),1968_1975,1971.5,7,38417,39512,3425,3752,1095,327,768,0.00402297814987507,0.00120138251599009,0.00282159563388498,EPCI
243300563,CA Bassin d'Arcachon Sud-Pôle Atlantique (COBAS),1975_1982,1978.5,7,39512,42877,3681,3246,3365,-435,3800,0.0117443045823482,-0.00151820876473149,0.0132625133470797,EPCI
243300563,CA Bassin d'Arcachon Sud-Pôle Atlantique (COBAS),1982_1990,1986,8,42877,47141,4372,3873,4264,-499,4763,0.01192144555458,-0.0013951222635402,0.0133165678181202,EPCI
243300563,CA Bassin d'Arcachon Sud-Pôle Atlantique (COBAS),1990_1999,1994.5,9,47141,54204,5560,4765,7063,-795,7858,0.0156333413563892,-0.001759663935768,0.0173930052921572,EPCI
243300563,CA Bassin d'Arcachon Sud-Pôle Atlantique (COBAS),1999_2006,2002.5,7,54204,60143,4696,3993,5939,-703,6642,0.0149637602176154,-0.00177126173311729,0.0167350219507327,EPCI
243300811,CC de l'Estuaire,2006_2011,2008.5,5,14380,15316,750,807,936,57,879,0.0126918021338442,0.00077289820686872,0.0119189039269755,EPCI
243300811,CC de l'Estuaire,2011_2016,2013.5,5,15316,15770,770,840,454,70,384,0.0058593728351406,0.000903427529647229,0.00495594530549337,EPCI
243300811,CC de l'Estuaire,1968_1975,1971.5,7,11442,10661,1149,954,-781,-195,-586,-0.0100489644583001,-0.00250902441660501,-0.00753994004169505,EPCI
243300811,CC de l'Estuaire,1975_1982,1978.5,7,10661,14224,1124,1087,3563,-37,3600,0.0420513350201122,-0.000436682401275372,0.0424880174213875,EPCI
243300811,CC de l'Estuaire,1982_1990,1986,8,14224,13297,1276,1475,-927,199,-1126,-0.00838864640357873,0.00180079895826555,-0.0101894453618443,EPCI
243300811,CC de l'Estuaire,1990_1999,1994.5,9,13297,13636,1425,1349,339,-76,415,0.00280112789247755,-0.000627981474419746,0.0034291093668973,EPCI
243300811,CC de l'Estuaire,1999_2006,2002.5,7,13636,14380,1080,1108,744,28,716,0.00761815704981461,0.000286704835208077,0.00733145221460653,EPCI
243301165,CC Jalle-Eau-Bourde,2006_2011,2008.5,5,28122,28550,934,1056,428,122,306,0.00302551725328692,0.000862413796497675,0.00216310345678925,EPCI
243301165,CC Jalle-Eau-Bourde,2011_2016,2013.5,5,28550,30457,967,1102,1907,135,1772,0.0130157604493555,0.000921409365843204,0.0120943510835123,EPCI
243301165,CC Jalle-Eau-Bourde,1968_1975,1971.5,7,5158,11200,415,725,6042,310,5732,0.11713392519508,0.00600985051480881,0.111124074680271,EPCI
243301165,CC Jalle-Eau-Bourde,1975_1982,1978.5,7,11200,19648,562,1449,8448,887,7561,0.0836061850612591,0.00877825356881354,0.0748279314924455,EPCI
243301165,CC Jalle-Eau-Bourde,1982_1990,1986,8,19648,25623,983,1937,5975,954,5021,0.0337462649156846,0.00538810656561725,0.0283581583500673,EPCI
243301165,CC Jalle-Eau-Bourde,1990_1999,1994.5,9,25623,27254,1379,2155,1631,776,855,0.00688021776882786,0.00327348190595366,0.0036067358628742,EPCI
243301165,CC Jalle-Eau-Bourde,1999_2006,2002.5,7,27254,28122,1236,1666,868,430,438,0.00448888626358435,0.00222375701997842,0.00226512924360593,EPCI
243301181,CC Latitude Nord Gironde,2006_2011,2008.5,5,15518,18023,668,1241,2505,573,1932,0.0303820088989077,0.0069496571253789,0.0234323517735289,EPCI
243301181,CC Latitude Nord Gironde,2011_2016,2013.5,5,18023,19535,753,1264,1512,511,1001,0.0162422966706512,0.00548929470813676,0.0107530019625145,EPCI
243301181,CC Latitude Nord Gironde,1968_1975,1971.5,7,9976,10091,909,893,115,-16,131,0.00163873112684287,-0.000227997374169443,0.00186672850101232,EPCI
243301181,CC Latitude Nord Gironde,1975_1982,1978.5,7,10091,11659,850,952,1568,102,1466,0.0208478389019595,0.00135617319387747,0.019491665708082,EPCI
243301181,CC Latitude Nord Gironde,1982_1990,1986,8,11659,12517,1013,1170,858,157,701,0.00891567324920306,0.00163142272741828,0.00728425052178478,EPCI
243301181,CC Latitude Nord Gironde,1990_1999,1994.5,9,12517,13383,1045,1400,866,355,511,0.00746075202581498,0.00305839141935833,0.00440236060645664,EPCI
243301181,CC Latitude Nord Gironde,1999_2006,2002.5,7,13383,15518,887,1281,2135,394,1741,0.0213701973015301,0.00394372727719104,0.0174264700243391,EPCI
243301215,CC du Créonnais,2006_2011,2008.5,5,13864,15495,466,927,1631,461,1170,0.0224936184240612,0.00635779159625518,0.016135826827806,EPCI
243301215,CC du Créonnais,2011_2016,2013.5,5,15495,16919,485,1028,1424,543,881,0.0177394800880473,0.0067644225335742,0.0109750575544731,EPCI
243301215,CC du Créonnais,1968_1975,1971.5,7,6700,7032,517,717,332,200,132,0.00693301339893315,0.00417651409574286,0.00275649930319029,EPCI
243301215,CC du Créonnais,1975_1982,1978.5,7,7032,9471,610,701,2439,91,2348,0.043455310105246,0.00162133383336506,0.0418339762718809,EPCI
243301215,CC du Créonnais,1982_1990,1986,8,9471,11012,710,1002,1541,292,1249,0.0190225526444174,0.0036045330124399,0.0154180196319775,EPCI
243301215,CC du Créonnais,1990_1999,1994.5,9,11012,11958,805,1142,946,337,609,0.00919926924027825,0.00327711811202301,0.00592215112825524,EPCI
243301215,CC du Créonnais,1999_2006,2002.5,7,11958,13864,622,1111,1906,489,1417,0.0213526366403076,0.00547819481485332,0.0158744418254543,EPCI
243301223,CC du Grand Cubzaguais,2006_2011,2008.5,5,28025,31255,1187,1901,3230,714,2516,0.0220561983649554,0.00487558069120067,0.0171806176737548,EPCI
243301223,CC du Grand Cubzaguais,2011_2016,2013.5,5,31255,34442,1304,2140,3187,836,2351,0.0196092618641166,0.00514381641619124,0.0144654454479254,EPCI
243301223,CC du Grand Cubzaguais,1968_1975,1971.5,7,17064,18179,1628,1941,1115,313,802,0.00908330517663258,0.00254984261909058,0.006533462557542,EPCI
243301223,CC du Grand Cubzaguais,1975_1982,1978.5,7,18179,21153,1608,1836,2974,228,2746,0.0218809023589761,0.00167748679819992,0.0202034155607762,EPCI
243301223,CC du Grand Cubzaguais,1982_1990,1986,8,21153,24185,1972,2299,3032,327,2705,0.0168848224168434,0.00182102141500917,0.0150638010018342,EPCI
243301223,CC du Grand Cubzaguais,1990_1999,1994.5,9,24185,25461,2047,2494,1276,447,829,0.00572915624290049,0.00200700065875903,0.00372215558414146,EPCI
243301223,CC du Grand Cubzaguais,1999_2006,2002.5,7,25461,28025,1645,2299,2564,654,1910,0.0138013859973112,0.0035203223253672,0.010281063671944,EPCI
243301249,CC du Secteur de Saint-Loubès,2006_2011,2008.5,5,23236,24742,820,1313,1506,493,1013,0.0126390874266733,0.00413749674724431,0.00850159067942899,EPCI
243301249,CC du Secteur de Saint-Loubès,2011_2016,2013.5,5,24742,26622,829,1451,1880,622,1258,0.0147549425548288,0.0048816884410125,0.00987325411381628,EPCI
243301249,CC du Secteur de Saint-Loubès,1968_1975,1971.5,7,9604,12456,732,1349,2852,617,2235,0.0378446471922895,0.00818728868080036,0.0296573585114892,EPCI
243301249,CC du Secteur de Saint-Loubès,1975_1982,1978.5,7,12456,16933,789,1331,4477,542,3935,0.0448423285967232,0.00542875633223676,0.0394135722644865,EPCI
243301249,CC du Secteur de Saint-Loubès,1982_1990,1986,8,16933,19356,997,1634,2423,637,1786,0.0168577738154629,0.00443186212152286,0.0124259116939401,EPCI
243301249,CC du Secteur de Saint-Loubès,1990_1999,1994.5,9,19356,21366,1345,2005,2010,660,1350,0.0110380777008652,0.00362444342416469,0.00741363427670049,EPCI
243301249,CC du Secteur de Saint-Loubès,1999_2006,2002.5,7,21366,23236,1043,1819,1870,776,1094,0.0120581093420169,0.00500379296759632,0.00705431637442058,EPCI
243301264,CC de Montesquieu,2006_2011,2008.5,5,34919,37668,1157,1995,2749,838,1911,0.0152714008933899,0.00465530518321597,0.0106160957101739,EPCI
243301264,CC de Montesquieu,2011_2016,2013.5,5,37668,42534,1249,2353,4866,1104,3762,0.0245961814946987,0.00558039136254569,0.019015790132153,EPCI
243301264,CC de Montesquieu,1968_1975,1971.5,7,14335,18101,1183,1682,3766,499,3267,0.0338847380878342,0.00448977278434128,0.0293949653034929,EPCI
243301264,CC de Montesquieu,1975_1982,1978.5,7,18101,23047,1253,1712,4946,459,4487,0.0351121463651138,0.0032584866925975,0.0318536596725163,EPCI
243301264,CC de Montesquieu,1982_1990,1986,8,23047,27872,1529,2440,4825,911,3914,0.0240454126681686,0.00453997325195888,0.0195054394162097,EPCI
243301264,CC de Montesquieu,1990_1999,1994.5,9,27872,30883,2042,2816,3011,774,2237,0.0114633474326238,0.00294673892821349,0.0085166085044103,EPCI
243301264,CC de Montesquieu,1999_2006,2002.5,7,30883,34919,1670,2569,4036,899,3137,0.0177013038882445,0.00394288210989391,0.0137584217783506,EPCI
243301355,CC des Coteaux Bordelais,2006_2011,2008.5,5,16308,17880,752,897,1572,145,1427,0.018575820240003,0.00171341853358807,0.016862401706415,EPCI
243301355,CC des Coteaux Bordelais,2011_2016,2013.5,5,17880,19151,828,908,1271,80,1191,0.0138291833745505,0.000870444272198302,0.0129587391023522,EPCI
243301355,CC des Coteaux Bordelais,1968_1975,1971.5,7,5854,8381,558,714,2527,156,2371,0.0525998486187305,0.0032471612127115,0.049352687406019,EPCI
243301355,CC des Coteaux Bordelais,1975_1982,1978.5,7,8381,11473,698,755,3092,57,3035,0.0458828022961753,0.000845834324347345,0.0450369679718279,EPCI
243301355,CC des Coteaux Bordelais,1982_1990,1986,8,11473,14107,957,1030,2634,73,2561,0.0261709336903933,0.000725314411313101,0.0254456192790802,EPCI
243301355,CC des Coteaux Bordelais,1990_1999,1994.5,9,14107,15278,1274,1167,1171,-107,1278,0.00889967503751388,-0.000813206856544821,0.0097128818940587,EPCI
243301355,CC des Coteaux Bordelais,1999_2006,2002.5,7,15278,16308,1071,1084,1030,13,1017,0.00936384038799165,0.000118184393246497,0.00924565599474515,EPCI
243301371,CC du Pays Foyen,2006_2011,2008.5,5,16032,16430,1172,846,398,-326,724,0.00491648788787669,-0.00402707299358744,0.00894356088146412,EPCI
243301371,CC du Pays Foyen,2011_2016,2013.5,5,16430,16600,1296,861,170,-435,605,0.0020608733490004,-0.00527341121655985,0.00733428456556026,EPCI
243301371,CC du Pays Foyen,1968_1975,1971.5,7,14961,15089,1559,1424,128,-135,263,0.00121776749161784,-0.00128436415131569,0.00250213164293353,EPCI
243301371,CC du Pays Foyen,1975_1982,1978.5,7,15089,14978,1748,1205,-111,-543,432,-0.00105423586026521,-0.00515720785697304,0.00410297199670783,EPCI
243301371,CC du Pays Foyen,1982_1990,1986,8,14978,15163,1879,1263,185,-616,801,0.00153565190659255,-0.00511330580789736,0.00664895771448991,EPCI
243301371,CC du Pays Foyen,1990_1999,1994.5,9,15163,15507,2056,1311,344,-745,1089,0.00249569630747271,-0.00540492368914874,0.00790061999662144,EPCI
243301371,CC du Pays Foyen,1999_2006,2002.5,7,15507,16032,1595,1152,525,-443,968,0.00476778560895452,-0.00402310290431782,0.00879088851327234,EPCI
243301389,CC Médullienne,2006_2011,2008.5,5,15967,18166,572,1293,2199,721,1478,0.0261413697571906,0.00857113578669142,0.0175702339704992,EPCI
243301389,CC Médullienne,2011_2016,2013.5,5,18166,20634,644,1414,2468,770,1698,0.0258050276085042,0.00805100132031939,0.0177540262881848,EPCI
243301389,CC Médullienne,1968_1975,1971.5,7,8185,8957,844,900,772,56,716,0.0129592726912482,0.000940050868795206,0.012019221822453,EPCI
243301389,CC Médullienne,1975_1982,1978.5,7,8957,10981,874,911,2024,37,1987,0.0295321245371802,0.00053986591298205,0.0289922586241982,EPCI
243301389,CC Médullienne,1982_1990,1986,8,10981,11904,923,1086,923,163,760,0.0101395568777958,0.00179062597083501,0.00834893090696077,EPCI
243301389,CC Médullienne,1990_1999,1994.5,9,11904,13064,1157,1236,1160,79,1081,0.0103853211378118,0.000707276180937181,0.00967804495687458,EPCI
243301389,CC Médullienne,1999_2006,2002.5,7,13064,15967,861,1396,2903,535,2368,0.0290810793868548,0.00535941352806314,0.0237216658587916,EPCI
243301397,CC du Fronsadais,2006_2011,2008.5,5,14757,16146,527,961,1389,434,955,0.0181537711163924,0.00567223661952073,0.0124815344968717,EPCI
243301397,CC du Fronsadais,2011_2016,2013.5,5,16146,16865,584,924,719,340,379,0.00875169965049705,0.00413849496685535,0.0046132046836417,EPCI
243301397,CC du Fronsadais,1968_1975,1971.5,7,8999,9652,802,918,653,116,537,0.0100576252804327,0.00178665318917335,0.0082709720912594,EPCI
243301397,CC du Fronsadais,1975_1982,1978.5,7,9652,12259,756,962,2607,206,2401,0.0347464895165253,0.00274559909489996,0.0320008904216253,EPCI
243301397,CC du Fronsadais,1982_1990,1986,8,12259,13889,889,1284,1630,395,1235,0.0157269873951218,0.00381114111722277,0.011915846277899,EPCI
243301397,CC du Fronsadais,1990_1999,1994.5,9,13889,13960,1029,1334,71,305,-234,0.000566709118986708,0.00243445466606966,-0.00186774554708295,EPCI
243301397,CC du Fronsadais,1999_2006,2002.5,7,13960,14757,847,1053,797,206,591,0.00796317434350957,0.00205823577761979,0.00590493856588978,EPCI
243301405,CC du Val de l'Eyre,2006_2011,2008.5,5,15291,17209,586,1136,1918,550,1368,0.0239151036118839,0.00685782428912207,0.0170572793227618,EPCI
243301405,CC du Val de l'Eyre,2011_2016,2013.5,5,17209,19625,599,1077,2416,478,1938,0.0266225659765644,0.00526721297052889,0.0213553530060355,EPCI
243301405,CC du Val de l'Eyre,1968_1975,1971.5,7,7602,7736,748,647,134,-101,235,0.00249931632299183,-0.00188381304941921,0.00438312937241104,EPCI
243301405,CC du Val de l'Eyre,1975_1982,1978.5,7,7736,9491,740,630,1755,-110,1865,0.0296392111356525,-0.00185772833328876,0.0314969394689413,EPCI
243301405,CC du Val de l'Eyre,1982_1990,1986,8,9491,10442,803,871,951,68,883,0.0120080437770711,0.000858619323702245,0.0111494244533689,EPCI
243301405,CC du Val de l'Eyre,1990_1999,1994.5,9,10442,11858,908,1122,1416,214,1202,0.0142299183144319,0.0021505667509099,0.012079351563522,EPCI
243301405,CC du Val de l'Eyre,1999_2006,2002.5,7,11858,15291,728,1248,3433,520,2913,0.0369908403689447,0.00560304019570383,0.0313878001732409,EPCI
243301439,CC des Portes de l'Entre-deux-Mers,2006_2011,2008.5,5,18715,19570,857,1054,855,197,658,0.00897451968032947,0.00206781330646188,0.0069067063738676,EPCI
243301439,CC des Portes de l'Entre-deux-Mers,2011_2016,2013.5,5,19570,20764,809,1033,1194,224,970,0.0119150122123175,0.00223531217383511,0.00967970003848239,EPCI
243301439,CC des Portes de l'Entre-deux-Mers,1968_1975,1971.5,7,11556,13258,1096,1312,1702,216,1486,0.0198219483343118,0.00251559391316766,0.0173063544211442,EPCI
243301439,CC des Portes de l'Entre-deux-Mers,1975_1982,1978.5,7,13258,16183,1140,1234,2925,94,2831,0.0288894570506721,0.000928413320602797,0.0279610437300693,EPCI
243301439,CC des Portes de l'Entre-deux-Mers,1982_1990,1986,8,16183,16962,1350,1327,779,-23,802,0.00589408207377562,-0.000174022962383619,0.00606810503615924,EPCI
243301439,CC des Portes de l'Entre-deux-Mers,1990_1999,1994.5,9,16962,17570,1548,1676,608,128,480,0.00392070529646404,0.000825411641360851,0.00309529365510319,EPCI
243301439,CC des Portes de l'Entre-deux-Mers,1999_2006,2002.5,7,17570,18715,1264,1385,1145,121,1024,0.00905971288157037,0.000957401972637567,0.0081023109089328,EPCI
243301447,CC Médoc Estuaire,2006_2011,2008.5,5,23088,25466,824,1650,2378,826,1552,0.0197997101576122,0.00687744347779128,0.0129222666798209,EPCI
243301447,CC Médoc Estuaire,2011_2016,2013.5,5,25466,27933,869,1799,2467,930,1537,0.0186649641180152,0.00703624508705073,0.0116287190309645,EPCI
243301447,CC Médoc Estuaire,1968_1975,1971.5,7,10999,12444,970,1263,1445,293,1152,0.0177898472415146,0.00360721470018254,0.014182632541332,EPCI
243301447,CC Médoc Estuaire,1975_1982,1978.5,7,12444,16559,997,1445,4115,448,3667,0.0416573244441507,0.00453523240607036,0.0371220920380804,EPCI
243301447,CC Médoc Estuaire,1982_1990,1986,8,16559,20438,1200,1882,3879,682,3197,0.0266573864107476,0.00468686195723894,0.0219705244535086,EPCI
243301447,CC Médoc Estuaire,1990_1999,1994.5,9,20438,21515,1443,2162,1077,719,358,0.00572236085788513,0.00382022047986946,0.00190214037801567,EPCI
243301447,CC Médoc Estuaire,1999_2006,2002.5,7,21515,23088,1069,1899,1573,830,743,0.0101313546789354,0.00534585148348151,0.00478550319545393,EPCI
243301454,CC Castillon/Pujols,2006_2011,2008.5,5,17908,18767,1091,1078,859,-13,872,0.00941453411411741,-0.000142478397536119,0.00955701251165353,EPCI
243301454,CC Castillon/Pujols,2011_2016,2013.5,5,18767,19157,1069,983,390,-86,476,0.00412210776561861,-0.00090897760985436,0.00503108537547297,EPCI
243301454,CC Castillon/Pujols,1968_1975,1971.5,7,16385,15538,1710,1428,-847,-282,-565,-0.00755384601385711,-0.00251497588654983,-0.00503887012730728,EPCI
243301454,CC Castillon/Pujols,1975_1982,1978.5,7,15538,16006,1635,1209,468,-426,894,0.00424828640892061,-0.00386702993632517,0.00811531634524578,EPCI
243301454,CC Castillon/Pujols,1982_1990,1986,8,16006,16589,1739,1351,583,-388,971,0.00448203605711672,-0.00298289878243789,0.00746493483955461,EPCI
243301454,CC Castillon/Pujols,1990_1999,1994.5,9,16589,17196,1826,1588,607,-238,845,0.00400097969230595,-0.001568753157774,0.00556973285007995,EPCI
243301454,CC Castillon/Pujols,1999_2006,2002.5,7,17196,17908,1474,1382,712,-92,804,0.00581264851090602,-0.000751072560397968,0.00656372107130398,EPCI
243301504,CA du Bassin d'Arcachon Nord,2006_2011,2008.5,5,52856,59175,2643,2807,6319,164,6155,0.0228425695146079,0.000592844026016095,0.0222497254885919,EPCI
243301504,CA du Bassin d'Arcachon Nord,2011_2016,2013.5,5,59175,65402,3173,2906,6227,-267,6494,0.0202122937088871,-0.000866658490488656,0.0210789521993758,EPCI
243301504,CA du Bassin d'Arcachon Nord,1968_1975,1971.5,7,23067,24408,2031,2122,1341,91,1250,0.00810523135437835,0.000550019428224034,0.00755521192615432,EPCI
243301504,CA du Bassin d'Arcachon Nord,1975_1982,1978.5,7,24408,28166,2326,1901,3758,-425,4183,0.0206684994050554,-0.00233744338668136,0.0230059427917368,EPCI
243301504,CA du Bassin d'Arcachon Nord,1982_1990,1986,8,28166,35480,2984,2702,7314,-282,7596,0.0292770860122309,-0.00112881299636985,0.0304058990086007,EPCI
243301504,CA du Bassin d'Arcachon Nord,1990_1999,1994.5,9,35480,44207,3957,3632,8727,-325,9052,0.0247358661218362,-0.000921182134708006,0.0256570482565442,EPCI
243301504,CA du Bassin d'Arcachon Nord,1999_2006,2002.5,7,44207,52856,3446,3545,8649,99,8550,0.0258554702178542,0.000295952312587301,0.0255595179052669,EPCI
243400017,Montpellier Méditerranée Métropole,2006_2011,2008.5,5,406140,427541,13101,26815,21401,13714,7687,0.0103233746125215,0.00661533383655531,0.00370804077596622,EPCI
243400017,Montpellier Méditerranée Métropole,2011_2016,2013.5,5,427541,465070,14266,28949,37529,14683,22846,0.0169699290460017,0.00663938469403509,0.0103305443519666,EPCI
243400017,Montpellier Méditerranée Métropole,1968_1975,1971.5,7,201068,249655,13216,25518,48587,12302,36285,0.0314025176562014,0.00795096985215365,0.0234515478040477,EPCI
243400017,Montpellier Méditerranée Métropole,1975_1982,1978.5,7,249655,277529,14850,25857,27874,11007,16867,0.0152356784559418,0.00601632750106016,0.0092193509548816,EPCI
243400017,Montpellier Méditerranée Métropole,1982_1990,1986,8,277529,316259,18384,32561,38730,14177,24553,0.0164635633482997,0.00602643784117853,0.0104371255071211,EPCI
243400017,Montpellier Méditerranée Métropole,1990_1999,1994.5,9,316259,366895,22588,40487,50636,17899,32737,0.0166384814291309,0.00588143176988733,0.0107570496592436,EPCI
243400017,Montpellier Méditerranée Métropole,1999_2006,2002.5,7,366895,406140,18254,34632,39245,16378,22867,0.0146233507251043,0.0061027197904385,0.00852063093466584,EPCI
243400355,CC du Clermontais,2006_2011,2008.5,5,21963,25617,1208,1512,3654,304,3350,0.0312579779720934,0.00260055427025627,0.0286574237018371,EPCI
243400355,CC du Clermontais,2011_2016,2013.5,5,25617,27483,1266,1459,1866,193,1673,0.0141616266867513,0.00146473416427813,0.0126968925224731,EPCI
243400355,CC du Clermontais,1968_1975,1971.5,7,15967,14516,1514,1172,-1451,-342,-1109,-0.0135181695237404,-0.00318622603523034,-0.0103319434885101,EPCI
243400355,CC du Clermontais,1975_1982,1978.5,7,14516,15454,1418,1049,938,-369,1307,0.00898532500319083,-0.00353473872726803,0.0125200637304589,EPCI
243400355,CC du Clermontais,1982_1990,1986,8,15454,16652,1740,1452,1198,-288,1486,0.00937649392534556,-0.00225411540108474,0.0116306093264303,EPCI
243400355,CC du Clermontais,1990_1999,1994.5,9,16652,18010,1926,1606,1358,-320,1678,0.00874880793134492,-0.00206157477027273,0.0108103827016176,EPCI
243400355,CC du Clermontais,1999_2006,2002.5,7,18010,21963,1605,1483,3953,-122,4075,0.0287530493783514,-0.000887394896068524,0.02964044427442,EPCI
243400470,CA du Pays de l'Or,2006_2011,2008.5,5,40887,43025,1686,2272,2138,586,1552,0.0102459697372754,0.00280829666325697,0.00743767307401846,EPCI
243400470,CA du Pays de l'Or,2011_2016,2013.5,5,43025,44778,2009,2210,1753,201,1552,0.00801910319903332,0.000919475038793894,0.00709962816023942,EPCI
243400470,CA du Pays de l'Or,1968_1975,1971.5,7,10135,14465,736,1233,4330,497,3833,0.0521330651216898,0.00598386451858657,0.0461492006031032,EPCI
243400470,CA du Pays de l'Or,1975_1982,1978.5,7,14465,22977,978,1761,8512,783,7729,0.068342973594959,0.0062867185532017,0.0620562550417573,EPCI
243400470,CA du Pays de l'Or,1982_1990,1986,8,22977,28876,1589,2671,5899,1082,4817,0.0289765171844751,0.00531489940559453,0.0236616177788806,EPCI
243400470,CA du Pays de l'Or,1990_1999,1994.5,9,28876,37187,2266,3903,8311,1637,6674,0.028504064475759,0.00561438497735742,0.0228896794984016,EPCI
243400470,CA du Pays de l'Or,1999_2006,2002.5,7,37187,40887,2108,3265,3700,1157,2543,0.0136426410365669,0.00426609072413726,0.00937655031242961,EPCI
243400488,CC La Domitienne,2006_2011,2008.5,5,23164,26033,1318,1334,2869,16,2853,0.0236279422287338,0.000131769632506009,0.0234961725962278,EPCI
243400488,CC La Domitienne,2011_2016,2013.5,5,26033,27400,1424,1449,1367,25,1342,0.010288172919138,0.00018815239427831,0.0101000205248597,EPCI
243400488,CC La Domitienne,1968_1975,1971.5,7,13081,13591,1199,1031,510,-168,678,0.00547881313924914,-0.00180478550469383,0.00728359864394297,EPCI
243400488,CC La Domitienne,1975_1982,1978.5,7,13591,14605,1315,853,1014,-462,1476,0.0103324617066722,-0.00470768965333587,0.0150401513600081,EPCI
243400488,CC La Domitienne,1982_1990,1986,8,14605,17141,1514,1191,2536,-323,2859,0.0202152810056495,-0.0025747380776123,0.0227900190832618,EPCI
243400488,CC La Domitienne,1990_1999,1994.5,9,17141,19155,2049,1609,2014,-440,2454,0.0124198855792845,-0.00271338115932731,0.0151332667386118,EPCI
243400488,CC La Domitienne,1999_2006,2002.5,7,19155,23164,1765,1499,4009,-266,4275,0.027519801509261,-0.00182595839397941,0.0293457599032404,EPCI
243400520,CC du Pays de Lunel,2006_2011,2008.5,5,44463,47997,1946,3317,3534,1371,2163,0.0154138112917914,0.00597972135853029,0.00943408993326113,EPCI
243400520,CC du Pays de Lunel,2011_2016,2013.5,5,47997,49618,2086,3232,1621,1146,475,0.00666514631429083,0.00471206519196625,0.00195308112232458,EPCI
243400520,CC du Pays de Lunel,1968_1975,1971.5,7,19022,21735,1710,2164,2713,454,2259,0.0192293562263699,0.00321788710902025,0.0160114691173497,EPCI
243400520,CC du Pays de Lunel,1975_1982,1978.5,7,21735,26109,1799,2333,4374,534,3840,0.0265398166097313,0.00324011478500148,0.0232997018247298,EPCI
243400520,CC du Pays de Lunel,1982_1990,1986,8,26109,32306,2199,3137,6197,938,5259,0.0269791317574848,0.00408365750984682,0.022895474247638,EPCI
243400520,CC du Pays de Lunel,1990_1999,1994.5,9,32306,40461,2783,4516,8155,1733,6422,0.0253248696897459,0.00538172889912074,0.0199431407906252,EPCI
243400520,CC du Pays de Lunel,1999_2006,2002.5,7,40461,44463,2579,4115,4002,1536,2466,0.0135653043804216,0.00520647364525926,0.00835883073516233,EPCI
243400694,CC Vallée de l'Hérault,2006_2011,2008.5,5,30769,34295,1342,2132,3526,790,2736,0.0219354979793125,0.00491464645594353,0.017020851523369,EPCI
243400694,CC Vallée de l'Hérault,2011_2016,2013.5,5,34295,37967,1451,2111,3672,660,3012,0.0205518986609257,0.00369396871356507,0.0168579299473606,EPCI
243400694,CC Vallée de l'Hérault,1968_1975,1971.5,7,17694,16913,1676,1319,-781,-357,-424,-0.00642825580067696,-0.00293839605741572,-0.00348985974326124,EPCI
243400694,CC Vallée de l'Hérault,1975_1982,1978.5,7,16913,18157,1671,1107,1244,-564,1808,0.0101906610232603,-0.00462020322919517,0.0148108642524554,EPCI
243400694,CC Vallée de l'Hérault,1982_1990,1986,8,18157,21615,2017,1807,3458,-210,3668,0.0220305866921569,-0.0013378898800905,0.0233684765722474,EPCI
243400694,CC Vallée de l'Hérault,1990_1999,1994.5,9,21615,25496,2268,2388,3881,120,3761,0.0185175917781828,0.000572561456681767,0.017945030321501,EPCI
243400694,CC Vallée de l'Hérault,1999_2006,2002.5,7,25496,30769,1975,2403,5273,428,4845,0.0272190084866892,0.00220931834483273,0.0250096901418565,EPCI
243400736,CC des Cévennes Gangeoises et Suménoises,2006_2011,2008.5,5,11618,12705,819,697,1087,-122,1209,0.0180489479523742,-0.00202573288885893,0.0200746808412331,EPCI
243400736,CC des Cévennes Gangeoises et Suménoises,2011_2016,2013.5,5,12705,13170,834,670,465,-164,629,0.00721508398911119,-0.00254467478325642,0.00975975877236761,EPCI
243400736,CC des Cévennes Gangeoises et Suménoises,1968_1975,1971.5,7,10654,9332,1029,745,-1322,-284,-1038,-0.0187485961298062,-0.00402768630927757,-0.0147209098205286,EPCI
243400736,CC des Cévennes Gangeoises et Suménoises,1975_1982,1978.5,7,9332,9146,1010,568,-186,-442,256,-0.00287197210674162,-0.00682479393107416,0.00395282182433255,EPCI
243400736,CC des Cévennes Gangeoises et Suménoises,1982_1990,1986,8,9146,9291,1142,760,145,-382,527,0.00196812978287375,-0.00518500397970878,0.00715313376258253,EPCI
243400736,CC des Cévennes Gangeoises et Suménoises,1990_1999,1994.5,9,9291,10331,1379,948,1040,-431,1471,0.0118589771042557,-0.00491463378070595,0.0167736108849616,EPCI
243400736,CC des Cévennes Gangeoises et Suménoises,1999_2006,2002.5,7,10331,11618,1038,811,1287,-227,1514,0.0169138079975197,-0.00298324352403806,0.0198970515215578,EPCI
243400769,CA de Béziers-Méditerranée,2006_2011,2008.5,5,112974,115188,6447,7168,2214,721,1493,0.00388911755215449,0.00126651027782447,0.00262260727433001,EPCI
243400769,CA de Béziers-Méditerranée,2011_2016,2013.5,5,115188,123613,6882,7830,8425,948,7477,0.0142181582823111,0.00159985923461495,0.0126182990476962,EPCI
243400769,CA de Béziers-Méditerranée,1968_1975,1971.5,7,100602,105788,8285,9189,5186,904,4282,0.00720655070933418,0.00125621323587314,0.00595033747346104,EPCI
243400769,CA de Béziers-Méditerranée,1975_1982,1978.5,7,105788,102637,8579,8024,-3151,-555,-2596,-0.00431048307489779,-0.00075922504175445,-0.00355125803314334,EPCI
243400769,CA de Béziers-Méditerranée,1982_1990,1986,8,102637,103381,10041,9619,744,-422,1166,0.000903245338445213,-0.000512324640892312,0.00141556997933753,EPCI
243400769,CA de Béziers-Méditerranée,1990_1999,1994.5,9,103381,105697,11114,10626,2316,-488,2804,0.00246473441913575,-0.000519339549455201,0.00298407396859095,EPCI
243400769,CA de Béziers-Méditerranée,1999_2006,2002.5,7,105697,112974,9165,8960,7277,-205,7482,0.00955697808895706,-0.000269229147758169,0.00982620723671523,EPCI
243400819,CA Hérault-Méditerranée,2006_2011,2008.5,5,65983,71289,3873,3900,5306,27,5279,0.0155892449516464,7.93271039755847e-05,0.0155099178476708,EPCI
243400819,CA Hérault-Méditerranée,2011_2016,2013.5,5,71289,77450,4426,3873,6161,-553,6714,0.0167162851327638,-0.0015004229310856,0.0182167080638494,EPCI
243400819,CA Hérault-Méditerranée,1968_1975,1971.5,7,42471,42045,3872,3689,-426,-183,-243,-0.001439108744971,-0.000618208686219935,-0.000820900058751061,EPCI
243400819,CA Hérault-Méditerranée,1975_1982,1978.5,7,42045,44724,3964,3567,2679,-397,3076,0.00886330524116707,-0.00131344986216623,0.0101767551033333,EPCI
243400819,CA Hérault-Méditerranée,1982_1990,1986,8,44724,52391,4910,4491,7667,-419,8086,0.0199749506625198,-0.00109162701546834,0.0210665776779881,EPCI
243400819,CA Hérault-Méditerranée,1990_1999,1994.5,9,52391,58276,5778,5481,5885,-297,6182,0.0118986236099972,-0.000600491284990511,0.0124991148949877,EPCI
243400819,CA Hérault-Méditerranée,1999_2006,2002.5,7,58276,65983,5139,4846,7707,-293,8000,0.0179021838290931,-0.000680594247038315,0.0185827780761315,EPCI
243500139,Métropole Rennes Métropole,2006_2011,2008.5,5,396933,413953,11365,24639,17020,13274,3746,0.00843234161100415,0.00657643375701933,0.00185590785398481,EPCI
243500139,Métropole Rennes Métropole,2011_2016,2013.5,5,413953,443192,12672,26448,29239,13776,15463,0.0137437171377071,0.00647537355207266,0.0072683435856344,EPCI
243500139,Métropole Rennes Métropole,1968_1975,1971.5,7,243257,284058,13055,39774,40801,26719,14082,0.0223985850787969,0.0146679687929309,0.00773061628586598,EPCI
243500139,Métropole Rennes Métropole,1975_1982,1978.5,7,284058,306622,13689,35560,22564,21871,693,0.0109794473967009,0.0106422395857669,0.000337207810933953,EPCI
243500139,Métropole Rennes Métropole,1982_1990,1986,8,306622,334531,15397,37259,27909,21862,6047,0.0109487324801893,0.00857648749442472,0.00237224498576463,EPCI
243500139,Métropole Rennes Métropole,1990_1999,1994.5,9,334531,373833,17952,42327,39302,24375,14927,0.0124186593248758,0.00770202078886186,0.00471663853601399,EPCI
243500139,Métropole Rennes Métropole,1999_2006,2002.5,7,373833,396933,15471,34066,23100,18595,4505,0.00860226394202979,0.00692463627714476,0.00167762766488503,EPCI
243500550,CC Montfort Communauté,2006_2011,2008.5,5,21956,24364,698,1674,2408,976,1432,0.0210313423986219,0.00852433147053779,0.0125070109280841,EPCI
243500550,CC Montfort Communauté,2011_2016,2013.5,5,24364,25337,807,1529,973,722,251,0.0078625779965098,0.00583430761919843,0.00202827037731137,EPCI
243500550,CC Montfort Communauté,1968_1975,1971.5,7,10368,11789,849,1258,1421,409,1012,0.0185183414451167,0.00533005042297869,0.013188291022138,EPCI
243500550,CC Montfort Communauté,1975_1982,1978.5,7,11789,16065,922,1477,4276,555,3721,0.045202734934757,0.00586705282712585,0.0393356821076312,EPCI
243500550,CC Montfort Communauté,1982_1990,1986,8,16065,17576,1064,1952,1511,888,623,0.0112997834688844,0.00664077281295125,0.00465901065593314,EPCI
243500550,CC Montfort Communauté,1990_1999,1994.5,9,17576,19411,1230,2126,1835,896,939,0.0110950519773985,0.0054175294668932,0.00567752251050526,EPCI
243500550,CC Montfort Communauté,1999_2006,2002.5,7,19411,21956,980,1971,2545,991,1554,0.0177558704268501,0.00691397547858879,0.0108418949482613,EPCI
243500618,CC de Brocéliande,2006_2011,2008.5,5,15108,16575,583,1265,1467,682,785,0.0187070510893517,0.00869680221059157,0.0100102488787601,EPCI
243500618,CC de Brocéliande,2011_2016,2013.5,5,16575,18066,614,1288,1491,674,817,0.0173764811628279,0.00785496197434338,0.00952151918848448,EPCI
243500618,CC de Brocéliande,1968_1975,1971.5,7,9085,9685,860,958,600,98,502,0.00917809058043062,0.001499088128137,0.00767900245229362,EPCI
243500618,CC de Brocéliande,1975_1982,1978.5,7,9685,10495,864,865,810,1,809,0.0115404626926985,1.42474848058006e-05,0.0115262152078927,EPCI
243500618,CC de Brocéliande,1982_1990,1986,8,10495,11310,985,1087,815,102,713,0.00939237621521394,0.00117548757540101,0.00821688863981293,EPCI
243500618,CC de Brocéliande,1990_1999,1994.5,9,11310,12627,993,1413,1317,420,897,0.012314100506494,0.00392704799751516,0.0083870525089788,EPCI
243500618,CC de Brocéliande,1999_2006,2002.5,7,12627,15108,785,1586,2481,801,1680,0.0259579054252082,0.00838060550003697,0.0175772999251712,EPCI
243500634,CC de la Roche aux Fées,2006_2011,2008.5,5,23434,25225,1013,1844,1791,831,960,0.0148385353826979,0.00688488157622665,0.00795365380647121,EPCI
243500634,CC de la Roche aux Fées,2011_2016,2013.5,5,25225,26310,1128,1689,1085,561,524,0.00845827654596532,0.00437335773482631,0.00408491881113901,EPCI
243500634,CC de la Roche aux Fées,1968_1975,1971.5,7,19670,19289,1613,2264,-381,651,-1032,-0.00279033506650683,0.00476773786954317,-0.00755807293605,EPCI
243500634,CC de la Roche aux Fées,1975_1982,1978.5,7,19289,19043,1551,1910,-246,359,-605,-0.00183194925241648,0.00267345439681917,-0.00450540364923564,EPCI
243500634,CC de la Roche aux Fées,1982_1990,1986,8,19043,18868,1617,1903,-175,286,-461,-0.00115336118646048,0.00188492171044398,-0.00303828289690446,EPCI
243500634,CC de la Roche aux Fées,1990_1999,1994.5,9,18868,19618,1879,2081,750,202,548,0.00434052030138332,0.00116904680117257,0.00317147350021075,EPCI
243500634,CC de la Roche aux Fées,1999_2006,2002.5,7,19618,23434,1456,2167,3816,711,3105,0.0257166022296229,0.00479153673617974,0.0209250654934432,EPCI
243500659,CC Pays de Châteaugiron Communauté,2006_2011,2008.5,5,21534,23222,658,1564,1688,906,782,0.0152078854384734,0.00816252618913324,0.00704535924934017,EPCI
243500659,CC Pays de Châteaugiron Communauté,2011_2016,2013.5,5,23222,25537,635,1591,2315,956,1359,0.0191874122479689,0.00792361387000359,0.0112637983779654,EPCI
243500659,CC Pays de Châteaugiron Communauté,1968_1975,1971.5,7,9509,10323,742,1260,814,518,296,0.0118027805453136,0.00751086034701774,0.00429192019829585,EPCI
243500659,CC Pays de Châteaugiron Communauté,1975_1982,1978.5,7,10323,13391,841,1292,3068,451,2617,0.0378721753276285,0.00556725915018268,0.0323049161774459,EPCI
243500659,CC Pays de Châteaugiron Communauté,1982_1990,1986,8,13391,15391,922,1589,2000,667,1333,0.0175522724553632,0.00585368286386362,0.0116985895914996,EPCI
243500659,CC Pays de Châteaugiron Communauté,1990_1999,1994.5,9,15391,19032,1009,2298,3641,1289,2352,0.0238737270192995,0.0084518632595103,0.0154218637597892,EPCI
243500659,CC Pays de Châteaugiron Communauté,1999_2006,2002.5,7,19032,21534,920,2046,2502,1126,1376,0.0178010559222035,0.00801118663805001,0.00978986928415348,EPCI
243500667,CC du Val d'Ille-Aubigné,2006_2011,2008.5,5,29888,32915,990,2565,3027,1575,1452,0.0194816213764424,0.0101366216279804,0.00934499974846196,EPCI
243500667,CC du Val d'Ille-Aubigné,2011_2016,2013.5,5,32915,35692,1005,2523,2777,1518,1259,0.0163315438621785,0.00892736175109361,0.00740418211108489,EPCI
243500667,CC du Val d'Ille-Aubigné,1968_1975,1971.5,7,15327,17170,1404,1876,1843,472,1371,0.0163533757007357,0.00418816784088293,0.0121652078598528,EPCI
243500667,CC du Val d'Ille-Aubigné,1975_1982,1978.5,7,17170,20226,1394,1963,3056,569,2487,0.0236766929511623,0.00440838949254297,0.0192683034586193,EPCI
243500667,CC du Val d'Ille-Aubigné,1982_1990,1986,8,20226,22312,1464,2439,2086,975,1111,0.0123450468166741,0.00577009618708403,0.00657495062959011,EPCI
243500667,CC du Val d'Ille-Aubigné,1990_1999,1994.5,9,22312,25357,1544,2877,3045,1333,1712,0.0143159698417135,0.00626705674844139,0.00804891309327207,EPCI
243500667,CC du Val d'Ille-Aubigné,1999_2006,2002.5,7,25357,29888,1284,3184,4531,1900,2631,0.0237640024669459,0.00996504186431189,0.013798960602634,EPCI
243500725,CC Côte d'Émeraude,2006_2011,2008.5,5,28491,29745,1931,1290,1254,-641,1895,0.00865177264741401,-0.00442247708691578,0.0130742497343298,EPCI
243500725,CC Côte d'Émeraude,2011_2016,2013.5,5,29745,30622,1965,1249,877,-716,1593,0.0058284505545938,-0.00475846134217692,0.0105869118967707,EPCI
243500725,CC Côte d'Émeraude,1968_1975,1971.5,7,21898,22294,2356,2092,396,-264,660,0.00256360550504375,-0.00170907033669584,0.00427267584173959,EPCI
243500725,CC Côte d'Émeraude,1975_1982,1978.5,7,22294,24080,2471,2075,1786,-396,2182,0.0110699717388612,-0.0024544842153354,0.0135244559541965,EPCI
243500725,CC Côte d'Émeraude,1982_1990,1986,8,24080,25775,2944,2284,1695,-660,2355,0.00853917873772003,-0.00332498995097063,0.0118641686886907,EPCI
243500725,CC Côte d'Émeraude,1990_1999,1994.5,9,25775,27182,3315,2528,1407,-787,2194,0.00592302321401483,-0.00331302009198982,0.00923604330600465,EPCI
243500725,CC Côte d'Émeraude,1999_2006,2002.5,7,27182,28491,2563,1798,1309,-765,2074,0.00674166028290602,-0.00393993133416585,0.0106815916170719,EPCI
243500733,CC Bretagne Romantique,2006_2011,2008.5,5,29191,33000,1405,2467,3809,1062,2747,0.0248327451126258,0.0069237005275948,0.017909044585031,EPCI
243500733,CC Bretagne Romantique,2011_2016,2013.5,5,33000,34937,1499,2371,1937,872,1065,0.0114730924243778,0.0051649646845934,0.00630812773978437,EPCI
243500733,CC Bretagne Romantique,1968_1975,1971.5,7,23537,22557,2217,2322,-980,105,-1085,-0.0060570405751007,0.000648968633046504,-0.00670600920814721,EPCI
243500733,CC Bretagne Romantique,1975_1982,1978.5,7,22557,22862,2150,2117,305,-33,338,0.00192051390612047,-0.000207793307875329,0.0021283072139958,EPCI
243500733,CC Bretagne Romantique,1982_1990,1986,8,22862,23371,2228,2245,509,17,492,0.002756265776791,9.20560279085403e-05,0.00266420974888246,EPCI
243500733,CC Bretagne Romantique,1990_1999,1994.5,9,23371,24458,2299,2423,1087,124,963,0.0050640484162634,0.000577683535985889,0.00448636488027751,EPCI
243500733,CC Bretagne Romantique,1999_2006,2002.5,7,24458,29191,1882,2770,4733,888,3845,0.0255939096433642,0.00480189980209326,0.0207920098412709,EPCI
243500741,CA Redon Agglomération,2006_2011,2008.5,5,61775,65455,3464,3959,3680,495,3185,0.01164005058085,0.00156571332541325,0.0100743372554368,EPCI
243500741,CA Redon Agglomération,2011_2016,2013.5,5,65455,66091,3642,3613,636,-29,665,0.00193581059035641,-8.82680929565031e-05,0.00202407868331292,EPCI
243500741,CA Redon Agglomération,1968_1975,1971.5,7,54508,54500,5181,6321,-8,1140,-1148,-2.09680970771897e-05,0.00298795383349954,-0.00300892193057672,EPCI
243500741,CA Redon Agglomération,1975_1982,1978.5,7,54500,55497,5120,5849,997,729,268,0.00259310824256653,0.00189606410113441,0.000697044141432127,EPCI
243500741,CA Redon Agglomération,1982_1990,1986,8,55497,56356,5494,5667,859,173,686,0.00192181268863401,0.000387047258595673,0.00153476543003833,EPCI
243500741,CA Redon Agglomération,1990_1999,1994.5,9,56356,57454,5884,5864,1098,-20,1118,0.00214629059589422,-3.90945463733009e-05,0.00218538514226752,EPCI
243500741,CA Redon Agglomération,1999_2006,2002.5,7,57454,61775,4748,5208,4321,460,3861,0.0104130024684763,0.00110853532411458,0.00930446714436174,EPCI
243500774,CC Liffré-Cormier Communauté,2006_2011,2008.5,5,22323,23430,845,1798,1107,953,154,0.00972694527345963,0.00837378396170463,0.001353161311755,EPCI
243500774,CC Liffré-Cormier Communauté,2011_2016,2013.5,5,23430,25590,948,1717,2160,769,1391,0.017793327689243,0.00633475416343884,0.0114585735258042,EPCI
243500774,CC Liffré-Cormier Communauté,1968_1975,1971.5,7,10813,11874,968,1136,1061,168,893,0.0134615186445808,0.00213151284852929,0.0113300057960515,EPCI
243500774,CC Liffré-Cormier Communauté,1975_1982,1978.5,7,11874,14465,1119,1301,2591,182,2409,0.0285985632038652,0.00200885314670146,0.0265897100571638,EPCI
243500774,CC Liffré-Cormier Communauté,1982_1990,1986,8,14465,16434,1282,1847,1969,565,1404,0.0160804739213485,0.0046142548326876,0.0114662190886609,EPCI
243500774,CC Liffré-Cormier Communauté,1990_1999,1994.5,9,16434,19251,1427,2265,2817,838,1979,0.0177343801812622,0.00527561611355971,0.0124587640677025,EPCI
243500774,CC Liffré-Cormier Communauté,1999_2006,2002.5,7,19251,22323,1184,2322,3072,1138,1934,0.0213759073589623,0.00791854901513644,0.0134573583438259,EPCI
243500782,CA du Pays de Saint Malo Agglomération,2006_2011,2008.5,5,81962,79697,4483,4162,-2265,-321,-1944,-0.00558907891394522,-0.000792094627539257,-0.00479698428640597,EPCI
243500782,CA du Pays de Saint Malo Agglomération,2011_2016,2013.5,5,79697,82577,4685,3857,2880,-828,3708,0.00712511317663034,-0.00204847003828122,0.00917358321491156,EPCI
243500782,CA du Pays de Saint Malo Agglomération,1968_1975,1971.5,7,64509,67495,5978,8021,2986,2043,943,0.00648504775202552,0.00443702362939991,0.00204802412262561,EPCI
243500782,CA du Pays de Saint Malo Agglomération,1975_1982,1978.5,7,67495,70544,6139,7263,3049,1124,1925,0.00633183435187612,0.00233420197163292,0.0039976323802432,EPCI
243500782,CA du Pays de Saint Malo Agglomération,1982_1990,1986,8,70544,74764,6870,8348,4220,1478,2742,0.0072889179171447,0.00255284850273457,0.00473606941441013,EPCI
243500782,CA du Pays de Saint Malo Agglomération,1990_1999,1994.5,9,74764,79045,7485,8512,4281,1027,3254,0.00620593583374562,0.00148878675572454,0.00471714907802108,EPCI
243500782,CA du Pays de Saint Malo Agglomération,1999_2006,2002.5,7,79045,81962,6176,6510,2917,334,2583,0.00519033976727412,0.000594300131048871,0.00459603963622525,EPCI
243600202,CC Chabris - Pays de Bazelle,2006_2011,2008.5,5,6393,6466,446,287,73,-159,232,0.00227338773979335,-0.00495162535105676,0.00722501309085011,EPCI
243600202,CC Chabris - Pays de Bazelle,2011_2016,2013.5,5,6466,6310,479,261,-156,-218,62,-0.00487249126345579,-0.00680899420149591,0.00193650293804012,EPCI
243600202,CC Chabris - Pays de Bazelle,1968_1975,1971.5,7,7158,6573,818,464,-585,-354,-231,-0.0121061611659724,-0.00732577957735766,-0.00478038158861475,EPCI
243600202,CC Chabris - Pays de Bazelle,1975_1982,1978.5,7,6573,6344,785,379,-229,-406,177,-0.00505302813305908,-0.00895864376428815,0.00390561563122907,EPCI
243600202,CC Chabris - Pays de Bazelle,1982_1990,1986,8,6344,6224,883,437,-120,-446,326,-0.0023842403551082,-0.00886142665315215,0.00647718629804395,EPCI
243600202,CC Chabris - Pays de Bazelle,1990_1999,1994.5,9,6224,6181,935,421,-43,-514,471,-0.00077000519361603,-0.00920424812834045,0.00843424293472442,EPCI
243600202,CC Chabris - Pays de Bazelle,1999_2006,2002.5,7,6181,6393,753,393,212,-360,572,0.0048292765642175,-0.00820065831659576,0.0130299348808133,EPCI
243600236,CC du Pays d'Issoudun,2006_2011,2008.5,5,22153,21429,1380,1051,-724,-329,-395,-0.00662352365503593,-0.00300986088744036,-0.00361366276759557,EPCI
243600236,CC du Pays d'Issoudun,2011_2016,2013.5,5,21429,20126,1352,857,-1303,-495,-808,-0.0124681471396489,-0.00473655628098713,-0.00773159085866182,EPCI
243600236,CC du Pays d'Issoudun,1968_1975,1971.5,7,23442,23903,2143,2457,461,314,147,0.00278597202313358,0.00189760350382634,0.000888368519307236,EPCI
243600236,CC du Pays d'Issoudun,1975_1982,1978.5,7,23903,22811,2165,1799,-1092,-366,-726,-0.00665789425447572,-0.00223149203034626,-0.00442640222412946,EPCI
243600236,CC du Pays d'Issoudun,1982_1990,1986,8,22811,22137,2334,1832,-674,-502,-172,-0.00374203843508769,-0.00278709687598519,-0.000954941559102497,EPCI
243600236,CC du Pays d'Issoudun,1990_1999,1994.5,9,22137,21828,2565,2025,-309,-540,231,-0.00156065506714598,-0.00272735836976967,0.00116670330262369,EPCI
243600236,CC du Pays d'Issoudun,1999_2006,2002.5,7,21828,22153,2002,1528,325,-474,799,0.00211357018672298,-0.00308256082617444,0.00519613101289742,EPCI
243600293,CC de la Région de Levroux,2006_2011,2008.5,5,6410,6522,457,343,112,-114,226,0.00347036912224019,-0.00353233999942305,0.00700270912166324,EPCI
243600293,CC de la Région de Levroux,2011_2016,2013.5,5,6522,6382,455,280,-140,-175,35,-0.00433050610203578,-0.00541313262754473,0.00108262652550895,EPCI
243600293,CC de la Région de Levroux,1968_1975,1971.5,7,7629,7090,819,675,-539,-144,-395,-0.0104127557539295,-0.00278188650939861,-0.00763086924453091,EPCI
243600293,CC de la Région de Levroux,1975_1982,1978.5,7,7090,7033,826,437,-57,-389,332,-0.00115247584876432,-0.00786514219595301,0.00671266634718869,EPCI
243600293,CC de la Région de Levroux,1982_1990,1986,8,7033,6728,914,524,-305,-390,85,-0.0055266011704791,-0.00706680149667819,0.00154020032619909,EPCI
243600293,CC de la Région de Levroux,1990_1999,1994.5,9,6728,6367,830,518,-361,-312,-49,-0.00610898841130436,-0.00527979053830183,-0.000829197873002531,EPCI
243600293,CC de la Région de Levroux,1999_2006,2002.5,7,6367,6410,679,416,43,-263,306,0.000962015282669926,-0.00588395393819048,0.0068459692208604,EPCI
243600301,CC Val de l'Indre - Brenne,2006_2011,2008.5,5,13514,13736,903,746,222,-157,379,0.00326410331424443,-0.00230839738890259,0.00557250070314702,EPCI
243600301,CC Val de l'Indre - Brenne,2011_2016,2013.5,5,13736,13652,933,739,-84,-194,110,-0.00122606627596411,-0.0028316292563933,0.00160556298042919,EPCI
243600301,CC Val de l'Indre - Brenne,1968_1975,1971.5,7,14216,13864,1368,1269,-352,-99,-253,-0.00357538424320758,-0.00100557681840213,-0.00256980742480545,EPCI
243600301,CC Val de l'Indre - Brenne,1975_1982,1978.5,7,13864,13397,1352,971,-467,-381,-86,-0.00488300363091132,-0.00398377812286341,-0.000899225508047909,EPCI
243600301,CC Val de l'Indre - Brenne,1982_1990,1986,8,13397,13282,1415,972,-115,-443,328,-0.00107705283382487,-0.0041489948294297,0.00307194199560483,EPCI
243600301,CC Val de l'Indre - Brenne,1990_1999,1994.5,9,13282,13016,1497,1114,-266,-383,117,-0.00224529390393102,-0.00323288558347963,0.000987591679548608,EPCI
243600301,CC Val de l'Indre - Brenne,1999_2006,2002.5,7,13016,13514,1183,1045,498,-138,636,0.0053782418395818,-0.00149035617241423,0.00686859801199603,EPCI
243600319,CC Brenne - Val de Creuse,2006_2011,2008.5,5,18713,18855,1252,912,142,-340,482,0.00151307578873605,-0.00362285752232576,0.00513593331106181,EPCI
243600319,CC Brenne - Val de Creuse,2011_2016,2013.5,5,18855,18247,1333,800,-608,-533,-75,-0.00653404920579292,-0.00572803984652571,-0.000806009359267219,EPCI
243600319,CC Brenne - Val de Creuse,1968_1975,1971.5,7,21056,20984,2048,1853,-72,-195,123,-0.000489210665754247,-0.00132494555308442,0.000835734887330172,EPCI
243600319,CC Brenne - Val de Creuse,1975_1982,1978.5,7,20984,19724,2028,1424,-1260,-604,-656,-0.00880728296141198,-0.00422190389578796,-0.00458537906562401,EPCI
243600319,CC Brenne - Val de Creuse,1982_1990,1986,8,19724,19094,2282,1527,-630,-755,125,-0.00404953079529613,-0.00485300912769616,0.000803478332400027,EPCI
243600319,CC Brenne - Val de Creuse,1990_1999,1994.5,9,19094,18337,2397,1601,-757,-796,39,-0.00448472158010904,-0.00471577064434187,0.000231049064232831,EPCI
243600319,CC Brenne - Val de Creuse,1999_2006,2002.5,7,18337,18713,1763,1280,376,-483,859,0.0029038642018393,-0.0037302298124691,0.0066340940143084,EPCI
243600327,CA Châteauroux Métropole,2006_2011,2008.5,5,77294,75094,3673,4397,-2200,724,-2924,-0.00575849013143881,0.00189506675234623,-0.00765355688378504,EPCI
243600327,CA Châteauroux Métropole,2011_2016,2013.5,5,75094,73617,3664,3962,-1477,298,-1775,-0.00396505528297209,0.000799990842468302,-0.00476504612544039,EPCI
243600327,CA Châteauroux Métropole,1968_1975,1971.5,7,64712,74723,5127,9026,10011,3899,6112,0.0207613345830737,0.00808594980915038,0.0126753847739233,EPCI
243600327,CA Châteauroux Métropole,1975_1982,1978.5,7,74723,76968,5102,8107,2245,3005,-760,0.00423778383940365,0.00567240108570511,-0.00143461724630146,EPCI
243600327,CA Châteauroux Métropole,1982_1990,1986,8,76968,78484,5619,8146,1516,2527,-1011,0.00244110356569638,0.00406904268503611,-0.00162793911933974,EPCI
243600327,CA Châteauroux Métropole,1990_1999,1994.5,9,78484,77497,6056,8362,-987,2306,-3293,-0.00140518473821816,0.00328303546740737,-0.00468822020562552,EPCI
243600327,CA Châteauroux Métropole,1999_2006,2002.5,7,77497,77294,4882,6493,-203,1611,-1814,-0.000374628811306899,0.00297303948283455,-0.00334766829414145,EPCI
243600343,CC Coeur de Brenne,2006_2011,2008.5,5,5190,5103,437,223,-87,-214,127,-0.00337530981051537,-0.00830248620057804,0.00492717639006267,EPCI
243600343,CC Coeur de Brenne,2011_2016,2013.5,5,5103,4802,398,177,-301,-221,-80,-0.0120855962387515,-0.00887347763708997,-0.00321211860166153,EPCI
243600343,CC Coeur de Brenne,1968_1975,1971.5,7,7275,6406,636,592,-869,-44,-825,-0.0180085528287979,-0.000911825459685968,-0.0170967273691119,EPCI
243600343,CC Coeur de Brenne,1975_1982,1978.5,7,6406,5941,678,398,-465,-280,-185,-0.0107076296278001,-0.00644760493716998,-0.00426002469063016,EPCI
243600343,CC Coeur de Brenne,1982_1990,1986,8,5941,5614,728,387,-327,-341,14,-0.00705176770488858,-0.00735367824882876,0.000301910543940184,EPCI
243600343,CC Coeur de Brenne,1990_1999,1994.5,9,5614,5304,777,383,-310,-394,84,-0.00629148355180897,-0.00799627264326689,0.00170478909145791,EPCI
243600343,CC Coeur de Brenne,1999_2006,2002.5,7,5304,5190,606,299,-114,-307,193,-0.00309912429864612,-0.00834588736565226,0.00524676306700615,EPCI
243600350,CC de la Châtre et Sainte-Sévère,2006_2011,2008.5,5,17291,17227,1222,636,-64,-586,522,-0.000741367942570181,-0.00678815022415822,0.00604678228158804,EPCI
243600350,CC de la Châtre et Sainte-Sévère,2011_2016,2013.5,5,17227,16673,1288,615,-554,-673,119,-0.00651613250771987,-0.00791580717995573,0.00139967467223586,EPCI
243600350,CC de la Châtre et Sainte-Sévère,1968_1975,1971.5,7,20052,18583,2022,1653,-1469,-369,-1100,-0.0108099642696062,-0.00271536883286909,-0.00809459543673714,EPCI
243600350,CC de la Châtre et Sainte-Sévère,1975_1982,1978.5,7,18583,17973,1949,1298,-610,-651,41,-0.00475672968850416,-0.00507644430691181,0.000319714618407656,EPCI
243600350,CC de la Châtre et Sainte-Sévère,1982_1990,1986,8,17973,17360,2287,1257,-613,-1030,417,-0.00432834591009013,-0.00727275087666041,0.00294440496657028,EPCI
243600350,CC de la Châtre et Sainte-Sévère,1990_1999,1994.5,9,17360,17111,2257,1254,-249,-1003,754,-0.00160395425294702,-0.00646090809520424,0.00485695384225723,EPCI
243600350,CC de la Châtre et Sainte-Sévère,1999_2006,2002.5,7,17111,17291,1810,1127,180,-683,863,0.0014960613238062,-0.00567672157866463,0.00717278290247082,EPCI
243700499,CC du Castelrenaudais,2006_2011,2008.5,5,15625,16476,668,1074,851,406,445,0.0106629646805398,0.00508714883701431,0.00557581584352554,EPCI
243700499,CC du Castelrenaudais,2011_2016,2013.5,5,16476,16799,691,1037,323,346,-23,0.00389046513911362,0.00416749516449942,-0.0002770300253858,EPCI
243700499,CC du Castelrenaudais,1968_1975,1971.5,7,11636,12491,1025,1425,855,400,455,0.0101807092589599,0.00476290491647245,0.00541780434248741,EPCI
243700499,CC du Castelrenaudais,1975_1982,1978.5,7,12491,13298,1017,1290,807,273,534,0.00898372256797608,0.00303910317355325,0.00594461939442284,EPCI
243700499,CC du Castelrenaudais,1982_1990,1986,8,13298,14008,1059,1526,710,467,243,0.00652305140647069,0.00429051409411523,0.00223253731235546,EPCI
243700499,CC du Castelrenaudais,1990_1999,1994.5,9,14008,14410,1269,1522,402,253,149,0.00314870401254019,0.00198164705266833,0.00116705695987186,EPCI
243700499,CC du Castelrenaudais,1999_2006,2002.5,7,14410,15625,1024,1377,1215,353,862,0.0116313795838749,0.00337932262807231,0.00825205695580264,EPCI
243700754,Tours Métropole Val de Loire,2006_2011,2008.5,5,287099,288134,11166,16477,1035,5311,-4276,0.000719968191077891,0.00369444547131853,-0.00297447728024064,EPCI
243700754,Tours Métropole Val de Loire,2011_2016,2013.5,5,288134,293123,12020,16614,4989,4594,395,0.00343923392855094,0.00316693539141372,0.000272298537137226,EPCI
243700754,Tours Métropole Val de Loire,1968_1975,1971.5,7,207812,243867,13635,30765,36055,17130,18925,0.023118786124684,0.0109839080936302,0.0121348780310538,EPCI
243700754,Tours Métropole Val de Loire,1975_1982,1978.5,7,243867,255809,14205,27432,11942,13227,-1285,0.00685310112468995,0.00759051821941668,-0.000737417094726729,EPCI
243700754,Tours Métropole Val de Loire,1982_1990,1986,8,255809,265274,16395,29318,9465,12923,-3458,0.00455185107094858,0.0062148517052159,-0.00166300063426732,EPCI
243700754,Tours Métropole Val de Loire,1990_1999,1994.5,9,265274,278103,19070,30335,12829,11265,1564,0.0052613809946449,0.00461995922555732,0.000641421769087585,EPCI
243700754,Tours Métropole Val de Loire,1999_2006,2002.5,7,278103,287099,15406,23379,8996,7973,1023,0.0045582940369584,0.00403993756743767,0.000518356469520725,EPCI
243700820,CC de Bléré Val de Cher,2006_2011,2008.5,5,19516,20828,955,1186,1312,231,1081,0.0130977525332647,0.00230608295364646,0.0107916695796183,EPCI
243700820,CC de Bléré Val de Cher,2011_2016,2013.5,5,20828,21452,947,1131,624,184,440,0.00592139170274142,0.00174605139952632,0.0041753403032151,EPCI
243700820,CC de Bléré Val de Cher,1968_1975,1971.5,7,13270,13616,1331,1165,346,-166,512,0.00368387219384458,-0.00176740689068844,0.00545127908453303,EPCI
243700820,CC de Bléré Val de Cher,1975_1982,1978.5,7,13616,14947,1475,1103,1331,-372,1703,0.0134127313597414,-0.00374871229588565,0.0171614436556271,EPCI
243700820,CC de Bléré Val de Cher,1982_1990,1986,8,14947,16648,1570,1395,1701,-175,1876,0.0135635969676322,-0.00139543178679344,0.0149590287544256,EPCI
243700820,CC de Bléré Val de Cher,1990_1999,1994.5,9,16648,17655,1838,1628,1007,-210,1217,0.00654677486515642,-0.00136526586065824,0.00791204072581467,EPCI
243700820,CC de Bléré Val de Cher,1999_2006,2002.5,7,17655,19516,1379,1605,1861,226,1635,0.0144194882121516,0.00175110388820325,0.0126683843239483,EPCI
243800604,CA Porte de l'Isère (C.A.P.I),2006_2011,2008.5,5,94929,99894,2650,8035,4965,5385,-420,0.0102482331042102,0.0111151531251101,-0.000866920020899956,EPCI
243800604,CA Porte de l'Isère (C.A.P.I),2011_2016,2013.5,5,99894,105299,2816,7882,5405,5066,339,0.0105945891104038,0.00993009961763285,0.000664489492770932,EPCI
243800604,CA Porte de l'Isère (C.A.P.I),1968_1975,1971.5,7,37611,45761,2784,5045,8150,2261,5889,0.0284156118637637,0.00788315318085519,0.0205324586829085,EPCI
243800604,CA Porte de l'Isère (C.A.P.I),1975_1982,1978.5,7,45761,60291,2822,6430,14530,3608,10922,0.0401791400955565,0.00997703630177341,0.030202103793783,EPCI
243800604,CA Porte de l'Isère (C.A.P.I),1982_1990,1986,8,60291,75073,3533,9282,14782,5749,9033,0.0277888702732736,0.0108076184008287,0.0169812518724449,EPCI
243800604,CA Porte de l'Isère (C.A.P.I),1990_1999,1994.5,9,75073,87098,4235,12233,12025,7998,4027,0.0166451169995838,0.0110709060925298,0.00557421090705398,EPCI
243800604,CA Porte de l'Isère (C.A.P.I),1999_2006,2002.5,7,87098,94929,3611,10342,7831,6731,1100,0.012375279584613,0.0106369565680029,0.00173832301661018,EPCI
243800745,CC de l'Oisans,2006_2011,2008.5,5,10715,10806,394,735,91,341,-250,0.00169281249139996,0.00634339625898228,-0.00465058376758232,EPCI
243800745,CC de l'Oisans,2011_2016,2013.5,5,10806,10680,479,590,-126,111,-237,-0.0023429912789823,0.00206406374577012,-0.00440705502475242,EPCI
243800745,CC de l'Oisans,1968_1975,1971.5,7,7981,8707,679,787,726,108,618,0.0125153240087821,0.00186178373684362,0.0106535402719385,EPCI
243800745,CC de l'Oisans,1975_1982,1978.5,7,8707,10325,605,719,1618,114,1504,0.0246475412753231,0.00173660055957159,0.0229109407157515,EPCI
243800745,CC de l'Oisans,1982_1990,1986,8,10325,9476,668,1134,-849,466,-1315,-0.0106684160101017,0.00585569123758233,-0.016524107247684,EPCI
243800745,CC de l'Oisans,1990_1999,1994.5,9,9476,10558,762,1251,1082,489,593,0.0120859609423174,0.00546213946468873,0.00662382147762867,EPCI
243800745,CC de l'Oisans,1999_2006,2002.5,7,10558,10715,609,975,157,366,-209,0.00211090519056323,0.00492096369265058,-0.00281005850208736,EPCI
243800935,CC Lyon Saint Exupéry en Dauphiné,2006_2011,2008.5,5,23082,24273,683,1772,1191,1089,102,0.0101131009265225,0.00924699152727373,0.000866109399248779,EPCI
243800935,CC Lyon Saint Exupéry en Dauphiné,2011_2016,2013.5,5,24273,27329,740,2036,3056,1296,1760,0.0240002365157921,0.0101781107737129,0.0138221257420792,EPCI
243800935,CC Lyon Saint Exupéry en Dauphiné,1968_1975,1971.5,7,11011,15039,735,1806,4028,1071,2957,0.0455426236055461,0.0121092725624478,0.0334333510430982,EPCI
243800935,CC Lyon Saint Exupéry en Dauphiné,1975_1982,1978.5,7,15039,18448,712,2172,3409,1460,1949,0.029617134963287,0.0126843699168082,0.0169327650464788,EPCI
243800935,CC Lyon Saint Exupéry en Dauphiné,1982_1990,1986,8,18448,21975,861,2948,3527,2087,1440,0.0221095573467813,0.0130826895896605,0.00902686775712081,EPCI
243800935,CC Lyon Saint Exupéry en Dauphiné,1990_1999,1994.5,9,21975,22374,1168,2705,399,1537,-1138,0.00200134745593039,0.00770945122748123,-0.00570810377155084,EPCI
243800935,CC Lyon Saint Exupéry en Dauphiné,1999_2006,2002.5,7,22374,23082,957,2215,708,1258,-550,0.00446042142245728,0.0079254380641967,-0.00346501664173942,EPCI
243800984,CA du Pays Voironnais,2006_2011,2008.5,5,88558,90259,3403,5479,1701,2076,-375,0.00381237079761054,0.00465284055017019,-0.000840469752559643,EPCI
243800984,CA du Pays Voironnais,2011_2016,2013.5,5,90259,93179,3570,5385,2920,1815,1105,0.0063881294534851,0.00397070375276557,0.00241742570071953,EPCI
243800984,CA du Pays Voironnais,1968_1975,1971.5,7,54552,60007,4620,6729,5455,2109,3346,0.013708373634195,0.00529990100724422,0.00840847262695076,EPCI
243800984,CA du Pays Voironnais,1975_1982,1978.5,7,60007,68510,4694,6575,8503,1881,6622,0.0191115455895712,0.00422778046030617,0.014883765129265,EPCI
243800984,CA du Pays Voironnais,1982_1990,1986,8,68510,75561,5238,7876,7051,2638,4413,0.0123203474428415,0.00460942796117088,0.00771091948167062,EPCI
243800984,CA du Pays Voironnais,1990_1999,1994.5,9,75561,82980,6088,9020,7419,2932,4487,0.0104609300074281,0.00413417533114694,0.00632675467628115,EPCI
243800984,CA du Pays Voironnais,1999_2006,2002.5,7,82980,88558,4680,7615,5578,2935,2643,0.00933733626092725,0.00491306596016879,0.00442427030075847,EPCI
243801024,CC du Massif du Vercors,2006_2011,2008.5,5,11043,11510,349,703,467,354,113,0.00831830234042275,0.00630552254498855,0.0020127797954342,EPCI
243801024,CC du Massif du Vercors,2011_2016,2013.5,5,11510,11747,333,592,237,259,-22,0.00408465276843217,0.00446381884820225,-0.000379166079770075,EPCI
243801024,CC du Massif du Vercors,1968_1975,1971.5,7,5957,6656,361,737,699,376,323,0.0159765249784576,0.00859395335035773,0.00738257162809986,EPCI
243801024,CC du Massif du Vercors,1975_1982,1978.5,7,6656,7390,350,752,734,402,332,0.0150563694430375,0.00824613149332569,0.00681023794971176,EPCI
243801024,CC du Massif du Vercors,1982_1990,1986,8,7390,8234,416,942,844,526,318,0.0136098051310047,0.00848194016458352,0.00512786496642122,EPCI
243801024,CC du Massif du Vercors,1990_1999,1994.5,9,8234,9951,502,1095,1717,593,1124,0.0212675679837109,0.0073451763624581,0.0139223916212528,EPCI
243801024,CC du Massif du Vercors,1999_2006,2002.5,7,9951,11043,436,1012,1092,576,516,0.0149859941081125,0.00790470018889452,0.007081293919218,EPCI
243801073,CC de Bièvre Est,2006_2011,2008.5,5,19813,21167,661,1324,1354,663,691,0.0133087995080963,0.00651679030566309,0.00679200920243318,EPCI
243801073,CC de Bièvre Est,2011_2016,2013.5,5,21167,22031,731,1278,864,547,317,0.00803353450958322,0.00508604557493289,0.00294748893465032,EPCI
243801073,CC de Bièvre Est,1968_1975,1971.5,7,12741,13535,1141,1390,794,249,545,0.00867365475956938,0.00272007561099846,0.00595357914857092,EPCI
243801073,CC de Bièvre Est,1975_1982,1978.5,7,13535,14511,1073,1279,976,206,770,0.009996500135381,0.00210991703677099,0.00788658309861001,EPCI
243801073,CC de Bièvre Est,1982_1990,1986,8,14511,16676,1205,1587,2165,382,1783,0.0175349098578881,0.00309391942989065,0.0144409904279974,EPCI
243801073,CC de Bièvre Est,1990_1999,1994.5,9,16676,17419,1217,1752,743,535,208,0.00485519338129792,0.00349600061775826,0.00135919276353966,EPCI
243801073,CC de Bièvre Est,1999_2006,2002.5,7,17419,19813,1007,1596,2394,589,1805,0.0185669360731844,0.00456805570054536,0.013998880372639,EPCI
243801255,CC des Collines du Nord Dauphiné,2006_2011,2008.5,5,22463,23391,667,1313,928,646,282,0.0081292285540695,0.00565892418742338,0.00247030436664612,EPCI
243801255,CC des Collines du Nord Dauphiné,2011_2016,2013.5,5,23391,24178,692,1237,787,545,242,0.0066403088928364,0.00459843500202775,0.00204187389080865,EPCI
243801255,CC des Collines du Nord Dauphiné,1968_1975,1971.5,7,7730,9546,605,945,1816,340,1476,0.0306037186471433,0.00572977111235062,0.0248739475347927,EPCI
243801255,CC des Collines du Nord Dauphiné,1975_1982,1978.5,7,9546,13155,667,998,3609,331,3278,0.0468769357767807,0.00429932550349526,0.0425776102732854,EPCI
243801255,CC des Collines du Nord Dauphiné,1982_1990,1986,8,13155,17031,737,1501,3876,764,3112,0.0328057854987085,0.00646636226032335,0.0263394232383852,EPCI
243801255,CC des Collines du Nord Dauphiné,1990_1999,1994.5,9,17031,20128,947,1960,3097,1013,2084,0.0187374578503312,0.00612884882221037,0.0126086090281208,EPCI
243801255,CC des Collines du Nord Dauphiné,1999_2006,2002.5,7,20128,22463,824,1933,2335,1109,1226,0.0158032324214967,0.00750568940275797,0.00829754301873875,EPCI
243900354,CC de la Station des Rousses-Haut Jura,2006_2011,2008.5,5,6105,6435,132,434,330,302,28,0.0105843689902043,0.00968630131830819,0.000898067671896125,EPCI
243900354,CC de la Station des Rousses-Haut Jura,2011_2016,2013.5,5,6435,7030,163,401,595,238,357,0.0178443137194799,0.00713772548779197,0.010706588231688,EPCI
243900354,CC de la Station des Rousses-Haut Jura,1968_1975,1971.5,7,3512,3963,206,302,451,96,355,0.0174091805633627,0.00370572357889761,0.0137034569844651,EPCI
243900354,CC de la Station des Rousses-Haut Jura,1975_1982,1978.5,7,3963,4285,207,283,322,76,246,0.0112223950008865,0.00264876403747632,0.00857363096341019,EPCI
243900354,CC de la Station des Rousses-Haut Jura,1982_1990,1986,8,4285,5184,235,420,899,185,714,0.0240927010356808,0.00495789732102442,0.0191348037146564,EPCI
243900354,CC de la Station des Rousses-Haut Jura,1990_1999,1994.5,9,5184,5544,292,640,360,348,12,0.0074878170802144,0.00723822317754059,0.000249593902673814,EPCI
243900354,CC de la Station des Rousses-Haut Jura,1999_2006,2002.5,7,5544,6105,221,536,561,315,246,0.0138655104375054,0.00778544703710196,0.00608006340040343,EPCI
243900412,CC Jura Sud,2006_2011,2008.5,5,7066,7286,281,465,220,184,36,0.00615086931361675,0.00514436342593401,0.00100650588768274,EPCI
243900412,CC Jura Sud,2011_2016,2013.5,5,7286,6979,274,347,-307,73,-380,-0.00857285342544456,0.00203849609139235,-0.0106113495168369,EPCI
243900412,CC Jura Sud,1968_1975,1971.5,7,5410,5523,408,609,113,201,-88,0.00295752172919683,0.0052607244917572,-0.00230320276256037,EPCI
243900412,CC Jura Sud,1975_1982,1978.5,7,5523,5762,385,542,239,157,82,0.00607027069192467,0.00398758367628525,0.00208268701563943,EPCI
243900412,CC Jura Sud,1982_1990,1986,8,5762,6153,462,602,391,140,251,0.00824066023599968,0.00295062003335027,0.00529004020264941,EPCI
243900412,CC Jura Sud,1990_1999,1994.5,9,6153,6727,472,755,574,283,291,0.00995921181725401,0.00491020373568447,0.00504900808156954,EPCI
243900412,CC Jura Sud,1999_2006,2002.5,7,6727,7066,385,648,339,263,76,0.00704833338199795,0.00546817604562083,0.00158015733637712,EPCI
243900420,CC du Val d'Amour,2006_2011,2008.5,5,8815,9205,475,550,390,75,315,0.00869599212854011,0.00167230617856541,0.0070236859499747,EPCI
243900420,CC du Val d'Amour,2011_2016,2013.5,5,9205,9183,445,460,-22,15,-37,-0.000478458712838137,0.000326221849662366,-0.000804680562500503,EPCI
243900420,CC du Val d'Amour,1968_1975,1971.5,7,7423,7240,754,739,-183,-15,-168,-0.0035596610082822,-0.000291775492482148,-0.00326788551580005,EPCI
243900420,CC du Val d'Amour,1975_1982,1978.5,7,7240,7492,682,530,252,-152,404,0.00489976164848427,-0.00295541178797464,0.00785517343645891,EPCI
243900420,CC du Val d'Amour,1982_1990,1986,8,7492,7774,681,638,282,-43,325,0.00462931329665262,-0.000705888197716534,0.00533520149436915,EPCI
243900420,CC du Val d'Amour,1990_1999,1994.5,9,7774,8002,955,743,228,-212,440,0.00321701663855678,-0.00299126108497385,0.00620827772353063,EPCI
243900420,CC du Val d'Amour,1999_2006,2002.5,7,8002,8815,707,666,813,-41,854,0.0139193133248392,-0.000701957990551546,0.0146212713153907,EPCI
243900479,CC du Haut-Jura - ARCADE,2006_2011,2008.5,5,9858,9551,411,594,-307,183,-490,-0.00630751304047761,0.00375985305018698,-0.0100673660906646,EPCI
243900479,CC du Haut-Jura - ARCADE,2011_2016,2013.5,5,9551,9400,410,562,-151,152,-303,-0.00318216051584719,0.00320323442654816,-0.00638539494239535,EPCI
243900479,CC du Haut-Jura - ARCADE,1968_1975,1971.5,7,9019,9633,626,1216,614,590,24,0.00945315007630598,0.00908364583879565,0.000369504237510331,EPCI
243900479,CC du Haut-Jura - ARCADE,1975_1982,1978.5,7,9633,9939,603,1069,306,466,-160,0.00447738053628788,0.00681849454219004,-0.00234111400590216,EPCI
243900479,CC du Haut-Jura - ARCADE,1982_1990,1986,8,9939,10843,724,1308,904,584,320,0.0109410829365022,0.00706813322446602,0.00387294971203618,EPCI
243900479,CC du Haut-Jura - ARCADE,1990_1999,1994.5,9,10843,10408,748,1470,-435,722,-1157,-0.00453910800002322,0.00753387580693509,-0.0120729838069583,EPCI
243900479,CC du Haut-Jura - ARCADE,1999_2006,2002.5,7,10408,9858,542,937,-550,395,-945,-0.00772591945796841,0.00554861488345004,-0.0132745343414185,EPCI
243900560,CC Jura Nord,2006_2011,2008.5,5,10885,11299,485,780,414,295,119,0.00749364417548737,0.00533967398977965,0.00215397018570772,EPCI
243900560,CC Jura Nord,2011_2016,2013.5,5,11299,11582,537,703,283,166,117,0.00495984804138083,0.00290931015854847,0.00205053788283236,EPCI
243900560,CC Jura Nord,1968_1975,1971.5,7,7657,7624,757,741,-33,-16,-17,-0.00061682336892821,-0.000299065875843981,-0.000317757493084229,EPCI
243900560,CC Jura Nord,1975_1982,1978.5,7,7624,8335,759,720,711,-39,750,0.0128189457581702,-0.000703148923443936,0.0135220946816142,EPCI
243900560,CC Jura Nord,1982_1990,1986,8,8335,8971,809,928,636,119,517,0.00923407799159226,0.00172775987578534,0.00750631811580692,EPCI
243900560,CC Jura Nord,1990_1999,1994.5,9,8971,9975,891,1054,1004,163,841,0.0118569439432756,0.00192498193501387,0.00993196200826176,EPCI
243900560,CC Jura Nord,1999_2006,2002.5,7,9975,10885,728,1014,910,286,624,0.0125500609617812,0.00394430487370268,0.00860575608807856,EPCI
243900610,CC La Grandvallière,2006_2011,2008.5,5,5154,5299,194,318,145,124,21,0.00556442648560673,0.00475854402907059,0.000805882456536148,EPCI
243900610,CC La Grandvallière,2011_2016,2013.5,5,5299,5365,222,269,66,47,19,0.00247871746752115,0.00176514728747718,0.000713570180043968,EPCI
243900610,CC La Grandvallière,1968_1975,1971.5,7,4064,4050,334,452,-14,118,-132,-0.000492854101458828,0.00415405599801013,-0.00464691009946895,EPCI
243900610,CC La Grandvallière,1975_1982,1978.5,7,4050,4273,310,441,223,131,92,0.00768642945506115,0.00451534645117942,0.00317108300388173,EPCI
243900610,CC La Grandvallière,1982_1990,1986,8,4273,4606,334,538,333,204,129,0.00942458995784312,0.00577362267687687,0.00365096728096625,EPCI
243900610,CC La Grandvallière,1990_1999,1994.5,9,4606,4958,346,596,352,250,102,0.00821608295898235,0.00583528619245906,0.00238079676652329,EPCI
243900610,CC La Grandvallière,1999_2006,2002.5,7,4958,5154,269,459,196,190,6,0.00555403515496211,0.00538401367062654,0.000170021484335575,EPCI
243900719,CC du Pays des Lacs,2006_2011,2008.5,5,5805,6087,285,340,282,55,227,0.00953229250508203,0.00185913506304791,0.00767315744203412,EPCI
243900719,CC du Pays des Lacs,2011_2016,2013.5,5,6087,6091,331,291,4,-40,44,0.000131393099829236,-0.00131393099829236,0.00144532409812159,EPCI
243900719,CC du Pays des Lacs,1968_1975,1971.5,7,5471,5153,486,542,-318,56,-374,-0.00851813416797442,0.00150004878429738,-0.0100181829522718,EPCI
243900719,CC du Pays des Lacs,1975_1982,1978.5,7,5153,5177,420,432,24,12,12,0.000664030166721119,0.00033201508336056,0.00033201508336056,EPCI
243900719,CC du Pays des Lacs,1982_1990,1986,8,5177,5201,477,527,24,50,-26,0.000578314268148805,0.00120482139197668,-0.000626507123827872,EPCI
243900719,CC du Pays des Lacs,1990_1999,1994.5,9,5201,5436,544,553,235,9,226,0.00492236204766416,0.000188515993314798,0.00473384605434937,EPCI
243900719,CC du Pays des Lacs,1999_2006,2002.5,7,5436,5805,401,478,369,77,292,0.00942645447009416,0.00196703792465379,0.00745941654544037,EPCI
243901071,CC de la Région d'Orgelet,2006_2011,2008.5,5,5523,5732,282,300,209,18,191,0.00745632478464375,0.000642171512553051,0.0068141532720907,EPCI
243901071,CC de la Région d'Orgelet,2011_2016,2013.5,5,5732,5757,292,270,25,-22,47,0.000870778052811216,-0.00076628468647387,0.00163706273928509,EPCI
243901071,CC de la Région d'Orgelet,1968_1975,1971.5,7,5044,4718,479,483,-326,4,-330,-0.00949951143044403,0.000116558422459436,-0.00961606985290347,EPCI
243901071,CC de la Région d'Orgelet,1975_1982,1978.5,7,4718,4867,492,356,149,-136,285,0.00445170092037972,-0.00406329748437344,0.00851499840475316,EPCI
243901071,CC de la Région d'Orgelet,1982_1990,1986,8,4867,5014,442,465,147,23,124,0.00372645966030083,0.00058305151147564,0.00314340814882519,EPCI
243901071,CC de la Région d'Orgelet,1990_1999,1994.5,9,5014,5118,537,513,104,-24,128,0.00228368564704629,-0.000527004380087604,0.00281069002713389,EPCI
243901071,CC de la Région d'Orgelet,1999_2006,2002.5,7,5118,5523,381,450,405,69,336,0.010939034626122,0.00186368738074671,0.00907534724537529,EPCI
243901089,CC de la Plaine Jurassienne,2006_2011,2008.5,5,8718,9267,447,504,549,57,492,0.012288864898006,0.00127589307684215,0.0110129718211638,EPCI
243901089,CC de la Plaine Jurassienne,2011_2016,2013.5,5,9267,9274,450,499,7,49,-42,0.000151028076534665,0.00105719653574265,-0.00090616845920799,EPCI
243901089,CC de la Plaine Jurassienne,1968_1975,1971.5,7,7590,7198,751,659,-392,-92,-300,-0.00754686145497285,-0.00177120217820791,-0.00577565927676494,EPCI
243901089,CC de la Plaine Jurassienne,1975_1982,1978.5,7,7198,7907,735,579,709,-156,865,0.0135112101049775,-0.00297284735737163,0.0164840574623491,EPCI
243901089,CC de la Plaine Jurassienne,1982_1990,1986,8,7907,8125,817,689,218,-128,346,0.00340544604138793,-0.00199952795090667,0.0054049739922946,EPCI
243901089,CC de la Plaine Jurassienne,1990_1999,1994.5,9,8125,8118,911,681,-7,-230,223,-9.57631698699224e-05,-0.00314650415286888,0.00305074098299896,EPCI
243901089,CC de la Plaine Jurassienne,1999_2006,2002.5,7,8118,8718,686,678,600,-8,608,0.0102386362760778,-0.000136515150347704,0.0103751514264255,EPCI
244000543,CC de Mimizan,2006_2011,2008.5,5,11075,11981,657,443,906,-214,1120,0.0158506589656826,-0.00374397463427823,0.0195946335999608,EPCI
244000543,CC de Mimizan,2011_2016,2013.5,5,11981,12025,710,479,44,-231,275,0.000733419687600767,-0.00385045335990403,0.00458387304750479,EPCI
244000543,CC de Mimizan,1968_1975,1971.5,7,9890,10952,800,1055,1062,255,807,0.014677811106443,0.00352433317527585,0.0111534779311671,EPCI
244000543,CC de Mimizan,1975_1982,1978.5,7,10952,10770,781,812,-182,31,-213,-0.00239107920766701,0.000407271733174052,-0.00279835094084106,EPCI
244000543,CC de Mimizan,1982_1990,1986,8,10770,10363,951,823,-407,-128,-279,-0.00480376495744028,-0.00151076637482151,-0.00329299858261877,EPCI
244000543,CC de Mimizan,1990_1999,1994.5,9,10363,10523,1027,883,160,-144,304,0.00170384629457154,-0.00153346166511439,0.00323730795968593,EPCI
244000543,CC de Mimizan,1999_2006,2002.5,7,10523,11075,877,621,552,-256,808,0.00733059222411381,-0.00339969494451655,0.0107302871686304,EPCI
244000659,CC du Seignanx,2006_2011,2008.5,5,23596,25154,1011,1381,1558,370,1188,0.0128700601174336,0.00305643276216332,0.00981362735527032,EPCI
244000659,CC du Seignanx,2011_2016,2013.5,5,25154,26825,1090,1246,1671,156,1515,0.0129465621259965,0.00120865571014689,0.0117379064158496,EPCI
244000659,CC du Seignanx,1968_1975,1971.5,7,10547,13202,934,1100,2655,166,2489,0.0325952234583846,0.00203796877366925,0.0305572546847154,EPCI
244000659,CC du Seignanx,1975_1982,1978.5,7,13202,16072,1062,1108,2870,46,2824,0.0285000416498329,0.000456795092645405,0.0280432465571875,EPCI
244000659,CC du Seignanx,1982_1990,1986,8,16072,17870,1330,1321,1798,-9,1807,0.0133438324911388,-6.67933773193822e-05,0.0134106258684582,EPCI
244000659,CC du Seignanx,1990_1999,1994.5,9,17870,20483,1583,1656,2613,73,2540,0.0152790993307601,0.000426855817506884,0.0148522435132532,EPCI
244000659,CC du Seignanx,1999_2006,2002.5,7,20483,23596,1314,1668,3113,354,2759,0.0204173442249278,0.00232179243675697,0.0180955517881708,EPCI
244000675,CA du Grand Dax,2006_2011,2008.5,5,51582,53357,2828,2711,1775,-117,1892,0.00678942509595992,-0.000447528302099894,0.00723695339805982,EPCI
244000675,CA du Grand Dax,2011_2016,2013.5,5,53357,54874,3208,2567,1517,-641,2158,0.00562264202016505,-0.00237581643699789,0.00799845845716293,EPCI
244000675,CA du Grand Dax,1968_1975,1971.5,7,35619,38525,3462,3941,2906,479,2427,0.0112670255657237,0.0018571594101795,0.00940986615554417,EPCI
244000675,CA du Grand Dax,1975_1982,1978.5,7,38525,40553,3572,3448,2028,-124,2152,0.0073558335372157,-0.000449764969731137,0.00780559850694683,EPCI
244000675,CA du Grand Dax,1982_1990,1986,8,40553,43509,4163,3817,2956,-346,3302,0.00883354408268233,-0.00103396693254671,0.00986751101522905,EPCI
244000675,CA du Grand Dax,1990_1999,1994.5,9,43509,45929,4623,4164,2420,-459,2879,0.00603244597870467,-0.00114417053893613,0.0071766165176408,EPCI
244000675,CA du Grand Dax,1999_2006,2002.5,7,45929,51582,3776,3363,5653,-413,6066,0.016720541975823,-0.00122157860180698,0.0179421205776299,EPCI
244000691,CC du Pays Morcenais,2006_2011,2008.5,5,9209,9455,718,375,246,-343,589,0.0052864110948625,-0.00737089026641397,0.0126573013612765,EPCI
244000691,CC du Pays Morcenais,2011_2016,2013.5,5,9455,9408,699,355,-47,-344,297,-0.000996165688030848,-0.00729108503580025,0.0062949193477694,EPCI
244000691,CC du Pays Morcenais,1968_1975,1971.5,7,10448,10641,885,1084,193,199,-6,0.00261826338394733,0.00269966017308559,-8.13967891382587e-05,EPCI
244000691,CC du Pays Morcenais,1975_1982,1978.5,7,10641,10261,944,826,-380,-118,-262,-0.00518141045480225,-0.0016089642991228,-0.00357244615567945,EPCI
244000691,CC du Pays Morcenais,1982_1990,1986,8,10261,9185,1061,782,-1076,-279,-797,-0.0137518896083843,-0.00356577806760149,-0.0101861115407828,EPCI
244000691,CC du Pays Morcenais,1990_1999,1994.5,9,9185,8924,1106,705,-261,-401,140,-0.00319792483260517,-0.00491328681178036,0.00171536197917519,EPCI
244000691,CC du Pays Morcenais,1999_2006,2002.5,7,8924,9209,947,532,285,-415,700,0.00450109824326383,-0.00655423077527892,0.0110553290185428,EPCI
244000766,CC du Pays Tarusate,2006_2011,2008.5,5,15134,16426,937,824,1292,-113,1405,0.0165192743674305,-0.00144479721634648,0.017964071583777,EPCI
244000766,CC du Pays Tarusate,2011_2016,2013.5,5,16426,17512,995,879,1086,-116,1202,0.0128865075223445,-0.00137645936702759,0.0142629668893721,EPCI
244000766,CC du Pays Tarusate,1968_1975,1971.5,7,14792,14575,1414,1175,-217,-239,22,-0.00210902456837059,-0.0023228427273759,0.000213818159005313,EPCI
244000766,CC du Pays Tarusate,1975_1982,1978.5,7,14575,14205,1425,932,-370,-493,123,-0.00366664949646167,-0.00488556270744758,0.00121891321098591,EPCI
244000766,CC du Pays Tarusate,1982_1990,1986,8,14205,14217,1525,1080,12,-445,457,0.000105557614239249,-0.00391442819470548,0.00401998580894473,EPCI
244000766,CC du Pays Tarusate,1990_1999,1994.5,9,14217,14185,1747,1076,-32,-671,639,-0.000250342369423451,-0.00524936655884798,0.00499902418942453,EPCI
244000766,CC du Pays Tarusate,1999_2006,2002.5,7,14185,15134,1276,976,949,-300,1249,0.0092941822922934,-0.00293809766879665,0.01223227996109,EPCI
244000774,CC du Pays de Villeneuve en Armagnac Landais,2006_2011,2008.5,5,5896,6040,328,310,144,-18,162,0.00483763516740732,-0.000604704395925915,0.00544233956333323,EPCI
244000774,CC du Pays de Villeneuve en Armagnac Landais,2011_2016,2013.5,5,6040,6282,321,256,242,-65,307,0.00788782409249356,-0.00211863043806645,0.01000645453056,EPCI
244000774,CC du Pays de Villeneuve en Armagnac Landais,1968_1975,1971.5,7,5425,5311,542,466,-114,-76,-38,-0.00302936760455697,-0.00201957840303798,-0.00100978920151899,EPCI
244000774,CC du Pays de Villeneuve en Armagnac Landais,1975_1982,1978.5,7,5311,5266,570,297,-45,-273,228,-0.00121484438781938,-0.00737005595277091,0.00615521156495153,EPCI
244000774,CC du Pays de Villeneuve en Armagnac Landais,1982_1990,1986,8,5266,5306,655,389,40,-266,306,0.000946346834036937,-0.00629320644634563,0.00723955328038257,EPCI
244000774,CC du Pays de Villeneuve en Armagnac Landais,1990_1999,1994.5,9,5306,5401,630,456,95,-174,269,0.00197370807995001,-0.00361500216748739,0.0055887102474374,EPCI
244000774,CC du Pays de Villeneuve en Armagnac Landais,1999_2006,2002.5,7,5401,5896,498,398,495,-100,595,0.0126059409995747,-0.00254665474738883,0.0151525957469635,EPCI
244000808,CA Mont-de-Marsan Agglomération,2006_2011,2008.5,5,50042,53526,2132,2954,3484,822,2662,0.0135519796502246,0.00319739588762475,0.0103545837625998,EPCI
244000808,CA Mont-de-Marsan Agglomération,2011_2016,2013.5,5,53526,53323,2250,2795,-203,545,-748,-0.000759663182898107,0.00203948982600723,-0.00279915300890534,EPCI
244000808,CA Mont-de-Marsan Agglomération,1968_1975,1971.5,7,35877,39359,2468,4659,3482,2191,1291,0.0133205446337967,0.00838176717192666,0.00493877746187007,EPCI
244000808,CA Mont-de-Marsan Agglomération,1975_1982,1978.5,7,39359,41788,2562,4009,2429,1447,982,0.00859163398509155,0.00511819447362185,0.0034734395114697,EPCI
244000808,CA Mont-de-Marsan Agglomération,1982_1990,1986,8,41788,44656,3004,4898,2868,1894,974,0.00833195157744515,0.00550234180184139,0.00282960977560376,EPCI
244000808,CA Mont-de-Marsan Agglomération,1990_1999,1994.5,9,44656,46598,3609,4971,1942,1362,580,0.0047410863259103,0.00332510791755398,0.00141597840835632,EPCI
244000808,CA Mont-de-Marsan Agglomération,1999_2006,2002.5,7,46598,50042,2761,3908,3444,1147,2297,0.0102384913314437,0.00340985759499592,0.0068286337364478,EPCI
244000824,CC du Pays Grenadois,2006_2011,2008.5,5,7615,7761,321,417,146,96,50,0.00380546356403966,0.00250222261745073,0.00130324094658892,EPCI
244000824,CC du Pays Grenadois,2011_2016,2013.5,5,7761,7684,370,369,-77,-1,-76,-0.00199220231855757,-2.58727573838645e-05,-0.0019663295611737,EPCI
244000824,CC du Pays Grenadois,1968_1975,1971.5,7,6038,5970,531,581,-68,50,-118,-0.00161667803447163,0.0011887338488762,-0.00280541188334783,EPCI
244000824,CC du Pays Grenadois,1975_1982,1978.5,7,5970,6336,556,572,366,16,350,0.00853633233124063,0.000373172998087022,0.0081631593331536,EPCI
244000824,CC du Pays Grenadois,1982_1990,1986,8,6336,6739,553,634,403,81,322,0.00773776943205196,0.00155523405458116,0.00618253537747079,EPCI
244000824,CC du Pays Grenadois,1990_1999,1994.5,9,6739,6933,623,676,194,53,141,0.00315843002869554,0.000862870059385894,0.00229555996930964,EPCI
244000824,CC du Pays Grenadois,1999_2006,2002.5,7,6933,7615,466,580,682,114,568,0.0134941445955692,0.00225561947785174,0.0112385251177174,EPCI
244000857,CC Côte Landes Nature,2006_2011,2008.5,5,9860,10685,573,456,825,-117,942,0.0162007762285472,-0.00229756462877579,0.018498340857323,EPCI
244000857,CC Côte Landes Nature,2011_2016,2013.5,5,10685,11534,642,454,849,-188,1037,0.0154091769761349,-0.00341216168611703,0.0188213386622519,EPCI
244000857,CC Côte Landes Nature,1968_1975,1971.5,7,8471,8356,815,741,-115,-74,-41,-0.00195076930781835,-0.00125527764155267,-0.000695491666265671,EPCI
244000857,CC Côte Landes Nature,1975_1982,1978.5,7,8356,8204,845,554,-152,-291,139,-0.00261913598887853,-0.00501426692607666,0.00239513093719813,EPCI
244000857,CC Côte Landes Nature,1982_1990,1986,8,8204,8652,940,680,448,-260,708,0.00666821770605375,-0.00386994777583476,0.0105381654818885,EPCI
244000857,CC Côte Landes Nature,1990_1999,1994.5,9,8652,9255,1090,783,603,-307,910,0.00751402722756356,-0.0038255495171841,0.0113395767447477,EPCI
244000857,CC Côte Landes Nature,1999_2006,2002.5,7,9255,9860,843,587,605,-256,861,0.00908707079744531,-0.00384510764321653,0.0129321784406618,EPCI
244000865,CC Maremne Adour Côte Sud,2006_2011,2008.5,5,52301,58641,2644,3040,6340,396,5944,0.0231475649792605,0.00144581005233236,0.0217017549269282,EPCI
244000865,CC Maremne Adour Côte Sud,2011_2016,2013.5,5,58641,64493,2952,3136,5852,184,5668,0.0192066352098237,0.000603899671669098,0.0186027355381546,EPCI
244000865,CC Maremne Adour Côte Sud,1968_1975,1971.5,7,27616,30271,2527,2635,2655,108,2547,0.0131999087509951,0.000536945440718444,0.0126629633102766,EPCI
244000865,CC Maremne Adour Côte Sud,1975_1982,1978.5,7,30271,32903,2837,2295,2632,-542,3174,0.0119817385482011,-0.00246736409313259,0.0144491026413336,EPCI
244000865,CC Maremne Adour Côte Sud,1982_1990,1986,8,32903,37210,3317,2680,4307,-637,4944,0.015495542856846,-0.00229177172041116,0.0177873145772571,EPCI
244000865,CC Maremne Adour Côte Sud,1990_1999,1994.5,9,37210,44095,4154,3556,6885,-598,7483,0.0190422403294457,-0.00165392297995766,0.0206961633094033,EPCI
244000865,CC Maremne Adour Côte Sud,1999_2006,2002.5,7,44095,52301,3549,3570,8206,21,8185,0.0246809533816259,6.31611041937782e-05,0.0246177922774321,EPCI
244000873,CC des Grands Lacs,2006_2011,2008.5,5,23611,25862,1114,1325,2251,211,2040,0.0183792581393711,0.0017228002964937,0.0166564578428774,EPCI
244000873,CC des Grands Lacs,2011_2016,2013.5,5,25862,29186,1231,1286,3324,55,3269,0.0244776638666013,0.000405015497191057,0.0240726483694103,EPCI
244000873,CC des Grands Lacs,1968_1975,1971.5,7,14455,15970,961,1992,1515,1031,484,0.01434065264874,0.00975921642300389,0.00458143622573607,EPCI
244000873,CC des Grands Lacs,1975_1982,1978.5,7,15970,16289,992,1408,319,416,-97,0.00282943404948299,0.00368979487330698,-0.000860360823823982,EPCI
244000873,CC des Grands Lacs,1982_1990,1986,8,16289,17947,1235,1629,1658,394,1264,0.0121903206672893,0.00289685545410856,0.00929346521318075,EPCI
244000873,CC des Grands Lacs,1990_1999,1994.5,9,17947,18836,1553,1742,889,189,700,0.00538633914737607,0.0011451272203083,0.00424121192706778,EPCI
244000873,CC des Grands Lacs,1999_2006,2002.5,7,18836,23611,1315,1541,4775,226,4549,0.0328041089146616,0.00155261332245309,0.0312514955922085,EPCI
244000881,CC Coteaux et Vallées des Luys,2006_2011,2008.5,5,7100,7549,464,344,449,-120,569,0.0123395760341838,-0.00329788223630747,0.0156374582704913,EPCI
244000881,CC Coteaux et Vallées des Luys,2011_2016,2013.5,5,7549,7628,461,323,79,-138,217,0.00208428582633236,-0.00364090435485905,0.00572519018119141,EPCI
244000881,CC Coteaux et Vallées des Luys,1968_1975,1971.5,7,7283,6912,665,524,-371,-141,-230,-0.00744129455282072,-0.0028280930780262,-0.00461320147479452,EPCI
244000881,CC Coteaux et Vallées des Luys,1975_1982,1978.5,7,6912,6668,652,432,-244,-220,-24,-0.0051209951397303,-0.00461729069975683,-0.000503704439973472,EPCI
244000881,CC Coteaux et Vallées des Luys,1982_1990,1986,8,6668,6752,792,484,84,-308,392,0.00156607406581877,-0.00574227157466882,0.00730834564048758,EPCI
244000881,CC Coteaux et Vallées des Luys,1990_1999,1994.5,9,6752,6682,783,514,-70,-269,199,-0.00115726466984323,-0.00444720280268326,0.00328993813284003,EPCI
244000881,CC Coteaux et Vallées des Luys,1999_2006,2002.5,7,6682,7100,621,461,418,-160,578,0.00870588341296186,-0.00333239556477009,0.0120382789777319,EPCI
244100293,CC des Collines du Perche,2006_2011,2008.5,5,6265,6328,408,272,63,-136,199,0.00200313201720781,-0.00432422149746448,0.00632735351467229,EPCI
244100293,CC des Collines du Perche,2011_2016,2013.5,5,6328,6156,425,256,-172,-169,-3,-0.0054962429803842,-0.00540037827723797,-9.58647031462359e-05,EPCI
244100293,CC des Collines du Perche,1968_1975,1971.5,7,7900,7454,637,655,-446,18,-464,-0.00826734432351772,0.000333659636375155,-0.00860100395989288,EPCI
244100293,CC des Collines du Perche,1975_1982,1978.5,7,7454,6957,664,476,-497,-188,-309,-0.0098090676063235,-0.00371047225349863,-0.00609859535282487,EPCI
244100293,CC des Collines du Perche,1982_1990,1986,8,6957,6445,641,513,-512,-128,-384,-0.00950995544096678,-0.00237748886024169,-0.00713246658072508,EPCI
244100293,CC des Collines du Perche,1990_1999,1994.5,9,6445,6352,681,534,-93,-147,54,-0.0016136868767751,-0.00255066635361226,0.000936979476837155,EPCI
244100293,CC des Collines du Perche,1999_2006,2002.5,7,6352,6265,590,407,-87,-183,96,-0.00196822273242825,-0.00414005471303873,0.00217183198061048,EPCI
244100780,CC de la Sologne des Étangs,2006_2011,2008.5,5,8396,8752,579,435,356,-144,500,0.00833995400070098,-0.00337346453960938,0.0117134185403104,EPCI
244100780,CC de la Sologne des Étangs,2011_2016,2013.5,5,8752,8696,544,415,-56,-129,73,-0.00128299542886023,-0.00295547161291018,0.00167247618404995,EPCI
244100780,CC de la Sologne des Étangs,1968_1975,1971.5,7,8468,7798,759,656,-670,-103,-567,-0.0117062372139365,-0.00179961557169471,-0.00990662164224177,EPCI
244100780,CC de la Sologne des Étangs,1975_1982,1978.5,7,7798,7582,837,493,-216,-344,128,-0.00400485530084516,-0.00637810288653117,0.00237324758568602,EPCI
244100780,CC de la Sologne des Étangs,1982_1990,1986,8,7582,7587,880,607,5,-273,278,8.24083031019107e-05,-0.00449949334936433,0.00458190165246624,EPCI
244100780,CC de la Sologne des Étangs,1990_1999,1994.5,9,7587,7863,989,671,276,-318,594,0.0039781091595994,-0.00458347359692974,0.00856158275652914,EPCI
244100780,CC de la Sologne des Étangs,1999_2006,2002.5,7,7863,8396,756,611,533,-145,678,0.00941363052216571,-0.00256093138032651,0.0119745619024922,EPCI
244100798,CC du Grand Chambord,2006_2011,2008.5,5,19339,20112,884,1168,773,284,489,0.00786937594266868,0.00289120668527543,0.00497816925739325,EPCI
244100798,CC du Grand Chambord,2011_2016,2013.5,5,20112,20629,928,1007,517,79,438,0.00508914612847811,0.000777645153094333,0.00431150097538377,EPCI
244100798,CC du Grand Chambord,1968_1975,1971.5,7,11794,12064,1025,1323,270,298,-28,0.0032387883903322,0.00357466274192221,-0.000335874351590006,EPCI
244100798,CC du Grand Chambord,1975_1982,1978.5,7,12064,15547,1002,1222,3483,220,3263,0.0368990274811825,0.00233068792588577,0.0345683395552967,EPCI
244100798,CC du Grand Chambord,1982_1990,1986,8,15547,17022,1227,1526,1475,299,1176,0.0113942924048873,0.00230975825699072,0.0090845341478966,EPCI
244100798,CC du Grand Chambord,1990_1999,1994.5,9,17022,17899,1477,1647,877,170,707,0.00559763300636451,0.00108505998983121,0.00451257301653331,EPCI
244100798,CC du Grand Chambord,1999_2006,2002.5,7,17899,19339,1260,1393,1440,133,1307,0.0111154565451836,0.00102663591702043,0.0100888206281632,EPCI
244100806,CC de la Sologne des Rivières,2006_2011,2008.5,5,11446,11474,778,504,28,-274,302,0.000488775850560952,-0.00478302082334646,0.00527179667390741,EPCI
244100806,CC de la Sologne des Rivières,2011_2016,2013.5,5,11474,11041,775,464,-433,-311,-122,-0.00766407797331181,-0.00550468417944567,-0.00215939379386615,EPCI
244100806,CC de la Sologne des Rivières,1968_1975,1971.5,7,11045,11607,943,1120,562,177,385,0.00711526945097329,0.00224093005840262,0.00487433939257067,EPCI
244100806,CC de la Sologne des Rivières,1975_1982,1978.5,7,11607,11889,1000,921,282,-79,361,0.00343520662873309,-0.000962345119396858,0.00439755174812995,EPCI
244100806,CC de la Sologne des Rivières,1982_1990,1986,8,11889,11912,1178,1061,23,-117,140,0.000241615747546442,-0.00122908880273625,0.00147070455028269,EPCI
244100806,CC de la Sologne des Rivières,1990_1999,1994.5,9,11912,11773,1295,988,-139,-307,168,-0.00130331897288727,-0.00287855341493807,0.0015752344420508,EPCI
244100806,CC de la Sologne des Rivières,1999_2006,2002.5,7,11773,11446,1008,757,-327,-251,-76,-0.00401597860398117,-0.00308260131375925,-0.000933377290221925,EPCI
244200614,CC des Vals d'Aix et Isable,2006_2011,2008.5,5,5643,5961,301,316,318,15,303,0.0110248128850383,0.000520038343633883,0.0105047745414044,EPCI
244200614,CC des Vals d'Aix et Isable,2011_2016,2013.5,5,5961,6039,312,295,78,-17,95,0.00260341964416355,-0.000567411973727954,0.00317083161789151,EPCI
244200614,CC des Vals d'Aix et Isable,1968_1975,1971.5,7,6132,5705,600,611,-427,11,-438,-0.0102581621128199,0.000264261787449694,-0.0105224239002696,EPCI
244200614,CC des Vals d'Aix et Isable,1975_1982,1978.5,7,5705,5504,538,434,-201,-104,-97,-0.00511087803148214,-0.00264443440434897,-0.00246644362713317,EPCI
244200614,CC des Vals d'Aix et Isable,1982_1990,1986,8,5504,5277,538,437,-227,-101,-126,-0.00525083419783579,-0.00233627424661416,-0.00291455995122163,EPCI
244200614,CC des Vals d'Aix et Isable,1990_1999,1994.5,9,5277,5252,597,491,-25,-106,81,-0.000527505040599841,-0.00223662137214332,0.00170911633154348,EPCI
244200614,CC des Vals d'Aix et Isable,1999_2006,2002.5,7,5252,5643,418,431,391,13,378,0.0103109210246943,0.000342818346089581,0.00996810267860475,EPCI
244200622,CC des Monts du Pilat,2006_2011,2008.5,5,15105,15346,896,867,241,-29,270,0.00317082424514936,-0.000381551465183948,0.00355237571033331,EPCI
244200622,CC des Monts du Pilat,2011_2016,2013.5,5,15346,15105,974,773,-241,-201,-40,-0.0031608018978575,-0.00263618747497659,-0.000524614422880913,EPCI
244200622,CC des Monts du Pilat,1968_1975,1971.5,7,11999,11932,1237,1221,-67,-16,-51,-0.000799601052814403,-0.000190949505149708,-0.000608651547664695,EPCI
244200622,CC des Monts du Pilat,1975_1982,1978.5,7,11932,12995,1268,1111,1063,-157,1220,0.0122661628592742,-0.00181165340442714,0.0140778162637013,EPCI
244200622,CC des Monts du Pilat,1982_1990,1986,8,12995,13084,1435,1256,89,-179,268,0.000853544259589834,-0.00171667890411888,0.00257022316370871,EPCI
244200622,CC des Monts du Pilat,1990_1999,1994.5,9,13084,14084,1555,1379,1000,-176,1176,0.00821682897218778,-0.00144616189910505,0.00966299087129283,EPCI
244200622,CC des Monts du Pilat,1999_2006,2002.5,7,14084,15105,1202,1207,1021,5,1016,0.0100482066574557,4.92076721716731e-05,0.00999899898528398,EPCI
244200630,CC du Pays entre Loire et Rhône,2006_2011,2008.5,5,12617,13489,750,836,872,86,786,0.0134556082517669,0.00132704393308711,0.0121285643186798,EPCI
244200630,CC du Pays entre Loire et Rhône,2011_2016,2013.5,5,13489,13825,846,824,336,-22,358,0.00493292881267893,-0.000322989386544454,0.00525591819922338,EPCI
244200630,CC du Pays entre Loire et Rhône,1968_1975,1971.5,7,12859,12095,1235,1264,-764,29,-793,-0.00871208665225642,0.00033069438863277,-0.00904278104088919,EPCI
244200630,CC du Pays entre Loire et Rhône,1975_1982,1978.5,7,12095,12064,1276,1053,-31,-223,192,-0.000366551774390045,-0.00263680792545097,0.00227025615106092,EPCI
244200630,CC du Pays entre Loire et Rhône,1982_1990,1986,8,12064,11943,1406,1155,-121,-251,130,-0.00125926628037421,-0.00261219699482583,0.00135293071445163,EPCI
244200630,CC du Pays entre Loire et Rhône,1990_1999,1994.5,9,11943,11765,1461,1189,-178,-272,94,-0.00166708780802483,-0.00254746002125142,0.000880372213226593,EPCI
244200630,CC du Pays entre Loire et Rhône,1999_2006,2002.5,7,11765,12617,1085,1030,852,-55,907,0.0100380593630749,-0.000647996789869858,0.0106860561529448,EPCI
244200770,Saint-Etienne Métropole,2006_2011,2008.5,5,404428,399131,18406,26480,-5297,8074,-13371,-0.00263333453982528,0.00401388391061909,-0.00664721845044438,EPCI
244200770,Saint-Etienne Métropole,2011_2016,2013.5,5,399131,404048,19373,26611,4917,7238,-2321,0.00245180055481464,0.00360913817688598,-0.00115733762207134,EPCI
244200770,Saint-Etienne Métropole,1968_1975,1971.5,7,434076,445790,32772,52711,11714,19939,-8225,0.0038112953185665,0.00648740117439794,-0.00267610585583144,EPCI
244200770,Saint-Etienne Métropole,1975_1982,1978.5,7,445790,432882,31086,45825,-12908,14739,-27647,-0.00418874770316735,0.00478292162976322,-0.00897166933293057,EPCI
244200770,Saint-Etienne Métropole,1982_1990,1986,8,432882,431823,32791,47001,-1059,14210,-15269,-0.000306127068428586,0.00410771071045345,-0.00441383777888203,EPCI
244200770,Saint-Etienne Métropole,1990_1999,1994.5,9,431823,408009,35265,46707,-23814,11442,-35256,-0.00628312797628539,0.00301887756381361,-0.009302005540099,EPCI
244200770,Saint-Etienne Métropole,1999_2006,2002.5,7,408009,404428,26504,35376,-3581,8872,-12453,-0.00125856589181728,0.0031181224775769,-0.00437668836939417,EPCI
244200820,CC du Pays d'Urfé,2006_2011,2008.5,5,5149,5168,309,266,19,-43,62,0.000736920475831404,-0.00166776739267107,0.00240468786850248,EPCI
244200820,CC du Pays d'Urfé,2011_2016,2013.5,5,5168,5224,375,250,56,-125,181,0.00215784991308987,-0.00481662927028989,0.00697447918337976,EPCI
244200820,CC du Pays d'Urfé,1968_1975,1971.5,7,7486,6607,581,646,-879,65,-944,-0.0176853058503738,0.00130778712204129,-0.018993092972415,EPCI
244200820,CC du Pays d'Urfé,1975_1982,1978.5,7,6607,6095,570,432,-512,-138,-374,-0.0114568546364153,-0.00308798035122132,-0.00836887428519401,EPCI
244200820,CC du Pays d'Urfé,1982_1990,1986,8,6095,5512,618,426,-583,-192,-391,-0.0124890104916525,-0.0041130188926197,-0.00837599159903282,EPCI
244200820,CC du Pays d'Urfé,1990_1999,1994.5,9,5512,5097,671,441,-415,-230,-185,-0.00865955511125749,-0.00479927150744391,-0.00386028360381358,EPCI
244200820,CC du Pays d'Urfé,1999_2006,2002.5,7,5097,5149,489,330,52,-159,211,0.00145110751137323,-0.00443704027516045,0.00588814778653368,EPCI
244200895,CC du Pilat Rhodanien,2006_2011,2008.5,5,15155,16108,623,970,953,347,606,0.012271794549809,0.00446832393366602,0.00780347061614296,EPCI
244200895,CC du Pilat Rhodanien,2011_2016,2013.5,5,16108,16771,660,954,663,294,369,0.00809965845002947,0.00359170374707189,0.00450795470295758,EPCI
244200895,CC du Pilat Rhodanien,1968_1975,1971.5,7,9750,9793,953,940,43,-13,56,0.000628849032541901,-0.000190117149373133,0.000818966181915033,EPCI
244200895,CC du Pilat Rhodanien,1975_1982,1978.5,7,9793,10489,892,782,696,-110,806,0.00985672409923199,-0.00155781559039586,0.0114145396896279,EPCI
244200895,CC du Pilat Rhodanien,1982_1990,1986,8,10489,11967,1009,1185,1478,176,1302,0.0166147362786895,0.00197848009813894,0.0146362561805505,EPCI
244200895,CC du Pilat Rhodanien,1990_1999,1994.5,9,11967,13216,1036,1404,1249,368,881,0.0110916563417669,0.00326799802543652,0.00782365831633037,EPCI
244200895,CC du Pilat Rhodanien,1999_2006,2002.5,7,13216,15155,879,1309,1939,430,1509,0.0197499707510107,0.00437982848011068,0.0153701422709,EPCI
244300307,CC du Pays de Montfaucon,2006_2011,2008.5,5,8181,8391,442,502,210,60,150,0.00508193150254188,0.00145198042929768,0.0036299510732442,EPCI
244300307,CC du Pays de Montfaucon,2011_2016,2013.5,5,8391,8280,434,388,-111,-46,-65,-0.00265980333641236,-0.00110226084211683,-0.00155754249429553,EPCI
244300307,CC du Pays de Montfaucon,1968_1975,1971.5,7,8697,8205,809,855,-492,46,-538,-0.00828469320986158,0.000774585137507384,-0.00905927834736897,EPCI
244300307,CC du Pays de Montfaucon,1975_1982,1978.5,7,8205,7957,759,722,-248,-37,-211,-0.00437492773495873,-0.000652710992715618,-0.00372221674224312,EPCI
244300307,CC du Pays de Montfaucon,1982_1990,1986,8,7957,8009,808,779,52,-29,81,0.000814564696041575,-0.000454276465100109,0.00126884116114168,EPCI
244300307,CC du Pays de Montfaucon,1990_1999,1994.5,9,8009,7877,845,824,-132,-21,-111,-0.00184482827745114,-0.000293495407776317,-0.00155133286967482,EPCI
244300307,CC du Pays de Montfaucon,1999_2006,2002.5,7,7877,8181,619,685,304,66,238,0.00542426862028789,0.00117763726624671,0.00424663135404117,EPCI
244301016,CC des Sucs,2006_2011,2008.5,5,16133,17101,887,974,968,87,881,0.0117221881391869,0.00105354376870791,0.010668644370479,EPCI
244301016,CC des Sucs,2011_2016,2013.5,5,17101,17731,1008,945,630,-63,693,0.00726175534034468,-0.000726175534034468,0.00798793087437915,EPCI
244301016,CC des Sucs,1968_1975,1971.5,7,13736,13876,1489,1438,140,-51,191,0.00144970774211051,-0.000528107820340256,0.00197781556245076,EPCI
244301016,CC des Sucs,1975_1982,1978.5,7,13876,13720,1425,1121,-156,-304,148,-0.00161385444978124,-0.00314494713290703,0.00153109268312579,EPCI
244301016,CC des Sucs,1982_1990,1986,8,13720,13568,1586,1186,-152,-400,248,-0.00139159873326933,-0.00366210192965613,0.0022705031963868,EPCI
244301016,CC des Sucs,1990_1999,1994.5,9,13568,14496,1650,1476,928,-174,1102,0.00737804801783137,-0.00138338400334338,0.00876143202117476,EPCI
244301016,CC des Sucs,1999_2006,2002.5,7,14496,16133,1345,1302,1637,-43,1680,0.0154022846040174,-0.000404580475242973,0.0158068650792604,EPCI
244301099,CC Auzon Communauté,2006_2011,2008.5,5,9041,9185,529,467,144,-62,206,0.0031653854679532,-0.00136287429870207,0.00452825976665527,EPCI
244301099,CC Auzon Communauté,2011_2016,2013.5,5,9185,9281,459,446,96,-13,109,0.00208167988257579,-0.000281894150765472,0.00236357403334127,EPCI
244301099,CC Auzon Communauté,1968_1975,1971.5,7,10201,10086,940,913,-115,-27,-88,-0.00161832210883173,-0.000379953886421362,-0.00123836822241037,EPCI
244301099,CC Auzon Communauté,1975_1982,1978.5,7,10086,9886,916,787,-200,-129,-71,-0.0028571546522802,-0.00184286475072073,-0.00101428990155947,EPCI
244301099,CC Auzon Communauté,1982_1990,1986,8,9886,9114,966,758,-772,-208,-564,-0.0101120165201637,-0.00272448113496638,-0.00738753538519731,EPCI
244301099,CC Auzon Communauté,1990_1999,1994.5,9,9114,8725,1115,624,-389,-491,102,-0.00483485480759016,-0.0061026059396575,0.00126775113206734,EPCI
244301099,CC Auzon Communauté,1999_2006,2002.5,7,8725,9041,812,638,316,-174,490,0.00509541191948704,-0.00280570149997071,0.00790111341945775,EPCI
244301107,CC du Haut-Lignon,2006_2011,2008.5,5,8279,8360,433,372,81,-61,142,0.00194914490614884,-0.00146787455895159,0.00341701946510043,EPCI
244301107,CC du Haut-Lignon,2011_2016,2013.5,5,8360,8149,509,294,-211,-215,4,-0.00509959404577876,-0.00519626881441911,9.66747686403559e-05,EPCI
244301107,CC du Haut-Lignon,1968_1975,1971.5,7,8899,8277,789,693,-622,-96,-526,-0.0102978003772914,-0.00158937111932472,-0.00870842925796672,EPCI
244301107,CC du Haut-Lignon,1975_1982,1978.5,7,8277,7783,798,600,-494,-198,-296,-0.00875271512837095,-0.00350817327007581,-0.00524454185829514,EPCI
244301107,CC du Haut-Lignon,1982_1990,1986,8,7783,7852,908,684,69,-224,293,0.00110390991512732,-0.00358370755055826,0.00468761746568558,EPCI
244301107,CC du Haut-Lignon,1990_1999,1994.5,9,7852,7734,807,711,-118,-96,-22,-0.00168103916031614,-0.00136762507957924,-0.000313414080736908,EPCI
244301107,CC du Haut-Lignon,1999_2006,2002.5,7,7734,8279,648,575,545,-73,618,0.00977547007373936,-0.00130937489061096,0.0110848449643503,EPCI
244301123,CC des Pays de Cayres et de Pradelles,2006_2011,2008.5,5,5337,5375,372,252,38,-120,158,0.00141998255423204,-0.00448415543441695,0.00590413798864899,EPCI
244301123,CC des Pays de Cayres et de Pradelles,2011_2016,2013.5,5,5375,5224,393,208,-151,-185,34,-0.00568282770587547,-0.00696240480521167,0.0012795770993362,EPCI
244301123,CC des Pays de Cayres et de Pradelles,1968_1975,1971.5,7,8115,7054,775,527,-1061,-248,-813,-0.0198180416200273,-0.00463230379054361,-0.0151857378294837,EPCI
244301123,CC des Pays de Cayres et de Pradelles,1975_1982,1978.5,7,7054,6223,753,406,-831,-347,-484,-0.0177467420708566,-0.00741049277808331,-0.0103362492927733,EPCI
244301123,CC des Pays de Cayres et de Pradelles,1982_1990,1986,8,6223,5509,769,382,-714,-387,-327,-0.0151181787033475,-0.00819430694425139,-0.00692387175909614,EPCI
244301123,CC des Pays de Cayres et de Pradelles,1990_1999,1994.5,9,5509,5220,771,384,-289,-387,98,-0.00596941367075432,-0.00799364391204817,0.00202423024129385,EPCI
244301123,CC des Pays de Cayres et de Pradelles,1999_2006,2002.5,7,5220,5337,582,362,117,-220,337,0.00317163265407827,-0.00596375370852325,0.00913538636260152,EPCI
244301131,CC Loire et Semène,2006_2011,2008.5,5,18562,19791,811,1265,1229,454,775,0.0129047181361737,0.00476708058081598,0.00813763755535768,EPCI
244301131,CC Loire et Semène,2011_2016,2013.5,5,19791,20514,812,1138,723,326,397,0.00720186780102705,0.00324731521872036,0.00395455258230669,EPCI
244301131,CC Loire et Semène,1968_1975,1971.5,7,12301,12470,1158,1180,169,22,147,0.00195121540604859,0.000254004372385024,0.00169721103366357,EPCI
244301131,CC Loire et Semène,1975_1982,1978.5,7,12470,13687,1172,1162,1217,-10,1227,0.0133918376922539,-0.000110039750963467,0.0135018774432174,EPCI
244301131,CC Loire et Semène,1982_1990,1986,8,13687,15863,1308,1554,2176,246,1930,0.0186139794196551,0.00210433774689116,0.016509641672764,EPCI
244301131,CC Loire et Semène,1990_1999,1994.5,9,15863,17221,1395,1733,1358,338,1020,0.00916846588948017,0.00228198930091627,0.0068864765885639,EPCI
244301131,CC Loire et Semène,1999_2006,2002.5,7,17221,18562,1132,1575,1341,443,898,0.0107699991975811,0.00355787445527849,0.00721212474230266,EPCI
244400404,Nantes Métropole,2006_2011,2008.5,5,579131,594017,19521,36666,14886,17145,-2259,0.00508875080247528,0.00586098565823181,-0.000772234855756527,EPCI
244400404,Nantes Métropole,2011_2016,2013.5,5,594017,638931,20854,39032,44914,18178,26736,0.0146844787257123,0.00594323494402633,0.00874124378168599,EPCI
244400404,Nantes Métropole,1968_1975,1971.5,7,411555,460825,26784,59736,49270,32952,16318,0.0162848463125571,0.0108913792508906,0.00539346706166647,EPCI
244400404,Nantes Métropole,1975_1982,1978.5,7,460825,475229,27261,54521,14404,27260,-12856,0.00440659945069277,0.00833962100985039,-0.00393302155915761,EPCI
244400404,Nantes Métropole,1982_1990,1986,8,475229,505076,30241,57145,29847,26904,2943,0.00764307530541553,0.00688944610905281,0.000753629196362713,EPCI
244400404,Nantes Métropole,1990_1999,1994.5,9,505076,554478,33739,65049,49402,31310,18092,0.0104226319932581,0.00660565579751652,0.00381697619574158,EPCI
244400404,Nantes Métropole,1999_2006,2002.5,7,554478,579131,26902,51284,24653,24382,271,0.00623386063644427,0.00616533444358837,6.85261928558955e-05,EPCI
244400438,CC de Grand Lieu,2006_2011,2008.5,5,33214,36201,1075,2667,2987,1592,1395,0.0173722257543492,0.0092589833950197,0.00811324235932945,EPCI
244400438,CC de Grand Lieu,2011_2016,2013.5,5,36201,38533,1140,2493,2332,1353,979,0.0125639260558854,0.00728944766449955,0.00527447839138586,EPCI
244400438,CC de Grand Lieu,1968_1975,1971.5,7,15506,17506,1362,2002,2000,640,1360,0.0174819998823155,0.00559423996234095,0.0118877599199745,EPCI
244400438,CC de Grand Lieu,1975_1982,1978.5,7,17506,21110,1268,2172,3604,904,2700,0.0271041234072575,0.00679859255276382,0.0203055308544937,EPCI
244400438,CC de Grand Lieu,1982_1990,1986,8,21110,24191,1585,2717,3081,1132,1949,0.0171750489974238,0.00631033932654456,0.0108647096708793,EPCI
244400438,CC de Grand Lieu,1990_1999,1994.5,9,24191,27720,1757,3130,3529,1373,2156,0.0152454339684405,0.0059314199032782,0.00931401406516227,EPCI
244400438,CC de Grand Lieu,1999_2006,2002.5,7,27720,33214,1370,3404,5494,2034,3460,0.0261675554088525,0.00968780627987004,0.0164797491289825,EPCI
244400453,CC de la Région de Blain,2006_2011,2008.5,5,13524,15431,663,1195,1907,532,1375,0.0267336170963532,0.00745793617999996,0.0192756809163533,EPCI
244400453,CC de la Région de Blain,2011_2016,2013.5,5,15431,16165,761,1058,734,297,437,0.00933731083170897,0.00377817618122284,0.00555913465048613,EPCI
244400453,CC de la Région de Blain,1968_1975,1971.5,7,10697,10768,910,1284,71,374,-303,0.000945510224430013,0.0049805749850257,-0.00403506476059569,EPCI
244400453,CC de la Région de Blain,1975_1982,1978.5,7,10768,11138,961,1078,370,117,253,0.00483793839609192,0.00152983457389934,0.00330810382219259,EPCI
244400453,CC de la Région de Blain,1982_1990,1986,8,11138,11483,1007,1256,345,249,96,0.00382040366160519,0.00275733481663679,0.0010630688449684,EPCI
244400453,CC de la Région de Blain,1990_1999,1994.5,9,11483,11741,1198,1177,258,-21,279,0.0024718621209352,-0.000201198079611004,0.0026730602005462,EPCI
244400453,CC de la Région de Blain,1999_2006,2002.5,7,11741,13524,1007,1308,1783,301,1482,0.0204023242113025,0.0034442510306237,0.0169580731806788,EPCI
244400503,CC d'Erdre et Gesvres,2006_2011,2008.5,5,50656,55541,1462,3627,4885,2165,2720,0.0185833207077379,0.0082360060045553,0.0103473147031826,EPCI
244400503,CC d'Erdre et Gesvres,2011_2016,2013.5,5,55541,61123,1685,3876,5582,2191,3391,0.0193379502044553,0.00759037063739905,0.0117475795670562,EPCI
244400503,CC d'Erdre et Gesvres,1968_1975,1971.5,7,21608,23984,2060,2451,2376,391,1985,0.0150149405349418,0.00247089299207165,0.0125440475428701,EPCI
244400503,CC d'Erdre et Gesvres,1975_1982,1978.5,7,23984,31987,2085,3173,8003,1088,6915,0.0419924121210142,0.0057088272382436,0.0362835848827706,EPCI
244400503,CC d'Erdre et Gesvres,1982_1990,1986,8,31987,37035,2306,3878,5048,1572,3476,0.0184855103783967,0.00575658128265445,0.0127289290957423,EPCI
244400503,CC d'Erdre et Gesvres,1990_1999,1994.5,9,37035,43201,2586,4576,6166,1990,4176,0.0172583709358736,0.00556992509931696,0.0116884458365566,EPCI
244400503,CC d'Erdre et Gesvres,1999_2006,2002.5,7,43201,50656,2067,4967,7455,2900,4555,0.0230025767622253,0.00894801778812251,0.0140545589741028,EPCI
244400537,CC de Nozay,2006_2011,2008.5,5,13230,14735,526,1333,1505,807,698,0.0217815563678716,0.0116795455075564,0.0101020108603152,EPCI
244400537,CC de Nozay,2011_2016,2013.5,5,14735,15756,507,1229,1021,722,299,0.0134892963552014,0.0095389539358035,0.00395034241939785,EPCI
244400537,CC de Nozay,1968_1975,1971.5,7,10953,10473,995,1258,-480,263,-743,-0.00638139110725411,0.00349647054418298,-0.00987786165143709,EPCI
244400537,CC de Nozay,1975_1982,1978.5,7,10473,10556,950,1056,83,106,-23,0.00112833635732357,0.00144100787802769,-0.000312671520704121,EPCI
244400537,CC de Nozay,1982_1990,1986,8,10556,10593,1004,1120,37,116,-79,0.000437469033339299,0.00137152453695564,-0.000934055503616342,EPCI
244400537,CC de Nozay,1990_1999,1994.5,9,10593,10922,1038,1182,329,144,185,0.00340419204710951,0.00148998071362848,0.00191421133348103,EPCI
244400537,CC de Nozay,1999_2006,2002.5,7,10922,13230,767,1335,2308,568,1740,0.0277653057818792,0.00683305618895467,0.0209322495929245,EPCI
244400552,CC du Pays d'Ancenis,2006_2011,2008.5,5,57883,63575,2375,4885,5692,2510,3182,0.0189363773198259,0.00835037018144114,0.0105860071383848,EPCI
244400552,CC du Pays d'Ancenis,2011_2016,2013.5,5,63575,66442,2509,4479,2867,1970,897,0.00886084195514569,0.00608854504765853,0.00277229690748716,EPCI
244400552,CC du Pays d'Ancenis,1968_1975,1971.5,7,41963,43719,3498,5476,1756,1978,-222,0.00587354093550441,0.00661609565514107,-0.000742554719636662,EPCI
244400552,CC du Pays d'Ancenis,1975_1982,1978.5,7,43719,47332,3466,5367,3613,1901,1712,0.011407981661681,0.0060023728588031,0.00540560880287791,EPCI
244400552,CC du Pays d'Ancenis,1982_1990,1986,8,47332,49813,3981,5696,2481,1715,766,0.0064066094161519,0.00442859135376885,0.00197801806238305,EPCI
244400552,CC du Pays d'Ancenis,1990_1999,1994.5,9,49813,51123,4150,5559,1310,1409,-99,0.00288844127013066,0.00310672805314053,-0.000218286783009874,EPCI
244400552,CC du Pays d'Ancenis,1999_2006,2002.5,7,51123,57883,3319,5555,6760,2236,4524,0.0178996317629452,0.00592064742928187,0.0119789843336633,EPCI
244400586,CC du Sud-Estuaire,2006_2011,2008.5,5,25754,27751,1477,1845,1997,368,1629,0.0150484893847467,0.00277308166929734,0.0122754077154493,EPCI
244400586,CC du Sud-Estuaire,2011_2016,2013.5,5,27751,29843,1602,1557,2092,-45,2137,0.0146418429959578,-0.000314953601729495,0.0149567965976873,EPCI
244400586,CC du Sud-Estuaire,1968_1975,1971.5,7,18825,19029,1629,2132,204,503,-299,0.00154095142364707,0.00379950277497293,-0.00225855135132586,EPCI
244400586,CC du Sud-Estuaire,1975_1982,1978.5,7,19029,19658,1533,1954,629,421,208,0.00465655805878962,0.00311671056081149,0.00153984749797812,EPCI
244400586,CC du Sud-Estuaire,1982_1990,1986,8,19658,20225,1888,2161,567,273,294,0.00356070966842448,0.00171441576627845,0.00184629390214603,EPCI
244400586,CC du Sud-Estuaire,1990_1999,1994.5,9,20225,21708,2195,2121,1483,-74,1557,0.007893366678978,-0.000393869948917311,0.00828723662789531,EPCI
244400586,CC du Sud-Estuaire,1999_2006,2002.5,7,21708,25754,1788,2169,4046,381,3665,0.0247160865820637,0.0023274416677623,0.0223886449143014,EPCI
244400610,CA de la Presqu'île de Guérande Atlantique (Cap Atlantique),2006_2011,2008.5,5,70248,72802,4076,3457,2554,-619,3173,0.00716788504461974,-0.00173724386946735,0.00890512891408709,EPCI
244400610,CA de la Presqu'île de Guérande Atlantique (Cap Atlantique),2011_2016,2013.5,5,72802,73599,4581,2914,797,-1667,2464,0.00217997496441846,-0.00455962141240349,0.00673959637682195,EPCI
244400610,CA de la Presqu'île de Guérande Atlantique (Cap Atlantique),1968_1975,1971.5,7,44385,48376,4189,5277,3991,1088,2903,0.0123762812830768,0.00337393987371274,0.00900234140936404,EPCI
244400610,CA de la Presqu'île de Guérande Atlantique (Cap Atlantique),1975_1982,1978.5,7,48376,52434,4254,4921,4058,667,3391,0.0115738088888369,0.00190234857783494,0.00967146031100192,EPCI
244400610,CA de la Presqu'île de Guérande Atlantique (Cap Atlantique),1982_1990,1986,8,52434,58461,5139,5744,6027,605,5422,0.0136934872679273,0.00137457438146607,0.0123189128864612,EPCI
244400610,CA de la Presqu'île de Guérande Atlantique (Cap Atlantique),1990_1999,1994.5,9,58461,64058,6278,6033,5597,-245,5842,0.0102105598157185,-0.000446951430203865,0.0106575112459224,EPCI
244400610,CA de la Presqu'île de Guérande Atlantique (Cap Atlantique),1999_2006,2002.5,7,64058,70248,5354,5008,6190,-346,6536,0.0132647659697831,-0.000741455416081575,0.0140062213858647,EPCI
244400644,CA de la Région Nazairienne et de l'Estuaire (CARENE),2006_2011,2008.5,5,116519,117400,5454,7116,881,1662,-781,0.00150764686998595,0.00284416469684068,-0.00133651782685474,EPCI
244400644,CA de la Région Nazairienne et de l'Estuaire (CARENE),2011_2016,2013.5,5,117400,123818,6028,7117,6418,1089,5329,0.0107020290014561,0.00181590987575346,0.00888611912570265,EPCI
244400644,CA de la Région Nazairienne et de l'Estuaire (CARENE),1968_1975,1971.5,7,99337,106515,7102,13424,7178,6322,856,0.0100166499038785,0.00882213160940652,0.001194518294472,EPCI
244400644,CA de la Région Nazairienne et de l'Estuaire (CARENE),1975_1982,1978.5,7,106515,110471,7221,12262,3956,5041,-1085,0.00522319683169625,0.00665574702441375,-0.0014325501927175,EPCI
244400644,CA de la Région Nazairienne et de l'Estuaire (CARENE),1982_1990,1986,8,110471,108399,8080,12161,-2072,4081,-6153,-0.00236397380299913,0.00465607002415032,-0.00702004382714945,EPCI
244400644,CA de la Région Nazairienne et de l'Estuaire (CARENE),1990_1999,1994.5,9,108399,110275,9150,12039,1876,2889,-1013,0.00190830540387155,0.0029387496331476,-0.00103044422927605,EPCI
244400644,CA de la Région Nazairienne et de l'Estuaire (CARENE),1999_2006,2002.5,7,110275,116519,7329,10050,6244,2721,3523,0.00789919298845621,0.00344229726482853,0.00445689572362768,EPCI
244500203,CA Montargoise et Rives du Loing (A.M.E.),2006_2011,2008.5,5,59945,60441,3181,3837,496,656,-160,0.00164940025515903,0.00218146485359742,-0.000532064598438396,EPCI
244500203,CA Montargoise et Rives du Loing (A.M.E.),2011_2016,2013.5,5,60441,61353,3181,4004,912,823,89,0.00299976774855515,0.00270702725554922,0.00029274049300593,EPCI
244500203,CA Montargoise et Rives du Loing (A.M.E.),1968_1975,1971.5,7,48401,53450,3703,6132,5049,2429,2620,0.0142761101845401,0.00686802765661476,0.00740808252792535,EPCI
244500203,CA Montargoise et Rives du Loing (A.M.E.),1975_1982,1978.5,7,53450,55957,3908,5510,2507,1602,905,0.00656961460506955,0.00419805448636674,0.00237156011870281,EPCI
244500203,CA Montargoise et Rives du Loing (A.M.E.),1982_1990,1986,8,55957,57101,4532,5960,1144,1428,-284,0.00253296392185653,0.00316177664371602,-0.00062881272185949,EPCI
244500203,CA Montargoise et Rives du Loing (A.M.E.),1990_1999,1994.5,9,57101,58412,5306,6599,1311,1293,18,0.00252537434771449,0.00249070101570926,3.46733320052335e-05,EPCI
244500203,CA Montargoise et Rives du Loing (A.M.E.),1999_2006,2002.5,7,58412,59945,4346,5093,1533,747,786,0.00370773197796792,0.00180670305775736,0.00190102892021056,EPCI
244500211,CC Giennoises,2006_2011,2008.5,5,25982,25632,1362,1660,-350,298,-648,-0.00270880847692312,0.00230635693178026,-0.00501516540870338,EPCI
244500211,CC Giennoises,2011_2016,2013.5,5,25632,24992,1425,1573,-640,148,-788,-0.0050443935437049,0.00116651600698176,-0.00621090955068665,EPCI
244500211,CC Giennoises,1968_1975,1971.5,7,19140,21686,1797,2211,2546,414,2132,0.0180010293623989,0.00292711160881113,0.0150739177535878,EPCI
244500211,CC Giennoises,1975_1982,1978.5,7,21686,24363,1822,2537,2677,715,1962,0.0167674063689562,0.00447840700552996,0.0122889993634263,EPCI
244500211,CC Giennoises,1982_1990,1986,8,24363,25989,1982,2916,1626,934,692,0.00810867158567619,0.00465774862301449,0.0034509229626617,EPCI
244500211,CC Giennoises,1990_1999,1994.5,9,25989,25094,2422,2911,-895,489,-1384,-0.00388627302313371,0.0021233379981144,-0.00600961102124811,EPCI
244500211,CC Giennoises,1999_2006,2002.5,7,25094,25982,1972,2173,888,201,687,0.00498024853552836,0.00112728598608243,0.00385296254944593,EPCI
244500419,CC des Quatre Vallées,2006_2011,2008.5,5,15874,16754,759,851,880,92,788,0.0108493287294991,0.00113424800353854,0.00971508072596053,EPCI
244500419,CC des Quatre Vallées,2011_2016,2013.5,5,16754,17349,843,857,595,14,581,0.00700398036275862,0.000164799537947262,0.00683918082481136,EPCI
244500419,CC des Quatre Vallées,1968_1975,1971.5,7,9286,9926,961,730,640,-231,871,0.00956685652032041,-0.00345303727530315,0.0130198937956236,EPCI
244500419,CC des Quatre Vallées,1975_1982,1978.5,7,9926,11257,992,681,1331,-311,1642,0.0181386251618116,-0.00423825125869528,0.0223768764205069,EPCI
244500419,CC des Quatre Vallées,1982_1990,1986,8,11257,13108,1167,944,1851,-223,2074,0.0192112783738949,-0.00231448680571505,0.02152576517961,EPCI
244500419,CC des Quatre Vallées,1990_1999,1994.5,9,13108,14514,1297,1254,1406,-43,1449,0.0113855464157642,-0.000348206611577425,0.0117337530273416,EPCI
244500419,CC des Quatre Vallées,1999_2006,2002.5,7,14514,15874,1175,1210,1360,35,1325,0.0128777633035122,0.000331413026193329,0.0125463502773189,EPCI
244500427,CC des Loges,2006_2011,2008.5,5,37970,40707,1417,2825,2737,1408,1329,0.0140180833795776,0.00721134870239137,0.00680673467718618,EPCI
244500427,CC des Loges,2011_2016,2013.5,5,40707,42030,1612,2561,1323,949,374,0.00641721891962921,0.00460312982216789,0.00181408909746132,EPCI
244500427,CC des Loges,1968_1975,1971.5,7,20476,22759,1956,2245,2283,289,1994,0.0152156256493892,0.00192611292714563,0.0132895127222435,EPCI
244500427,CC des Loges,1975_1982,1978.5,7,22759,28818,1961,2415,6059,454,5605,0.0342948927186468,0.00256971138707141,0.0317251813315754,EPCI
244500427,CC des Loges,1982_1990,1986,8,28818,31728,2387,3074,2910,687,2223,0.0120975125351501,0.00285601069128802,0.00924150184386211,EPCI
244500427,CC des Loges,1990_1999,1994.5,9,31728,34673,2640,3455,2945,815,2130,0.00991120657057687,0.00274282966214606,0.00716837690843081,EPCI
244500427,CC des Loges,1999_2006,2002.5,7,34673,37970,2127,3423,3297,1296,2001,0.0130610005408427,0.00513407846555418,0.00792692207528851,EPCI
244500468,Orléans Métropole,2006_2011,2008.5,5,272572,273878,8907,19184,1306,10277,-8971,0.000956447578781328,0.00752634897943009,-0.00656990140064877,EPCI
244500468,Orléans Métropole,2011_2016,2013.5,5,273878,282828,9680,19541,8950,9861,-911,0.00645196226535361,0.00710869272610636,-0.000656730460752752,EPCI
244500468,Orléans Métropole,1968_1975,1971.5,7,171160,210796,10741,26579,39636,15838,23798,0.0302031410199881,0.0120687593973805,0.0181343816226077,EPCI
244500468,Orléans Métropole,1975_1982,1978.5,7,210796,222870,11105,25353,12074,14248,-2174,0.00798856835590045,0.00942696057105099,-0.00143839221515054,EPCI
244500468,Orléans Métropole,1982_1990,1986,8,222870,245849,12670,30129,22979,17459,5520,0.0123416478298228,0.00937694544849109,0.00296470238133174,EPCI
244500468,Orléans Métropole,1990_1999,1994.5,9,245849,266446,14598,32793,20597,18195,2402,0.00897941635889699,0.00793224647522118,0.00104716988367581,EPCI
244500468,Orléans Métropole,1999_2006,2002.5,7,266446,272572,12382,25738,6126,13356,-7230,0.00325259294595215,0.00709135347472036,-0.00383876052876821,EPCI
244500484,CC de la Forêt,2006_2011,2008.5,5,15112,15812,555,982,700,427,273,0.00909713270565793,0.00554925095045134,0.00354788175520659,EPCI
244500484,CC de la Forêt,2011_2016,2013.5,5,15812,16521,548,933,709,385,324,0.00881122299695947,0.00478465564715006,0.0040265673498094,EPCI
244500484,CC de la Forêt,1968_1975,1971.5,7,7484,8825,703,838,1341,135,1206,0.0238252778050669,0.00239851789983895,0.021426759905228,EPCI
244500484,CC de la Forêt,1975_1982,1978.5,7,8825,10918,656,900,2093,244,1849,0.0308703621539566,0.00359883820619465,0.0272715239477619,EPCI
244500484,CC de la Forêt,1982_1990,1986,8,10918,12906,811,1319,1988,508,1480,0.0211300840300017,0.00539943797144913,0.0157306460585526,EPCI
244500484,CC de la Forêt,1990_1999,1994.5,9,12906,13853,977,1319,947,342,605,0.00789875364885861,0.00285255939589192,0.0050461942529667,EPCI
244500484,CC de la Forêt,1999_2006,2002.5,7,13853,15112,759,1398,1259,639,620,0.0125042922184173,0.00634649938647233,0.00615779283194498,EPCI
244500542,CC de la Plaine du Nord Loiret,2006_2011,2008.5,5,6550,6783,296,414,233,118,115,0.00701537975346467,0.00355285326570314,0.00346252648776153,EPCI
244500542,CC de la Plaine du Nord Loiret,2011_2016,2013.5,5,6783,6893,333,388,110,55,55,0.00322256572435764,0.00161128286217882,0.00161128286217882,EPCI
244500542,CC de la Plaine du Nord Loiret,1968_1975,1971.5,7,5818,5632,448,497,-186,49,-235,-0.00463094982000867,0.00121998140419583,-0.0058509312242045,EPCI
244500542,CC de la Plaine du Nord Loiret,1975_1982,1978.5,7,5632,5694,491,395,62,-96,158,0.00156527662575745,-0.00242365413020508,0.00398893075596253,EPCI
244500542,CC de la Plaine du Nord Loiret,1982_1990,1986,8,5694,5720,546,522,26,-24,50,0.000569639249832443,-0.000525820845999178,0.00109546009583162,EPCI
244500542,CC de la Plaine du Nord Loiret,1990_1999,1994.5,9,5720,6071,587,646,351,59,292,0.00663911192495759,0.00111597607855412,0.00552313584640346,EPCI
244500542,CC de la Plaine du Nord Loiret,1999_2006,2002.5,7,6071,6550,478,524,479,46,433,0.0109078780110403,0.0010475206440665,0.00986035736697381,EPCI
244600433,CC de la Vallée du Lot et du Vignoble,2006_2011,2008.5,5,14557,14677,990,568,120,-422,542,0.00164328171937389,-0.00577887404646485,0.00742215576583874,EPCI
244600433,CC de la Vallée du Lot et du Vignoble,2011_2016,2013.5,5,14677,14555,1021,530,-122,-491,369,-0.00166802039137093,-0.00671309846035349,0.00504507806898256,EPCI
244600433,CC de la Vallée du Lot et du Vignoble,1968_1975,1971.5,7,13530,13608,1371,1104,78,-267,345,0.000821539122962012,-0.00281219161321612,0.00363373073617813,EPCI
244600433,CC de la Vallée du Lot et du Vignoble,1975_1982,1978.5,7,13608,13782,1350,907,174,-443,617,0.00181672508353326,-0.00462534029888064,0.0064420653824139,EPCI
244600433,CC de la Vallée du Lot et du Vignoble,1982_1990,1986,8,13782,13900,1546,1045,118,-501,619,0.0010662489398594,-0.00452703999042001,0.00559328893027942,EPCI
244600433,CC de la Vallée du Lot et du Vignoble,1990_1999,1994.5,9,13900,13966,1862,1034,66,-828,894,0.000526467900848537,-0.0066047791197362,0.00713124702058473,EPCI
244600433,CC de la Vallée du Lot et du Vignoble,1999_2006,2002.5,7,13966,14557,1449,809,591,-640,1231,0.00593844494676743,-0.00643080332644865,0.0123692482732161,EPCI
244600482,CC Quercy - Bouriane,2006_2011,2008.5,5,10392,10465,691,406,73,-285,358,0.00140099578486974,-0.00546964107791611,0.00687063686278585,EPCI
244600482,CC Quercy - Bouriane,2011_2016,2013.5,5,10465,10370,749,346,-95,-403,308,-0.0018222044970968,-0.00772998328768433,0.00590777879058753,EPCI
244600482,CC Quercy - Bouriane,1968_1975,1971.5,7,9734,9241,960,715,-493,-245,-248,-0.00739747534758573,-0.00367623014230934,-0.00372124520527639,EPCI
244600482,CC Quercy - Bouriane,1975_1982,1978.5,7,9241,9488,989,569,247,-420,667,0.00377535696640519,-0.0064196353274906,0.0101949922938958,EPCI
244600482,CC Quercy - Bouriane,1982_1990,1986,8,9488,9524,1091,724,36,-367,403,0.000473497860894456,-0.00482704763745182,0.00530054549834627,EPCI
244600482,CC Quercy - Bouriane,1990_1999,1994.5,9,9524,10061,1155,784,537,-371,908,0.00611323609747916,-0.00422348341185245,0.0103367195093316,EPCI
244600482,CC Quercy - Bouriane,1999_2006,2002.5,7,10061,10392,949,608,331,-341,672,0.00463495347241194,-0.00477498227822499,0.00940993575063693,EPCI
244600532,CC du Pays de Lalbenque-Limogne,2006_2011,2008.5,5,7254,7975,433,366,721,-67,788,0.0191324453071537,-0.00177791100635132,0.0209103563135051,EPCI
244600532,CC du Pays de Lalbenque-Limogne,2011_2016,2013.5,5,7975,8301,411,333,326,-78,404,0.00804505710629622,-0.00192489096408314,0.00996994807037936,EPCI
244600532,CC du Pays de Lalbenque-Limogne,1968_1975,1971.5,7,5653,5462,590,361,-191,-229,38,-0.0048981582266292,-0.00587266091046119,0.000974502683831988,EPCI
244600532,CC du Pays de Lalbenque-Limogne,1975_1982,1978.5,7,5462,5693,603,336,231,-267,498,0.00593501811677011,-0.00685995600509792,0.012794974121868,EPCI
244600532,CC du Pays de Lalbenque-Limogne,1982_1990,1986,8,5693,5831,593,417,138,-176,314,0.00299838146430398,-0.00382402273708334,0.00682240420138731,EPCI
244600532,CC du Pays de Lalbenque-Limogne,1990_1999,1994.5,9,5831,6419,702,457,588,-245,833,0.0107320497156751,-0.00447168738153129,0.0152037370972064,EPCI
244600532,CC du Pays de Lalbenque-Limogne,1999_2006,2002.5,7,6419,7254,593,446,835,-147,982,0.0176235945368459,-0.00310259688253455,0.0207261914193805,EPCI
244600573,CC du Causse de Labastide-Murat,2006_2011,2008.5,5,3774,3850,217,142,76,-75,151,0.00399550108721369,-0.0039429287044872,0.00793842979170089,EPCI
244600573,CC du Causse de Labastide-Murat,2011_2016,2013.5,5,3850,3869,249,109,19,-140,159,0.000985070347140793,-0.00725841308419532,0.00824348343133611,EPCI
244600573,CC du Causse de Labastide-Murat,1968_1975,1971.5,7,3687,3582,479,233,-105,-246,141,-0.00411889621252193,-0.00964998541219423,0.0055310891996723,EPCI
244600573,CC du Causse de Labastide-Murat,1975_1982,1978.5,7,3582,3654,406,217,72,-189,261,0.00284706726514417,-0.00747355157100343,0.0103206188361476,EPCI
244600573,CC du Causse de Labastide-Murat,1982_1990,1986,8,3654,3374,434,250,-280,-184,-96,-0.00991594382354588,-0.00651619165547301,-0.00339975216807287,EPCI
244600573,CC du Causse de Labastide-Murat,1990_1999,1994.5,9,3374,3469,427,233,95,-194,289,0.00309002920190826,-0.00631016489652845,0.00940019409843671,EPCI
244600573,CC du Causse de Labastide-Murat,1999_2006,2002.5,7,3469,3774,344,196,305,-148,453,0.0121111935220553,-0.00587690702053829,0.0179881005425935,EPCI
244700449,CC du Pays de Duras,2006_2011,2008.5,5,5334,5565,277,203,231,-74,305,0.00851516127911212,-0.00272780058291903,0.0112429618620311,EPCI
244700449,CC du Pays de Duras,2011_2016,2013.5,5,5565,5712,335,232,147,-103,250,0.00522806695763545,-0.00366320337847926,0.00889127033611471,EPCI
244700449,CC du Pays de Duras,1968_1975,1971.5,7,6187,5566,545,518,-621,-27,-594,-0.014996930844246,-0.000652040471488958,-0.0143448903727571,EPCI
244700449,CC du Pays de Duras,1975_1982,1978.5,7,5566,5308,473,362,-258,-111,-147,-0.00675728711105994,-0.00290720491987463,-0.00385008219118531,EPCI
244700449,CC du Pays de Duras,1982_1990,1986,8,5308,5102,529,404,-206,-125,-81,-0.0049355918343581,-0.00299489795774157,-0.00194069387661653,EPCI
244700449,CC du Pays de Duras,1990_1999,1994.5,9,5102,5107,527,379,5,-148,153,0.000108842361332018,-0.00322173389542773,0.00333057625675974,EPCI
244700449,CC du Pays de Duras,1999_2006,2002.5,7,5107,5334,383,308,227,-75,302,0.00623209319881313,-0.00205906162956381,0.00829115482837694,EPCI
244700464,CC du Pays de Lauzun,2006_2011,2008.5,5,10412,10734,646,437,322,-209,531,0.00611004797952264,-0.00396583859540444,0.0100758865749271,EPCI
244700464,CC du Pays de Lauzun,2011_2016,2013.5,5,10734,10515,688,411,-219,-277,58,-0.00411420628813652,-0.0052038134329398,0.00108960714480328,EPCI
244700464,CC du Pays de Lauzun,1968_1975,1971.5,7,11097,11496,921,1108,399,187,212,0.00505908951766454,0.00237105197945681,0.00268803753820772,EPCI
244700464,CC du Pays de Lauzun,1975_1982,1978.5,7,11496,11143,931,826,-353,-105,-248,-0.00444546819732539,-0.00132230640430359,-0.0031231617930218,EPCI
244700464,CC du Pays de Lauzun,1982_1990,1986,8,11143,10688,1044,804,-455,-240,-215,-0.00519768022908529,-0.0027416335274296,-0.00245604670165569,EPCI
244700464,CC du Pays de Lauzun,1990_1999,1994.5,9,10688,10258,1206,745,-430,-461,31,-0.00455224341219285,-0.00488042840237419,0.000328184990181345,EPCI
244700464,CC du Pays de Lauzun,1999_2006,2002.5,7,10258,10412,889,536,154,-353,507,0.00213099566000019,-0.00488468485701342,0.00701568051701361,EPCI
244701355,CC des Coteaux et Landes de Gascogne,2006_2011,2008.5,5,11775,12431,724,508,656,-216,872,0.0109019403269053,-0.00358966327837125,0.0144916036052765,EPCI
244701355,CC des Coteaux et Landes de Gascogne,2011_2016,2013.5,5,12431,12492,836,501,61,-335,396,0.000979496716141615,-0.00537920327717116,0.00635869999331278,EPCI
244701355,CC des Coteaux et Landes de Gascogne,1968_1975,1971.5,7,12763,11839,1225,999,-924,-226,-698,-0.0106784608673031,-0.00261183133767369,-0.00806662952962937,EPCI
244701355,CC des Coteaux et Landes de Gascogne,1975_1982,1978.5,7,11839,11545,1142,802,-294,-340,46,-0.00358594417917346,-0.00414701027523462,0.000561066096061154,EPCI
244701355,CC des Coteaux et Landes de Gascogne,1982_1990,1986,8,11545,11702,1277,830,157,-447,604,0.00168984174606313,-0.00481120548082941,0.00650104722689253,EPCI
244701355,CC des Coteaux et Landes de Gascogne,1990_1999,1994.5,9,11702,11405,1352,906,-297,-446,149,-0.00285235889774338,-0.00428334029762137,0.00143098139987799,EPCI
244701355,CC des Coteaux et Landes de Gascogne,1999_2006,2002.5,7,11405,11775,1058,698,370,-360,730,0.00457138621772102,-0.00444783523886369,0.00901922145658471,EPCI
244701405,CC Lot et Tolzac,2006_2011,2008.5,5,7153,7266,488,343,113,-145,258,0.00313973561153369,-0.00402886428028659,0.00716859989182028,EPCI
244701405,CC Lot et Tolzac,2011_2016,2013.5,5,7266,7299,543,330,33,-213,246,0.000906694533291175,-0.00585230107851576,0.00675899561180694,EPCI
244701405,CC Lot et Tolzac,1968_1975,1971.5,7,7801,7111,759,611,-690,-148,-542,-0.0131427342521555,-0.00281902125988263,-0.0103237129922729,EPCI
244701405,CC Lot et Tolzac,1975_1982,1978.5,7,7111,6992,816,514,-119,-302,183,-0.00240798792707853,-0.00611102818468668,0.00370304025760815,EPCI
244701405,CC Lot et Tolzac,1982_1990,1986,8,6992,7259,846,673,267,-173,440,0.004695419088381,-0.00304235019584237,0.00773776928422338,EPCI
244701405,CC Lot et Tolzac,1990_1999,1994.5,9,7259,6901,869,565,-358,-304,-54,-0.00560376772955029,-0.00475850667537231,-0.000845261054177977,EPCI
244701405,CC Lot et Tolzac,1999_2006,2002.5,7,6901,7153,682,523,252,-159,411,0.00513679410321433,-0.00324107246988523,0.00837786657309956,EPCI
244800405,CC Coeur de Lozère,2006_2011,2008.5,5,15298,15288,660,908,-10,248,-258,-0.000130770241167033,0.00324310198094242,-0.00337387222210945,EPCI
244800405,CC Coeur de Lozère,2011_2016,2013.5,5,15288,15124,658,820,-164,162,-326,-0.0021547393907897,0.00212846208114592,-0.00428320147193561,EPCI
244800405,CC Coeur de Lozère,1968_1975,1971.5,7,11529,12480,788,1613,951,825,126,0.0113874580017292,0.00987870962295124,0.00150874837877801,EPCI
244800405,CC Coeur de Lozère,1975_1982,1978.5,7,12480,13277,799,1532,797,733,64,0.00888291412729703,0.00816960609198083,0.000713308035316197,EPCI
244800405,CC Coeur de Lozère,1982_1990,1986,8,13277,13922,883,1555,645,672,-27,0.0059472535851941,0.00619620838643478,-0.000248954801240683,EPCI
244800405,CC Coeur de Lozère,1990_1999,1994.5,9,13922,14562,1024,1526,640,502,138,0.00500638731194458,0.00392688504780653,0.00107950226413805,EPCI
244800405,CC Coeur de Lozère,1999_2006,2002.5,7,14562,15298,805,1259,736,454,282,0.00706868100397906,0.00436030051060665,0.00270838049337241,EPCI
244800470,CC du Gévaudan,2006_2011,2008.5,5,9812,9900,539,482,88,-57,145,0.00178732150728278,-0.00115769688539907,0.00294501839268185,EPCI
244800470,CC du Gévaudan,2011_2016,2013.5,5,9900,9834,621,472,-66,-149,83,-0.00133690317781954,-0.00301816020447138,0.00168125702665184,EPCI
244800470,CC du Gévaudan,1968_1975,1971.5,7,7880,8763,776,1026,883,250,633,0.0152886085325989,0.00432859811228736,0.0109600104203116,EPCI
244800470,CC du Gévaudan,1975_1982,1978.5,7,8763,9626,825,981,863,156,707,0.0135089261419772,0.00244193798163203,0.0110669881603452,EPCI
244800470,CC du Gévaudan,1982_1990,1986,8,9626,9767,850,833,141,-17,158,0.00181935121283128,-0.000219354401547033,0.00203870561437831,EPCI
244800470,CC du Gévaudan,1990_1999,1994.5,9,9767,9757,997,839,-10,-158,148,-0.000113813560470466,-0.00179825425543336,0.0016844406949629,EPCI
244800470,CC du Gévaudan,1999_2006,2002.5,7,9757,9812,848,674,55,-174,229,0.000803343975263937,-0.00254148821265318,0.00334483218791712,EPCI
244900015,CU Angers Loire Métropole,2006_2011,2008.5,5,282777,283523,9847,16644,746,6797,-6051,0.000527068346009463,0.00480225676652322,-0.00427518842051375,EPCI
244900015,CU Angers Loire Métropole,2011_2016,2013.5,5,283523,293701,10221,17169,10178,6948,3230,0.00707873551928606,0.0048322906649636,0.00224644485432246,EPCI
244900015,CU Angers Loire Métropole,1968_1975,1971.5,7,191586,219017,12699,30092,27431,17393,10038,0.019299961857123,0.0122374042718436,0.00706255758527946,EPCI
244900015,CU Angers Loire Métropole,1975_1982,1978.5,7,219017,237526,13059,29248,18509,16189,2320,0.0116570974854151,0.0101959452802088,0.00146115220520628,EPCI
244900015,CU Angers Loire Métropole,1982_1990,1986,8,237526,256811,14539,31051,19285,16512,2773,0.0098056780053446,0.00839571455661136,0.00140996344873324,EPCI
244900015,CU Angers Loire Métropole,1990_1999,1994.5,9,256811,276888,16669,32162,20077,15493,4584,0.00839870471316795,0.00648110435429153,0.00191760035887642,EPCI
244900015,CU Angers Loire Métropole,1999_2006,2002.5,7,276888,282777,13913,25188,5889,11275,-5386,0.00301102532342235,0.00576486848727915,-0.00275384316385681,EPCI
244900809,CC Anjou Bleu Communauté,2006_2011,2008.5,5,32902,34357,1692,2296,1455,604,851,0.00869202542830827,0.00360823598535958,0.00508378944294869,EPCI
244900809,CC Anjou Bleu Communauté,2011_2016,2013.5,5,34357,34679,1795,2120,322,325,-3,0.00186744830489127,0.00188484689158281,-1.73985866915335e-05,EPCI
244900809,CC Anjou Bleu Communauté,1968_1975,1971.5,7,34472,33691,2552,4265,-781,1713,-2494,-0.0032684556368362,0.00716884059654342,-0.0104372962333796,EPCI
244900809,CC Anjou Bleu Communauté,1975_1982,1978.5,7,33691,33295,2556,3663,-396,1107,-1503,-0.00168764629412466,0.00471773850403029,-0.00640538479815495,EPCI
244900809,CC Anjou Bleu Communauté,1982_1990,1986,8,33295,31947,2724,3577,-1348,853,-2201,-0.00515279803733104,0.00326063555329627,-0.00841343359062732,EPCI
244900809,CC Anjou Bleu Communauté,1990_1999,1994.5,9,31947,31337,2951,3437,-610,486,-1096,-0.0021397931126691,0.00170481877501177,-0.00384461188768087,EPCI
244900809,CC Anjou Bleu Communauté,1999_2006,2002.5,7,31337,32902,2459,2839,1565,380,1185,0.00698628216547759,0.00169634966318306,0.00528993250229453,EPCI
244900882,CC Baugeois Vallée,2006_2011,2008.5,5,32400,34898,1733,2379,2498,646,1852,0.0149650918492261,0.00387007579447561,0.0110950160547505,EPCI
244900882,CC Baugeois Vallée,2011_2016,2013.5,5,34898,35372,1709,2159,474,450,24,0.00270184857917077,0.00256504611946592,0.000136802459704849,EPCI
244900882,CC Baugeois Vallée,1968_1975,1971.5,7,28234,27414,2514,3075,-820,561,-1381,-0.00420159046693713,0.0028745027462826,-0.00707609321321973,EPCI
244900882,CC Baugeois Vallée,1975_1982,1978.5,7,27414,28646,2405,2628,1232,223,1009,0.00629975846623987,0.00114029718991192,0.00515946127632795,EPCI
244900882,CC Baugeois Vallée,1982_1990,1986,8,28646,29462,2654,3064,816,410,406,0.0035171055560419,0.00176717313477595,0.00174993242126595,EPCI
244900882,CC Baugeois Vallée,1990_1999,1994.5,9,29462,30397,2945,3179,935,234,701,0.00347743473329731,0.000870288478707563,0.00260714625458975,EPCI
244900882,CC Baugeois Vallée,1999_2006,2002.5,7,30397,32400,2447,2866,2003,419,1584,0.00915803818831407,0.00191573539735576,0.0072423027909583,EPCI
245100615,CC de la Grande Vallée de la Marne,2006_2011,2008.5,5,15244,15159,811,769,-85,-42,-43,-0.00111768852711835,-0.000552269625164363,-0.000565418901953991,EPCI
245100615,CC de la Grande Vallée de la Marne,2011_2016,2013.5,5,15159,15097,804,705,-62,-99,37,-0.000819337438080825,-0.00130829687693551,0.000488959438854686,EPCI
245100615,CC de la Grande Vallée de la Marne,1968_1975,1971.5,7,14002,14232,1262,1608,230,346,-116,0.00233024993744446,0.00350550642763384,-0.00117525649018938,EPCI
245100615,CC de la Grande Vallée de la Marne,1975_1982,1978.5,7,14232,14684,1189,1275,452,86,366,0.00447649186989896,0.000851721904449802,0.00362476996544916,EPCI
245100615,CC de la Grande Vallée de la Marne,1982_1990,1986,8,14684,15091,1285,1431,407,146,261,0.00342335559304563,0.00122803419308271,0.00219532139996292,EPCI
245100615,CC de la Grande Vallée de la Marne,1990_1999,1994.5,9,15091,15485,1630,1537,394,-93,487,0.00286780138503051,-0.000676917585806694,0.0035447189708372,EPCI
245100615,CC de la Grande Vallée de la Marne,1999_2006,2002.5,7,15485,15244,1220,1234,-241,14,-255,-0.00223832412442015,0.000130027127559677,-0.00236835125197983,EPCI
245100888,CC de la Brie Champenoise,2006_2011,2008.5,5,7118,7491,463,451,373,-12,385,0.0102674548452824,-0.000330320263119003,0.0105977751084014,EPCI
245100888,CC de la Brie Champenoise,2011_2016,2013.5,5,7491,7441,478,431,-50,-47,-3,-0.00133851370048899,-0.00125820287845965,-8.03108220293392e-05,EPCI
245100888,CC de la Brie Champenoise,1968_1975,1971.5,7,6214,6162,564,633,-52,69,-121,-0.00119976696006341,0.00159199846623798,-0.00279176542630139,EPCI
245100888,CC de la Brie Champenoise,1975_1982,1978.5,7,6162,6281,605,555,119,-50,169,0.00273628012765315,-0.00114969753262737,0.00388597766028052,EPCI
245100888,CC de la Brie Champenoise,1982_1990,1986,8,6281,6472,702,609,191,-93,284,0.00375151642314187,-0.00182665459346698,0.00557817101660885,EPCI
245100888,CC de la Brie Champenoise,1990_1999,1994.5,9,6472,6707,809,766,235,-43,278,0.00397081592186854,-0.000726574828256797,0.00469739075012534,EPCI
245100888,CC de la Brie Champenoise,1999_2006,2002.5,7,6707,7118,598,609,411,11,400,0.00853262998139126,0.000228367225779328,0.00830426275561193,EPCI
245100979,CC du Sud Marnais,2006_2011,2008.5,5,6078,6178,271,335,100,64,36,0.00326911192947299,0.00209223163486271,0.00117688029461028,EPCI
245100979,CC du Sud Marnais,2011_2016,2013.5,5,6178,6069,288,313,-109,25,-134,-0.00355381971012969,0.000815096263791214,-0.0043689159739209,EPCI
245100979,CC du Sud Marnais,1968_1975,1971.5,7,5543,5787,463,588,244,125,119,0.00617299663205984,0.00316239581560442,0.00301060081645541,EPCI
245100979,CC du Sud Marnais,1975_1982,1978.5,7,5787,6103,425,574,316,149,167,0.00762412115263067,0.0035949178852594,0.00402920326737127,EPCI
245100979,CC du Sud Marnais,1982_1990,1986,8,6103,5977,469,593,-126,124,-250,-0.00260431334164168,0.0025629750346315,-0.00516728837627318,EPCI
245100979,CC du Sud Marnais,1990_1999,1994.5,9,5977,5866,518,576,-111,58,-169,-0.00208069892606244,0.00108721205145605,-0.00316791097751849,EPCI
245100979,CC du Sud Marnais,1999_2006,2002.5,7,5866,6078,424,526,212,102,110,0.0050847011446491,0.00244641281487834,0.00263828832977076,EPCI
245200597,CC des Trois Forêts,2006_2011,2008.5,5,8139,8056,549,441,-83,-108,25,-0.00204793350247601,-0.00266478094298083,0.000616847440504821,EPCI
245200597,CC des Trois Forêts,2011_2016,2013.5,5,8056,7707,591,435,-349,-156,-193,-0.00881851649062171,-0.00394180106744122,-0.00487671542318049,EPCI
245200597,CC des Trois Forêts,1968_1975,1971.5,7,8773,8220,813,837,-553,24,-577,-0.00925810793886816,0.000401798536225743,-0.00965990647509391,EPCI
245200597,CC des Trois Forêts,1975_1982,1978.5,7,8220,8250,812,727,30,-85,115,0.000520562771296307,-0.0014749278520062,0.00199549062330251,EPCI
245200597,CC des Trois Forêts,1982_1990,1986,8,8250,8275,915,814,25,-101,126,0.000378286646921522,-0.00152827805356295,0.00190656470048447,EPCI
245200597,CC des Trois Forêts,1990_1999,1994.5,9,8275,8186,1056,728,-89,-328,239,-0.00120078328131956,-0.00442535860980692,0.00322457532848736,EPCI
245200597,CC des Trois Forêts,1999_2006,2002.5,7,8186,8139,782,644,-47,-138,91,-0.000822241163649151,-0.00241424001241666,0.00159199884876751,EPCI
245300223,CC du Pays de Meslay-Grez,2006_2011,2008.5,5,13160,13791,541,986,631,445,186,0.00941086220677767,0.0066368204152394,0.00277404179153827,EPCI
245300223,CC du Pays de Meslay-Grez,2011_2016,2013.5,5,13791,14033,523,887,242,364,-122,0.00348515774377089,0.00524213809393639,-0.00175698035016549,EPCI
245300223,CC du Pays de Meslay-Grez,1968_1975,1971.5,7,12225,11194,918,1112,-1031,194,-1225,-0.0125075669639652,0.00235350920563457,-0.0148610761695997,EPCI
245300223,CC du Pays de Meslay-Grez,1975_1982,1978.5,7,11194,11057,823,945,-137,122,-259,-0.00175762626392517,0.00156518543210855,-0.00332281169603372,EPCI
245300223,CC du Pays de Meslay-Grez,1982_1990,1986,8,11057,11233,918,1094,176,176,0,0.00197597004831995,0.00197597004831995,0,EPCI
245300223,CC du Pays de Meslay-Grez,1990_1999,1994.5,9,11233,12087,1013,1386,854,373,481,0.00817485762254333,0.00357051743935441,0.00460434018318893,EPCI
245300223,CC du Pays de Meslay-Grez,1999_2006,2002.5,7,12087,13160,695,1401,1073,706,367,0.0122243180262109,0.00804321391100179,0.00418110411520914,EPCI
245300355,CC de l'Ernée,2006_2011,2008.5,5,20343,20700,1076,1400,357,324,33,0.00348542559902421,0.00316324340079508,0.000322182198229128,EPCI
245300355,CC de l'Ernée,2011_2016,2013.5,5,20700,21025,1081,1227,325,146,179,0.00312055995918681,0.00140185155089623,0.00171870840829058,EPCI
245300355,CC de l'Ernée,1968_1975,1971.5,7,19647,19361,1551,2085,-286,534,-820,-0.00209265326977226,0.00390726169950485,-0.00599991496927711,EPCI
245300355,CC de l'Ernée,1975_1982,1978.5,7,19361,19655,1532,1974,294,442,-148,0.00215532301468979,0.0032403155526969,-0.00108499253800711,EPCI
245300355,CC de l'Ernée,1982_1990,1986,8,19655,19662,1697,2093,7,396,-389,4.45109994486881e-05,0.00251805082595435,-0.00247353982650567,EPCI
245300355,CC de l'Ernée,1990_1999,1994.5,9,19662,19271,1846,2023,-391,177,-568,-0.00222934062397728,0.0010091900011355,-0.00323853062511278,EPCI
245300355,CC de l'Ernée,1999_2006,2002.5,7,19271,20343,1423,1867,1072,444,628,0.00776362430315869,0.00321553096138289,0.0045480933417758,EPCI
245300389,CC du Bocage Mayennais,2006_2011,2008.5,5,19759,19638,1262,980,-121,-282,161,-0.001227769474486,-0.00286141315541364,0.00163364368092765,EPCI
245300389,CC du Bocage Mayennais,2011_2016,2013.5,5,19638,19199,1354,900,-439,-454,15,-0.00451144679320648,-0.00466559645584451,0.000154149662638035,EPCI
245300389,CC du Bocage Mayennais,1968_1975,1971.5,7,23682,22431,1969,2232,-1251,263,-1514,-0.00772307053517896,0.00162363513249566,-0.00934670566767461,EPCI
245300389,CC du Bocage Mayennais,1975_1982,1978.5,7,22431,21878,1955,2002,-553,47,-600,-0.00355970132859984,0.000302542427566352,-0.00386224375616619,EPCI
245300389,CC du Bocage Mayennais,1982_1990,1986,8,21878,21118,2040,2054,-760,14,-774,-0.00440972452574495,8.12317675795123e-05,-0.00449095629332446,EPCI
245300389,CC du Bocage Mayennais,1990_1999,1994.5,9,21118,20243,2214,1888,-875,-326,-549,-0.00469081942478766,-0.00174766529426375,-0.00294315413052392,EPCI
245300389,CC du Bocage Mayennais,1999_2006,2002.5,7,20243,19759,1784,1453,-484,-331,-153,-0.00345116969475479,-0.00236020076232197,-0.00109096893243281,EPCI
245300447,CC du Pays de Château-Gontier,2006_2011,2008.5,5,28255,29808,1213,1972,1553,759,794,0.0107587396056559,0.00525813481049118,0.00550060479516469,EPCI
245300447,CC du Pays de Château-Gontier,2011_2016,2013.5,5,29808,30274,1336,1767,466,431,35,0.00310730659590197,0.00287392519921405,0.000233381396687916,EPCI
245300447,CC du Pays de Château-Gontier,1968_1975,1971.5,7,21967,22785,1653,3014,818,1361,-543,0.00523667764172808,0.00871285852126152,-0.00347618087953343,EPCI
245300447,CC du Pays de Château-Gontier,1975_1982,1978.5,7,22785,23813,1747,2783,1028,1036,-8,0.00632408818137797,0.00637330287539648,-4.92146940185055e-05,EPCI
245300447,CC du Pays de Château-Gontier,1982_1990,1986,8,23813,25195,1902,2861,1382,959,423,0.00707666106972904,0.00491064975822732,0.00216601131150173,EPCI
245300447,CC du Pays de Château-Gontier,1990_1999,1994.5,9,25195,26528,2013,3183,1333,1170,163,0.00574479583725029,0.00504231892691886,0.000702476910331431,EPCI
245300447,CC du Pays de Château-Gontier,1999_2006,2002.5,7,26528,28255,1586,2644,1727,1058,669,0.00905066237318786,0.00554464434906355,0.00350601802412431,EPCI
245400171,CC Moselle et Madon,2006_2011,2008.5,5,28789,29122,1110,1580,333,470,-137,0.0023027537843836,0.00325013296894983,-0.000947379184566228,EPCI
245400171,CC Moselle et Madon,2011_2016,2013.5,5,29122,28837,1129,1420,-285,291,-576,-0.00196499036843745,0.00200635858672034,-0.00397134895515779,EPCI
245400171,CC Moselle et Madon,1968_1975,1971.5,7,22104,23554,1548,2442,1450,894,556,0.00911804263573801,0.00562174490782744,0.00349629772791057,EPCI
245400171,CC Moselle et Madon,1975_1982,1978.5,7,23554,26027,1500,2337,2473,837,1636,0.0143648835879127,0.00486187123456648,0.00950301235334618,EPCI
245400171,CC Moselle et Madon,1982_1990,1986,8,26027,27058,1593,2664,1031,1071,-40,0.00486784080882718,0.00505669981207945,-0.000188859003252267,EPCI
245400171,CC Moselle et Madon,1990_1999,1994.5,9,27058,27973,1959,2792,915,833,82,0.00370206344411494,0.00337029382398661,0.000331769620128334,EPCI
245400171,CC Moselle et Madon,1999_2006,2002.5,7,27973,28789,1462,2225,816,763,53,0.00411610663578021,0.00384876147438763,0.000267345161392587,EPCI
245400189,CC des Pays du Sel et du Vermois,2006_2011,2008.5,5,29288,29738,1446,1755,450,309,141,0.00305421733806655,0.00209722923880569,0.000956988099260851,EPCI
245400189,CC des Pays du Sel et du Vermois,2011_2016,2013.5,5,29738,29320,1505,1633,-418,128,-546,-0.00282715849041582,0.000865732743476613,-0.00369289123389243,EPCI
245400189,CC des Pays du Sel et du Vermois,1968_1975,1971.5,7,27062,28077,2187,2885,1015,698,317,0.00527388767122106,0.00362677201429783,0.00164711565692323,EPCI
245400189,CC des Pays du Sel et du Vermois,1975_1982,1978.5,7,28077,28537,2262,2529,460,267,193,0.00232423328843212,0.00134906584350299,0.000975167444929129,EPCI
245400189,CC des Pays du Sel et du Vermois,1982_1990,1986,8,28537,28535,2485,3023,-2,538,-540,-8.76082509804199e-06,0.0023566619513733,-0.00236542277647134,EPCI
245400189,CC des Pays du Sel et du Vermois,1990_1999,1994.5,9,28535,28392,2775,2841,-143,66,-209,-0.000558065184164236,0.00025756854653734,-0.000815633730701576,EPCI
245400189,CC des Pays du Sel et du Vermois,1999_2006,2002.5,7,28392,29288,2086,2326,896,240,656,0.0044485025515002,0.00119156318343755,0.00325693936806265,EPCI
245400262,CA de Longwy,2006_2011,2008.5,5,57292,59244,2563,3343,1952,780,1172,0.0067232021616459,0.00268652545393638,0.00403667670770953,EPCI
245400262,CA de Longwy,2011_2016,2013.5,5,59244,61223,2621,3124,1979,503,1476,0.00659332627316012,0.00167581764295075,0.00491750863020936,EPCI
245400262,CA de Longwy,1968_1975,1971.5,7,71897,71938,3641,8804,41,5163,-5122,8.14458446487532e-05,0.0102562169736954,-0.0101747711290467,EPCI
245400262,CA de Longwy,1975_1982,1978.5,7,71938,64514,3683,7370,-7424,3687,-11111,-0.0154399037377324,0.00766795865854248,-0.0231078623962749,EPCI
245400262,CA de Longwy,1982_1990,1986,8,64514,57148,4199,6079,-7366,1880,-9246,-0.0150404775006241,0.00383873169986062,-0.0188792092004847,EPCI
245400262,CA de Longwy,1990_1999,1994.5,9,57148,56212,4480,5501,-936,1021,-1957,-0.00183322167761035,0.00199970014192326,-0.00383292181953361,EPCI
245400262,CA de Longwy,1999_2006,2002.5,7,56212,57292,3438,4671,1080,1233,-153,0.00272237619416971,0.00310804615501042,-0.000385669960840708,EPCI
245400510,CC du Pays de Colombey et du Sud Toulois,2006_2011,2008.5,5,10763,11125,399,770,362,371,-9,0.00663803509343919,0.00680306911509928,-0.000165034021660091,EPCI
245400510,CC du Pays de Colombey et du Sud Toulois,2011_2016,2013.5,5,11125,11449,408,735,324,327,-3,0.00575802645018952,0.0058113415099135,-5.33150597239775e-05,EPCI
245400510,CC du Pays de Colombey et du Sud Toulois,1968_1975,1971.5,7,9161,8379,782,826,-782,44,-826,-0.01266578619688,0.000712652931793758,-0.0133784391286737,EPCI
245400510,CC du Pays de Colombey et du Sud Toulois,1975_1982,1978.5,7,8379,8748,705,758,369,53,316,0.00617563784385955,0.000887015733670884,0.00528862211018867,EPCI
245400510,CC du Pays de Colombey et du Sud Toulois,1982_1990,1986,8,8748,9112,712,941,364,229,135,0.00510889654908664,0.00321411348829901,0.00189478306078763,EPCI
245400510,CC du Pays de Colombey et du Sud Toulois,1990_1999,1994.5,9,9112,9696,763,929,584,166,418,0.00692623206997545,0.00196875774591768,0.00495747432405777,EPCI
245400510,CC du Pays de Colombey et du Sud Toulois,1999_2006,2002.5,7,9696,10763,577,1029,1067,452,615,0.0150261887151981,0.00636535829359845,0.00866083042159967,EPCI
245400601,CC du Bassin de Pompey,2006_2011,2008.5,5,40494,40723,1973,2149,229,176,53,0.00112848193901671,0.000867304896362189,0.000261177042654523,EPCI
245400601,CC du Bassin de Pompey,2011_2016,2013.5,5,40723,40578,2028,2306,-145,278,-423,-0.00071314470694428,0.00136727054158972,-0.002080415248534,EPCI
245400601,CC du Bassin de Pompey,1968_1975,1971.5,7,35211,38567,2367,4416,3356,2049,1307,0.0130904327930581,0.00799234111828846,0.00509809167476965,EPCI
245400601,CC du Bassin de Pompey,1975_1982,1978.5,7,38567,42720,2755,4001,4153,1246,2907,0.0147172775882429,0.00441553765349162,0.0103017399347513,EPCI
245400601,CC du Bassin de Pompey,1982_1990,1986,8,42720,41785,3003,4496,-935,1493,-2428,-0.00276239893480823,0.00441097498360287,-0.0071733739184111,EPCI
245400601,CC du Bassin de Pompey,1990_1999,1994.5,9,41785,41385,3395,4350,-400,955,-1355,-0.00106819874866204,0.00255032451243062,-0.00361852326109267,EPCI
245400601,CC du Bassin de Pompey,1999_2006,2002.5,7,41385,40494,2792,3220,-891,428,-1319,-0.00310441151109542,0.00149123246548691,-0.00459564397658233,EPCI
245400676,Métropole du Grand Nancy,2006_2011,2008.5,5,258526,256246,9557,14578,-2280,5021,-7301,-0.00177010123696619,0.00389810452228388,-0.00566820575925008,EPCI
245400676,Métropole du Grand Nancy,2011_2016,2013.5,5,256246,256610,10064,14674,364,4610,-4246,0.00028394070529969,0.00359606222920761,-0.00331212152390792,EPCI
245400676,Métropole du Grand Nancy,1968_1975,1971.5,7,231933,252292,15109,34626,20359,19517,842,0.0120923295425568,0.0115922194450651,0.000500110097491666,EPCI
245400676,Métropole du Grand Nancy,1975_1982,1978.5,7,252292,250951,15050,30674,-1341,15624,-16965,-0.000761059662781283,0.0088671112388477,-0.00962817090162898,EPCI
245400676,Métropole du Grand Nancy,1982_1990,1986,8,250951,256371,16319,32593,5420,16274,-10854,0.00267455941639461,0.00803058670524093,-0.00535602728884632,EPCI
245400676,Métropole du Grand Nancy,1990_1999,1994.5,9,256371,258268,17136,32369,1897,15233,-13336,0.000819467952597019,0.00658036653764386,-0.00576089858504684,EPCI
245400676,Métropole du Grand Nancy,1999_2006,2002.5,7,258268,258526,13494,21920,258,8426,-8168,0.000142647842865218,0.0046587237363656,-0.00451607589350039,EPCI
245400759,CC du Pays du Sanon,2006_2011,2008.5,5,5791,6014,276,350,223,74,149,0.00758564559910568,0.00251720975037588,0.00506843584872981,EPCI
245400759,CC du Pays du Sanon,2011_2016,2013.5,5,6014,6005,233,348,-9,115,-124,-0.000299480953501963,0.00382670107252508,-0.00412618202602704,EPCI
245400759,CC du Pays du Sanon,1968_1975,1971.5,7,5422,5168,434,482,-254,48,-302,-0.00683070460974933,0.00129084181601562,-0.00812154642576495,EPCI
245400759,CC du Pays du Sanon,1975_1982,1978.5,7,5168,5300,474,334,132,-140,272,0.00360950636026436,-0.0038282643214925,0.00743777068175686,EPCI
245400759,CC du Pays du Sanon,1982_1990,1986,8,5300,5451,442,561,151,119,32,0.00351770484271174,0.00277223096875959,0.000745473873952158,EPCI
245400759,CC du Pays du Sanon,1990_1999,1994.5,9,5451,5659,441,528,208,87,121,0.00416957080346103,0.00174400317260149,0.00242556763085954,EPCI
245400759,CC du Pays du Sanon,1999_2006,2002.5,7,5659,5791,358,521,132,163,-31,0.00329940109275007,0.00407426044028985,-0.000774859347539788,EPCI
245500327,CC du Sammiellois,2006_2011,2008.5,5,9328,9004,528,491,-324,-37,-287,-0.00704540525301856,-0.000804567883832366,-0.00624083736918619,EPCI
245500327,CC du Sammiellois,2011_2016,2013.5,5,9004,8693,505,451,-311,-54,-257,-0.00700550999529237,-0.00121639080304112,-0.00578911919225125,EPCI
245500327,CC du Sammiellois,1968_1975,1971.5,7,9416,9509,892,1328,93,436,-343,0.00140503593930053,0.00658705021005408,-0.00518201427075355,EPCI
245500327,CC du Sammiellois,1975_1982,1978.5,7,9509,9480,823,1148,-29,325,-354,-0.000436248000497019,0.0048889862124666,-0.00532523421296362,EPCI
245500327,CC du Sammiellois,1982_1990,1986,8,9480,9711,821,1229,231,408,-177,0.00301390111300792,0.00532325391388412,-0.0023093528008762,EPCI
245500327,CC du Sammiellois,1990_1999,1994.5,9,9711,9627,888,1248,-84,360,-444,-0.000964824570108935,0.00413496244332401,-0.00509978701343294,EPCI
245500327,CC du Sammiellois,1999_2006,2002.5,7,9627,9328,684,796,-299,112,-411,-0.00449714615943786,0.00168454973196335,-0.00618169589140121,EPCI
245501176,CC du Territoire de Fresnes-en-Woëvre,2006_2011,2008.5,5,4817,5087,266,298,270,32,238,0.0109670900594281,0.00129980326630259,0.0096672867931255,EPCI
245501176,CC du Territoire de Fresnes-en-Woëvre,2011_2016,2013.5,5,5087,4886,238,277,-201,39,-240,-0.00803044094145011,0.00155814525729629,-0.0095885861987464,EPCI
245501176,CC du Territoire de Fresnes-en-Woëvre,1968_1975,1971.5,7,4677,4359,458,410,-318,-48,-270,-0.0100087479567575,-0.00151075440856718,-0.00849799354819037,EPCI
245501176,CC du Territoire de Fresnes-en-Woëvre,1975_1982,1978.5,7,4359,4206,450,326,-153,-124,-29,-0.00509136568990776,-0.00412633559182067,-0.000965030098087091,EPCI
245501176,CC du Territoire de Fresnes-en-Woëvre,1982_1990,1986,8,4206,4325,475,427,119,-48,167,0.00349359631931101,-0.00140918170862965,0.00490277802794066,EPCI
245501176,CC du Territoire de Fresnes-en-Woëvre,1990_1999,1994.5,9,4325,4424,490,443,99,-47,146,0.00251784488704643,-0.00119534050193113,0.00371318538897756,EPCI
245501176,CC du Territoire de Fresnes-en-Woëvre,1999_2006,2002.5,7,4424,4817,353,354,393,1,392,0.012232362697671,3.11256048286795e-05,0.0122012370928423,EPCI
245501184,CC du Pays de Revigny-sur-Ornain,2006_2011,2008.5,5,7585,7421,339,437,-164,98,-262,-0.00436221653566349,0.00260669036887208,-0.00696890690453557,EPCI
245501184,CC du Pays de Revigny-sur-Ornain,2011_2016,2013.5,5,7421,7318,321,425,-103,104,-207,-0.00279144712397639,0.00281854855236451,-0.00560999567634089,EPCI
245501184,CC du Pays de Revigny-sur-Ornain,1968_1975,1971.5,7,8010,8108,567,1056,98,489,-391,0.00173871946705262,0.008675855299885,-0.00693713583283239,EPCI
245501184,CC du Pays de Revigny-sur-Ornain,1975_1982,1978.5,7,8108,8511,571,913,403,342,61,0.00695381137193274,0.00590124935285607,0.00105256201907667,EPCI
245501184,CC du Pays de Revigny-sur-Ornain,1982_1990,1986,8,8511,7926,651,1052,-585,401,-986,-0.00886186882124285,0.00607454597832202,-0.0149364147995649,EPCI
245501184,CC du Pays de Revigny-sur-Ornain,1990_1999,1994.5,9,7926,7844,608,912,-82,304,-386,-0.00115484225963713,0.00428136642597182,-0.00543620868560895,EPCI
245501184,CC du Pays de Revigny-sur-Ornain,1999_2006,2002.5,7,7844,7585,453,652,-259,199,-458,-0.00478512826739719,0.00367660434444803,-0.00846173261184522,EPCI
245501242,CC du Pays d'Étain,2006_2011,2008.5,5,7544,8100,363,506,556,143,413,0.0143239214010487,0.00368403014451431,0.0106398912565343,EPCI
245501242,CC du Pays d'Étain,2011_2016,2013.5,5,8100,7739,414,498,-361,84,-445,-0.00907687049970896,0.00211206958995998,-0.0111889400896689,EPCI
245501242,CC du Pays d'Étain,1968_1975,1971.5,7,6425,7130,635,852,705,217,488,0.0149846759630357,0.0046123045162819,0.0103723714467538,EPCI
245501242,CC du Pays d'Étain,1975_1982,1978.5,7,7130,7134,597,725,4,128,-124,8.01249970496798e-05,0.00256399990558975,-0.00248387490854007,EPCI
245501242,CC du Pays d'Étain,1982_1990,1986,8,7134,6826,620,816,-308,196,-504,-0.00550146576105648,0.00350093275703594,-0.00900239851809242,EPCI
245501242,CC du Pays d'Étain,1990_1999,1994.5,9,6826,7141,654,943,315,289,26,0.00502524798108617,0.00461046560804414,0.000414782373042033,EPCI
245501242,CC du Pays d'Étain,1999_2006,2002.5,7,7141,7544,480,749,403,269,134,0.0078736529907697,0.00525561452733759,0.00261803846343211,EPCI
245501259,CC du Pays de Montmédy,2006_2011,2008.5,5,7138,7462,275,343,324,68,256,0.00891769778870022,0.00187161558528276,0.00704608220341746,EPCI
245501259,CC du Pays de Montmédy,2011_2016,2013.5,5,7462,7190,261,325,-272,64,-336,-0.00739895259244827,0.00174093002175253,-0.00913988261420081,EPCI
245501259,CC du Pays de Montmédy,1968_1975,1971.5,7,7416,6809,675,704,-607,29,-636,-0.0121251142496763,0.000579288819177288,-0.0127044030688536,EPCI
245501259,CC du Pays de Montmédy,1975_1982,1978.5,7,6809,6346,627,564,-463,-63,-400,-0.0100096485446484,-0.00136200401363466,-0.00864764453101371,EPCI
245501259,CC du Pays de Montmédy,1982_1990,1986,8,6346,6125,599,628,-221,29,-250,-0.00442094083449385,0.000580123457920007,-0.00500106429241385,EPCI
245501259,CC du Pays de Montmédy,1990_1999,1994.5,9,6125,6795,547,518,670,-29,699,0.0116010305791816,-0.000502134159397413,0.012103164738579,EPCI
245501259,CC du Pays de Montmédy,1999_2006,2002.5,7,6795,7138,417,484,343,67,276,0.0070598868205447,0.00137904494745334,0.00568084187309137,EPCI
245600440,CC de Blavet Bellevue Océan,2006_2011,2008.5,5,14800,16860,488,996,2060,508,1552,0.0264059737079159,0.00651176439010741,0.0198942093178085,EPCI
245600440,CC de Blavet Bellevue Océan,2011_2016,2013.5,5,16860,17872,570,979,1012,409,603,0.0117264802999966,0.00473925933072984,0.00698722096926673,EPCI
245600440,CC de Blavet Bellevue Océan,1968_1975,1971.5,7,8232,8339,731,896,107,165,-58,0.00184660381580359,0.00284756663184666,-0.00100096281604307,EPCI
245600440,CC de Blavet Bellevue Océan,1975_1982,1978.5,7,8339,10077,666,834,1738,168,1570,0.027413638214393,0.00264987987342809,0.0247637583409649,EPCI
245600440,CC de Blavet Bellevue Océan,1982_1990,1986,8,10077,11796,791,1107,1719,316,1403,0.0198832005317013,0.00365508514718884,0.0162281153845125,EPCI
245600440,CC de Blavet Bellevue Océan,1990_1999,1994.5,9,11796,12544,823,1144,748,321,427,0.00685471705570095,0.00294166333540108,0.00391305372029988,EPCI
245600440,CC de Blavet Bellevue Océan,1999_2006,2002.5,7,12544,14800,666,1300,2256,634,1622,0.0239077023856995,0.00671874260307335,0.0171889597826261,EPCI
245600465,CC de Belle-Île-en-Mer,2006_2011,2008.5,5,5045,5249,333,242,204,-91,295,0.00795949538591434,-0.00355055921626571,0.0115100546021801,EPCI
245600465,CC de Belle-Île-en-Mer,2011_2016,2013.5,5,5249,5396,362,216,147,-146,293,0.00553935703014585,-0.00550167432926051,0.0110410313594064,EPCI
245600465,CC de Belle-Île-en-Mer,1968_1975,1971.5,7,4412,4328,457,460,-84,3,-87,-0.00274231294950666,9.79397481966666e-05,-0.00284025269770333,EPCI
245600465,CC de Belle-Île-en-Mer,1975_1982,1978.5,7,4328,4191,509,333,-137,-176,39,-0.00458462588525266,-0.00588973836353626,0.0013051124782836,EPCI
245600465,CC de Belle-Île-en-Mer,1982_1990,1986,8,4191,4489,545,409,298,-136,434,0.0086232920670537,-0.00393546215140706,0.0125587542184608,EPCI
245600465,CC de Belle-Île-en-Mer,1990_1999,1994.5,9,4489,4735,650,453,246,-197,443,0.00594557930211193,-0.0047612972460002,0.0107068765481121,EPCI
245600465,CC de Belle-Île-en-Mer,1999_2006,2002.5,7,4735,5045,495,419,310,-76,386,0.00910057889908389,-0.00223110966558186,0.0113316885646657,EPCI
245614383,CC Questembert Communauté,2006_2011,2008.5,5,19851,22168,1035,1430,2317,395,1922,0.0223246315844479,0.00380588238060289,0.018518749203845,EPCI
245614383,CC Questembert Communauté,2011_2016,2013.5,5,22168,23209,1050,1347,1041,297,744,0.00922031297762893,0.00263057920687396,0.00658973377075497,EPCI
245614383,CC Questembert Communauté,1968_1975,1971.5,7,15472,15538,1396,1742,66,346,-280,0.000608284618283106,0.00318888602918113,-0.00258060141089803,EPCI
245614383,CC Questembert Communauté,1975_1982,1978.5,7,15538,16142,1369,1599,604,230,374,0.00546285791246026,0.00208022735077129,0.00338263056168897,EPCI
245614383,CC Questembert Communauté,1982_1990,1986,8,16142,16522,1582,1695,380,113,267,0.00291276578748634,0.000866164563120937,0.0020466012243654,EPCI
245614383,CC Questembert Communauté,1990_1999,1994.5,9,16522,17355,1733,1671,833,-62,895,0.00548027575783361,-0.000407895674652682,0.00588817143248629,EPCI
245614383,CC Questembert Communauté,1999_2006,2002.5,7,17355,19851,1402,1545,2496,143,2353,0.0193816803695923,0.00111040877117456,0.0182712715984178,EPCI
245614417,CC Roi Morvan Communauté,2006_2011,2008.5,5,25412,25734,2021,1162,322,-859,1181,0.00252148788858353,-0.00672657793879892,0.00924806582738245,EPCI
245614417,CC Roi Morvan Communauté,2011_2016,2013.5,5,25734,24936,2124,1027,-798,-1097,299,-0.00628030239990518,-0.00863344828658645,0.00235314588668126,EPCI
245614417,CC Roi Morvan Communauté,1968_1975,1971.5,7,35028,32292,3455,2695,-2736,-760,-1976,-0.0115510851404128,-0.00320863476122578,-0.00834245037918703,EPCI
245614417,CC Roi Morvan Communauté,1975_1982,1978.5,7,32292,30149,3649,1930,-2143,-1719,-424,-0.00976172294082622,-0.0078303321209894,-0.00193139081983683,EPCI
245614417,CC Roi Morvan Communauté,1982_1990,1986,8,30149,27509,3911,2126,-2640,-1785,-855,-0.0113894597866111,-0.00770082792390182,-0.00368863186270928,EPCI
245614417,CC Roi Morvan Communauté,1990_1999,1994.5,9,27509,25712,4012,2061,-1797,-1951,154,-0.00747805636269083,-0.00811891372488025,0.000640857362189421,EPCI
245614417,CC Roi Morvan Communauté,1999_2006,2002.5,7,25712,25412,3110,1573,-300,-1537,1237,-0.0016752103505151,-0.00858266102913903,0.00690745067862393,EPCI
245614433,CC Pontivy Communauté,2006_2011,2008.5,5,43951,45222,2550,2416,1271,-134,1405,0.00571794883717836,-0.000602836462770967,0.00632078529994932,EPCI
245614433,CC Pontivy Communauté,2011_2016,2013.5,5,45222,46027,2689,2354,805,-335,1140,0.00353513123496896,-0.0014711415698318,0.00500627280480076,EPCI
245614433,CC Pontivy Communauté,1968_1975,1971.5,7,39166,40006,3431,4526,840,1095,-255,0.00303608808940647,0.0039577576879763,-0.000921669598569822,EPCI
245614433,CC Pontivy Communauté,1975_1982,1978.5,7,40006,41262,3367,3858,1256,491,765,0.0044258419074974,0.00173016590492135,0.00269567600257604,EPCI
245614433,CC Pontivy Communauté,1982_1990,1986,8,41262,41765,3941,4082,503,141,362,0.00151573364505042,0.000424887562529045,0.00109084608252138,EPCI
245614433,CC Pontivy Communauté,1990_1999,1994.5,9,41765,42585,4087,4188,820,101,719,0.00216271423165848,0.000266383094387203,0.00189633113727128,EPCI
245614433,CC Pontivy Communauté,1999_2006,2002.5,7,42585,43951,3482,3480,1366,-2,1368,0.00452065868737828,-6.618826775078e-06,0.00452727751415335,EPCI
245700133,CC du District Urbain de Faulquemont (DUF),2006_2011,2008.5,5,24417,24819,993,1435,402,442,-40,0.00327131468173314,0.0035968186301643,-0.000325503948431158,EPCI
245700133,CC du District Urbain de Faulquemont (DUF),2011_2016,2013.5,5,24819,24682,1101,1322,-137,221,-358,-0.00110643861395143,0.00178483893199465,-0.00289127754594608,EPCI
245700133,CC du District Urbain de Faulquemont (DUF),1968_1975,1971.5,7,20633,20691,1264,2532,58,1268,-1210,0.000401092889703802,0.00876872041628313,-0.00836762752657933,EPCI
245700133,CC du District Urbain de Faulquemont (DUF),1975_1982,1978.5,7,20691,22794,1304,2259,2103,955,1148,0.0139244140617747,0.00632325983309312,0.00760115422868157,EPCI
245700133,CC du District Urbain de Faulquemont (DUF),1982_1990,1986,8,22794,22922,1510,2551,128,1041,-913,0.000700220620197589,0.00569476301270071,-0.00499454239250312,EPCI
245700133,CC du District Urbain de Faulquemont (DUF),1990_1999,1994.5,9,22922,23410,1626,2451,488,825,-337,0.0023434230255599,0.00396172950017811,-0.00161830647461821,EPCI
245700133,CC du District Urbain de Faulquemont (DUF),1999_2006,2002.5,7,23410,24417,1293,1958,1007,665,342,0.00603475470518133,0.00398521537134616,0.00204953933383517,EPCI
245700372,CA de Forbach Porte de France,2006_2011,2008.5,5,80807,79682,3724,4169,-1125,445,-1570,-0.00280004894483377,0.00110757491595647,-0.00390762386079023,EPCI
245700372,CA de Forbach Porte de France,2011_2016,2013.5,5,79682,77984,3832,4139,-1698,307,-2005,-0.00429874103207184,0.000777216429237959,-0.0050759574613098,EPCI
245700372,CA de Forbach Porte de France,1968_1975,1971.5,7,81676,82705,4661,10050,1029,5389,-4360,0.00179015164509666,0.0093752451073138,-0.00758509346221714,EPCI
245700372,CA de Forbach Porte de France,1975_1982,1978.5,7,82705,85537,4902,8311,2832,3409,-577,0.00482143893653908,0.00580377307014891,-0.000982334133609834,EPCI
245700372,CA de Forbach Porte de France,1982_1990,1986,8,85537,86362,5559,10526,825,4967,-4142,0.00120056177001748,0.0072281094686992,-0.00602754769868171,EPCI
245700372,CA de Forbach Porte de France,1990_1999,1994.5,9,86362,82146,6336,8626,-4216,2290,-6506,-0.00554563392538865,0.00301221577066888,-0.00855784969605753,EPCI
245700372,CA de Forbach Porte de France,1999_2006,2002.5,7,82146,80807,4989,5889,-1339,900,-2239,-0.00234503986520795,0.00157620304606957,-0.00392124291127753,EPCI
245700398,CC de Freyming-Merlebach,2006_2011,2008.5,5,35013,33302,1717,1981,-1711,264,-1975,-0.00997035630059928,0.00153838343854951,-0.0115087397391488,EPCI
245700398,CC de Freyming-Merlebach,2011_2016,2013.5,5,33302,32281,1713,1873,-1021,160,-1181,-0.00620837458158208,0.000972908847260658,-0.00718128342884274,EPCI
245700398,CC de Freyming-Merlebach,1968_1975,1971.5,7,41405,39807,2290,4825,-1598,2535,-4133,-0.00560691798318258,0.00889457890323394,-0.0145014968864165,EPCI
245700398,CC de Freyming-Merlebach,1975_1982,1978.5,7,39807,39946,2337,4261,139,1924,-1785,0.000498090551718899,0.00689443324825297,-0.00639634269653407,EPCI
245700398,CC de Freyming-Merlebach,1982_1990,1986,8,39946,38518,2715,5197,-1428,2482,-3910,-0.00454002249122576,0.00789099147284477,-0.0124310139640705,EPCI
245700398,CC de Freyming-Merlebach,1990_1999,1994.5,9,38518,37826,2940,4533,-692,1593,-2285,-0.00201230233667404,0.00463236650624531,-0.00664466884291935,EPCI
245700398,CC de Freyming-Merlebach,1999_2006,2002.5,7,37826,35013,2488,2948,-2813,460,-3273,-0.0109788979413341,0.00179534058052389,-0.012774238521858,EPCI
245700695,CC de Cattenom et Environs,2006_2011,2008.5,5,22917,24585,699,1234,1668,535,1133,0.0141506879028988,0.00453873982497052,0.00961194807792823,EPCI
245700695,CC de Cattenom et Environs,2011_2016,2013.5,5,24585,25693,787,1177,1108,390,718,0.00885539514311295,0.00311697121463362,0.00573842392847933,EPCI
245700695,CC de Cattenom et Environs,1968_1975,1971.5,7,14415,15726,1139,1524,1311,385,926,0.0125127897622317,0.00367461789356156,0.00883817186867013,EPCI
245700695,CC de Cattenom et Environs,1975_1982,1978.5,7,15726,17091,1037,1262,1365,225,1140,0.0119619234269932,0.00197174561983404,0.00999017780715916,EPCI
245700695,CC de Cattenom et Environs,1982_1990,1986,8,17091,18284,1179,1740,1193,561,632,0.00846996277984236,0.00398294142455286,0.0044870213552895,EPCI
245700695,CC de Cattenom et Environs,1990_1999,1994.5,9,18284,19549,1324,1925,1265,601,664,0.00746077993137373,0.00354460769862104,0.00391617223275269,EPCI
245700695,CC de Cattenom et Environs,1999_2006,2002.5,7,19549,22917,1076,1911,3368,835,2533,0.0229676225934921,0.00569417009072621,0.0172734525027658,EPCI
245700950,CC du Pays de Phalsbourg,2006_2011,2008.5,5,17324,17727,713,935,403,222,181,0.00460980816065493,0.00253939804383472,0.0020704101168202,EPCI
245700950,CC du Pays de Phalsbourg,2011_2016,2013.5,5,17727,17611,748,921,-116,173,-289,-0.00131217718540877,0.00195695390582515,-0.00326913109123392,EPCI
245700950,CC du Pays de Phalsbourg,1968_1975,1971.5,7,15180,15937,1288,1716,757,428,329,0.00697631876807292,0.00394433874865946,0.00303198001941346,EPCI
245700950,CC du Pays de Phalsbourg,1975_1982,1978.5,7,15937,15670,1285,1366,-267,81,-348,-0.00241071718707886,0.000731341169113811,-0.00314205835619267,EPCI
245700950,CC du Pays de Phalsbourg,1982_1990,1986,8,15670,15771,1419,1609,101,190,-89,0.000803416833732085,0.00151137820207026,-0.000707961368338174,EPCI
245700950,CC du Pays de Phalsbourg,1990_1999,1994.5,9,15771,16709,1397,1873,938,476,462,0.00644005811485937,0.0032680891926152,0.00317196892224417,EPCI
245700950,CC du Pays de Phalsbourg,1999_2006,2002.5,7,16709,17324,987,1465,615,478,137,0.0051769725863271,0.00402372828660871,0.00115324429971839,EPCI
245701164,CC du Warndt,2006_2011,2008.5,5,18468,18397,913,941,-71,28,-99,-0.000770082694226626,0.000303694583638669,-0.0010737772778653,EPCI
245701164,CC du Warndt,2011_2016,2013.5,5,18397,18053,1063,934,-344,-129,-215,-0.00376802947134269,-0.00141301105175351,-0.00235501841958918,EPCI
245701164,CC du Warndt,1968_1975,1971.5,7,18482,19782,1097,2425,1300,1328,-28,0.00975803758747773,0.00996821070474648,-0.000210173117268751,EPCI
245701164,CC du Warndt,1975_1982,1978.5,7,19782,19689,1176,2025,-93,849,-942,-0.00067296333823863,0.00614350402327524,-0.00681646736151387,EPCI
245701164,CC du Warndt,1982_1990,1986,8,19689,19865,1325,2438,176,1113,-937,0.00111302959656312,0.007038647391902,-0.00592561779533888,EPCI
245701164,CC du Warndt,1990_1999,1994.5,9,19865,19093,1492,2011,-772,519,-1291,-0.00439449510628465,0.00295433025927685,-0.0073488253655615,EPCI
245701164,CC du Warndt,1999_2006,2002.5,7,19093,18468,1230,1336,-625,106,-731,-0.00474332488912699,0.000804467901195937,-0.00554779279032293,EPCI
245701206,CC du Saulnois,2006_2011,2008.5,5,29561,29867,1590,1872,306,282,24,0.00206177593456292,0.00190006801812661,0.000161707916436307,EPCI
245701206,CC du Saulnois,2011_2016,2013.5,5,29867,29212,1606,1492,-655,-114,-541,-0.00442510189836121,-0.000770170406737676,-0.00365493149162353,EPCI
245701206,CC du Saulnois,1968_1975,1971.5,7,30465,29275,2793,3213,-1190,420,-1610,-0.00567591282539171,0.00200326335013825,-0.00767917617552995,EPCI
245701206,CC du Saulnois,1975_1982,1978.5,7,29275,28739,2778,2590,-536,-188,-348,-0.00263635072881663,-0.000924690181002847,-0.00171166054781378,EPCI
245701206,CC du Saulnois,1982_1990,1986,8,28739,28315,2960,3081,-424,121,-545,-0.00185619835011319,0.00052971698198985,-0.00238591533210304,EPCI
245701206,CC du Saulnois,1990_1999,1994.5,9,28315,28480,3144,3057,165,-87,252,0.00064580699671235,-0.00034051641644833,0.00098632341316068,EPCI
245701206,CC du Saulnois,1999_2006,2002.5,7,28480,29561,2387,2474,1081,87,994,0.00533616379876345,0.000429459991204829,0.00490670380755862,EPCI
245701222,CA du Val de Fensch,2006_2011,2008.5,5,67758,69099,3281,4272,1341,991,350,0.00392723644602566,0.00290223066220092,0.00102500578382474,EPCI
245701222,CA du Val de Fensch,2011_2016,2013.5,5,69099,70307,3526,4450,1208,924,284,0.00347223593882262,0.00265591556909942,0.000816320369723199,EPCI
245701222,CA du Val de Fensch,1968_1975,1971.5,7,89007,88806,4533,12234,-201,7701,-7902,-0.000322919713280134,0.012372162746121,-0.0126950824594011,EPCI
245701222,CA du Val de Fensch,1975_1982,1978.5,7,88806,77909,4429,8213,-10897,3784,-14681,-0.0185280255592568,0.00643388535525629,-0.0249619109145131,EPCI
245701222,CA du Val de Fensch,1982_1990,1986,8,77909,73149,4927,8372,-4760,3445,-8205,-0.00784940898820719,0.00568092730343986,-0.0135303362916471,EPCI
245701222,CA du Val de Fensch,1990_1999,1994.5,9,73149,68978,5556,7211,-4171,1655,-5826,-0.00650219571461796,0.00257998894933894,-0.00908218466395691,EPCI
245701222,CA du Val de Fensch,1999_2006,2002.5,7,68978,67758,4530,5490,-1220,960,-2180,-0.00254605033148836,0.00200344944117117,-0.00454949977265953,EPCI
245701271,CC du Pays Orne Moselle,2006_2011,2008.5,5,52794,53199,2393,2950,405,557,-152,0.00152957887165028,0.00210364304076348,-0.000574064169113193,EPCI
245701271,CC du Pays Orne Moselle,2011_2016,2013.5,5,53199,53726,2551,3095,527,544,-17,0.00197343596380417,0.00203709518844302,-6.36592246388442e-05,EPCI
245701271,CC du Pays Orne Moselle,1968_1975,1971.5,7,61856,61419,3569,7665,-437,4096,-4533,-0.00101232575040877,0.00948852694204651,-0.0105008526924553,EPCI
245701271,CC du Pays Orne Moselle,1975_1982,1978.5,7,61419,55829,3423,5265,-5590,1842,-7432,-0.0135397567353723,0.00446157994750552,-0.0180013366828778,EPCI
245701271,CC du Pays Orne Moselle,1982_1990,1986,8,55829,53358,3722,5683,-2471,1961,-4432,-0.00564271076459599,0.00447808814624555,-0.0101207989108415,EPCI
245701271,CC du Pays Orne Moselle,1990_1999,1994.5,9,53358,52792,4114,5488,-566,1374,-1940,-0.0011842155476457,0.00287475647078655,-0.00405897201843224,EPCI
245701271,CC du Pays Orne Moselle,1999_2006,2002.5,7,52792,52794,3292,4055,2,763,-761,5.41198755299455e-06,0.00206467325146742,-0.00205926126391442,EPCI
245701354,CC de l'Arc Mosellan,2006_2011,2008.5,5,30065,32504,1007,1877,2439,870,1569,0.0157226106228703,0.00560831129229075,0.0101142993305795,EPCI
245701354,CC de l'Arc Mosellan,2011_2016,2013.5,5,32504,34422,1132,1804,1918,672,1246,0.0115325400806858,0.00404059798447387,0.00749194209621196,EPCI
245701354,CC de l'Arc Mosellan,1968_1975,1971.5,7,24547,26145,1125,3126,1598,2001,-403,0.00905047012459126,0.0113329103374888,-0.00228244021289755,EPCI
245701354,CC de l'Arc Mosellan,1975_1982,1978.5,7,26145,27334,1185,2536,1189,1351,-162,0.0063735654043251,0.00724195699011204,-0.000868391585786936,EPCI
245701354,CC de l'Arc Mosellan,1982_1990,1986,8,27334,27294,1320,2738,-40,1418,-1458,-0.00018303958704613,0.00648875336078531,-0.00667179294783144,EPCI
245701354,CC de l'Arc Mosellan,1990_1999,1994.5,9,27294,27991,1569,2647,697,1078,-381,0.00280572114637878,0.00433940802840219,-0.00153368688202341,EPCI
245701354,CC de l'Arc Mosellan,1999_2006,2002.5,7,27991,30065,1320,2062,2074,742,1332,0.0102635518328964,0.00367191680810469,0.00659163502479171,EPCI
245701362,CA Portes de France-Thionville,2006_2011,2008.5,5,78443,78686,3412,4704,243,1292,-1049,0.000618791869726465,0.00329003743080902,-0.00267124556108256,EPCI
245701362,CA Portes de France-Thionville,2011_2016,2013.5,5,78686,79372,3541,4282,686,741,-55,0.00173759033330612,0.00187690151163241,-0.000139311178326292,EPCI
245701362,CA Portes de France-Thionville,1968_1975,1971.5,7,76625,79752,4298,10776,3127,6478,-3351,0.00573041716482847,0.0118713279161365,-0.00614091075130803,EPCI
245701362,CA Portes de France-Thionville,1975_1982,1978.5,7,79752,75656,4523,8635,-4096,4112,-8208,-0.00750385728160274,0.00753316922410901,-0.0150370265057117,EPCI
245701362,CA Portes de France-Thionville,1982_1990,1986,8,75656,74889,5073,9317,-767,4244,-5011,-0.00127290572469663,0.00704330103730441,-0.00831620676200104,EPCI
245701362,CA Portes de France-Thionville,1990_1999,1994.5,9,74889,77026,5610,9276,2137,3666,-1529,0.00313111505922525,0.00537139345209161,-0.00224027839286636,EPCI
245701362,CA Portes de France-Thionville,1999_2006,2002.5,7,77026,78443,4605,7000,1417,2395,-978,0.00260756797743822,0.00440728673674279,-0.00179971875930457,EPCI
245701404,CC du Pays Haut Val d'Alzette,2006_2011,2008.5,5,26105,26769,1260,1218,664,-42,706,0.00503616601157186,-0.000318552669406654,0.00535471868097852,EPCI
245701404,CC du Pays Haut Val d'Alzette,2011_2016,2013.5,5,26769,28273,1316,1070,1504,-246,1750,0.0109925355838039,-0.00179798121915941,0.0127905168029633,EPCI
245701404,CC du Pays Haut Val d'Alzette,1968_1975,1971.5,7,35333,31722,1950,3460,-3611,1510,-5121,-0.0152830005350579,0.00639084209580102,-0.021673842630859,EPCI
245701404,CC du Pays Haut Val d'Alzette,1975_1982,1978.5,7,31722,28276,1895,2580,-3446,685,-4131,-0.0162939450167863,0.00323892987129965,-0.0195328748880859,EPCI
245701404,CC du Pays Haut Val d'Alzette,1982_1990,1986,8,28276,26101,2184,2377,-2175,193,-2368,-0.00995508685283197,0.000883370925331757,-0.0108384577781637,EPCI
245701404,CC du Pays Haut Val d'Alzette,1990_1999,1994.5,9,26101,25497,2494,2191,-604,-303,-301,-0.00259804473449765,-0.00130332376581587,-0.00129472096868178,EPCI
245701404,CC du Pays Haut Val d'Alzette,1999_2006,2002.5,7,25497,26105,1921,1839,608,-82,690,0.00337225453907863,-0.000454810645073105,0.00382706518415174,EPCI
245801063,CC Loire et Allier,2006_2011,2008.5,5,7190,7289,312,351,99,39,60,0.00273878176243114,0.00107891402762439,0.00165986773480675,EPCI
245801063,CC Loire et Allier,2011_2016,2013.5,5,7289,7194,326,334,-95,8,-103,-0.00262036426167533,0.000220662253614765,-0.0028410265152901,EPCI
245801063,CC Loire et Allier,1968_1975,1971.5,7,5589,5673,421,522,84,101,-17,0.00213337212937859,0.0025651260127052,-0.000431753883326619,EPCI
245801063,CC Loire et Allier,1975_1982,1978.5,7,5673,6314,394,448,641,54,587,0.0154105815491636,0.00129823931927432,0.0141123422298893,EPCI
245801063,CC Loire et Allier,1982_1990,1986,8,6314,7055,463,596,741,133,608,0.0139675466656604,0.00250699555537494,0.0114605511102854,EPCI
245801063,CC Loire et Allier,1990_1999,1994.5,9,7055,7114,534,630,59,96,-37,0.000925771397766395,0.00150633990145041,-0.00058056850368401,EPCI
245801063,CC Loire et Allier,1999_2006,2002.5,7,7114,7190,458,484,76,26,50,0.00151922402572402,0.000519734535116112,0.000999489490607908,EPCI
245804406,CA de Nevers,2006_2011,2008.5,5,71688,69722,3765,3785,-1966,20,-1986,-0.00554605616336068,5.6419696473659e-05,-0.00560247585983434,EPCI
245804406,CA de Nevers,2011_2016,2013.5,5,69722,65942,3760,3455,-3780,-305,-3475,-0.011086158288714,-0.000894518062978242,-0.0101916402257357,EPCI
245804406,CA de Nevers,1968_1975,1971.5,7,69571,75877,5223,8657,6306,3434,2872,0.0124722512760973,0.00679189833208343,0.00568035294401387,EPCI
245804406,CA de Nevers,1975_1982,1978.5,7,75877,75736,5396,7888,-141,2492,-2633,-0.000265678893825227,0.00469554470505296,-0.00496122359887818,EPCI
245804406,CA de Nevers,1982_1990,1986,8,75736,75741,6244,8179,5,1935,-1930,8.25211192467812e-06,0.00319356731485043,-0.00318531520292575,EPCI
245804406,CA de Nevers,1990_1999,1994.5,9,75741,74208,7037,8072,-1533,1035,-2568,-0.00226938375468855,0.00153216711422221,-0.00380155086891076,EPCI
245804406,CA de Nevers,1999_2006,2002.5,7,74208,71688,5396,5656,-2520,260,-2780,-0.00492335343843775,0.000507965037299133,-0.00543131847573688,EPCI
245804497,CC du Nivernais Bourbonnais,2006_2011,2008.5,5,5674,5771,378,298,97,-80,177,0.00339596112286844,-0.00280079267865438,0.00619675380152283,EPCI
245804497,CC du Nivernais Bourbonnais,2011_2016,2013.5,5,5771,5574,400,237,-197,-163,-34,-0.00692241824555095,-0.00572768616256246,-0.00119473208298849,EPCI
245804497,CC du Nivernais Bourbonnais,1968_1975,1971.5,7,6425,6144,671,517,-281,-154,-127,-0.00636829802132832,-0.00349009927147531,-0.00287819874985301,EPCI
245804497,CC du Nivernais Bourbonnais,1975_1982,1978.5,7,6144,5731,679,372,-413,-307,-106,-0.00989160452462345,-0.00735283919869104,-0.00253876532593241,EPCI
245804497,CC du Nivernais Bourbonnais,1982_1990,1986,8,5731,5515,747,409,-216,-338,122,-0.00479078526200272,-0.00749669175257833,0.00270590649057561,EPCI
245804497,CC du Nivernais Bourbonnais,1990_1999,1994.5,9,5515,5518,737,462,3,-275,278,6.04266133508169e-05,-0.00553910622382488,0.0055995328371757,EPCI
245804497,CC du Nivernais Bourbonnais,1999_2006,2002.5,7,5518,5674,571,420,156,-151,307,0.00399063583675829,-0.0038627308419904,0.00785336667874869,EPCI
245900410,Métropole Européenne de Lille,2006_2011,2008.5,5,1113427,1119712,40890,85762,6285,44872,-38587,0.00112640649276718,0.00804202261630057,-0.00691561612353339,EPCI
245900410,Métropole Européenne de Lille,2011_2016,2013.5,5,1119712,1143572,41260,85035,23860,43775,-19915,0.00422594175446855,0.00775316849546777,-0.00352722674099921,EPCI
245900410,Métropole Européenne de Lille,1968_1975,1971.5,7,994634,1046430,78866,142342,51796,63476,-11680,0.00727847738870202,0.00891977432089832,-0.0016412969321963,EPCI
245900410,Métropole Européenne de Lille,1975_1982,1978.5,7,1046430,1052137,76847,132826,5707,55979,-50272,0.000777296644133285,0.00762437162115598,-0.00684707497702269,EPCI
245900410,Métropole Européenne de Lille,1982_1990,1986,8,1052137,1072719,79350,150085,20582,70735,-50153,0.00242458616729868,0.00833267430492043,-0.00590808813762174,EPCI
245900410,Métropole Européenne de Lille,1990_1999,1994.5,9,1072719,1097074,80470,154195,24355,73725,-49370,0.00249756806623558,0.00756038619105802,-0.00506281812482244,EPCI
245900410,Métropole Européenne de Lille,1999_2006,2002.5,7,1097074,1113427,59335,119363,16353,60028,-43675,0.00211595130065634,0.00776715738248631,-0.00565120608182997,EPCI
245900428,CU de Dunkerque,2006_2011,2008.5,5,205780,200966,8632,13124,-4814,4492,-9306,-0.00472318997599774,0.00440726409891605,-0.00913045407491379,EPCI
245900428,CU de Dunkerque,2011_2016,2013.5,5,200966,198341,9076,12553,-2625,3477,-6102,-0.00262613923318344,0.00347850899572527,-0.00610464822890872,EPCI
245900428,CU de Dunkerque,1968_1975,1971.5,7,178000,205555,11907,29651,27555,17744,9811,0.0207742838168654,0.0133775682107226,0.00739671560614286,EPCI
245900428,CU de Dunkerque,1975_1982,1978.5,7,205555,216443,11882,29387,10888,17505,-6617,0.00740062098990424,0.0118982246903264,-0.00449760370042215,EPCI
245900428,CU de Dunkerque,1982_1990,1986,8,216443,213616,12929,31254,-2827,18325,-21152,-0.0016420531886191,0.0106440129753962,-0.0122860661640153,EPCI
245900428,CU de Dunkerque,1990_1999,1994.5,9,213616,213698,14526,28867,82,14341,-14259,4.26445447196944e-05,0.00745811482713582,-0.00741547028241612,EPCI
245900428,CU de Dunkerque,1999_2006,2002.5,7,213698,205780,11712,19930,-7918,8218,-16136,-0.00537921797234675,0.00558302769597696,-0.0109622456683237,EPCI
245900758,CC Flandre Lys,2006_2011,2008.5,5,37137,38452,1723,2348,1315,625,690,0.00698365940333812,0.00331922975443827,0.00366442964889985,EPCI
245900758,CC Flandre Lys,2011_2016,2013.5,5,38452,39541,1705,2396,1089,691,398,0.00560110748685627,0.00355405442921734,0.00204705305763893,EPCI
245900758,CC Flandre Lys,1968_1975,1971.5,7,27825,28636,2516,3574,811,1058,-247,0.00411268689075772,0.00536525614108714,-0.00125256925032942,EPCI
245900758,CC Flandre Lys,1975_1982,1978.5,7,28636,31533,2468,3587,2897,1119,1778,0.0138623389698092,0.00535448992309853,0.00850784904671062,EPCI
245900758,CC Flandre Lys,1982_1990,1986,8,31533,35091,2740,4324,3558,1584,1974,0.0134534529836539,0.00598939559474641,0.00746405738890745,EPCI
245900758,CC Flandre Lys,1990_1999,1994.5,9,35091,35874,2931,4229,783,1298,-515,0.00245502106215612,0.00406975394467259,-0.00161473288251647,EPCI
245900758,CC Flandre Lys,1999_2006,2002.5,7,35874,37137,2397,3351,1263,954,309,0.00495523363295192,0.00374290806479503,0.00121232556815688,EPCI
245901038,CC du Pays Solesmois,2006_2011,2008.5,5,14755,14888,858,918,133,60,73,0.0017963136308583,0.000810367051515024,0.00098594657934328,EPCI
245901038,CC du Pays Solesmois,2011_2016,2013.5,5,14888,15056,807,880,168,73,95,0.00224673283082111,0.0009762589086306,0.00127047392219051,EPCI
245901038,CC du Pays Solesmois,1968_1975,1971.5,7,18016,17097,1632,1916,-919,284,-1203,-0.00745170341917167,0.00230281150276905,-0.00975451492194072,EPCI
245901038,CC du Pays Solesmois,1975_1982,1978.5,7,17097,16228,1481,1566,-869,85,-954,-0.00742442522807796,0.000726209602286106,-0.00815063483036406,EPCI
245901038,CC du Pays Solesmois,1982_1990,1986,8,16228,15284,1590,1619,-944,29,-973,-0.00746346098495543,0.000229280051444605,-0.00769274103640003,EPCI
245901038,CC du Pays Solesmois,1990_1999,1994.5,9,15284,14734,1615,1437,-550,-178,-372,-0.00406380711064114,-0.0013151957558075,-0.00274861135483364,EPCI
245901038,CC du Pays Solesmois,1999_2006,2002.5,7,14734,14755,1145,1246,21,101,-80,0.000203486434025013,0.000978672849358396,-0.000775186415333383,EPCI
245901061,CC de la Haute-Deûle,2006_2011,2008.5,5,23437,23308,798,1501,-129,703,-832,-0.00110325514383802,0.00601231291564442,-0.00711556805948244,EPCI
245901061,CC de la Haute-Deûle,2011_2016,2013.5,5,23308,24412,906,1405,1104,499,605,0.00929859890848372,0.00420289932548313,0.00509569958300059,EPCI
245901061,CC de la Haute-Deûle,1968_1975,1971.5,7,15464,15524,1220,2005,60,785,-725,0.000553363277661534,0.00723983621607173,-0.0066864729384102,EPCI
245901061,CC de la Haute-Deûle,1975_1982,1978.5,7,15524,18320,1301,1973,2796,672,2124,0.0239400918159547,0.00575384180984319,0.0181862500061115,EPCI
245901061,CC de la Haute-Deûle,1982_1990,1986,8,18320,21458,1362,2669,3138,1307,1831,0.0199596035213494,0.00831332116074049,0.0116462823606089,EPCI
245901061,CC de la Haute-Deûle,1990_1999,1994.5,9,21458,22939,1412,2735,1481,1323,158,0.00744322886362214,0.00664915042982586,0.000794078433796285,EPCI
245901061,CC de la Haute-Deûle,1999_2006,2002.5,7,22939,23437,1119,2368,498,1249,-751,0.00307291910834273,0.00770697985204834,-0.00463406074370561,EPCI
245901152,CC Coeur d'Ostrevent,2006_2011,2008.5,5,71221,72087,3621,4916,866,1295,-429,0.00242012461553243,0.00361900851860796,-0.00119888390307553,EPCI
245901152,CC Coeur d'Ostrevent,2011_2016,2013.5,5,72087,71195,3428,4735,-892,1307,-2199,-0.00248712829239672,0.00364425636565305,-0.00613138465804977,EPCI
245901152,CC Coeur d'Ostrevent,1968_1975,1971.5,7,74669,71981,5562,9055,-2688,3493,-6181,-0.00522385331635289,0.00678828855432316,-0.012012141870676,EPCI
245901152,CC Coeur d'Ostrevent,1975_1982,1978.5,7,71981,70145,5764,7744,-1836,1980,-3816,-0.00368429158587746,0.00397325563182864,-0.0076575472177061,EPCI
245901152,CC Coeur d'Ostrevent,1982_1990,1986,8,70145,71031,6013,9044,886,3031,-2145,0.00157021566191395,0.005371697145893,-0.00380148148397904,EPCI
245901152,CC Coeur d'Ostrevent,1990_1999,1994.5,9,71031,70893,6405,8300,-138,1895,-2033,-0.000216054813637068,0.00296683965103075,-0.00318289446466782,EPCI
245901152,CC Coeur d'Ostrevent,1999_2006,2002.5,7,70893,71221,5010,6815,328,1805,-1477,0.00065964900039428,0.00363008062716974,-0.00297043162677546,EPCI
245901160,CA Valenciennes Métropole,2006_2011,2008.5,5,191024,191712,9183,13737,688,4554,-3866,0.000719292826798945,0.00476113304250348,-0.00404184021570454,EPCI
245901160,CA Valenciennes Métropole,2011_2016,2013.5,5,191712,192471,9173,13781,759,4608,-3849,0.000790561754728802,0.00479961602870925,-0.00400905427398045,EPCI
245901160,CA Valenciennes Métropole,1968_1975,1971.5,7,195613,199420,15584,26906,3807,11322,-7515,0.0027573567975625,0.00820036607880291,-0.0054430092812404,EPCI
245901160,CA Valenciennes Métropole,1975_1982,1978.5,7,199420,197998,15523,24621,-1422,9098,-10520,-0.00102179529234303,0.00653747789714268,-0.00755927318948571,EPCI
245901160,CA Valenciennes Métropole,1982_1990,1986,8,197998,191854,16827,24918,-6144,8091,-14235,-0.00393253021312312,0.00517872753163723,-0.00911125774476035,EPCI
245901160,CA Valenciennes Métropole,1990_1999,1994.5,9,191854,191819,16652,23682,-35,7030,-7065,-2.02716869958097e-05,0.00407171313087264,-0.00409198481786845,EPCI
245901160,CA Valenciennes Métropole,1999_2006,2002.5,7,191819,191024,12790,18625,-795,5835,-6630,-0.000593130380369233,0.00435335316912513,-0.00494648354949436,EPCI
246000129,CC du Liancourtois,2006_2011,2008.5,5,22392,23301,857,1490,909,633,276,0.00799025826062572,0.00556417324419811,0.00242608501642761,EPCI
246000129,CC du Liancourtois,2011_2016,2013.5,5,23301,23562,992,1511,261,519,-258,0.00223027671905918,0.00443491807353147,-0.00220464135447229,EPCI
246000129,CC du Liancourtois,1968_1975,1971.5,7,13950,16095,1201,1837,2145,636,1509,0.0206429140629993,0.0061206961977005,0.0145222178652988,EPCI
246000129,CC du Liancourtois,1975_1982,1978.5,7,16095,17422,1129,1445,1327,316,1011,0.0113821623844284,0.00271044710887668,0.00867171527555167,EPCI
246000129,CC du Liancourtois,1982_1990,1986,8,17422,20423,1361,1918,3001,557,2444,0.0200646347263127,0.00372409248335761,0.0163405422429551,EPCI
246000129,CC du Liancourtois,1990_1999,1994.5,9,20423,21479,1535,2499,1056,964,92,0.00561727325485628,0.00512788960007714,0.000489383654779145,EPCI
246000129,CC du Liancourtois,1999_2006,2002.5,7,21479,22392,1154,1814,913,660,253,0.00596458034773262,0.00431174482968623,0.00165283551804639,EPCI
246000376,CC du Clermontois,2006_2011,2008.5,5,36824,37176,1437,2349,352,912,-560,0.0019045283682646,0.00493445986323101,-0.00302993149496641,EPCI
246000376,CC du Clermontois,2011_2016,2013.5,5,37176,37378,1447,2327,202,880,-678,0.00108436835577774,0.00472398095586344,-0.00363961260008569,EPCI
246000376,CC du Clermontois,1968_1975,1971.5,7,25844,29037,1705,3199,3193,1494,1699,0.0167810189741797,0.00785181407686329,0.00892920489731642,EPCI
246000376,CC du Clermontois,1975_1982,1978.5,7,29037,31206,1810,2856,2169,1046,1123,0.0103444960384447,0.00498863202222827,0.0053558640162164,EPCI
246000376,CC du Clermontois,1982_1990,1986,8,31206,33880,2075,3670,2674,1595,1079,0.0103297984994699,0.00616156641984088,0.00416823207962903,EPCI
246000376,CC du Clermontois,1990_1999,1994.5,9,33880,35307,2257,4255,1427,1998,-571,0.00459456443391426,0.00643303415484281,-0.00183846972092855,EPCI
246000376,CC du Clermontois,1999_2006,2002.5,7,35307,36824,1951,3387,1517,1436,81,0.00602788961083478,0.00570603129937953,0.000321858311455252,EPCI
246000566,CC du Plateau Picard,2006_2011,2008.5,5,28476,29506,1128,1965,1030,837,193,0.0071317114384295,0.00579538104268494,0.00133633039574456,EPCI
246000566,CC du Plateau Picard,2011_2016,2013.5,5,29506,30311,1121,1908,805,787,18,0.0053979266783537,0.00527722769672592,0.000120698981627785,EPCI
246000566,CC du Plateau Picard,1968_1975,1971.5,7,19643,20106,1691,2344,463,653,-190,0.00333372127688092,0.0047017710449314,-0.00136804976805048,EPCI
246000566,CC du Plateau Picard,1975_1982,1978.5,7,20106,21547,1679,2014,1441,335,1106,0.00993738219607243,0.00231021723503419,0.00762716496103824,EPCI
246000566,CC du Plateau Picard,1982_1990,1986,8,21547,24895,1848,2882,3348,1034,2314,0.0182177530423737,0.00562639087389917,0.0125913621684746,EPCI
246000566,CC du Plateau Picard,1990_1999,1994.5,9,24895,27296,2083,3416,2401,1333,1068,0.0102828635659593,0.00570889509930186,0.00457396846665745,EPCI
246000566,CC du Plateau Picard,1999_2006,2002.5,7,27296,28476,1601,2645,1180,1044,136,0.00606423575281845,0.00536530688639192,0.000698928866426533,EPCI
246000582,CC des Sablons,2006_2011,2008.5,5,35152,36475,1259,2556,1323,1297,26,0.0074164826332821,0.00727073165182682,0.000145750981455279,EPCI
246000582,CC des Sablons,2011_2016,2013.5,5,36475,38341,1391,2585,1866,1194,672,0.0100284967486743,0.00641694808034146,0.00361154866833288,EPCI
246000582,CC des Sablons,1968_1975,1971.5,7,17736,20367,1638,2266,2631,628,2003,0.0199564441031794,0.00476345378061447,0.015192990322565,EPCI
246000582,CC des Sablons,1975_1982,1978.5,7,20367,26515,1605,2562,6148,957,5191,0.0384040346113004,0.00597798651968355,0.0324260480916168,EPCI
246000582,CC des Sablons,1982_1990,1986,8,26515,30499,1922,3438,3984,1516,2468,0.0176518959686285,0.00671693631737971,0.0109349596512488,EPCI
246000582,CC des Sablons,1990_1999,1994.5,9,30499,34037,2224,4143,3538,1919,1619,0.0122695803266637,0.00665498152822714,0.00561459879843655,EPCI
246000582,CC des Sablons,1999_2006,2002.5,7,34037,35152,1758,3398,1115,1640,-525,0.00461538213592672,0.00678854412817921,-0.00217316199225249,EPCI
246000707,CC du Vexin-Thelle,2006_2011,2008.5,5,19237,19711,884,1087,474,203,271,0.00488013880135974,0.00209001725037136,0.00279012155098837,EPCI
246000707,CC du Vexin-Thelle,2011_2016,2013.5,5,19711,20302,979,1080,591,101,490,0.00592599923511727,0.00101273421784576,0.00491326501727151,EPCI
246000707,CC du Vexin-Thelle,1968_1975,1971.5,7,11371,11982,1201,1402,611,201,410,0.00750506128226314,0.0024689317802535,0.00503612950200963,EPCI
246000707,CC du Vexin-Thelle,1975_1982,1978.5,7,11982,14461,1137,1127,2479,-10,2489,0.0272283612802178,-0.000109836068092851,0.0273381973483106,EPCI
246000707,CC du Vexin-Thelle,1982_1990,1986,8,14461,17014,1351,1598,2553,247,2306,0.0205305564953882,0.00198630922614997,0.0185442472692382,EPCI
246000707,CC du Vexin-Thelle,1990_1999,1994.5,9,17014,18522,1517,1977,1508,460,1048,0.00948051137084494,0.00289193317678294,0.006588578194062,EPCI
246000707,CC du Vexin-Thelle,1999_2006,2002.5,7,18522,19237,1197,1501,715,304,411,0.00542556437825192,0.00230681338599802,0.0031187509922539,EPCI
246000749,CC des Lisières de l'Oise,2006_2011,2008.5,5,16327,16364,757,1006,37,249,-212,0.00045282667968527,0.00304740116869276,-0.00259457448900749,EPCI
246000749,CC des Lisières de l'Oise,2011_2016,2013.5,5,16364,16347,786,860,-17,74,-91,-0.000207859553825185,0.000904800410768452,-0.00111265996459364,EPCI
246000749,CC des Lisières de l'Oise,1968_1975,1971.5,7,12396,13030,1171,1608,634,437,197,0.00715124190522687,0.00492916831637877,0.0022220735888481,EPCI
246000749,CC des Lisières de l'Oise,1975_1982,1978.5,7,13030,13473,1060,1299,443,239,204,0.00478760866955574,0.00258293108808989,0.00220467758146585,EPCI
246000749,CC des Lisières de l'Oise,1982_1990,1986,8,13473,14674,1206,1577,1201,371,830,0.0107308592557547,0.00331486160190257,0.00741599765385211,EPCI
246000749,CC des Lisières de l'Oise,1990_1999,1994.5,9,14674,15942,1438,1759,1268,321,947,0.00925141171249289,0.00234203719220049,0.0069093745202924,EPCI
246000749,CC des Lisières de l'Oise,1999_2006,2002.5,7,15942,16327,1156,1433,385,277,108,0.00341482343261346,0.00245689893723098,0.000957924495382476,EPCI
246000756,CC du Pays Noyonnais,2006_2011,2008.5,5,33529,33021,1593,2446,-508,853,-1361,-0.00304874576427261,0.00511925223804042,-0.00816799800231303,EPCI
246000756,CC du Pays Noyonnais,2011_2016,2013.5,5,33021,33114,1564,2322,93,758,-665,0.000562644420236014,0.00458585452192364,-0.00402321010168762,EPCI
246000756,CC du Pays Noyonnais,1968_1975,1971.5,7,24993,27974,2083,3587,2981,1504,1477,0.0162273594415994,0.00818716826573816,0.00804019117586121,EPCI
246000756,CC du Pays Noyonnais,1975_1982,1978.5,7,27974,29393,1990,3586,1419,1596,-177,0.00709376286148089,0.00797860854610536,-0.000884845684624467,EPCI
246000756,CC du Pays Noyonnais,1982_1990,1986,8,29393,31421,2161,4066,2028,1905,123,0.0083748631415268,0.00786692025868272,0.000507942882844082,EPCI
246000756,CC du Pays Noyonnais,1990_1999,1994.5,9,31421,32508,2472,4269,1087,1797,-710,0.0037860104223888,0.00625893351336952,-0.00247292309098072,EPCI
246000756,CC du Pays Noyonnais,1999_2006,2002.5,7,32508,33529,2232,3369,1021,1137,-116,0.00442756183089754,0.00493059530042165,-0.000503033469524109,EPCI
246000764,CC de l'Aire Cantilienne,2006_2011,2008.5,5,44944,45323,1874,2432,379,558,-179,0.00168088301221503,0.00247475651930339,-0.000793873507088364,EPCI
246000764,CC de l'Aire Cantilienne,2011_2016,2013.5,5,45323,44643,1845,2314,-680,469,-1149,-0.00301885602115659,0.0020821227557683,-0.00510097877692489,EPCI
246000764,CC de l'Aire Cantilienne,1968_1975,1971.5,7,28498,33930,2118,3475,5432,1357,4075,0.0252368581942599,0.00630456858792539,0.0189322896063345,EPCI
246000764,CC de l'Aire Cantilienne,1975_1982,1978.5,7,33930,38576,2343,3414,4646,1071,3575,0.0185020436731689,0.00426510735556691,0.014236936317602,EPCI
246000764,CC de l'Aire Cantilienne,1982_1990,1986,8,38576,43050,2639,4036,4474,1397,3077,0.0138109912972362,0.00431246196742042,0.00949852932981576,EPCI
246000764,CC de l'Aire Cantilienne,1990_1999,1994.5,9,43050,43214,3147,4637,164,1490,-1326,0.000422565472283365,0.00383916191281838,-0.00341659644053501,EPCI
246000764,CC de l'Aire Cantilienne,1999_2006,2002.5,7,43214,44944,2623,3783,1730,1160,570,0.0056232878799054,0.00377052828941634,0.00185275959048906,EPCI
246000772,CC des Deux Vallées,2006_2011,2008.5,5,22506,22832,810,1397,326,587,-261,0.00288036438234429,0.00518642298293282,-0.00230605860058853,EPCI
246000772,CC des Deux Vallées,2011_2016,2013.5,5,22832,22896,898,1254,64,356,-292,0.000559989151337037,0.00311493965431227,-0.00255495050297523,EPCI
246000772,CC des Deux Vallées,1968_1975,1971.5,7,16090,18924,1029,2158,2834,1129,1705,0.0234467960410989,0.00934066080818654,0.0141061352329124,EPCI
246000772,CC des Deux Vallées,1975_1982,1978.5,7,18924,21046,937,2093,2122,1156,966,0.0152986385234182,0.00833422532189982,0.00696441320151836,EPCI
246000772,CC des Deux Vallées,1982_1990,1986,8,21046,22383,1189,2391,1337,1202,135,0.00772861573633499,0.00694823942787932,0.000780376308455664,EPCI
246000772,CC des Deux Vallées,1990_1999,1994.5,9,22383,23095,1342,2649,712,1307,-595,0.00348543803135759,0.00639812852104547,-0.00291269048968787,EPCI
246000772,CC des Deux Vallées,1999_2006,2002.5,7,23095,22506,1106,2015,-589,909,-1498,-0.00368379861203538,0.00568518325694425,-0.00936898186897963,EPCI
246000848,CC de la Picardie Verte,2006_2011,2008.5,5,30776,32332,1364,2007,1556,643,913,0.00991327141936393,0.00409655110710219,0.00581672031226174,EPCI
246000848,CC de la Picardie Verte,2011_2016,2013.5,5,32332,33052,1521,2070,720,549,171,0.00441464133809455,0.00336616402029709,0.00104847731779746,EPCI
246000848,CC de la Picardie Verte,1968_1975,1971.5,7,25720,25591,1984,2850,-129,866,-995,-0.000718052390690116,0.0048204137235476,-0.00553846611423772,EPCI
246000848,CC de la Picardie Verte,1975_1982,1978.5,7,25591,25765,2070,2343,174,273,-99,0.00096850507090096,0.00151955105951702,-0.000551045988616064,EPCI
246000848,CC de la Picardie Verte,1982_1990,1986,8,25765,26792,2304,2978,1027,674,353,0.00489774916840102,0.0032142969225923,0.00168345224580873,EPCI
246000848,CC de la Picardie Verte,1990_1999,1994.5,9,26792,28451,2373,3205,1659,832,827,0.00669788381462322,0.00335903516200513,0.00333884865261808,EPCI
246000848,CC de la Picardie Verte,1999_2006,2002.5,7,28451,30776,1929,2712,2325,783,1542,0.011284893115304,0.00380046077818625,0.00748443233711776,EPCI
246000855,CC du Pays des Sources,2006_2011,2008.5,5,20314,21340,704,1381,1026,677,349,0.00990330482325952,0.00653463680833011,0.00336866801492941,EPCI
246000855,CC du Pays des Sources,2011_2016,2013.5,5,21340,22083,755,1366,743,611,132,0.00686844750548121,0.00564821187866625,0.00122023562681497,EPCI
246000855,CC du Pays des Sources,1968_1975,1971.5,7,13806,13415,1291,1369,-391,78,-469,-0.00409584567869492,0.000817074074010751,-0.00491291975270567,EPCI
246000855,CC du Pays des Sources,1975_1982,1978.5,7,13415,14965,1164,1257,1550,93,1457,0.0157427252575164,0.000944563515450985,0.0147981617420654,EPCI
246000855,CC du Pays des Sources,1982_1990,1986,8,14965,16908,1271,1672,1943,401,1542,0.0153761070497551,0.00317334993667103,0.0122027571130841,EPCI
246000855,CC du Pays des Sources,1990_1999,1994.5,9,16908,18751,1274,2034,1843,760,1083,0.0115619060305909,0.00476779630127461,0.00679410972931632,EPCI
246000855,CC du Pays des Sources,1999_2006,2002.5,7,18751,20314,989,1846,1563,857,706,0.0115032622098179,0.00630729092374532,0.00519597128607258,EPCI
246000871,CC du Pays de Valois,2006_2011,2008.5,5,51594,53458,1999,3551,1864,1552,312,0.00712343425006545,0.00593109976185707,0.00119233448820838,EPCI
246000871,CC du Pays de Valois,2011_2016,2013.5,5,53458,55570,2031,3383,2112,1352,760,0.00777954229244804,0.0049800857856959,0.00279945650675213,EPCI
246000871,CC du Pays de Valois,1968_1975,1971.5,7,30448,34355,2414,3879,3907,1465,2442,0.0173963350532591,0.00652306906911302,0.0108732659841461,EPCI
246000871,CC du Pays de Valois,1975_1982,1978.5,7,34355,39776,2491,3741,5421,1250,4171,0.0211514652897482,0.00487720561006922,0.016274259679679,EPCI
246000871,CC du Pays de Valois,1982_1990,1986,8,39776,46184,3043,4954,6408,1911,4497,0.0188466098219833,0.0056204543336158,0.0132261554883675,EPCI
246000871,CC du Pays de Valois,1990_1999,1994.5,9,46184,50100,3560,5893,3916,2333,1583,0.00908407764178554,0.00541193900364802,0.00367213863813751,EPCI
246000871,CC du Pays de Valois,1999_2006,2002.5,7,50100,51594,2835,4836,1494,2001,-507,0.0042065913374767,0.00563412936164047,-0.00142753802416378,EPCI
246000897,CC de la Plaine d'Estrées,2006_2011,2008.5,5,16266,16772,545,1015,506,470,36,0.00614556488301399,0.00570833101781932,0.000437233865194671,EPCI
246000897,CC de la Plaine d'Estrées,2011_2016,2013.5,5,16772,17728,566,983,956,417,539,0.0111485836486571,0.00486292822331592,0.0062856554253412,EPCI
246000897,CC de la Plaine d'Estrées,1968_1975,1971.5,7,10251,11555,809,1168,1304,359,945,0.0172532881391381,0.00474994665793755,0.0125033414812005,EPCI
246000897,CC de la Plaine d'Estrées,1975_1982,1978.5,7,11555,13280,754,1225,1725,471,1254,0.0200761399036162,0.00548165906933522,0.014594480834281,EPCI
246000897,CC de la Plaine d'Estrées,1982_1990,1986,8,13280,14914,879,1528,1634,649,985,0.0146108633638309,0.00580321317204789,0.008807650191783,EPCI
246000897,CC de la Plaine d'Estrées,1990_1999,1994.5,9,14914,15843,963,1714,929,751,178,0.00673674527564661,0.00544595877503832,0.00129078650060828,EPCI
246000897,CC de la Plaine d'Estrées,1999_2006,2002.5,7,15843,16266,708,1452,423,744,-321,0.00377127591121007,0.00663316614170282,-0.00286189023049275,EPCI
246000913,CC du Pays de Bray,2006_2011,2008.5,5,17572,18229,640,1162,657,522,135,0.00736841544066524,0.00585435747340526,0.00151405796725998,EPCI
246000913,CC du Pays de Bray,2011_2016,2013.5,5,18229,18369,605,1098,140,493,-353,0.00153131699292342,0.0053924234107946,-0.00386110641787118,EPCI
246000913,CC du Pays de Bray,1968_1975,1971.5,7,11080,11514,842,1298,434,456,-22,0.00550394922686337,0.00578295126140483,-0.000279002034541461,EPCI
246000913,CC du Pays de Bray,1975_1982,1978.5,7,11514,12815,839,1124,1301,285,1016,0.0154107790858586,0.00337592009182914,0.0120348589940295,EPCI
246000913,CC du Pays de Bray,1982_1990,1986,8,12815,15199,896,1630,2384,734,1650,0.0215556980645772,0.00663669562894283,0.0149190024356344,EPCI
246000913,CC du Pays de Bray,1990_1999,1994.5,9,15199,16792,1043,1764,1593,721,872,0.0111363241129319,0.00504035761796853,0.00609596649496333,EPCI
246000913,CC du Pays de Bray,1999_2006,2002.5,7,16792,17572,809,1570,780,761,19,0.00650738786813676,0.00634887457391292,0.000158513294223844,EPCI
246000921,CC des Pays d'Oise et d'Halatte,2006_2011,2008.5,5,33191,33532,1151,2148,341,997,-656,0.00204638137431723,0.005983115044558,-0.00393673367024077,EPCI
246000921,CC des Pays d'Oise et d'Halatte,2011_2016,2013.5,5,33532,34034,1151,2075,502,924,-422,0.00297638429691416,0.00547844440308503,-0.00250206010617087,EPCI
246000921,CC des Pays d'Oise et d'Halatte,1968_1975,1971.5,7,19736,22079,1281,2557,2343,1276,1067,0.0161551851250128,0.00879812898826988,0.00735705613674292,EPCI
246000921,CC des Pays d'Oise et d'Halatte,1975_1982,1978.5,7,22079,25311,1334,2172,3232,838,2394,0.0197077043880556,0.00510985652140798,0.0145978478666476,EPCI
246000921,CC des Pays d'Oise et d'Halatte,1982_1990,1986,8,25311,29136,1515,2986,3825,1471,2354,0.0177475792750952,0.00682527819965098,0.0109223010754442,EPCI
246000921,CC des Pays d'Oise et d'Halatte,1990_1999,1994.5,9,29136,32751,1799,3918,3615,2119,1496,0.0130802491645452,0.00766723318939731,0.00541301597514789,EPCI
246000921,CC des Pays d'Oise et d'Halatte,1999_2006,2002.5,7,32751,33191,1411,2858,440,1447,-1007,0.00190828401357224,0.00627565219917961,-0.00436736818560737,EPCI
246100390,CC du Val d'Orne,2006_2011,2008.5,5,5674,5763,222,342,89,120,-31,0.00311761690411716,0.00420352841004561,-0.00108591150592845,EPCI
246100390,CC du Val d'Orne,2011_2016,2013.5,5,5763,5751,223,287,-12,64,-76,-0.00041679706054476,0.00222291765623872,-0.00263971471678348,EPCI
246100390,CC du Val d'Orne,1968_1975,1971.5,7,6510,5699,553,579,-811,26,-837,-0.0188274688958306,0.000603593330815779,-0.0194310622266464,EPCI
246100390,CC du Val d'Orne,1975_1982,1978.5,7,5699,5394,462,453,-305,-9,-296,-0.00782685173362852,-0.000230956280664448,-0.00759589545296407,EPCI
246100390,CC du Val d'Orne,1982_1990,1986,8,5394,5254,444,471,-140,27,-167,-0.00328179478236457,0.000632917565170309,-0.00391471234753488,EPCI
246100390,CC du Val d'Orne,1990_1999,1994.5,9,5254,5155,462,495,-99,33,-132,-0.00211138719009141,0.000703795730030469,-0.00281518292012188,EPCI
246100390,CC du Val d'Orne,1999_2006,2002.5,7,5155,5674,343,438,519,95,424,0.0137982170930531,0.00252568520971106,0.011272531883342,EPCI
246100663,CU d'Alençon,2006_2011,2008.5,5,57967,56530,2419,3415,-1437,996,-2433,-0.00500790092571979,0.00347102945164712,-0.00847893037736691,EPCI
246100663,CU d'Alençon,2011_2016,2013.5,5,56530,56511,2609,3120,-19,511,-530,-6.72299837648493e-05,0.00180813272125463,-0.00187536270501948,EPCI
246100663,CU d'Alençon,1968_1975,1971.5,7,48530,53590,3005,7673,5060,4668,392,0.0142694677533046,0.0131640070103609,0.00110546074294376,EPCI
246100663,CU d'Alençon,1975_1982,1978.5,7,53590,56861,2816,6674,3271,3858,-587,0.00849980704983144,0.01002514692701,-0.00152533987717856,EPCI
246100663,CU d'Alençon,1982_1990,1986,8,56861,57340,3326,6782,479,3456,-2977,0.00104914588529947,0.00756962041669099,-0.00652047453139151,EPCI
246100663,CU d'Alençon,1990_1999,1994.5,9,57340,57942,3819,6834,602,3015,-2413,0.00116112355566567,0.00581526166168104,-0.00465413810601537,EPCI
246100663,CU d'Alençon,1999_2006,2002.5,7,57942,57967,3242,4796,25,1554,-1529,6.16265979893615e-05,0.00383070933101871,-0.00376908273302935,EPCI
246200299,CA d'Hénin-Carvin,2006_2011,2008.5,5,124580,124434,5808,8961,-146,3153,-3299,-0.000234497494504882,0.00506418219297186,-0.00529867968747674,EPCI
246200299,CA d'Hénin-Carvin,2011_2016,2013.5,5,124434,125453,6046,9085,1019,3039,-2020,0.00163247735818728,0.00486859537932399,-0.00323611802113671,EPCI
246200299,CA d'Hénin-Carvin,1968_1975,1971.5,7,127920,126887,9091,16596,-1033,7505,-8538,-0.00115763541132397,0.00841050702999648,-0.00956814244132044,EPCI
246200299,CA d'Hénin-Carvin,1975_1982,1978.5,7,126887,128905,9215,15304,2018,6089,-4071,0.00225665275207199,0.00680909742684159,-0.0045524446747696,EPCI
246200299,CA d'Hénin-Carvin,1982_1990,1986,8,128905,129039,10041,18053,134,8012,-7878,0.000129881596328651,0.00776575634168027,-0.00763587474535161,EPCI
246200299,CA d'Hénin-Carvin,1990_1999,1994.5,9,129039,125313,10615,16011,-3726,5396,-9122,-0.0032502704789269,0.00470704763936917,-0.00795731811829607,EPCI
246200299,CA d'Hénin-Carvin,1999_2006,2002.5,7,125313,124580,8130,12296,-733,4166,-4899,-0.000837724297463205,0.00476119975884272,-0.00559892405630592,EPCI
246200364,CA de Lens - Liévin,2006_2011,2008.5,5,246097,243987,12373,17548,-2110,5175,-7285,-0.00172068231997224,0.00422015687481344,-0.00594083919478569,EPCI
246200364,CA de Lens - Liévin,2011_2016,2013.5,5,243987,242386,12451,16958,-1601,4507,-6108,-0.0013158232311935,0.00370419444284142,-0.00502001767403492,EPCI
246200364,CA de Lens - Liévin,1968_1975,1971.5,7,277620,262363,19127,34335,-15257,15208,-30465,-0.0080423758094712,0.00801654658913535,-0.0160589223986066,EPCI
246200364,CA de Lens - Liévin,1975_1982,1978.5,7,262363,254282,19528,29144,-8081,9616,-17697,-0.0044593351706782,0.00530639363955471,-0.00976572881023291,EPCI
246200364,CA de Lens - Liévin,1982_1990,1986,8,254282,251585,21457,34232,-2697,12775,-15472,-0.0013319849664456,0.00630927250513256,-0.00764125747157816,EPCI
246200364,CA de Lens - Liévin,1990_1999,1994.5,9,251585,250199,22757,32013,-1386,9256,-10642,-0.000613623143466802,0.0040979046290972,-0.004711527772564,EPCI
246200364,CA de Lens - Liévin,1999_2006,2002.5,7,250199,246097,17569,24161,-4102,6592,-10694,-0.00235876146363767,0.00379057912440262,-0.00614934058804029,EPCI
246200380,CC de la Terre des Deux Caps,2006_2011,2008.5,5,21459,21987,892,1407,528,515,13,0.00487328236612372,0.00475329624726083,0.000119986118862894,EPCI
246200380,CC de la Terre des Deux Caps,2011_2016,2013.5,5,21987,22134,940,1300,147,360,-213,0.00133359209029216,0.00326593981296039,-0.00193234772266823,EPCI
246200380,CC de la Terre des Deux Caps,1968_1975,1971.5,7,18384,18467,1266,2389,83,1123,-1040,0.000643726296803981,0.00870969435314303,-0.00806596805633904,EPCI
246200380,CC de la Terre des Deux Caps,1975_1982,1978.5,7,18467,18977,1321,1800,510,479,31,0.0038993490572099,0.00366232980079126,0.000237019256418641,EPCI
246200380,CC de la Terre des Deux Caps,1982_1990,1986,8,18977,19701,1417,2270,724,853,-129,0.0046911788249755,0.0055270380355029,-0.000835859210527402,EPCI
246200380,CC de la Terre des Deux Caps,1990_1999,1994.5,9,19701,20561,1589,2452,860,863,-3,0.0047586958736856,0.00477529597557055,-1.66001018849496e-05,EPCI
246200380,CC de la Terre des Deux Caps,1999_2006,2002.5,7,20561,21459,1191,2054,898,863,35,0.00612555067184828,0.00588680426481633,0.000238746407031949,EPCI
246200729,CA du Boulonnais,2006_2011,2008.5,5,120397,117684,5911,8007,-2713,2096,-4809,-0.00454793655761321,0.0035136288333053,-0.00806156539091851,EPCI
246200729,CA du Boulonnais,2011_2016,2013.5,5,117684,114762,5833,7124,-2922,1291,-4213,-0.00501590762319459,0.00221613167061746,-0.00723203929381205,EPCI
246200729,CA du Boulonnais,1968_1975,1971.5,7,116128,120968,8582,16628,4840,8046,-3206,0.0058503348665746,0.00972557734224365,-0.00387524247566904,EPCI
246200729,CA du Boulonnais,1975_1982,1978.5,7,120968,120990,8885,14211,22,5326,-5304,2.59788721619358e-05,0.00628924877883956,-0.00626326990667762,EPCI
246200729,CA du Boulonnais,1982_1990,1986,8,120990,119925,9680,16257,-1065,6577,-7642,-0.00110455829656453,0.00682129569624874,-0.00792585399281326,EPCI
246200729,CA du Boulonnais,1990_1999,1994.5,9,119925,122755,10384,16540,2830,6156,-3326,0.00259491115275523,0.00564461945454459,-0.00304970830178936,EPCI
246200729,CA du Boulonnais,1999_2006,2002.5,7,122755,120397,8088,11971,-2358,3883,-6241,-0.00276700525342066,0.00455652306998831,-0.00732352832340897,EPCI
246200844,CC de la Région d'Audruicq,2006_2011,2008.5,5,25318,26387,847,1777,1069,930,139,0.0083054725287004,0.00722552801842037,0.00107994451028003,EPCI
246200844,CC de la Région d'Audruicq,2011_2016,2013.5,5,26387,27090,935,1817,703,882,-179,0.0052724892002356,0.00661498645036671,-0.00134249725013111,EPCI
246200844,CC de la Région d'Audruicq,1968_1975,1971.5,7,16047,16191,1267,2165,144,898,-754,0.00127704559880115,0.00796379824807941,-0.00668675264927825,EPCI
246200844,CC de la Région d'Audruicq,1975_1982,1978.5,7,16191,20172,1269,2271,3981,1002,2979,0.031904073054897,0.00803011333861008,0.0238739597162869,EPCI
246200844,CC de la Région d'Audruicq,1982_1990,1986,8,20172,22918,1377,3010,2746,1633,1113,0.0160813252331569,0.00956329355635293,0.00651803167680393,EPCI
246200844,CC de la Région d'Audruicq,1990_1999,1994.5,9,22918,24026,1437,2867,1108,1430,-322,0.00525977868816496,0.00678834253075442,-0.00152856384258946,EPCI
246200844,CC de la Région d'Audruicq,1999_2006,2002.5,7,24026,25318,1121,2447,1292,1326,-34,0.00751078376840875,0.00770843597284056,-0.00019765220443181,EPCI
246201016,CC du Pays de Lumbres,2006_2011,2008.5,5,21950,23473,923,1617,1523,694,829,0.0135071452763988,0.00615493028353303,0.00735221499286582,EPCI
246201016,CC du Pays de Lumbres,2011_2016,2013.5,5,23473,24257,916,1575,784,659,125,0.00659251782419634,0.00554141485477728,0.00105110296941906,EPCI
246201016,CC du Pays de Lumbres,1968_1975,1971.5,7,17334,17368,1275,2324,34,1049,-1015,0.000279973737309813,0.0086380132481763,-0.00835803951086648,EPCI
246201016,CC du Pays de Lumbres,1975_1982,1978.5,7,17368,18535,1347,2052,1167,705,462,0.00933348843573234,0.00563848273109794,0.0036950057046344,EPCI
246201016,CC du Pays de Lumbres,1982_1990,1986,8,18535,20126,1457,2533,1591,1076,515,0.0103471244330018,0.00699780382772465,0.00334932060527713,EPCI
246201016,CC du Pays de Lumbres,1990_1999,1994.5,9,20126,20376,1539,2155,250,616,-366,0.00137263299571178,0.00338216770143382,-0.00200953470572204,EPCI
246201016,CC du Pays de Lumbres,1999_2006,2002.5,7,20376,21950,1207,2005,1574,798,776,0.0106866128119492,0.00541799048534652,0.00526862232660264,EPCI
246201149,CA du Calaisis,2006_2011,2008.5,5,101774,100523,4287,7828,-1251,3541,-4792,-0.00247056545890878,0.00699302341326618,-0.00946358887217496,EPCI
246201149,CA du Calaisis,2011_2016,2013.5,5,100523,103575,4505,7157,3052,2652,400,0.00599981339479982,0.00521346825786669,0.000786345136933135,EPCI
246201149,CA du Calaisis,1968_1975,1971.5,7,92304,98090,6970,13826,5786,6856,-1070,0.00872324871506902,0.0103364315918619,-0.00161318287679292,EPCI
246201149,CA du Calaisis,1975_1982,1978.5,7,98090,99068,7337,12618,978,5281,-4303,0.00141829890145129,0.00765852402716181,-0.00624022512571052,EPCI
246201149,CA du Calaisis,1982_1990,1986,8,99068,100214,7781,14340,1146,6559,-5413,0.00143871100490434,0.00823429797658599,-0.00679558697168165,EPCI
246201149,CA du Calaisis,1990_1999,1994.5,9,100214,103070,7720,15021,2856,7301,-4445,0.00312715377553818,0.00799417006834884,-0.00486701629281065,EPCI
246201149,CA du Calaisis,1999_2006,2002.5,7,103070,101774,6085,10842,-1296,4757,-6053,-0.00180603861790474,0.00662910934056546,-0.0084351479584702,EPCI
246300701,Clermont Auvergne Métropole,2006_2011,2008.5,5,279621,281727,10993,15685,2106,4692,-2586,0.00150180700420188,0.00334590620309365,-0.00184409919889177,EPCI
246300701,Clermont Auvergne Métropole,2011_2016,2013.5,5,281727,288435,11543,15638,6708,4095,2613,0.00471733984602207,0.00287977141762975,0.00183756842839232,EPCI
246300701,Clermont Auvergne Métropole,1968_1975,1971.5,7,230379,263791,13975,32768,33412,18793,14619,0.019535707430929,0.0109881045657084,0.00854760286522062,EPCI
246300701,Clermont Auvergne Métropole,1975_1982,1978.5,7,263791,269841,14472,29152,6050,14680,-8630,0.00324464875702368,0.00787296590960457,-0.00462831715258089,EPCI
246300701,Clermont Auvergne Métropole,1982_1990,1986,8,269841,270032,16700,28486,191,11786,-11595,8.84506425034015e-05,0.00545800666253974,-0.00536955602003634,EPCI
246300701,Clermont Auvergne Métropole,1990_1999,1994.5,9,270032,275391,19236,27023,5359,7787,-2428,0.0021858783928792,0.00317623344753692,-0.000990355054657717,EPCI
246300701,Clermont Auvergne Métropole,1999_2006,2002.5,7,275391,279621,15126,21236,4230,6110,-1880,0.00217997395462533,0.00314885126779214,-0.000968877313166811,EPCI
246300966,CC du Massif du Sancy,2006_2011,2008.5,5,10217,9797,719,410,-420,-309,-111,-0.00836021405635345,-0.00615072891288861,-0.00220948514346484,EPCI
246300966,CC du Massif du Sancy,2011_2016,2013.5,5,9797,9637,699,371,-160,-328,168,-0.00328785502681384,-0.00674010280496836,0.00345224777815453,EPCI
246300966,CC du Massif du Sancy,1968_1975,1971.5,7,13730,12965,1236,1232,-765,-4,-761,-0.0081565250951624,-4.26484972296073e-05,-0.0081138765979328,EPCI
246300966,CC du Massif du Sancy,1975_1982,1978.5,7,12965,12454,1143,969,-511,-174,-337,-0.00572804079177691,-0.00195044833222932,-0.00377759245954759,EPCI
246300966,CC du Massif du Sancy,1982_1990,1986,8,12454,11515,1259,995,-939,-264,-675,-0.00975106245557889,-0.00274151276706371,-0.00700954968851517,EPCI
246300966,CC du Massif du Sancy,1990_1999,1994.5,9,11515,10616,1271,915,-899,-356,-543,-0.00899136002500778,-0.0035605385638518,-0.00543082146115598,EPCI
246300966,CC du Massif du Sancy,1999_2006,2002.5,7,10616,10217,974,638,-399,-336,-63,-0.00545780852283218,-0.00459604928238499,-0.000861759240447186,EPCI
246301097,CC Entre Dore et Allier,2006_2011,2008.5,5,16574,17693,1040,1097,1119,57,1062,0.0131525191110462,0.000669967461420584,0.0124825516496256,EPCI
246301097,CC Entre Dore et Allier,2011_2016,2013.5,5,17693,18861,1086,1094,1168,8,1160,0.0128675266194089,8.81337439685543e-05,0.0127793928754404,EPCI
246301097,CC Entre Dore et Allier,1968_1975,1971.5,7,11429,12391,1471,1072,962,-399,1361,0.0116121056039538,-0.00481624754259621,0.01642835314655,EPCI
246301097,CC Entre Dore et Allier,1975_1982,1978.5,7,12391,13257,1430,869,866,-561,1427,0.00969747762620021,-0.0062820842359103,0.0159795618621105,EPCI
246301097,CC Entre Dore et Allier,1982_1990,1986,8,13257,14215,1543,1189,958,-354,1312,0.00875964690774511,-0.00323686326236093,0.011996510170106,EPCI
246301097,CC Entre Dore et Allier,1990_1999,1994.5,9,14215,14893,1735,1316,678,-419,1097,0.005190486230785,-0.00320768986828748,0.00839817609907248,EPCI
246301097,CC Entre Dore et Allier,1999_2006,2002.5,7,14893,16574,1307,1212,1681,-95,1776,0.0153950004445396,-0.000870032743742569,0.0162650331882821,EPCI
246400337,CC de la Vallée d'Ossau,2006_2011,2008.5,5,9998,10138,572,450,140,-122,262,0.00278500435098383,-0.0024269323630002,0.00521193671398403,EPCI
246400337,CC de la Vallée d'Ossau,2011_2016,2013.5,5,10138,9818,612,392,-320,-220,-100,-0.00639413086689078,-0.00439596497098741,-0.00199816589590337,EPCI
246400337,CC de la Vallée d'Ossau,1968_1975,1971.5,7,11500,11016,946,1050,-484,104,-588,-0.00612378330023811,0.00131585426286108,-0.00743963756309919,EPCI
246400337,CC de la Vallée d'Ossau,1975_1982,1978.5,7,11016,10609,904,764,-407,-140,-267,-0.00536357353433026,-0.00184496386930279,-0.00351860966502747,EPCI
246400337,CC de la Vallée d'Ossau,1982_1990,1986,8,10609,10469,996,784,-140,-212,72,-0.00165914561110103,-0.00251242049681013,0.000853274885709102,EPCI
246400337,CC de la Vallée d'Ossau,1990_1999,1994.5,9,10469,9953,1053,841,-516,-212,-304,-0.00560031456210086,-0.00230090443249105,-0.00329941012960981,EPCI
246400337,CC de la Vallée d'Ossau,1999_2006,2002.5,7,9953,9998,791,651,45,-140,185,0.000644644798124983,-0.00200556159416661,0.0026502063922916,EPCI
246401756,CC Pays de Nay,2006_2011,2008.5,5,26139,27513,1314,1408,1374,94,1280,0.0102987040021172,0.000704569269431598,0.00959413473268559,EPCI
246401756,CC Pays de Nay,2011_2016,2013.5,5,27513,28598,1350,1347,1085,-3,1088,0.00776563032170707,-2.14717889079458e-05,0.00778710211061502,EPCI
246401756,CC Pays de Nay,1968_1975,1971.5,7,20993,21447,1913,2007,454,94,360,0.00306120833374624,0.000633818465577414,0.00242738986816882,EPCI
246401756,CC Pays de Nay,1975_1982,1978.5,7,21447,22897,1776,1785,1450,9,1441,0.00938968365169734,5.82807950795008e-05,0.00933140285661784,EPCI
246401756,CC Pays de Nay,1982_1990,1986,8,22897,23692,1965,1961,795,-4,799,0.00427555682378666,-2.15122355913794e-05,0.00429706905937804,EPCI
246401756,CC Pays de Nay,1990_1999,1994.5,9,23692,24533,2429,2123,841,-306,1147,0.00388326614878265,-0.00141293631572829,0.00529620246451094,EPCI
246401756,CC Pays de Nay,1999_2006,2002.5,7,24533,26139,1859,1825,1606,-34,1640,0.00909962381925844,-0.000192644588950677,0.00929226840820912,EPCI
246500482,CC de la Haute-Bigorre,2006_2011,2008.5,5,17196,17352,1064,719,156,-345,501,0.0018078271307711,-0.00399807923151301,0.00580590636228411,EPCI
246500482,CC de la Haute-Bigorre,2011_2016,2013.5,5,17352,16955,1181,590,-397,-591,194,-0.00461830228310234,-0.00687510491010953,0.00225680262700719,EPCI
246500482,CC de la Haute-Bigorre,1968_1975,1971.5,7,18786,18183,1868,1457,-603,-411,-192,-0.00464984440683369,-0.00316929693401102,-0.00148054747282267,EPCI
246500482,CC de la Haute-Bigorre,1975_1982,1978.5,7,18183,17802,1826,1206,-381,-620,239,-0.00302061175901436,-0.00491543120889476,0.0018948194498804,EPCI
246500482,CC de la Haute-Bigorre,1982_1990,1986,8,17802,17236,2014,1276,-566,-738,172,-0.00403067876806029,-0.00525554934775353,0.00122487057969323,EPCI
246500482,CC de la Haute-Bigorre,1990_1999,1994.5,9,17236,16918,2135,1303,-318,-832,514,-0.00206698038911113,-0.00540794869100773,0.0033409683018966,EPCI
246500482,CC de la Haute-Bigorre,1999_2006,2002.5,7,16918,17196,1466,1023,278,-443,721,0.00233109203033433,-0.00371465384689966,0.00604574587723399,EPCI
246500573,CC Aure-Louron,2006_2011,2008.5,5,7283,7142,364,353,-141,-11,-130,-0.00390236910318131,-0.000304440142801379,-0.00359792896037993,EPCI
246500573,CC Aure-Louron,2011_2016,2013.5,5,7142,6943,377,287,-199,-90,-109,-0.00563583702764059,-0.00254887101752589,-0.00308696601011469,EPCI
246500573,CC Aure-Louron,1968_1975,1971.5,7,6793,6222,636,491,-571,-145,-426,-0.0124647027737722,-0.00316529229806825,-0.00929941047570396,EPCI
246500573,CC Aure-Louron,1975_1982,1978.5,7,6222,6334,609,388,112,-221,333,0.00255190051792975,-0.00503544655770067,0.00758734707563042,EPCI
246500573,CC Aure-Louron,1982_1990,1986,8,6334,6707,705,536,373,-169,542,0.00717811617600161,-0.00325228320038679,0.0104303993763884,EPCI
246500573,CC Aure-Louron,1990_1999,1994.5,9,6707,6874,698,666,167,-32,199,0.00273645074388851,-0.000524349843140313,0.00326080058702882,EPCI
246500573,CC Aure-Louron,1999_2006,2002.5,7,6874,7283,523,486,409,-37,446,0.00829084984705908,-0.000750027981274293,0.00904087782833337,EPCI
246600282,CC Sud-Roussillon,2006_2011,2008.5,5,19752,21191,1257,977,1439,-280,1719,0.014163730686483,-0.00275597261446508,0.0169197033009481,EPCI
246600282,CC Sud-Roussillon,2011_2016,2013.5,5,21191,22767,1294,958,1576,-336,1912,0.0144505249408513,-0.00308082257622211,0.0175313475170734,EPCI
246600282,CC Sud-Roussillon,1968_1975,1971.5,7,5309,6686,439,496,1377,57,1320,0.0334932960643279,0.00138643273468896,0.032106863329639,EPCI
246600282,CC Sud-Roussillon,1975_1982,1978.5,7,6686,9067,562,635,2381,73,2308,0.0444787441286778,0.00136369102116484,0.043115053107513,EPCI
246600282,CC Sud-Roussillon,1982_1990,1986,8,9067,13391,866,1058,4324,192,4132,0.049950136355124,0.00221795240059755,0.0477321839545265,EPCI
246600282,CC Sud-Roussillon,1990_1999,1994.5,9,13391,16734,1560,1401,3343,-159,3502,0.0250713225560586,-0.00119244399832884,0.0262637665543874,EPCI
246600282,CC Sud-Roussillon,1999_2006,2002.5,7,16734,19752,1720,1227,3018,-493,3511,0.0239702295122801,-0.00391561403232409,0.0278858435446042,EPCI
246600373,CC du Vallespir,2006_2011,2008.5,5,19507,20191,1233,845,684,-388,1072,0.00691652645747509,-0.00392340974488353,0.0108399362023586,EPCI
246600373,CC du Vallespir,2011_2016,2013.5,5,20191,20692,1379,843,501,-536,1037,0.00491407296115565,-0.00525737147141602,0.0101714444325717,EPCI
246600373,CC du Vallespir,1968_1975,1971.5,7,12079,13645,1290,836,1566,-454,2020,0.0175674883899715,-0.00509300110411689,0.0226604894940884,EPCI
246600373,CC du Vallespir,1975_1982,1978.5,7,13645,15577,1533,935,1932,-598,2530,0.019097542402053,-0.00591114407682592,0.0250086864788789,EPCI
246600373,CC du Vallespir,1982_1990,1986,8,15577,17180,1917,1176,1603,-741,2344,0.0123190683977821,-0.00569459119323551,0.0180136595910176,EPCI
246600373,CC du Vallespir,1990_1999,1994.5,9,17180,18097,2265,1425,917,-840,1757,0.00579453062203394,-0.00530796698201583,0.0111024976040498,EPCI
246600373,CC du Vallespir,1999_2006,2002.5,7,18097,19507,1747,1108,1410,-639,2049,0.0107758163377936,-0.00488350825521283,0.0156593245930064,EPCI
246600399,CC Pyrénées Cerdagne,2006_2011,2008.5,5,8847,8919,443,247,72,-196,268,0.00162239750164339,-0.00441652653225145,0.00603892403389485,EPCI
246600399,CC Pyrénées Cerdagne,2011_2016,2013.5,5,8919,8705,386,205,-214,-181,-33,-0.0048454745210782,-0.00409827517904277,-0.000747199342035423,EPCI
246600399,CC Pyrénées Cerdagne,1968_1975,1971.5,7,5780,6433,469,567,653,98,555,0.0154085504331269,0.00231246239272043,0.0130960880404065,EPCI
246600399,CC Pyrénées Cerdagne,1975_1982,1978.5,7,6433,7068,494,540,635,46,589,0.0135389124374941,0.000980771609645239,0.0125581408278488,EPCI
246600399,CC Pyrénées Cerdagne,1982_1990,1986,8,7068,7409,586,708,341,122,219,0.00590711899473195,0.00211339741160498,0.00379372158312697,EPCI
246600399,CC Pyrénées Cerdagne,1990_1999,1994.5,9,7409,8043,715,747,634,32,602,0.00916470445549344,0.000462571833715758,0.00870213262177769,EPCI
246600399,CC Pyrénées Cerdagne,1999_2006,2002.5,7,8043,8847,557,430,804,-127,931,0.0137039457242618,-0.00216467799375777,0.0158686237180196,EPCI
246600415,CC Roussillon-Conflent,2006_2011,2008.5,5,16040,17355,1021,1017,1315,-4,1319,0.0158838374234149,-4.83158552803496e-05,0.0159321532786953,EPCI
246600415,CC Roussillon-Conflent,2011_2016,2013.5,5,17355,18353,1076,1017,998,-59,1057,0.0112452375515391,-0.000664798612766337,0.0119100361643054,EPCI
246600415,CC Roussillon-Conflent,1968_1975,1971.5,7,13292,12644,1318,977,-648,-341,-307,-0.00711450779999634,-0.00374389993796104,-0.0033706078620353,EPCI
246600415,CC Roussillon-Conflent,1975_1982,1978.5,7,12644,13004,1437,792,360,-645,1005,0.00401865437877347,-0.00720008909530246,0.0112187434740759,EPCI
246600415,CC Roussillon-Conflent,1982_1990,1986,8,13004,13521,1570,1067,517,-503,1020,0.00488527296588792,-0.00475298317570914,0.00963825614159706,EPCI
246600415,CC Roussillon-Conflent,1990_1999,1994.5,9,13521,14636,1848,1270,1115,-578,1693,0.00884334164261791,-0.00458426140756336,0.0134276030501813,EPCI
246600415,CC Roussillon-Conflent,1999_2006,2002.5,7,14636,16040,1385,1147,1404,-238,1642,0.0131719030890698,-0.00223284397093918,0.015404747060009,EPCI
246600423,CC Agly Fenouillèdes,2006_2011,2008.5,5,6091,6212,411,296,121,-115,236,0.00394187552111114,-0.00374641061923786,0.007688286140349,EPCI
246600423,CC Agly Fenouillèdes,2011_2016,2013.5,5,6212,5947,505,242,-265,-263,-2,-0.00868130090111996,-0.00861578164903603,-6.55192520839249e-05,EPCI
246600423,CC Agly Fenouillèdes,1968_1975,1971.5,7,8077,7128,755,490,-949,-265,-684,-0.0176972212353025,-0.00494179518161766,-0.0127554260536848,EPCI
246600423,CC Agly Fenouillèdes,1975_1982,1978.5,7,7128,6736,761,357,-392,-404,12,-0.00804806992912188,-0.00829443941674806,0.000246369487626181,EPCI
246600423,CC Agly Fenouillèdes,1982_1990,1986,8,6736,6112,830,383,-624,-447,-177,-0.0120779964585742,-0.00865202630926711,-0.00342597014930711,EPCI
246600423,CC Agly Fenouillèdes,1990_1999,1994.5,9,6112,5750,858,394,-362,-464,102,-0.00676084164732305,-0.00866583017778424,0.00190498853046119,EPCI
246600423,CC Agly Fenouillèdes,1999_2006,2002.5,7,5750,6091,636,305,341,-331,672,0.00826430769412845,-0.0080219526297845,0.016286260323913,EPCI
246600449,CC des Aspres,2006_2011,2008.5,5,17808,19066,883,944,1258,61,1197,0.0137453808182548,0.00066650892679932,0.0130788718914555,EPCI
246600449,CC des Aspres,2011_2016,2013.5,5,19066,20996,932,1040,1930,108,1822,0.0194722178121225,0.0010896370589167,0.0183825807532058,EPCI
246600449,CC des Aspres,1968_1975,1971.5,7,10366,11908,1103,843,1542,-260,1802,0.0200088641755181,-0.00337373844723391,0.023382602622752,EPCI
246600449,CC des Aspres,1975_1982,1978.5,7,11908,12859,1168,848,951,-320,1271,0.011036675681928,-0.00371370790559092,0.0147503835875189,EPCI
246600449,CC des Aspres,1982_1990,1986,8,12859,14309,1399,1112,1450,-287,1737,0.0134451786525116,-0.00266121811949712,0.0161063967720087,EPCI
246600449,CC des Aspres,1990_1999,1994.5,9,14309,16040,1501,1500,1731,-1,1732,0.0127693847390222,-7.37688315368124e-06,0.0127767616221759,EPCI
246600449,CC des Aspres,1999_2006,2002.5,7,16040,17808,1204,1285,1768,81,1687,0.0150495773833492,0.000689488556590095,0.0143600888267591,EPCI
246600464,CC Pyrénées catalanes,2006_2011,2008.5,5,6284,5931,152,241,-353,89,-442,-0.011496185505469,0.00289847169967916,-0.0143946572051482,EPCI
246600464,CC Pyrénées catalanes,2011_2016,2013.5,5,5931,5973,199,201,42,2,40,0.00141229252582642,6.72520250393533e-05,0.00134504050078707,EPCI
246600464,CC Pyrénées catalanes,1968_1975,1971.5,7,4522,4829,305,505,307,200,107,0.00942773992858847,0.00614185011634428,0.00328588981224419,EPCI
246600464,CC Pyrénées catalanes,1975_1982,1978.5,7,4829,5189,291,440,360,149,211,0.0103245907607203,0.00427323339818703,0.00605135736253331,EPCI
246600464,CC Pyrénées catalanes,1982_1990,1986,8,5189,5253,323,657,64,334,-270,0.00153346725858117,0.00800278225572047,-0.0064693149971393,EPCI
246600464,CC Pyrénées catalanes,1990_1999,1994.5,9,5253,5926,360,761,673,401,272,0.0134845639484011,0.0080346361713356,0.00544992777706554,EPCI
246600464,CC Pyrénées catalanes,1999_2006,2002.5,7,5926,6284,223,475,358,252,106,0.00841481738296768,0.00592327927516161,0.00249153810780607,EPCI
246600548,CC du Haut Vallespir,2006_2011,2008.5,5,10187,10037,953,362,-150,-591,441,-0.00296242987448658,-0.0116719737054771,0.00870954383099056,EPCI
246600548,CC du Haut Vallespir,2011_2016,2013.5,5,10037,9726,976,319,-311,-657,346,-0.00627533787366252,-0.0132569034823031,0.00698156560864062,EPCI
246600548,CC du Haut Vallespir,1968_1975,1971.5,7,11350,11283,1314,572,-67,-742,675,-0.000845438953658295,-0.00936292094946948,0.00851748199581118,EPCI
246600548,CC du Haut Vallespir,1975_1982,1978.5,7,11283,10657,1477,578,-626,-899,273,-0.0081211601620762,-0.0116628162710967,0.00354165610902045,EPCI
246600548,CC du Haut Vallespir,1982_1990,1986,8,10657,10062,1712,628,-595,-1084,489,-0.00715565068754642,-0.0130365131853787,0.00588086249783227,EPCI
246600548,CC du Haut Vallespir,1990_1999,1994.5,9,10062,9734,1807,620,-328,-1187,859,-0.00367556635903998,-0.0133015160615258,0.00962594970248581,EPCI
246600548,CC du Haut Vallespir,1999_2006,2002.5,7,9734,10187,1374,544,453,-830,1283,0.00651937150291859,-0.0119449853143983,0.0184643568173169,EPCI
246700306,CC de la Vallée de la Bruche,2006_2011,2008.5,5,21300,21623,1088,1076,323,-12,335,0.00301463294944404,-0.000111998747347766,0.00312663169679181,EPCI
246700306,CC de la Vallée de la Bruche,2011_2016,2013.5,5,21623,21203,1128,937,-420,-191,-229,-0.00391529155884274,-0.00178052544699753,-0.00213476611184521,EPCI
246700306,CC de la Vallée de la Bruche,1968_1975,1971.5,7,19660,19399,1787,2039,-261,252,-513,-0.00190740663633648,0.00184163399370419,-0.00374904063004068,EPCI
246700306,CC de la Vallée de la Bruche,1975_1982,1978.5,7,19399,18881,1721,1576,-518,-145,-373,-0.00385901947716305,-0.00108022745982363,-0.00277879201733942,EPCI
246700306,CC de la Vallée de la Bruche,1982_1990,1986,8,18881,18635,1904,1871,-246,-33,-213,-0.00163798110290669,-0.000219729172341142,-0.00141825193056555,EPCI
246700306,CC de la Vallée de la Bruche,1990_1999,1994.5,9,18635,19989,1969,2004,1354,35,1319,0.00782384639087108,0.000202241228715279,0.0076216051621558,EPCI
246700306,CC de la Vallée de la Bruche,1999_2006,2002.5,7,19989,21300,1483,1689,1311,206,1105,0.00911629551782878,0.00143246138571528,0.0076838341321135,EPCI
246700488,Eurométropole de Strasbourg,2006_2011,2008.5,5,473915,476503,16965,32152,2588,15187,-12599,0.00108980105451506,0.00639521198412683,-0.00530541092961177,EPCI
246700488,Eurométropole de Strasbourg,2011_2016,2013.5,5,476503,491409,18034,32311,14906,14277,629,0.00617956641463602,0.00591880247563118,0.000260763939004834,EPCI
246700488,Eurométropole de Strasbourg,1968_1975,1971.5,7,369808,397665,27114,48566,27857,21452,6405,0.0104291498676377,0.00803123534338094,0.00239791452425671,EPCI
246700488,Eurométropole de Strasbourg,1975_1982,1978.5,7,397665,409098,26728,43490,11433,16762,-5329,0.00405746557736308,0.00594867821287151,-0.00189121263550843,EPCI
246700488,Eurométropole de Strasbourg,1982_1990,1986,8,409098,430272,29106,51422,21174,22316,-1142,0.00632779024454999,0.00666907372708877,-0.000341283482538778,EPCI
246700488,Eurométropole de Strasbourg,1990_1999,1994.5,9,430272,458629,31411,58523,28357,27112,1245,0.00711676437824438,0.00680430637313403,0.000312458005110352,EPCI
246700488,Eurométropole de Strasbourg,1999_2006,2002.5,7,458629,473915,23473,44791,15286,21318,-6032,0.00469475403824649,0.00654734833097858,-0.00185259429273209,EPCI
246700744,CC des Portes de Rosheim,2006_2011,2008.5,5,16948,17686,628,935,738,307,431,0.00856114545952824,0.00356134370741893,0.00499980175210931,EPCI
246700744,CC des Portes de Rosheim,2011_2016,2013.5,5,17686,17882,624,842,196,218,-22,0.00220668197873919,0.00245437077227114,-0.00024768879353195,EPCI
246700744,CC des Portes de Rosheim,1968_1975,1971.5,7,10034,11119,996,1065,1085,69,1016,0.0147761074615689,0.000939678723362445,0.0138364287382064,EPCI
246700744,CC des Portes de Rosheim,1975_1982,1978.5,7,11119,12400,934,966,1281,32,1249,0.0156992608821478,0.000392175135229297,0.0153070857469185,EPCI
246700744,CC des Portes de Rosheim,1982_1990,1986,8,12400,13525,1074,1254,1125,180,945,0.0109145528566963,0.00174632845707141,0.00916822439962488,EPCI
246700744,CC des Portes de Rosheim,1990_1999,1994.5,9,13525,15645,1132,1615,2120,483,1637,0.0163106510982096,0.00371605871718644,0.0125945923810232,EPCI
246700744,CC des Portes de Rosheim,1999_2006,2002.5,7,15645,16948,860,1372,1303,512,791,0.0114939038904929,0.00451640736142161,0.00697749652907127,EPCI
246700777,CC de la Vallée de Villé,2006_2011,2008.5,5,10392,10819,457,590,427,133,294,0.0080860304414363,0.00251859964569327,0.00556743079574303,EPCI
246700777,CC de la Vallée de Villé,2011_2016,2013.5,5,10819,10942,481,508,123,27,96,0.00226350746113568,0.000496867491468808,0.00176663996966687,EPCI
246700777,CC de la Vallée de Villé,1968_1975,1971.5,7,8623,8839,821,864,216,43,173,0.00354063846262354,0.000704849323577834,0.0028357891390457,EPCI
246700777,CC de la Vallée de Villé,1975_1982,1978.5,7,8839,8922,729,706,83,-23,106,0.00133609014952829,-0.000370241848664466,0.00170633199819276,EPCI
246700777,CC de la Vallée de Villé,1982_1990,1986,8,8922,9092,809,791,170,-18,188,0.00236213160786125,-0.000250108052597074,0.00261223966045832,EPCI
246700777,CC de la Vallée de Villé,1990_1999,1994.5,9,9092,9768,841,887,676,46,630,0.0080003700453255,0.000544403878823925,0.00745596616650158,EPCI
246700777,CC de la Vallée de Villé,1999_2006,2002.5,7,9768,10392,666,701,624,35,589,0.00888560793293558,0.000498391470597348,0.00838721646233823,EPCI
246700843,CC de la Basse-Zorn,2006_2011,2008.5,5,16350,16890,549,830,540,281,259,0.00651992949877167,0.00339277812806452,0.00312715137070715,EPCI
246700843,CC de la Basse-Zorn,2011_2016,2013.5,5,16890,17189,603,829,299,226,73,0.00351574850165881,0.00265738849958158,0.000858360002077235,EPCI
246700843,CC de la Basse-Zorn,1968_1975,1971.5,7,12605,13308,932,1324,703,392,311,0.00778324714378975,0.00434001832199941,0.00344322882179035,EPCI
246700843,CC de la Basse-Zorn,1975_1982,1978.5,7,13308,13880,965,1116,572,151,421,0.00603005041319382,0.00159184897271375,0.00443820144048007,EPCI
246700843,CC de la Basse-Zorn,1982_1990,1986,8,13880,14604,1047,1278,724,231,493,0.00637605463257618,0.00203434892282472,0.00434170570975146,EPCI
246700843,CC de la Basse-Zorn,1990_1999,1994.5,9,14604,15683,1069,1516,1079,447,632,0.0079516544012368,0.00329415154527604,0.00465750285596076,EPCI
246700843,CC de la Basse-Zorn,1999_2006,2002.5,7,15683,16350,806,1114,667,308,359,0.00596781892656639,0.00275575446684025,0.00321206445972614,EPCI
246700926,CC du Pays de Wissembourg,2006_2011,2008.5,5,16855,16587,700,811,-268,111,-379,-0.00320048602308975,0.00132557443493643,-0.00452606045802618,EPCI
246700926,CC du Pays de Wissembourg,2011_2016,2013.5,5,16587,16169,694,722,-418,28,-446,-0.00509167868768445,0.000341069385777906,-0.00543274807346236,EPCI
246700926,CC du Pays de Wissembourg,1968_1975,1971.5,7,14307,14449,1158,1852,142,694,-552,0.00141189293039434,0.00690037812460334,-0.00548848519420899,EPCI
246700926,CC du Pays de Wissembourg,1975_1982,1978.5,7,14449,15104,1173,1643,655,470,185,0.00635358484469695,0.00455906088092758,0.00179452396376937,EPCI
246700926,CC du Pays de Wissembourg,1982_1990,1986,8,15104,15400,1234,1739,296,505,-209,0.00242893259083621,0.00414395594044691,-0.0017150233496107,EPCI
246700926,CC du Pays de Wissembourg,1990_1999,1994.5,9,15400,16560,1242,1906,1160,664,496,0.00810182576458507,0.00463759681696938,0.00346422894761568,EPCI
246700926,CC du Pays de Wissembourg,1999_2006,2002.5,7,16560,16855,902,1295,295,393,-98,0.00252564117571619,0.00336466773578462,-0.000839026560068428,EPCI
246700959,CC du Pays de la Zorn,2006_2011,2008.5,5,14877,15537,548,819,660,271,389,0.00871937015958224,0.0035802262321921,0.00513914392739014,EPCI
246700959,CC du Pays de la Zorn,2011_2016,2013.5,5,15537,15900,662,855,363,193,170,0.004629650492743,0.00246149461459889,0.0021681558781441,EPCI
246700959,CC du Pays de la Zorn,1968_1975,1971.5,7,12126,12274,1038,1214,148,176,-28,0.00173454491680247,0.00206270206322456,-0.000328157146422089,EPCI
246700959,CC du Pays de la Zorn,1975_1982,1978.5,7,12274,12767,1042,1036,493,-6,499,0.00564164201317108,-6.86609575639482e-05,0.00571030297073503,EPCI
246700959,CC du Pays de la Zorn,1982_1990,1986,8,12767,13139,1090,1211,372,121,251,0.00359660103089277,0.00116986216327426,0.00242673886761851,EPCI
246700959,CC du Pays de la Zorn,1990_1999,1994.5,9,13139,14097,1081,1368,958,287,671,0.007850331544621,0.0023518216631589,0.0054985098814621,EPCI
246700959,CC du Pays de la Zorn,1999_2006,2002.5,7,14097,14877,840,1038,780,198,582,0.00772315480171382,0.00196049314197351,0.00576266165974031,EPCI
246700967,CC de Sélestat,2006_2011,2008.5,5,35398,36033,1325,2282,635,957,-322,0.00356230274641178,0.00536869878474973,-0.00180639603833794,EPCI
246700967,CC de Sélestat,2011_2016,2013.5,5,36033,36424,1299,2132,391,833,-442,0.00216087388851527,0.00460360089292383,-0.00244272700440857,EPCI
246700967,CC de Sélestat,1968_1975,1971.5,7,27118,28310,2127,3459,1192,1332,-140,0.00616426207207743,0.00688825258389861,-0.000723990511821175,EPCI
246700967,CC de Sélestat,1975_1982,1978.5,7,28310,28505,2139,2741,195,602,-407,0.000981111169243709,0.00302886627633186,-0.00204775510708815,EPCI
246700967,CC de Sélestat,1982_1990,1986,8,28505,29047,2222,3137,542,915,-373,0.00235723607986538,0.00397946681379487,-0.00162223073392949,EPCI
246700967,CC de Sélestat,1990_1999,1994.5,9,29047,31809,2322,3754,2762,1432,1330,0.0101437762351355,0.00525919173378496,0.00488458450135056,EPCI
246700967,CC de Sélestat,1999_2006,2002.5,7,31809,35398,1761,3053,3589,1292,2297,0.0153895106876774,0.00554005232891589,0.00984945835876146,EPCI
246701064,CC de la Région de Molsheim-Mutzig,2006_2011,2008.5,5,37739,38664,1383,2165,925,782,143,0.00485472458218084,0.00410421040353018,0.000750514178650659,EPCI
246701064,CC de la Région de Molsheim-Mutzig,2011_2016,2013.5,5,38664,40037,1477,2119,1373,642,731,0.00700342850654501,0.00327472767749592,0.00372870082904909,EPCI
246701064,CC de la Région de Molsheim-Mutzig,1968_1975,1971.5,7,24433,26713,2151,2728,2280,577,1703,0.012826659254775,0.00324604490789701,0.00958061434687799,EPCI
246701064,CC de la Région de Molsheim-Mutzig,1975_1982,1978.5,7,26713,28726,2238,2484,2013,246,1767,0.0104329472752276,0.00127496524078787,0.00915798203443972,EPCI
246701064,CC de la Région de Molsheim-Mutzig,1982_1990,1986,8,28726,31367,2369,3186,2641,817,1824,0.0110548771214356,0.00341985407353763,0.00763502304789797,EPCI
246701064,CC de la Région de Molsheim-Mutzig,1990_1999,1994.5,9,31367,35485,2498,3660,4118,1162,2956,0.013800322570104,0.00389411724780496,0.00990620532229903,EPCI
246701064,CC de la Région de Molsheim-Mutzig,1999_2006,2002.5,7,35485,37739,1991,3003,2254,1012,1242,0.00883652366665899,0.0039674187891122,0.00486910487754679,EPCI
246701080,CC du Pays de Sainte-Odile,2006_2011,2008.5,5,17619,17617,619,912,-2,293,-295,-2.27037949627196e-05,0.00332610596203842,-0.00334880975700114,EPCI
246701080,CC du Pays de Sainte-Odile,2011_2016,2013.5,5,17617,17971,640,926,354,286,68,0.00398692725355332,0.00322107682066737,0.000765850432885948,EPCI
246701080,CC du Pays de Sainte-Odile,1968_1975,1971.5,7,10872,12736,990,1595,1864,605,1259,0.0228634449671836,0.00742080697700971,0.0154426379901739,EPCI
246701080,CC du Pays de Sainte-Odile,1975_1982,1978.5,7,12736,14181,889,1429,1445,540,905,0.015471377391133,0.00578169120499089,0.00968968618614214,EPCI
246701080,CC du Pays de Sainte-Odile,1982_1990,1986,8,14181,15066,1052,1643,885,591,294,0.00759589214329837,0.00507251102450772,0.00252338111879064,EPCI
246701080,CC du Pays de Sainte-Odile,1990_1999,1994.5,9,15066,16836,1145,2010,1770,865,905,0.012418578194761,0.00606896617992557,0.00634961201483543,EPCI
246701080,CC du Pays de Sainte-Odile,1999_2006,2002.5,7,16836,17619,850,1608,783,758,25,0.00651519130774281,0.00630717115104604,0.000208020156696769,EPCI
246701098,CC du Pays de Niederbronn-les-Bains,2006_2011,2008.5,5,23536,23484,1050,1169,-52,119,-171,-0.000442267302399602,0.00101211171126063,-0.00145437901366023,EPCI
246701098,CC du Pays de Niederbronn-les-Bains,2011_2016,2013.5,5,23484,23359,1093,1147,-125,54,-179,-0.0010668284089993,0.000460869872687697,-0.001527698281687,EPCI
246701098,CC du Pays de Niederbronn-les-Bains,1968_1975,1971.5,7,20742,21801,1652,2331,1059,679,380,0.00713896321280871,0.00457729558215025,0.00256166763065846,EPCI
246701098,CC du Pays de Niederbronn-les-Bains,1975_1982,1978.5,7,21801,22313,1740,2044,512,304,208,0.00332173734682573,0.00197228154967777,0.00134945579714795,EPCI
246701098,CC du Pays de Niederbronn-les-Bains,1982_1990,1986,8,22313,22552,1841,2277,239,436,-197,0.00133267291531802,0.00243115226392744,-0.00109847934860942,EPCI
246701098,CC du Pays de Niederbronn-les-Bains,1990_1999,1994.5,9,22552,22898,2025,2306,346,281,65,0.00169318923886785,0.00137510455526551,0.000318084683602342,EPCI
246701098,CC du Pays de Niederbronn-les-Bains,1999_2006,2002.5,7,22898,23536,1504,1761,638,257,381,0.00393365851315175,0.00158456150137931,0.00234909701177244,EPCI
246800205,CC de la Vallée de Saint-Amarin,2006_2011,2008.5,5,13240,12919,670,623,-321,-47,-274,-0.00489666297145264,-0.000716956883670635,-0.004179706087782,EPCI
246800205,CC de la Vallée de Saint-Amarin,2011_2016,2013.5,5,12919,12483,706,554,-436,-152,-284,-0.00684275645260957,-0.00238554812109324,-0.00445720833151632,EPCI
246800205,CC de la Vallée de Saint-Amarin,1968_1975,1971.5,7,13075,12353,1238,1129,-722,-109,-613,-0.00808188756846506,-0.00122011876033614,-0.00686176880812892,EPCI
246800205,CC de la Vallée de Saint-Amarin,1975_1982,1978.5,7,12353,12536,1092,951,183,-141,324,0.00210300199890523,-0.00162034580243518,0.00372334780134041,EPCI
246800205,CC de la Vallée de Saint-Amarin,1982_1990,1986,8,12536,12824,1167,1193,288,26,262,0.00284327323747879,0.000256684389494613,0.00258658884798418,EPCI
246800205,CC de la Vallée de Saint-Amarin,1990_1999,1994.5,9,12824,13137,1261,1262,313,1,312,0.00268295505265459,8.57174138228304e-06,0.00267438331127231,EPCI
246800205,CC de la Vallée de Saint-Amarin,1999_2006,2002.5,7,13137,13240,952,915,103,-37,140,0.00111631890941921,-0.000401007763577775,0.00151732667299699,EPCI
246800395,CC du Val d'Argent,2006_2011,2008.5,5,10292,9926,572,566,-366,-6,-360,-0.00721570434271579,-0.000118290235126488,-0.0070974141075893,EPCI
246800395,CC du Val d'Argent,2011_2016,2013.5,5,9926,9571,627,497,-355,-130,-225,-0.00725751292439991,-0.00265768078921687,-0.00459983213518304,EPCI
246800395,CC du Val d'Argent,1968_1975,1971.5,7,12187,11320,1431,1148,-867,-283,-584,-0.0104872974934778,-0.00342318937791719,-0.00706410811556057,EPCI
246800395,CC du Val d'Argent,1975_1982,1978.5,7,11320,10624,1299,904,-696,-395,-301,-0.00902410471664272,-0.00512143874004867,-0.00390266597659405,EPCI
246800395,CC du Val d'Argent,1982_1990,1986,8,10624,10021,1229,1072,-603,-157,-446,-0.0072774776853447,-0.00189479933101015,-0.00538267835433456,EPCI
246800395,CC du Val d'Argent,1990_1999,1994.5,9,10021,10303,1217,1105,282,-112,394,0.00308833955645693,-0.0012265745756141,0.00431491413207103,EPCI
246800395,CC du Val d'Argent,1999_2006,2002.5,7,10303,10292,850,869,-11,19,-30,-0.000152591291540549,0.000263566776297312,-0.000416158067837861,EPCI
246800445,CC du Centre du Haut-Rhin,2006_2011,2008.5,5,13723,14933,491,911,1210,420,790,0.0170436681625425,0.00591598399030402,0.0111276841722385,EPCI
246800445,CC du Centre du Haut-Rhin,2011_2016,2013.5,5,14933,15361,574,897,428,323,105,0.00566766089895343,0.00427723007093915,0.00139043082801428,EPCI
246800445,CC du Centre du Haut-Rhin,1968_1975,1971.5,7,10204,10836,764,1035,632,271,361,0.00862183056482579,0.00369701911877815,0.00492481144604764,EPCI
246800445,CC du Centre du Haut-Rhin,1975_1982,1978.5,7,10836,11363,709,923,527,214,313,0.0068071409355277,0.00276419005731106,0.00404295087821664,EPCI
246800445,CC du Centre du Haut-Rhin,1982_1990,1986,8,11363,12044,881,1211,681,330,351,0.00730204934784418,0.00353843800996854,0.00376361133787563,EPCI
246800445,CC du Centre du Haut-Rhin,1990_1999,1994.5,9,12044,12883,930,1263,839,333,506,0.00751050812773269,0.00298092873246124,0.00452957939527144,EPCI
246800445,CC du Centre du Haut-Rhin,1999_2006,2002.5,7,12883,13723,715,1049,840,334,506,0.00906435533391847,0.0036041603351533,0.00546019499876517,EPCI
246800494,"CC du Pays de Rouffach, Vignobles et Châteaux",2006_2011,2008.5,5,13045,13229,498,681,184,183,1,0.00280522146915652,0.0027899757003024,1.52457688541116e-05,EPCI
246800494,"CC du Pays de Rouffach, Vignobles et Châteaux",2011_2016,2013.5,5,13229,13262,579,675,33,96,-63,0.00049840685672975,0.00144991085594109,-0.00095150399921134,EPCI
246800494,"CC du Pays de Rouffach, Vignobles et Châteaux",1968_1975,1971.5,7,11875,11703,851,1115,-172,264,-436,-0.00208213373569377,0.00319583317571602,-0.00527796691140979,EPCI
246800494,"CC du Pays de Rouffach, Vignobles et Châteaux",1975_1982,1978.5,7,11703,11653,808,826,-50,18,-68,-0.000611464636614989,0.000220127269181396,-0.000831591905796385,EPCI
246800494,"CC du Pays de Rouffach, Vignobles et Châteaux",1982_1990,1986,8,11653,11708,901,1020,55,119,-64,0.000588762157253342,0.00127386721296632,-0.00068510505571298,EPCI
246800494,"CC du Pays de Rouffach, Vignobles et Châteaux",1990_1999,1994.5,9,11708,12006,927,1269,298,342,-44,0.00279658717456188,0.00320950608624216,-0.000412918911680278,EPCI
246800494,"CC du Pays de Rouffach, Vignobles et Châteaux",1999_2006,2002.5,7,12006,13045,661,955,1039,294,745,0.0119274852373645,0.00337505357053433,0.0085524316668302,EPCI
246800551,CC de la Vallée de Kaysersberg,2006_2011,2008.5,5,17160,17107,808,824,-53,16,-69,-0.00061848018016919,0.000186710997786925,-0.000805191177956115,EPCI
246800551,CC de la Vallée de Kaysersberg,2011_2016,2013.5,5,17107,16680,901,694,-427,-207,-220,-0.00504271053724004,-0.00244459269603908,-0.00259811784120096,EPCI
246800551,CC de la Vallée de Kaysersberg,1968_1975,1971.5,7,14659,14824,1358,1459,165,101,64,0.00160028018036673,0.000979565443739635,0.000620714736627096,EPCI
246800551,CC de la Vallée de Kaysersberg,1975_1982,1978.5,7,14824,14755,1371,1111,-69,-260,191,-0.000666275166939512,-0.0025106020783228,0.00184432691138329,EPCI
246800551,CC de la Vallée de Kaysersberg,1982_1990,1986,8,14755,15673,1412,1481,918,69,849,0.0075732176308505,0.000569228776175038,0.00700398885467547,EPCI
246800551,CC de la Vallée de Kaysersberg,1990_1999,1994.5,9,15673,16574,1588,1811,901,223,678,0.00622996106611162,0.0015419326501031,0.00468802841600852,EPCI
246800551,CC de la Vallée de Kaysersberg,1999_2006,2002.5,7,16574,17160,1145,1380,586,235,351,0.00497603836579486,0.0019955102661464,0.00298052809964845,EPCI
246800569,CC de la Région de Guebwiller,2006_2011,2008.5,5,38462,38926,1594,2267,464,673,-209,0.0024012116884442,0.00348279195328222,-0.00108158026483801,EPCI
246800569,CC de la Région de Guebwiller,2011_2016,2013.5,5,38926,38208,1670,1994,-718,324,-1042,-0.00371657438736472,0.00167711713301695,-0.00539369152038167,EPCI
246800569,CC de la Région de Guebwiller,1968_1975,1971.5,7,30883,32287,2933,3535,1404,602,802,0.00637146939397337,0.00273192633559257,0.0036395430583808,EPCI
246800569,CC de la Région de Guebwiller,1975_1982,1978.5,7,32287,32391,2783,3118,104,335,-231,0.000459524692024038,0.00148019972911589,-0.00102067503709185,EPCI
246800569,CC de la Région de Guebwiller,1982_1990,1986,8,32391,33635,2743,3601,1244,858,386,0.00472193650203034,0.00325676970959971,0.00146516679243064,EPCI
246800569,CC de la Région de Guebwiller,1990_1999,1994.5,9,33635,36769,2861,4069,3134,1208,1926,0.00994781012629264,0.0038343824609322,0.00611342766536045,EPCI
246800569,CC de la Région de Guebwiller,1999_2006,2002.5,7,36769,38462,2191,3247,1693,1056,637,0.0064515280330506,0.00402410726692347,0.00242742076612713,EPCI
246800577,CC du Pays de Ribeauvillé,2006_2011,2008.5,5,18345,18142,929,944,-203,15,-218,-0.00222299859359476,0.000164260979822273,-0.00238725957341703,EPCI
246800577,CC du Pays de Ribeauvillé,2011_2016,2013.5,5,18142,18195,966,957,53,-9,62,0.000583598001361541,-9.91015474010163e-05,0.000682699548762557,EPCI
246800577,CC du Pays de Ribeauvillé,1968_1975,1971.5,7,15679,15907,1648,1451,228,-197,425,0.00206456063907434,-0.00178385283288441,0.00384841347195875,EPCI
246800577,CC du Pays de Ribeauvillé,1975_1982,1978.5,7,15907,16184,1597,1289,277,-308,585,0.00246930600496809,-0.00274565433043383,0.00521496033540191,EPCI
246800577,CC du Pays de Ribeauvillé,1982_1990,1986,8,16184,16627,1880,1631,443,-249,692,0.0033813012694659,-0.00190055082640408,0.00528185209586998,EPCI
246800577,CC du Pays de Ribeauvillé,1990_1999,1994.5,9,16627,17679,1742,1880,1052,138,914,0.00683990989043548,0.000897250536958267,0.00594265935347721,EPCI
246800577,CC du Pays de Ribeauvillé,1999_2006,2002.5,7,17679,18345,1363,1429,666,66,600,0.00529677331943179,0.000524905464087835,0.00477186785534396,EPCI
246800585,CC de la Vallée de Munster,2006_2011,2008.5,5,16818,16687,780,801,-131,21,-152,-0.0015627313109895,0.00025051417962427,-0.00181324549061377,EPCI
246800585,CC de la Vallée de Munster,2011_2016,2013.5,5,16687,16228,785,701,-459,-84,-375,-0.00556283537404123,-0.00101803523185068,-0.00454480014219055,EPCI
246800585,CC de la Vallée de Munster,1968_1975,1971.5,7,15323,15303,1567,1477,-20,-90,70,-0.00018656544980733,-0.000839544524132985,0.000652979074325655,EPCI
246800585,CC de la Vallée de Munster,1975_1982,1978.5,7,15303,14726,1415,1176,-577,-239,-338,-0.00547556111893133,-0.00226804004752961,-0.00320752107140171,EPCI
246800585,CC de la Vallée de Munster,1982_1990,1986,8,14726,15097,1422,1428,371,6,365,0.00311501782102219,5.03776467011675e-05,0.00306464017432103,EPCI
246800585,CC de la Vallée de Munster,1990_1999,1994.5,9,15097,16194,1499,1635,1097,136,961,0.00782431282988805,0.000970015081918664,0.00685429774796938,EPCI
246800585,CC de la Vallée de Munster,1999_2006,2002.5,7,16194,16818,1126,1282,624,156,468,0.00541589007219145,0.00135397251804786,0.00406191755414359,EPCI
246800676,CC de la Vallée de la Doller et du Soultzbach,2006_2011,2008.5,5,15339,16226,588,837,887,249,638,0.0113067008104359,0.00317403438759701,0.00813266642283893,EPCI
246800676,CC de la Vallée de la Doller et du Soultzbach,2011_2016,2013.5,5,16226,16247,689,831,21,142,-121,0.000258709934592316,0.00174937193867185,-0.00149066200407954,EPCI
246800676,CC de la Vallée de la Doller et du Soultzbach,1968_1975,1971.5,7,11892,12190,1002,1251,298,249,49,0.00354197779583587,0.00295957205088299,0.000582405744952878,EPCI
246800676,CC de la Vallée de la Doller et du Soultzbach,1975_1982,1978.5,7,12190,12613,1050,1133,423,83,340,0.00488504807528556,0.000958531891840902,0.00392651618344466,EPCI
246800676,CC de la Vallée de la Doller et du Soultzbach,1982_1990,1986,8,12613,13548,1041,1424,935,383,552,0.0089789343026061,0.00367800196566646,0.00530093233693964,EPCI
246800676,CC de la Vallée de la Doller et du Soultzbach,1990_1999,1994.5,9,13548,14598,1046,1484,1050,438,612,0.00832844547642164,0.00347415154159303,0.00485429393482862,EPCI
246800676,CC de la Vallée de la Doller et du Soultzbach,1999_2006,2002.5,7,14598,15339,869,1108,741,239,502,0.00709851467718536,0.00228953442354562,0.00480898025363975,EPCI
246800726,CA Colmar Agglomération,2006_2011,2008.5,5,107093,109953,4210,6633,2860,2423,437,0.00528499375187908,0.00447746148979126,0.000807532262087817,EPCI
246800726,CA Colmar Agglomération,2011_2016,2013.5,5,109953,114022,4577,6704,4069,2127,1942,0.00729415579154646,0.00381289490504284,0.00348126088650362,EPCI
246800726,CA Colmar Agglomération,1968_1975,1971.5,7,85060,95130,7123,11666,10070,4543,5527,0.0161123530676996,0.00726895928367026,0.00884339378402939,EPCI
246800726,CA Colmar Agglomération,1975_1982,1978.5,7,95130,96142,6797,10142,1012,3345,-2333,0.00151284148136921,0.00500044936282609,-0.00348760788145688,EPCI
246800726,CA Colmar Agglomération,1982_1990,1986,8,96142,98724,7456,11745,2582,4289,-1707,0.00331821973403512,0.00551194594859668,-0.00219372621456156,EPCI
246800726,CA Colmar Agglomération,1990_1999,1994.5,9,98724,104149,8057,13010,5425,4953,472,0.00596153163665014,0.00544285091176556,0.000518680724884584,EPCI
246800726,CA Colmar Agglomération,1999_2006,2002.5,7,104149,107093,6119,9600,2944,3481,-537,0.00399008925355471,0.004717901050144,-0.000727811796589293,EPCI
246900575,CC de l'Est Lyonnais (CCEL),2006_2011,2008.5,5,36132,38787,1006,1911,2655,905,1750,0.0142822788435706,0.00486834740242237,0.00941393144114822,EPCI
246900575,CC de l'Est Lyonnais (CCEL),2011_2016,2013.5,5,38787,40443,1255,2119,1656,864,792,0.00839674383695921,0.00438090982797872,0.00401583400898049,EPCI
246900575,CC de l'Est Lyonnais (CCEL),1968_1975,1971.5,7,10482,16289,800,1426,5807,626,5181,0.0650010556993874,0.00700717424966704,0.0579938814497204,EPCI
246900575,CC de l'Est Lyonnais (CCEL),1975_1982,1978.5,7,16289,19854,842,1272,3565,430,3135,0.0286771308876999,0.00345895267369171,0.0252181782140081,EPCI
246900575,CC de l'Est Lyonnais (CCEL),1982_1990,1986,8,19854,29161,1193,2432,9307,1239,8068,0.049226617210852,0.0065533231679645,0.0426732940428875,EPCI
246900575,CC de l'Est Lyonnais (CCEL),1990_1999,1994.5,9,29161,33858,1547,3206,4697,1659,3038,0.0167321184465468,0.0059098540563809,0.0108222643901659,EPCI
246900575,CC de l'Est Lyonnais (CCEL),1999_2006,2002.5,7,33858,36132,1338,2677,2274,1339,935,0.00932947807997775,0.00549347895738356,0.00383599912259419,EPCI
246900625,CC du Pays de l'Arbresle (CCPA),2006_2011,2008.5,5,34435,36286,1231,2162,1851,931,920,0.0105267207306579,0.00529463911412343,0.00523208161653443,EPCI
246900625,CC du Pays de l'Arbresle (CCPA),2011_2016,2013.5,5,36286,37282,1234,2149,996,915,81,0.00543042046945352,0.0049887898891064,0.000441630580347124,EPCI
246900625,CC du Pays de l'Arbresle (CCPA),1968_1975,1971.5,7,17515,19117,1307,2036,1602,729,873,0.0125813930704717,0.00572524066690003,0.00685615240357165,EPCI
246900625,CC du Pays de l'Arbresle (CCPA),1975_1982,1978.5,7,19117,23204,1346,2126,4087,780,3307,0.0280646950781058,0.00535611993171582,0.02270857514639,EPCI
246900625,CC du Pays de l'Arbresle (CCPA),1982_1990,1986,8,23204,27124,1486,2826,3920,1340,2580,0.0197033823649682,0.00673533989006565,0.0129680424749025,EPCI
246900625,CC du Pays de l'Arbresle (CCPA),1990_1999,1994.5,9,27124,31550,1926,3431,4426,1505,2921,0.016936788698684,0.00575912042284668,0.0111776682758373,EPCI
246900625,CC du Pays de l'Arbresle (CCPA),1999_2006,2002.5,7,31550,34435,1793,2958,2885,1165,1720,0.0125784370765936,0.005079334209439,0.00749910286715457,EPCI
246900724,CC des Vallons du Lyonnais (CCVL),2006_2011,2008.5,5,25211,27142,1017,1460,1931,443,1488,0.0148698597614259,0.00341136606644829,0.0114584936949776,EPCI
246900724,CC des Vallons du Lyonnais (CCVL),2011_2016,2013.5,5,27142,29143,1043,1585,2001,542,1459,0.0143281585921295,0.0038809904832255,0.0104471681089041,EPCI
246900724,CC des Vallons du Lyonnais (CCVL),1968_1975,1971.5,7,10307,12523,786,1292,2216,506,1710,0.0282111300391605,0.00644171110099965,0.0217694189381609,EPCI
246900724,CC des Vallons du Lyonnais (CCVL),1975_1982,1978.5,7,12523,15467,848,1287,2944,439,2505,0.0306226248761909,0.00456634929369831,0.0260562755824926,EPCI
246900724,CC des Vallons du Lyonnais (CCVL),1982_1990,1986,8,15467,17825,1026,1667,2358,641,1717,0.0178948841028173,0.00486455500844184,0.0130303290943754,EPCI
246900724,CC des Vallons du Lyonnais (CCVL),1990_1999,1994.5,9,17825,22182,1459,2194,4357,735,3622,0.0245952811786245,0.00414907772923779,0.0204462034493867,EPCI
246900724,CC des Vallons du Lyonnais (CCVL),1999_2006,2002.5,7,22182,25211,1288,2108,3029,820,2209,0.0184538137071408,0.00499575016172185,0.013458063545419,EPCI
246900740,CC du Pays Mornantais (COPAMO),2006_2011,2008.5,5,24799,26341,706,1509,1542,803,739,0.012137737828861,0.00632075452436793,0.00581698330449303,EPCI
246900740,CC du Pays Mornantais (COPAMO),2011_2016,2013.5,5,26341,28310,764,1651,1969,887,1082,0.0145221238563493,0.00654196234666422,0.0079801615096851,EPCI
246900740,CC du Pays Mornantais (COPAMO),1968_1975,1971.5,7,11126,12759,917,1314,1633,397,1236,0.0197572400726518,0.00480319920933421,0.0149540408633176,EPCI
246900740,CC du Pays Mornantais (COPAMO),1975_1982,1978.5,7,12759,15481,864,1327,2722,463,2259,0.0280103375300866,0.00476443287157609,0.0232459046585106,EPCI
246900740,CC du Pays Mornantais (COPAMO),1982_1990,1986,8,15481,18778,1022,1842,3297,820,2477,0.024427646820357,0.00607542323102601,0.018352223589331,EPCI
246900740,CC du Pays Mornantais (COPAMO),1990_1999,1994.5,9,18778,22772,1247,2633,3994,1386,2608,0.021658517519384,0.0075159502458353,0.0141425672735487,EPCI
246900740,CC du Pays Mornantais (COPAMO),1999_2006,2002.5,7,22772,24799,998,2154,2027,1156,871,0.0122561584288006,0.00698969864020398,0.00526645978859659,EPCI
246900757,CC de la Vallée du Garon (CCVG),2006_2011,2008.5,5,28459,28698,765,1573,239,808,-569,0.00167399535177504,0.00565936503863695,-0.00398536968686191,EPCI
246900757,CC de la Vallée du Garon (CCVG),2011_2016,2013.5,5,28698,30450,883,1675,1752,792,960,0.0119222218638386,0.00538949755488595,0.00653272430895267,EPCI
246900757,CC de la Vallée du Garon (CCVG),1968_1975,1971.5,7,11285,16317,793,1643,5032,850,4182,0.0540882307209243,0.00913652545961559,0.0449517052613087,EPCI
246900757,CC de la Vallée du Garon (CCVG),1975_1982,1978.5,7,16317,20661,863,1958,4344,1095,3249,0.0342950162094413,0.008644807262739,0.0256502089467023,EPCI
246900757,CC de la Vallée du Garon (CCVG),1982_1990,1986,8,20661,23999,957,2356,3338,1399,1939,0.0188968650530108,0.00791992636583646,0.0109769386871743,EPCI
246900757,CC de la Vallée du Garon (CCVG),1990_1999,1994.5,9,23999,27515,1256,2687,3516,1431,2085,0.0153069863905584,0.00622989121868289,0.00907709517187549,EPCI
246900757,CC de la Vallée du Garon (CCVG),1999_2006,2002.5,7,27515,28459,1014,2334,944,1320,-376,0.00483065079706124,0.00675472357216191,-0.00192407277510066,EPCI
246900765,CC du Pays de l'Ozon,2006_2011,2008.5,5,23158,24308,683,1316,1150,633,517,0.00974017392339377,0.00536133051609414,0.00437884340729963,EPCI
246900765,CC du Pays de l'Ozon,2011_2016,2013.5,5,24308,25574,824,1467,1266,643,623,0.0102058674317458,0.00518354878247436,0.00502231864927143,EPCI
246900765,CC du Pays de l'Ozon,1968_1975,1971.5,7,9704,12725,653,1431,3021,778,2243,0.0394779617322416,0.0101667839217756,0.029311177810466,EPCI
246900765,CC du Pays de l'Ozon,1975_1982,1978.5,7,12725,17456,725,1531,4731,806,3925,0.0461944705447395,0.0078699520733587,0.0383245184713808,EPCI
246900765,CC du Pays de l'Ozon,1982_1990,1986,8,17456,19589,825,1757,2133,932,1201,0.0145149275694325,0.00634219995063812,0.0081727276187944,EPCI
246900765,CC du Pays de l'Ozon,1990_1999,1994.5,9,19589,22010,1058,2197,2421,1139,1282,0.0130318181474003,0.00613103712097849,0.0069007810264218,EPCI
246900765,CC du Pays de l'Ozon,1999_2006,2002.5,7,22010,23158,952,1918,1148,966,182,0.00728978457442708,0.00613408701994474,0.00115569755448234,EPCI
247000011,CA de Vesoul,2006_2011,2008.5,5,32781,32657,1444,1966,-124,522,-646,-0.000757683095905959,0.00318960141986218,-0.00394728451576814,EPCI
247000011,CA de Vesoul,2011_2016,2013.5,5,32657,32350,1487,1830,-307,343,-650,-0.00188725826344904,0.00210856542137792,-0.00399582368482696,EPCI
247000011,CA de Vesoul,1968_1975,1971.5,7,25160,29584,1813,3933,4424,2120,2304,0.0234095499879965,0.0112179579508482,0.0121915920371483,EPCI
247000011,CA de Vesoul,1975_1982,1978.5,7,29584,32145,1829,3805,2561,1976,585,0.0119310774691956,0.00920570444323724,0.0027253730259584,EPCI
247000011,CA de Vesoul,1982_1990,1986,8,32145,32795,2052,4058,650,2006,-1356,0.00250552699364315,0.00773244176807408,-0.00522691477443094,EPCI
247000011,CA de Vesoul,1990_1999,1994.5,9,32795,33069,2288,3626,274,1338,-1064,0.000924896664883823,0.00451646619567356,-0.00359156953078974,EPCI
247000011,CA de Vesoul,1999_2006,2002.5,7,33069,32781,1998,2644,-288,646,-934,-0.00124882077246824,0.00280117437157807,-0.0040499951440463,EPCI
247000367,CC des Combes,2006_2011,2008.5,5,7301,7519,345,467,218,122,96,0.00590171194893618,0.00330279292555144,0.00259891902338474,EPCI
247000367,CC des Combes,2011_2016,2013.5,5,7519,7663,361,412,144,51,93,0.00380128695250748,0.00134628912901306,0.00245499782349441,EPCI
247000367,CC des Combes,1968_1975,1971.5,7,6656,6365,699,664,-291,-35,-256,-0.0063660036625568,-0.000765670543606488,-0.00560033311895031,EPCI
247000367,CC des Combes,1975_1982,1978.5,7,6365,6697,606,581,332,-25,357,0.00729007744639665,-0.000548951614939507,0.00783902906133615,EPCI
247000367,CC des Combes,1982_1990,1986,8,6697,6941,694,716,244,22,222,0.00448329395371339,0.000404231422056125,0.00407906253165726,EPCI
247000367,CC des Combes,1990_1999,1994.5,9,6941,6977,661,624,36,-37,73,0.000574961738242896,-0.000590932897638532,0.00116589463588143,EPCI
247000367,CC des Combes,1999_2006,2002.5,7,6977,7301,514,567,324,53,271,0.00650568493408321,0.00106420154785929,0.00544148338622392,EPCI
247000623,CC des Quatre Rivières,2006_2011,2008.5,5,9897,10124,607,543,227,-64,291,0.0045457329937133,-0.00128161635065045,0.00582734934436375,EPCI
247000623,CC des Quatre Rivières,2011_2016,2013.5,5,10124,9651,555,424,-473,-131,-342,-0.00952381956270665,-0.00263767518544307,-0.00688614437726358,EPCI
247000623,CC des Quatre Rivières,1968_1975,1971.5,7,10997,10404,1119,1130,-593,11,-604,-0.0078876083751287,0.000146313140179453,-0.00803392151530815,EPCI
247000623,CC des Quatre Rivières,1975_1982,1978.5,7,10404,10092,1093,825,-312,-268,-44,-0.00434017080442328,-0.00372809543456872,-0.000612075369854566,EPCI
247000623,CC des Quatre Rivières,1982_1990,1986,8,10092,9834,1023,807,-258,-216,-42,-0.00323192377779502,-0.00270579665117723,-0.000526127126617794,EPCI
247000623,CC des Quatre Rivières,1990_1999,1994.5,9,9834,9434,1112,842,-400,-270,-130,-0.00460332585904699,-0.00310724495485672,-0.00149608090419027,EPCI
247000623,CC des Quatre Rivières,1999_2006,2002.5,7,9434,9897,909,759,463,-150,613,0.00686797655481142,-0.0022250464000469,0.00909302295485831,EPCI
247000664,CC du Pays de Lure,2006_2011,2008.5,5,18774,19571,822,1198,797,376,421,0.00834985616684136,0.00393920441497158,0.00441065175186978,EPCI
247000664,CC du Pays de Lure,2011_2016,2013.5,5,19571,19706,888,1125,135,237,-102,0.00137580138305515,0.00241529576136349,-0.00103949437830834,EPCI
247000664,CC du Pays de Lure,1968_1975,1971.5,7,15558,17082,1293,2025,1524,732,792,0.0134395528070173,0.00645521827738624,0.00698433452963101,EPCI
247000664,CC du Pays de Lure,1975_1982,1978.5,7,17082,18149,1231,2113,1067,882,185,0.00869330999231766,0.00718603506394018,0.00150727492837748,EPCI
247000664,CC du Pays de Lure,1982_1990,1986,8,18149,18168,1373,2098,19,725,-706,0.00013080130736931,0.00499110251803948,-0.00486030121067017,EPCI
247000664,CC du Pays de Lure,1990_1999,1994.5,9,18168,18164,1635,2070,-4,435,-439,-2.44654304445424e-05,0.00266061556084399,-0.00268508099128853,EPCI
247000664,CC du Pays de Lure,1999_2006,2002.5,7,18164,18774,1177,1652,610,475,135,0.00472991097798503,0.00368312740088998,0.00104678357709505,EPCI
247000698,CC des Monts de Gy,2006_2011,2008.5,5,5746,6049,292,366,303,74,229,0.0103307997296513,0.00252303359734059,0.00780776613231075,EPCI
247000698,CC des Monts de Gy,2011_2016,2013.5,5,6049,6152,277,320,103,43,60,0.00338256060571251,0.0014121369518994,0.00197042365381312,EPCI
247000698,CC des Monts de Gy,1968_1975,1971.5,7,5550,5229,488,541,-321,53,-374,-0.00847500756722786,0.00139930031483824,-0.0098743078820661,EPCI
247000698,CC des Monts de Gy,1975_1982,1978.5,7,5229,5134,509,465,-95,-44,-51,-0.00261585449683255,-0.00121155366169086,-0.00140430083514168,EPCI
247000698,CC des Monts de Gy,1982_1990,1986,8,5134,5018,450,509,-116,59,-175,-0.00285262781602968,0.00145090552711855,-0.00430353334314823,EPCI
247000698,CC des Monts de Gy,1990_1999,1994.5,9,5018,5361,520,533,343,13,330,0.00737361630851918,0.000279466507319969,0.00709414980119921,EPCI
247000698,CC des Monts de Gy,1999_2006,2002.5,7,5361,5746,382,471,385,89,296,0.00995687676875767,0.0023017195647258,0.00765515720403187,EPCI
247000706,CC du Pays Riolais,2006_2011,2008.5,5,10636,11518,347,819,882,472,410,0.0160609232027225,0.00859496116971088,0.00746596203301157,EPCI
247000706,CC du Pays Riolais,2011_2016,2013.5,5,11518,12524,337,838,1006,501,505,0.0168881746006702,0.00841051240053255,0.00847766220013761,EPCI
247000706,CC du Pays Riolais,1968_1975,1971.5,7,5376,5811,497,551,435,54,381,0.0111774445686623,0.00138754484300636,0.00978989972565596,EPCI
247000706,CC du Pays Riolais,1975_1982,1978.5,7,5811,6782,479,545,971,66,905,0.0223196334811566,0.00151709146215895,0.0208025420189977,EPCI
247000706,CC du Pays Riolais,1982_1990,1986,8,6782,7561,526,685,779,159,620,0.013684209923728,0.00279305440035013,0.0108911555233779,EPCI
247000706,CC du Pays Riolais,1990_1999,1994.5,9,7561,8774,559,897,1213,338,875,0.0166695617541714,0.00464493971385816,0.0120246220403133,EPCI
247000706,CC du Pays Riolais,1999_2006,2002.5,7,8774,10636,450,1007,1862,557,1305,0.0278745184369007,0.00833840320588275,0.0195361152310179,EPCI
247000714,CC du Pays de Villersexel,2006_2011,2008.5,5,7704,7951,496,421,247,-75,322,0.0063315666443744,-0.00192254047906105,0.00825410712343545,EPCI
247000714,CC du Pays de Villersexel,2011_2016,2013.5,5,7951,7934,508,393,-17,-115,98,-0.000427985353570248,-0.00289519503885756,0.00246720968528731,EPCI
247000714,CC du Pays de Villersexel,1968_1975,1971.5,7,7249,7250,694,819,1,125,-124,1.97059867093063e-05,0.00246324833866329,-0.00244354235195399,EPCI
247000714,CC du Pays de Villersexel,1975_1982,1978.5,7,7250,7611,692,650,361,-42,403,0.00696602212946806,-0.000810451328082157,0.00777647345755022,EPCI
247000714,CC du Pays de Villersexel,1982_1990,1986,8,7611,7580,780,770,-31,-10,-21,-0.000510041088671143,-0.000164529383442304,-0.000345511705228839,EPCI
247000714,CC du Pays de Villersexel,1990_1999,1994.5,9,7580,7368,882,669,-212,-213,1,-0.00314691590321359,-0.00316175984615327,1.48439429396869e-05,EPCI
247000714,CC du Pays de Villersexel,1999_2006,2002.5,7,7368,7704,633,567,336,-66,402,0.00639081689990118,-0.00125533903390916,0.00764615593381033,EPCI
247000722,CC du Pays d'Héricourt,2006_2011,2008.5,5,20726,21146,816,1231,420,415,5,0.00402042261199265,0.00397256043804035,4.78621739522936e-05,EPCI
247000722,CC du Pays d'Héricourt,2011_2016,2013.5,5,21146,21021,880,1098,-125,218,-343,-0.00118506210941449,0.00206674831881887,-0.00325181042823337,EPCI
247000722,CC du Pays d'Héricourt,1968_1975,1971.5,7,14141,15944,1039,1838,1803,799,1004,0.0172912500749307,0.00766262274535199,0.00962862732957872,EPCI
247000722,CC du Pays d'Héricourt,1975_1982,1978.5,7,15944,18985,1090,1720,3041,630,2411,0.0252516424141818,0.00523134979313861,0.0200202926210432,EPCI
247000722,CC du Pays d'Héricourt,1982_1990,1986,8,18985,19007,1207,1896,22,689,-667,0.000144777814913288,0.00453417793069344,-0.00438940011578015,EPCI
247000722,CC du Pays d'Héricourt,1990_1999,1994.5,9,19007,19817,1396,1975,810,579,231,0.0046477477424951,0.00332227894185761,0.00132546880063749,EPCI
247000722,CC du Pays d'Héricourt,1999_2006,2002.5,7,19817,20726,1043,1648,909,605,304,0.00642753933798645,0.00427795522495248,0.00214958411303397,EPCI
247000755,CC du Pays de Luxeuil,2006_2011,2008.5,5,16275,15904,791,959,-371,168,-539,-0.0046012891202043,0.00208360262046987,-0.00668489174067417,EPCI
247000755,CC du Pays de Luxeuil,2011_2016,2013.5,5,15904,15072,846,772,-832,-74,-758,-0.0106888502917872,-0.000950691011529153,-0.00973815928025808,EPCI
247000755,CC du Pays de Luxeuil,1968_1975,1971.5,7,17285,18302,1296,2508,1017,1212,-195,0.00820076788211743,0.00977318650258243,-0.00157241862046499,EPCI
247000755,CC du Pays de Luxeuil,1975_1982,1978.5,7,18302,18711,1156,2090,409,934,-525,0.00316230997429146,0.0072215098190421,-0.00405919984475065,EPCI
247000755,CC du Pays de Luxeuil,1982_1990,1986,8,18711,17381,1323,2249,-1330,926,-2256,-0.00917439735947667,0.00638758793599654,-0.0155619852954732,EPCI
247000755,CC du Pays de Luxeuil,1990_1999,1994.5,9,17381,16782,1460,2159,-599,699,-1298,-0.00388916997163269,0.00453844709544449,-0.00842761706707718,EPCI
247000755,CC du Pays de Luxeuil,1999_2006,2002.5,7,16782,16275,1085,1453,-507,368,-875,-0.00437279641324562,0.0031739429587266,-0.00754673937197222,EPCI
247000821,CC Rahin et Chérimont,2006_2011,2008.5,5,11596,12122,545,729,526,184,342,0.00891183049305222,0.00311744640821599,0.00579438408483623,EPCI
247000821,CC Rahin et Chérimont,2011_2016,2013.5,5,12122,11983,557,604,-139,47,-186,-0.0023039428058993,0.000779031020699762,-0.00308297382659906,EPCI
247000821,CC Rahin et Chérimont,1968_1975,1971.5,7,10187,10415,931,1076,228,145,83,0.00316710143087584,0.00201416538367104,0.0011529360472048,EPCI
247000821,CC Rahin et Chérimont,1975_1982,1978.5,7,10415,11212,952,932,797,-20,817,0.0105896141835649,-0.000265736867843535,0.0108553510514084,EPCI
247000821,CC Rahin et Chérimont,1982_1990,1986,8,11212,11205,1072,1054,-7,-18,11,-7.80627091545583e-05,-0.00020073268068315,0.000122669971528592,EPCI
247000821,CC Rahin et Chérimont,1990_1999,1994.5,9,11205,11064,1026,1038,-141,12,-153,-0.00140606754726325,0.00011966532317134,-0.00152573287043459,EPCI
247000821,CC Rahin et Chérimont,1999_2006,2002.5,7,11064,11596,822,967,532,145,387,0.00673164444708729,0.00183475271584146,0.00489689173124583,EPCI
247000854,CC des 1000 étangs,2006_2011,2008.5,5,8995,8851,476,405,-144,-71,-73,-0.00322248071066733,-0.00158886201706514,-0.00163361869360219,EPCI
247000854,CC des 1000 étangs,2011_2016,2013.5,5,8851,8641,457,328,-210,-129,-81,-0.00479091281545041,-0.00294298930091954,-0.00184792351453087,EPCI
247000854,CC des 1000 étangs,1968_1975,1971.5,7,11411,10680,911,1126,-731,215,-946,-0.00941326788364927,0.00276860820107331,-0.0121818760847226,EPCI
247000854,CC des 1000 étangs,1975_1982,1978.5,7,10680,10107,910,840,-573,-70,-503,-0.00784684868329066,-0.000958602805986643,-0.00688824587730402,EPCI
247000854,CC des 1000 étangs,1982_1990,1986,8,10107,9146,977,776,-961,-201,-760,-0.0124112901499956,-0.00259590980244446,-0.00981538034755119,EPCI
247000854,CC des 1000 étangs,1990_1999,1994.5,9,9146,8683,966,715,-463,-251,-212,-0.00575554349262364,-0.00312017584589316,-0.00263536764673048,EPCI
247000854,CC des 1000 étangs,1999_2006,2002.5,7,8683,8995,698,606,312,-92,404,0.00505584879107701,-0.00149082720762527,0.00654667599870228,EPCI
247100290,CU Le Creusot Montceau-les-Mines,2006_2011,2008.5,5,98959,97598,5750,4870,-1361,-880,-481,-0.00276589215932588,-0.00178837994137162,-0.00097751221795426,EPCI
247100290,CU Le Creusot Montceau-les-Mines,2011_2016,2013.5,5,97598,95094,6033,4742,-2504,-1291,-1213,-0.00518473767386307,-0.00267312154031838,-0.00251161613354469,EPCI
247100290,CU Le Creusot Montceau-les-Mines,1968_1975,1971.5,7,116628,119597,10215,12404,2969,2189,780,0.00359765254071709,0.00265249626528451,0.000945156275432579,EPCI
247100290,CU Le Creusot Montceau-les-Mines,1975_1982,1978.5,7,119597,120079,9727,11841,482,2114,-1632,0.000574751094601478,0.00252079629457993,-0.00194604519997845,EPCI
247100290,CU Le Creusot Montceau-les-Mines,1982_1990,1986,8,120079,112539,10658,11395,-7540,737,-8277,-0.0080734868320882,0.000789145861438859,-0.00886263269352705,EPCI
247100290,CU Le Creusot Montceau-les-Mines,1990_1999,1994.5,9,112539,104030,11024,9634,-8509,-1390,-7119,-0.00869756753007001,-0.00142080372156508,-0.00727676380850492,EPCI
247100290,CU Le Creusot Montceau-les-Mines,1999_2006,2002.5,7,104030,98959,8279,6738,-5071,-1541,-3530,-0.00711367661316387,-0.00216173844624049,-0.00495193816692338,EPCI
247100589,CA Le Grand Chalon,2006_2011,2008.5,5,111936,112367,4912,6457,431,1545,-1114,0.000768899581876426,0.00275626416241085,-0.00198736458053443,EPCI
247100589,CA Le Grand Chalon,2011_2016,2013.5,5,112367,113920,5071,6412,1553,1341,212,0.00274900111654897,0.00237373502723256,0.000375266089316407,EPCI
247100589,CA Le Grand Chalon,1968_1975,1971.5,7,90865,104395,6756,12708,13530,5952,7578,0.0200274678004584,0.00881030956011296,0.0112171582403454,EPCI
247100589,CA Le Grand Chalon,1975_1982,1978.5,7,104395,107866,6895,11458,3471,4563,-1092,0.00468349550427138,0.00615695476404216,-0.00147345925977077,EPCI
247100589,CA Le Grand Chalon,1982_1990,1986,8,107866,110447,7627,12328,2581,4701,-2120,0.00296012903747966,0.0053915407226625,-0.00243141168518283,EPCI
247100589,CA Le Grand Chalon,1990_1999,1994.5,9,110447,110608,8404,12649,161,4245,-4084,0.000161863244803273,0.004267760709254,-0.00410589746445073,EPCI
247100589,CA Le Grand Chalon,1999_2006,2002.5,7,110608,111936,6662,9263,1328,2601,-1273,0.00170643433245399,0.00334219555625966,-0.00163576122380567,EPCI
247100639,CC de Marcigny,2006_2011,2008.5,5,6200,6380,360,324,180,-36,216,0.00574017307935537,-0.00114803461587107,0.00688820769522645,EPCI
247100639,CC de Marcigny,2011_2016,2013.5,5,6380,6233,374,289,-147,-85,-62,-0.00465121733599727,-0.00268947941197121,-0.00196173792402606,EPCI
247100639,CC de Marcigny,1968_1975,1971.5,7,7836,7454,748,796,-382,48,-430,-0.00711424438549013,0.000893936467286718,-0.00800818085277685,EPCI
247100639,CC de Marcigny,1975_1982,1978.5,7,7454,7135,709,619,-319,-90,-229,-0.006228883870533,-0.00175736535532279,-0.00447151851521021,EPCI
247100639,CC de Marcigny,1982_1990,1986,8,7135,6556,702,561,-579,-141,-438,-0.0105231884791034,-0.00256264175397854,-0.00796054672512484,EPCI
247100639,CC de Marcigny,1990_1999,1994.5,9,6556,6185,683,486,-371,-197,-174,-0.00645172600066202,-0.00342584911625449,-0.00302587688440752,EPCI
247100639,CC de Marcigny,1999_2006,2002.5,7,6185,6200,502,432,15,-70,85,0.000346100765710622,-0.00161513690664957,0.00196123767236019,EPCI
247100647,CC Bresse Nord Intercom,2006_2011,2008.5,5,6277,6471,476,264,194,-212,406,0.00610626704869333,-0.00667282790888137,0.0127790949575747,EPCI
247100647,CC Bresse Nord Intercom,2011_2016,2013.5,5,6471,6535,494,265,64,-229,293,0.00197027664947913,-0.00704989613641751,0.00902017278589664,EPCI
247100647,CC Bresse Nord Intercom,1968_1975,1971.5,7,8084,7479,875,544,-605,-331,-274,-0.0110510133975699,-0.00604609162743079,-0.00500492177013908,EPCI
247100647,CC Bresse Nord Intercom,1975_1982,1978.5,7,7479,6827,890,377,-652,-513,-139,-0.0129460065117311,-0.0101860450007945,-0.00275996151093653,EPCI
247100647,CC Bresse Nord Intercom,1982_1990,1986,8,6827,6304,1004,434,-523,-570,47,-0.00991316069935799,-0.0108040183530288,0.000890857653670795,EPCI
247100647,CC Bresse Nord Intercom,1990_1999,1994.5,9,6304,6094,981,470,-210,-511,301,-0.00375733149772362,-0.00914283997779413,0.00538550848007051,EPCI
247100647,CC Bresse Nord Intercom,1999_2006,2002.5,7,6094,6277,669,347,183,-322,505,0.00423572812665918,-0.0074530298184932,0.0116887579451524,EPCI
247103765,CC Entre Saône et Grosne,2006_2011,2008.5,5,10665,11171,583,550,506,-33,539,0.00931386310362403,-0.000607425854584176,0.00992128895820821,EPCI
247103765,CC Entre Saône et Grosne,2011_2016,2013.5,5,11171,11346,579,540,175,-39,214,0.00311366227073306,-0.000693901877477654,0.00380756414821072,EPCI
247103765,CC Entre Saône et Grosne,1968_1975,1971.5,7,8717,8387,1009,712,-330,-297,-33,-0.00549800946511314,-0.00494820851860183,-0.000549800946511314,EPCI
247103765,CC Entre Saône et Grosne,1975_1982,1978.5,7,8387,8688,979,588,301,-391,692,0.00504983266901382,-0.00655974941390168,0.0116095820829155,EPCI
247103765,CC Entre Saône et Grosne,1982_1990,1986,8,8688,9097,1088,745,409,-343,752,0.00576680507461425,-0.00483622039264715,0.0106030254672614,EPCI
247103765,CC Entre Saône et Grosne,1990_1999,1994.5,9,9097,9997,1078,946,900,-132,1032,0.0105373935023418,-0.00154548438034347,0.0120828778826853,EPCI
247103765,CC Entre Saône et Grosne,1999_2006,2002.5,7,9997,10665,838,871,668,33,635,0.009283152775174,0.000458598864641829,0.00882455391053217,EPCI
247103864,CC du Canton de Semur-en-Brionnais,2006_2011,2008.5,5,4974,5079,279,254,105,-25,130,0.00418674933614494,-0.000996845080034508,0.00518359441617944,EPCI
247103864,CC du Canton de Semur-en-Brionnais,2011_2016,2013.5,5,5079,5196,267,225,117,-42,159,0.00456533091197109,-0.00163883673763065,0.00620416764960174,EPCI
247103864,CC du Canton de Semur-en-Brionnais,1968_1975,1971.5,7,5593,5163,644,456,-430,-188,-242,-0.0113632323186876,-0.00496811087421692,-0.00639512144447071,EPCI
247103864,CC du Canton de Semur-en-Brionnais,1975_1982,1978.5,7,5163,5143,548,363,-20,-185,165,-0.000554309043194201,-0.00512735864954636,0.00457304960635216,EPCI
247103864,CC du Canton de Semur-en-Brionnais,1982_1990,1986,8,5143,4865,521,437,-278,-84,-194,-0.00692216209161956,-0.00209158854566922,-0.00483057354595034,EPCI
247103864,CC du Canton de Semur-en-Brionnais,1990_1999,1994.5,9,4865,4965,531,432,100,-99,199,0.00226328869755044,-0.00224065581057493,0.00450394450812537,EPCI
247103864,CC du Canton de Semur-en-Brionnais,1999_2006,2002.5,7,4965,4974,393,334,9,-59,68,0.000258754597493915,-0.00169628013912678,0.00195503473662069,EPCI
247104094,CC Sud Côte Chalonnaise,2006_2011,2008.5,5,11004,11450,606,624,446,18,428,0.00797783204407709,0.000321975284290107,0.00765585675978699,EPCI
247104094,CC Sud Côte Chalonnaise,2011_2016,2013.5,5,11450,11479,665,545,29,-120,149,0.000506037810577009,-0.00209394956100831,0.00259998737158532,EPCI
247104094,CC Sud Côte Chalonnaise,1968_1975,1971.5,7,9119,8688,1001,697,-431,-304,-127,-0.00689290360128192,-0.00486181599719189,-0.00203108760409003,EPCI
247104094,CC Sud Côte Chalonnaise,1975_1982,1978.5,7,8688,9124,978,622,436,-356,792,0.00701960001804469,-0.00573160001473374,0.0127512000327784,EPCI
247104094,CC Sud Côte Chalonnaise,1982_1990,1986,8,9124,9635,1074,848,511,-226,737,0.00683500241466284,-0.00302291691920509,0.00985791933386793,EPCI
247104094,CC Sud Côte Chalonnaise,1990_1999,1994.5,9,9635,10290,1111,952,655,-159,814,0.00733457250381719,-0.00178045347802585,0.00911502598184305,EPCI
247104094,CC Sud Côte Chalonnaise,1999_2006,2002.5,7,10290,11004,822,795,714,-27,741,0.00962982742589658,-0.000364153137954072,0.00999398056385065,EPCI
247200090,CC de Sablé-sur-Sarthe,2006_2011,2008.5,5,28445,29178,1251,1935,733,684,49,0.00510148899731289,0.00476046176556891,0.000341027231743972,EPCI
247200090,CC de Sablé-sur-Sarthe,2011_2016,2013.5,5,29178,28937,1359,1696,-241,337,-578,-0.00165741448312251,0.00231762938096384,-0.00397504386408635,EPCI
247200090,CC de Sablé-sur-Sarthe,1968_1975,1971.5,7,19423,20788,1483,2609,1365,1126,239,0.00974978911611513,0.00804268318296383,0.00170710593315129,EPCI
247200090,CC de Sablé-sur-Sarthe,1975_1982,1978.5,7,20788,23074,1576,2746,2286,1170,1116,0.0150159875217943,0.00768534794422545,0.00733063957756889,EPCI
247200090,CC de Sablé-sur-Sarthe,1982_1990,1986,8,23074,24634,1971,2889,1560,918,642,0.00821117327244392,0.00483195965647661,0.0033792136159673,EPCI
247200090,CC de Sablé-sur-Sarthe,1990_1999,1994.5,9,24634,26699,2236,3249,2065,1013,1052,0.00898439836380827,0.00440735861624105,0.00457703974756721,EPCI
247200090,CC de Sablé-sur-Sarthe,1999_2006,2002.5,7,26699,28445,1767,2789,1746,1022,724,0.00909053976974272,0.00532103759718045,0.00376950217256227,EPCI
247200132,CU Le Mans Métropole,2006_2011,2008.5,5,204048,203543,8687,12410,-505,3723,-4228,-0.000495472315384271,0.00365275926767454,-0.00414823158305881,EPCI
247200132,CU Le Mans Métropole,2011_2016,2013.5,5,203543,205113,9232,12884,1570,3652,-2082,0.00153793381150336,0.00357741036917851,-0.00203947655767515,EPCI
247200132,CU Le Mans Métropole,1968_1975,1971.5,7,176177,199979,10513,28335,23802,17822,5980,0.0182681710826058,0.0136784868932947,0.0045896841893111,EPCI
247200132,CU Le Mans Métropole,1975_1982,1978.5,7,199979,201297,10876,23968,1318,13092,-11774,0.000938878809586763,0.0093261011950758,-0.00838722238548903,EPCI
247200132,CU Le Mans Métropole,1982_1990,1986,8,201297,202745,12140,23874,1448,11734,-10286,0.00089635178010461,0.00726366836170407,-0.00636731658159946,EPCI
247200132,CU Le Mans Métropole,1990_1999,1994.5,9,202745,205768,14222,24539,3023,10317,-7294,0.00164582942228053,0.00561694414477944,-0.00397111472249891,EPCI
247200132,CU Le Mans Métropole,1999_2006,2002.5,7,205768,204048,11837,17546,-1720,5709,-7429,-0.00119843277057441,0.00397782132977285,-0.00517625410034726,EPCI
247200348,CC du Pays Fléchois,2006_2011,2008.5,5,26019,26910,1185,1703,891,518,373,0.00675691048080651,0.00392825996527247,0.00282865051553404,EPCI
247200348,CC du Pays Fléchois,2011_2016,2013.5,5,26910,27358,1120,1425,448,305,143,0.00330766347170486,0.0022518691046205,0.00105579436708436,EPCI
247200348,CC du Pays Fléchois,1968_1975,1971.5,7,22600,23088,1818,2996,488,1178,-690,0.00305653252074767,0.00737826907672285,-0.00432173655597519,EPCI
247200348,CC du Pays Fléchois,1975_1982,1978.5,7,23088,23475,1752,2386,387,634,-247,0.0023775394554717,0.0038949871182663,-0.0015174476627946,EPCI
247200348,CC du Pays Fléchois,1982_1990,1986,8,23475,23738,1848,2575,263,727,-464,0.00139360948994716,0.00385229695510107,-0.00245868746515392,EPCI
247200348,CC du Pays Fléchois,1990_1999,1994.5,9,23738,24360,2079,2873,622,794,-172,0.00287805625309701,0.00367391746777978,-0.000795861214682773,EPCI
247200348,CC du Pays Fléchois,1999_2006,2002.5,7,24360,26019,1664,2326,1659,662,997,0.00945651832956051,0.00377348712125923,0.00568303120830129,EPCI
247200421,CC du Sud Est du Pays Manceau,2006_2011,2008.5,5,15563,16757,632,914,1194,282,912,0.0148937790540344,0.0035176262087418,0.0113761528452926,EPCI
247200421,CC du Sud Est du Pays Manceau,2011_2016,2013.5,5,16757,17238,711,897,481,186,295,0.00567608181487977,0.0021949089762321,0.00348117283864768,EPCI
247200421,CC du Sud Est du Pays Manceau,1968_1975,1971.5,7,9630,11373,610,1099,1743,489,1254,0.0240502084001122,0.00674730459417949,0.0173029038059327,EPCI
247200421,CC du Sud Est du Pays Manceau,1975_1982,1978.5,7,11373,12137,676,961,764,285,479,0.00933134128219582,0.00348093228458875,0.00585040899760706,EPCI
247200421,CC du Sud Est du Pays Manceau,1982_1990,1986,8,12137,12889,822,1124,752,302,450,0.00754275386595804,0.00302913785574379,0.00451361601021425,EPCI
247200421,CC du Sud Est du Pays Manceau,1990_1999,1994.5,9,12889,14117,1243,1418,1228,175,1053,0.0101630196134888,0.00144831305566819,0.00871470655782057,EPCI
247200421,CC du Sud Est du Pays Manceau,1999_2006,2002.5,7,14117,15563,885,1212,1446,327,1119,0.0140284244317892,0.00317240303540461,0.0108560213963846,EPCI
247200447,CC Orée de Bercé - Belinois,2006_2011,2008.5,5,18221,19240,646,1221,1019,575,444,0.0109427729492939,0.0061747737446948,0.00476799920459911,EPCI
247200447,CC Orée de Bercé - Belinois,2011_2016,2013.5,5,19240,19467,709,1159,227,450,-223,0.00234860948648463,0.00465583378378011,-0.00230722429729548,EPCI
247200447,CC Orée de Bercé - Belinois,1968_1975,1971.5,7,11239,12767,789,1445,1528,656,872,0.0183773723453551,0.00788976194931475,0.0104876103960403,EPCI
247200447,CC Orée de Bercé - Belinois,1975_1982,1978.5,7,12767,14226,756,1333,1459,577,882,0.015578319135072,0.0061608568477975,0.00941746228727451,EPCI
247200447,CC Orée de Bercé - Belinois,1982_1990,1986,8,14226,15194,941,1483,968,542,426,0.00826261563047837,0.00462638189227198,0.00363623373820639,EPCI
247200447,CC Orée de Bercé - Belinois,1990_1999,1994.5,9,15194,16135,1080,1682,941,602,339,0.00669902905439535,0.00428567002204676,0.00241335903234859,EPCI
247200447,CC Orée de Bercé - Belinois,1999_2006,2002.5,7,16135,18221,882,1687,2086,805,1281,0.0175208562341622,0.00676140425143844,0.0107594519827238,EPCI
247200629,CC du Val de Sarthe,2006_2011,2008.5,5,28327,30180,901,1962,1853,1061,792,0.0127534483005958,0.00730243316078366,0.00545101513981212,EPCI
247200629,CC du Val de Sarthe,2011_2016,2013.5,5,30180,30457,948,1674,277,726,-449,0.00182895038406161,0.00479356671057303,-0.00296461632651142,EPCI
247200629,CC du Val de Sarthe,1968_1975,1971.5,7,15297,17980,1272,1980,2683,708,1975,0.0233547340571565,0.00616293392190339,0.0171918001352531,EPCI
247200629,CC du Val de Sarthe,1975_1982,1978.5,7,17980,21542,1236,1840,3562,604,2958,0.0261568817711375,0.00443536119869934,0.0217215205724382,EPCI
247200629,CC du Val de Sarthe,1982_1990,1986,8,21542,23360,1411,2178,1818,767,1051,0.010179037508925,0.0042944564187819,0.00588458109014312,EPCI
247200629,CC du Val de Sarthe,1990_1999,1994.5,9,23360,24959,1597,2510,1599,913,686,0.00738371737666732,0.0042159687085036,0.00316774866816372,EPCI
247200629,CC du Val de Sarthe,1999_2006,2002.5,7,24959,28327,1347,2665,3368,1318,2050,0.0182474779438104,0.0071407885777738,0.0111066893660366,EPCI
247200686,CC du Pays de l'Huisne Sarthoise,2006_2011,2008.5,5,28130,29102,1337,1733,972,396,576,0.00681718751970672,0.00277737269321385,0.00403981482649287,EPCI
247200686,CC du Pays de l'Huisne Sarthoise,2011_2016,2013.5,5,29102,28767,1477,1644,-335,167,-502,-0.00231292176456677,0.00115300876024672,-0.00346593052481348,EPCI
247200686,CC du Pays de l'Huisne Sarthoise,1968_1975,1971.5,7,22747,23638,1781,2683,891,902,-11,0.00550399419958625,0.00557194474526015,-6.79505456739043e-05,EPCI
247200686,CC du Pays de l'Huisne Sarthoise,1975_1982,1978.5,7,23638,24413,1751,2305,775,554,221,0.00461923459689229,0.00330200769893978,0.00131722689795251,EPCI
247200686,CC du Pays de l'Huisne Sarthoise,1982_1990,1986,8,24413,25142,1994,2527,729,533,196,0.00368476928019135,0.00269407685369271,0.000990692426498634,EPCI
247200686,CC du Pays de l'Huisne Sarthoise,1990_1999,1994.5,9,25142,26087,2323,2701,945,378,567,0.00410812100736369,0.00164324840294547,0.00246487260441821,EPCI
247200686,CC du Pays de l'Huisne Sarthoise,1999_2006,2002.5,7,26087,28130,1781,2290,2043,509,1534,0.010829579448089,0.00269811842343481,0.00813146102465423,EPCI
247300015,CC des Vallées d'Aigueblanche,2006_2011,2008.5,5,6771,7033,241,372,262,131,131,0.00762181343414947,0.00381090671707474,0.00381090671707474,EPCI
247300015,CC des Vallées d'Aigueblanche,2011_2016,2013.5,5,7033,7131,251,336,98,85,13,0.00277145735086526,0.00240381504921987,0.000367642301645391,EPCI
247300015,CC des Vallées d'Aigueblanche,1968_1975,1971.5,7,6235,6411,493,709,176,216,-40,0.00398458685178249,0.00489017477264215,-0.000905587920859657,EPCI
247300015,CC des Vallées d'Aigueblanche,1975_1982,1978.5,7,6411,6115,401,603,-296,202,-498,-0.00673017820071131,0.00459289188021515,-0.0113230700809265,EPCI
247300015,CC des Vallées d'Aigueblanche,1982_1990,1986,8,6115,6326,454,562,211,108,103,0.00424942276809737,0.0021750599950451,0.00207436277305227,EPCI
247300015,CC des Vallées d'Aigueblanche,1990_1999,1994.5,9,6326,6226,462,705,-100,243,-343,-0.00176888399556396,0.00429838810922043,-0.0060672721047844,EPCI
247300015,CC des Vallées d'Aigueblanche,1999_2006,2002.5,7,6226,6771,352,534,545,182,363,0.0120599582115808,0.00402736219175725,0.00803259601982354,EPCI
247300254,CC de Haute-Tarentaise,2006_2011,2008.5,5,16138,16519,430,1096,381,666,-285,0.00467780576226273,0.00817695180490021,-0.00349914604263748,EPCI
247300254,CC de Haute-Tarentaise,2011_2016,2013.5,5,16519,15920,454,971,-599,517,-1116,-0.00735979372674178,0.00635227605463356,-0.0137120697813753,EPCI
247300254,CC de Haute-Tarentaise,1968_1975,1971.5,7,9137,10228,589,1343,1091,754,337,0.0162443787380309,0.0112266375513064,0.00501774118672447,EPCI
247300254,CC de Haute-Tarentaise,1975_1982,1978.5,7,10228,11896,572,1343,1668,771,897,0.0218164520360058,0.0100842233331897,0.0117322287028161,EPCI
247300254,CC de Haute-Tarentaise,1982_1990,1986,8,11896,13253,673,1638,1357,965,392,0.0135942899691992,0.00966727326475846,0.00392701670444074,EPCI
247300254,CC de Haute-Tarentaise,1990_1999,1994.5,9,13253,14566,776,2021,1313,1245,68,0.0105515124647515,0.0100050518039723,0.00054646066077921,EPCI
247300254,CC de Haute-Tarentaise,1999_2006,2002.5,7,14566,16138,631,1597,1572,966,606,0.0147486600195235,0.00906310787459266,0.0056855521449308,EPCI
247300262,CC de Yenne,2006_2011,2008.5,5,6359,6858,318,426,499,108,391,0.0152236614741703,0.00329490067978035,0.01192876079439,EPCI
247300262,CC de Yenne,2011_2016,2013.5,5,6858,7133,336,419,275,83,192,0.00789420607562397,0.00238261492464287,0.0055115911509811,EPCI
247300262,CC de Yenne,1968_1975,1971.5,7,4277,4260,504,368,-17,-136,119,-0.000568790886169124,-0.00455032708935299,0.00398153620318387,EPCI
247300262,CC de Yenne,1975_1982,1978.5,7,4260,4535,464,331,275,-133,408,0.0089766107409055,-0.00434141537651066,0.0133180261174162,EPCI
247300262,CC de Yenne,1982_1990,1986,8,4535,5091,518,449,556,-69,625,0.0145611443731439,-0.0018070484923506,0.0163681928654945,EPCI
247300262,CC de Yenne,1990_1999,1994.5,9,5091,5628,576,568,537,-8,545,0.0112045127302678,-0.000166920115162276,0.0113714328454301,EPCI
247300262,CC de Yenne,1999_2006,2002.5,7,5628,6359,470,511,731,41,690,0.0175983424482769,0.000987047934855473,0.0166112945134214,EPCI
247300361,CC du Canton de la Chambre,2006_2011,2008.5,5,6801,7231,370,355,430,-15,445,0.0123370166180483,-0.000430361044815639,0.012767377662864,EPCI
247300361,CC du Canton de la Chambre,2011_2016,2013.5,5,7231,7413,364,344,182,-20,202,0.00498395408233776,-0.000547687261795358,0.00553164134413312,EPCI
247300361,CC du Canton de la Chambre,1968_1975,1971.5,7,5530,5491,610,378,-39,-232,193,-0.00101055008393758,-0.0060114774223979,0.00500092733846032,EPCI
247300361,CC du Canton de la Chambre,1975_1982,1978.5,7,5491,5706,559,361,215,-198,413,0.00550191804774758,-0.005066882667228,0.0105688007149756,EPCI
247300361,CC du Canton de la Chambre,1982_1990,1986,8,5706,5942,591,526,236,-65,301,0.0050787941038497,-0.00139882040995861,0.00647761451380831,EPCI
247300361,CC du Canton de la Chambre,1990_1999,1994.5,9,5942,6184,618,521,242,-97,339,0.00444535521190148,-0.00178181593204316,0.00622717114394464,EPCI
247300361,CC du Canton de la Chambre,1999_2006,2002.5,7,6184,6801,503,463,617,-40,657,0.0136790492191119,-0.000886810322146638,0.0145658595412585,EPCI
247300452,CC Maurienne Galibier,2006_2011,2008.5,5,6065,5789,257,293,-276,36,-312,-0.00927174528552577,0.00120935808072075,-0.0104811033662465,EPCI
247300452,CC Maurienne Galibier,2011_2016,2013.5,5,5789,5461,286,291,-328,5,-333,-0.0115977499223219,0.000176794968328077,-0.01177454489065,EPCI
247300452,CC Maurienne Galibier,1968_1975,1971.5,7,7235,6452,432,730,-783,298,-1081,-0.0162297408748942,0.0061768362461283,-0.0224065771210224,EPCI
247300452,CC Maurienne Galibier,1975_1982,1978.5,7,6452,5972,433,459,-480,26,-506,-0.0109832785629682,0.000594927588827445,-0.0115782061517957,EPCI
247300452,CC Maurienne Galibier,1982_1990,1986,8,5972,5516,450,452,-456,2,-458,-0.00987948898938262,4.33310920586957e-05,-0.00992282008144132,EPCI
247300452,CC Maurienne Galibier,1990_1999,1994.5,9,5516,5670,527,536,154,9,145,0.00306425836068214,0.000179080034065839,0.0028851783266163,EPCI
247300452,CC Maurienne Galibier,1999_2006,2002.5,7,5670,6065,334,431,395,97,298,0.00966720337927418,0.00237397146275847,0.00729323191651571,EPCI
247300528,CC Val Guiers,2006_2011,2008.5,5,10553,11711,558,726,1158,168,990,0.021042003876601,0.00305272595100948,0.0179892779255916,EPCI
247300528,CC Val Guiers,2011_2016,2013.5,5,11711,12204,547,650,493,103,390,0.00828113966460364,0.00173013668449123,0.00655100298011242,EPCI
247300528,CC Val Guiers,1968_1975,1971.5,7,7963,7777,736,681,-186,-55,-131,-0.00337075670998865,-0.000996729134674064,-0.00237402757531459,EPCI
247300528,CC Val Guiers,1975_1982,1978.5,7,7777,8328,735,608,551,-127,678,0.00982692328602575,-0.00226500772654314,0.0120919310125689,EPCI
247300528,CC Val Guiers,1982_1990,1986,8,8328,8595,740,761,267,21,246,0.00395245386526333,0.00031086715794206,0.00364158670732127,EPCI
247300528,CC Val Guiers,1990_1999,1994.5,9,8595,9194,856,900,599,44,555,0.00751369369732902,0.000551924077934018,0.006961769619395,EPCI
247300528,CC Val Guiers,1999_2006,2002.5,7,9194,10553,778,821,1359,43,1316,0.0198893638657922,0.000629317620477605,0.0192600462453146,EPCI
247300668,CC du Lac d'Aiguebelette (CCLA),2006_2011,2008.5,5,4984,5552,172,285,568,113,455,0.0218197315871809,0.00434089730519619,0.0174788342819847,EPCI
247300668,CC du Lac d'Aiguebelette (CCLA),2011_2016,2013.5,5,5552,5747,191,311,195,120,75,0.00692783847615708,0.00426328521609666,0.00266455326006041,EPCI
247300668,CC du Lac d'Aiguebelette (CCLA),1968_1975,1971.5,7,2535,2589,280,200,54,-80,134,0.00301569003275737,-0.00446768893741832,0.00748337897017569,EPCI
247300668,CC du Lac d'Aiguebelette (CCLA),1975_1982,1978.5,7,2589,2892,252,166,303,-86,389,0.0159365976903587,-0.00452325875039884,0.0204598564407576,EPCI
247300668,CC du Lac d'Aiguebelette (CCLA),1982_1990,1986,8,2892,3711,281,326,819,45,774,0.0316599786556908,0.0017395592667962,0.0299204193888946,EPCI
247300668,CC du Lac d'Aiguebelette (CCLA),1990_1999,1994.5,9,3711,4153,279,433,442,154,288,0.0125817798431134,0.00438369704941054,0.00819808279370283,EPCI
247300668,CC du Lac d'Aiguebelette (CCLA),1999_2006,2002.5,7,4153,4984,224,379,831,155,676,0.0263998646034072,0.00492416247115296,0.0214757021322542,EPCI
247300676,CC Porte de Maurienne,2006_2011,2008.5,5,6162,6807,279,378,645,99,546,0.0201095452753435,0.00308658136784342,0.0170229639075001,EPCI
247300676,CC Porte de Maurienne,2011_2016,2013.5,5,6807,6795,342,365,-12,23,-35,-0.000352827114410426,0.000676251969286649,-0.00102907908369707,EPCI
247300676,CC Porte de Maurienne,1968_1975,1971.5,7,5087,4755,562,411,-332,-151,-181,-0.00959532112437977,-0.00436413701741369,-0.00523118410696608,EPCI
247300676,CC Porte de Maurienne,1975_1982,1978.5,7,4755,4718,495,299,-37,-196,159,-0.0011153368364093,-0.00590827080908709,0.00479293397267779,EPCI
247300676,CC Porte de Maurienne,1982_1990,1986,8,4718,4307,527,339,-411,-188,-223,-0.0113282682938445,-0.00518178695679504,-0.00614648133704944,EPCI
247300676,CC Porte de Maurienne,1990_1999,1994.5,9,4307,4966,550,469,659,-81,740,0.015945017668346,-0.00195985801386347,0.0179048756822095,EPCI
247300676,CC Porte de Maurienne,1999_2006,2002.5,7,4966,6162,461,437,1196,-24,1220,0.0313067353994654,-0.00062822880400265,0.031934964203468,EPCI
247300817,CC Les Versants d'Aime,2006_2011,2008.5,5,9190,9648,309,645,458,336,122,0.00977440116819595,0.00717073972164593,0.00260366144655001,EPCI
247300817,CC Les Versants d'Aime,2011_2016,2013.5,5,9648,9566,293,511,-82,218,-300,-0.00170564268072082,0.00453451346825779,-0.00624015614897861,EPCI
247300817,CC Les Versants d'Aime,1968_1975,1971.5,7,6452,6321,452,803,-131,351,-482,-0.00292610156283224,0.00784016525613829,-0.0107662668189705,EPCI
247300817,CC Les Versants d'Aime,1975_1982,1978.5,7,6321,6717,407,578,396,171,225,0.00871838606582376,0.00376475761933299,0.00495362844649077,EPCI
247300817,CC Les Versants d'Aime,1982_1990,1986,8,6717,7753,476,802,1036,326,710,0.0180914833623786,0.00569287989974463,0.012398603462634,EPCI
247300817,CC Les Versants d'Aime,1990_1999,1994.5,9,7753,8347,475,994,594,519,75,0.00823621336102609,0.0071962874316036,0.00103992592942249,EPCI
247300817,CC Les Versants d'Aime,1999_2006,2002.5,7,8347,9190,393,871,843,478,365,0.0138397148151463,0.0078474302273309,0.00599228458781544,EPCI
247400047,CC de la Vallée Verte,2006_2011,2008.5,5,6722,7314,226,407,592,181,411,0.0170242059238073,0.00520503593278567,0.0118191699910216,EPCI
247400047,CC de la Vallée Verte,2011_2016,2013.5,5,7314,7593,208,454,279,246,33,0.00751538994408851,0.00662647285392751,0.000888917090161007,EPCI
247400047,CC de la Vallée Verte,1968_1975,1971.5,7,3374,3310,293,335,-64,42,-106,-0.00273208885282961,0.00179293330966943,-0.00452502216249904,EPCI
247400047,CC de la Vallée Verte,1975_1982,1978.5,7,3310,3729,265,299,419,34,385,0.0171732087357217,0.00139353006447384,0.0157796786712479,EPCI
247400047,CC de la Vallée Verte,1982_1990,1986,8,3729,4802,324,494,1073,170,903,0.0321165013317939,0.00508835529021898,0.0270281460415749,EPCI
247400047,CC de la Vallée Verte,1990_1999,1994.5,9,4802,5707,348,643,905,295,610,0.0193697609036241,0.00631389996305978,0.0130558609405643,EPCI
247400047,CC de la Vallée Verte,1999_2006,2002.5,7,5707,6722,287,550,1015,263,752,0.0236601690675813,0.00613066449731417,0.0175295045702671,EPCI
247400112,CC du Pays de Cruseilles,2006_2011,2008.5,5,11517,13444,276,778,1927,502,1425,0.0314254123593305,0.00818658900071817,0.0232388233586123,EPCI
247400112,CC du Pays de Cruseilles,2011_2016,2013.5,5,13444,15166,305,941,1722,636,1086,0.024397499176251,0.00901092304070595,0.0153865761355451,EPCI
247400112,CC du Pays de Cruseilles,1968_1975,1971.5,7,4686,5097,382,494,411,112,299,0.0120828132107358,0.00329264009635622,0.00879017311437956,EPCI
247400112,CC du Pays de Cruseilles,1975_1982,1978.5,7,5097,6091,436,484,994,48,946,0.0257781021419177,0.00124481780967007,0.0245332843322476,EPCI
247400112,CC du Pays de Cruseilles,1982_1990,1986,8,6091,7624,483,685,1533,202,1331,0.0284585334657426,0.00374991765171559,0.024708615814027,EPCI
247400112,CC du Pays de Cruseilles,1990_1999,1994.5,9,7624,9737,557,1133,2113,576,1537,0.0275541037690628,0.00751119913439666,0.0200429046346661,EPCI
247400112,CC du Pays de Cruseilles,1999_2006,2002.5,7,9737,11517,417,923,1780,506,1274,0.0242743892304027,0.00690047244414819,0.0173739167862545,EPCI
247400567,CC Fier et Usses,2006_2011,2008.5,5,12073,14126,225,828,2053,603,1450,0.0319075743675528,0.00937178146304643,0.0225357929045063,EPCI
247400567,CC Fier et Usses,2011_2016,2013.5,5,14126,15111,356,884,985,528,457,0.0135724576837464,0.00727538848428232,0.00629706919946406,EPCI
247400567,CC Fier et Usses,1968_1975,1971.5,7,3258,4126,253,375,868,122,746,0.0343178519737497,0.00482347689031966,0.02949437508343,EPCI
247400567,CC Fier et Usses,1975_1982,1978.5,7,4126,5948,277,528,1822,251,1571,0.0536386097018584,0.0073892925549761,0.0462493171468823,EPCI
247400567,CC Fier et Usses,1982_1990,1986,8,5948,8231,331,775,2283,444,1839,0.0414422805812753,0.00805973393696287,0.0333825466443124,EPCI
247400567,CC Fier et Usses,1990_1999,1994.5,9,8231,10270,373,1171,2039,798,1241,0.0248959104580482,0.00974347059613656,0.0151524398619116,EPCI
247400567,CC Fier et Usses,1999_2006,2002.5,7,10270,12073,310,903,1803,593,1210,0.0233753814862683,0.00768807610724187,0.0156873053790264,EPCI
247400583,CC Arve et Salève,2006_2011,2008.5,5,15309,17959,460,897,2650,437,2213,0.0324453330546739,0.00535041907354434,0.0270949139811296,EPCI
247400583,CC Arve et Salève,2011_2016,2013.5,5,17959,19765,479,1132,1806,653,1153,0.0193490761445527,0.00699609453067161,0.0123529816138811,EPCI
247400583,CC Arve et Salève,1968_1975,1971.5,7,6784,8199,958,757,1415,-201,1616,0.0274331596891726,-0.00389686579330296,0.0313300254824756,EPCI
247400583,CC Arve et Salève,1975_1982,1978.5,7,8199,9576,850,767,1377,-83,1460,0.022426018972949,-0.00135174987273404,0.0237777688456831,EPCI
247400583,CC Arve et Salève,1982_1990,1986,8,9576,11294,750,985,1718,235,1483,0.0208406508681049,0.00285072930966511,0.0179899215584398,EPCI
247400583,CC Arve et Salève,1990_1999,1994.5,9,11294,13156,838,1354,1862,516,1346,0.0171008307711729,0.0047390057346537,0.0123618250365192,EPCI
247400583,CC Arve et Salève,1999_2006,2002.5,7,13156,15309,684,1130,2153,446,1707,0.0218879540555428,0.00453415118846822,0.0173538028670746,EPCI
247400617,CC des Vallées de Thônes,2006_2011,2008.5,5,16973,17672,550,1119,699,569,130,0.00810418655718914,0.00659697017316255,0.00150721638402659,EPCI
247400617,CC des Vallées de Thônes,2011_2016,2013.5,5,17672,18457,590,1040,785,450,335,0.00873033626419795,0.00500465136164214,0.00372568490255581,EPCI
247400617,CC des Vallées de Thônes,1968_1975,1971.5,7,9323,10057,683,1251,734,568,166,0.0108851661481795,0.00842339832720155,0.00246176782097792,EPCI
247400617,CC des Vallées de Thônes,1975_1982,1978.5,7,10057,11408,703,1210,1351,507,844,0.0181696605367085,0.00681866609334658,0.011350994443362,EPCI
247400617,CC des Vallées de Thônes,1982_1990,1986,8,11408,13027,849,1419,1619,570,1049,0.016727013652337,0.00588906595542438,0.0108379476969126,EPCI
247400617,CC des Vallées de Thônes,1990_1999,1994.5,9,13027,15212,888,1918,2185,1030,1155,0.0173782146122103,0.00819201878744927,0.00918619582476107,EPCI
247400617,CC des Vallées de Thônes,1999_2006,2002.5,7,15212,16973,748,1610,1761,862,899,0.0157715435478714,0.00772008548453442,0.00805145806333694,EPCI
247400666,CC des Quatre Rivières,2006_2011,2008.5,5,16420,17679,452,994,1259,542,717,0.0148851750857086,0.00640807378590475,0.00847710129980389,EPCI
247400666,CC des Quatre Rivières,2011_2016,2013.5,5,17679,18929,525,1086,1250,561,689,0.0137573012287187,0.00617427679144893,0.00758302443726972,EPCI
247400666,CC des Quatre Rivières,1968_1975,1971.5,7,8189,8773,700,889,584,189,395,0.00988958661491401,0.00320056827092251,0.0066890183439915,EPCI
247400666,CC des Quatre Rivières,1975_1982,1978.5,7,8773,9514,652,846,741,194,547,0.0116510038698079,0.00305033029789842,0.00860067357190946,EPCI
247400666,CC des Quatre Rivières,1982_1990,1986,8,9514,11930,745,1058,2416,313,2103,0.0286903411774035,0.00371691920054938,0.0249734219768542,EPCI
247400666,CC des Quatre Rivières,1990_1999,1994.5,9,11930,14422,806,1607,2492,801,1691,0.0213013222402343,0.00684685357721816,0.0144544686630161,EPCI
247400666,CC des Quatre Rivières,1999_2006,2002.5,7,14422,16420,637,1434,1998,797,1201,0.0187078808730521,0.00746255308099225,0.0112453277920598,EPCI
247400682,CC du Haut-Chablais,2006_2011,2008.5,5,11556,12071,393,746,515,353,162,0.00875835169873507,0.00600329737796792,0.00275505432076715,EPCI
247400682,CC du Haut-Chablais,2011_2016,2013.5,5,12071,12628,469,789,557,320,237,0.00906295995591155,0.0052067274432526,0.00385623251265896,EPCI
247400682,CC du Haut-Chablais,1968_1975,1971.5,7,8570,8865,717,935,295,218,77,0.00484645007717721,0.00358144446381231,0.0012650056133649,EPCI
247400682,CC du Haut-Chablais,1975_1982,1978.5,7,8865,9293,703,858,428,155,273,0.00675852056444448,0.00244759506422639,0.00431092550021809,EPCI
247400682,CC du Haut-Chablais,1982_1990,1986,8,9293,10075,769,1094,782,325,457,0.0101506315760582,0.00421861286728762,0.0059320187087706,EPCI
247400682,CC du Haut-Chablais,1990_1999,1994.5,9,10075,10682,763,1394,607,631,-24,0.00652150345417901,0.00677935532057159,-0.00025785186639258,EPCI
247400682,CC du Haut-Chablais,1999_2006,2002.5,7,10682,11556,624,1053,874,429,445,0.0112983063924048,0.00554573620405225,0.00575257018835256,EPCI
247400690,CC du Genevois,2006_2011,2008.5,5,32299,36669,766,1979,4370,1213,3157,0.0257038791657729,0.00713473808422941,0.0185691410815435,EPCI
247400690,CC du Genevois,2011_2016,2013.5,5,36669,44185,904,2547,7516,1643,5873,0.0379947539172971,0.00830566533875987,0.0296890885785373,EPCI
247400690,CC du Genevois,1968_1975,1971.5,7,12786,17401,977,1813,4615,836,3779,0.045008756475573,0.00815326552840283,0.0368554909471702,EPCI
247400690,CC du Genevois,1975_1982,1978.5,7,17401,19559,962,1970,2158,1008,1150,0.0168413666578533,0.00786658831840414,0.00897477833944916,EPCI
247400690,CC du Genevois,1982_1990,1986,8,19559,22942,1098,2283,3383,1185,2198,0.0201418835713145,0.00705531540999341,0.0130865681613211,EPCI
247400690,CC du Genevois,1990_1999,1994.5,9,22942,26905,1305,2814,3963,1509,2454,0.0178624195765722,0.00680151176912628,0.0110609078074459,EPCI
247400690,CC du Genevois,1999_2006,2002.5,7,26905,32299,1107,2384,5394,1277,4117,0.0264471255721988,0.00626121233883904,0.0201859132333597,EPCI
247400724,CC du Pays Rochois,2006_2011,2008.5,5,22936,24937,720,1596,2001,876,1125,0.0168696961538612,0.0073852342982421,0.00948446185561914,EPCI
247400724,CC du Pays Rochois,2011_2016,2013.5,5,24937,27787,767,1613,2850,846,2004,0.0218790395994299,0.00649462017583078,0.0153844194235992,EPCI
247400724,CC du Pays Rochois,1968_1975,1971.5,7,10717,12206,820,1294,1489,474,1015,0.0187589751369333,0.00597162808254289,0.0127873470543904,EPCI
247400724,CC du Pays Rochois,1975_1982,1978.5,7,12206,14114,894,1334,1908,440,1468,0.0209652580291582,0.00483475552035094,0.0161305025088072,EPCI
247400724,CC du Pays Rochois,1982_1990,1986,8,14114,16251,1101,1668,2137,567,1570,0.017779612574081,0.00471737965816749,0.0130622329159135,EPCI
247400724,CC du Pays Rochois,1990_1999,1994.5,9,16251,19903,1184,2388,3652,1204,2448,0.0227795838519449,0.00751002709686245,0.0152695567550825,EPCI
247400724,CC du Pays Rochois,1999_2006,2002.5,7,19903,22936,1011,2015,3033,1004,2029,0.0204691422332357,0.00677580573760918,0.0136933364956265,EPCI
247400740,CC Rumilly Terre de Savoie,2006_2011,2008.5,5,25778,27881,799,1809,2103,1010,1093,0.0158084598913242,0.00759227032346049,0.00821618956786368,EPCI
247400740,CC Rumilly Terre de Savoie,2011_2016,2013.5,5,27881,31027,907,2005,3146,1098,2048,0.0216127110753401,0.00754315218077669,0.0140695588945634,EPCI
247400740,CC Rumilly Terre de Savoie,1968_1975,1971.5,7,12795,13880,986,1547,1085,561,524,0.011695649100856,0.00604724345214765,0.00564840564870832,EPCI
247400740,CC Rumilly Terre de Savoie,1975_1982,1978.5,7,13880,16807,1038,1620,2927,582,2345,0.0277122505027136,0.00551025958065574,0.0222019909220579,EPCI
247400740,CC Rumilly Terre de Savoie,1982_1990,1986,8,16807,19637,1187,2165,2830,978,1852,0.0196429422905771,0.00678826768911108,0.012854674601466,EPCI
247400740,CC Rumilly Terre de Savoie,1990_1999,1994.5,9,19637,22799,1384,2627,3162,1243,1919,0.0167273765852416,0.00657562589989099,0.0101517506853506,EPCI
247400740,CC Rumilly Terre de Savoie,1999_2006,2002.5,7,22799,25778,1119,2323,2979,1204,1775,0.0176983259027501,0.00715299912283019,0.0105453267799199,EPCI
247400773,CC des Sources du Lac d'Annecy,2006_2011,2008.5,5,13965,14924,590,833,959,243,716,0.0133719060356843,0.00338829318735274,0.00998361284833154,EPCI
247400773,CC des Sources du Lac d'Annecy,2011_2016,2013.5,5,14924,15190,599,749,266,150,116,0.0035395818265902,0.00199600478943056,0.00154357703715964,EPCI
247400773,CC des Sources du Lac d'Annecy,1968_1975,1971.5,7,8275,9273,581,1053,998,472,526,0.0163998872243074,0.00775625928845,0.00864362793585741,EPCI
247400773,CC des Sources du Lac d'Annecy,1975_1982,1978.5,7,9273,10692,630,1116,1419,486,933,0.0205495572057839,0.00703811473009934,0.0135114424756845,EPCI
247400773,CC des Sources du Lac d'Annecy,1982_1990,1986,8,10692,11629,752,1239,937,487,450,0.0105560991036358,0.00548646773049158,0.00506963137314417,EPCI
247400773,CC des Sources du Lac d'Annecy,1990_1999,1994.5,9,11629,12698,917,1392,1069,475,594,0.00981928730284687,0.00436310708031082,0.00545618022253605,EPCI
247400773,CC des Sources du Lac d'Annecy,1999_2006,2002.5,7,12698,13965,733,1194,1267,461,806,0.0136798239222458,0.00497742606799944,0.00870239785424632,EPCI
247600505,CC Campagne-de-Caux,2006_2011,2008.5,5,13978,14957,436,982,979,546,433,0.0136310171410212,0.00760218116342961,0.00602883597759161,EPCI
247600505,CC Campagne-de-Caux,2011_2016,2013.5,5,14957,15097,449,924,140,475,-335,0.00186506325265401,0.00632789317864753,-0.00446282992599352,EPCI
247600505,CC Campagne-de-Caux,1968_1975,1971.5,7,8948,8900,642,897,-48,255,-303,-0.00076810012992401,0.0040805319402213,-0.00484863207014531,EPCI
247600505,CC Campagne-de-Caux,1975_1982,1978.5,7,8900,10646,596,946,1746,350,1396,0.0259206684632352,0.00519601028759009,0.0207246581756451,EPCI
247600505,CC Campagne-de-Caux,1982_1990,1986,8,10646,11733,690,1120,1087,430,657,0.0122267871277142,0.00483672351878298,0.00739006360893121,EPCI
247600505,CC Campagne-de-Caux,1990_1999,1994.5,9,11733,12488,756,1248,755,492,263,0.00695326231462734,0.00453113252820749,0.00242212978641986,EPCI
247600505,CC Campagne-de-Caux,1999_2006,2002.5,7,12488,13978,602,1280,1490,678,812,0.0162326961221364,0.00738642145691844,0.00884627466521796,EPCI
247600588,CC des Villes Soeurs,2006_2011,2008.5,5,40459,39224,2250,2061,-1235,-189,-1046,-0.00618088153831475,-0.000945900089669222,-0.00523498144864553,EPCI
247600588,CC des Villes Soeurs,2011_2016,2013.5,5,39224,37890,2215,1794,-1334,-421,-913,-0.00689642561897097,-0.00217645816011003,-0.00471996745886094,EPCI
247600588,CC des Villes Soeurs,1968_1975,1971.5,7,39402,42397,3020,5371,2995,2351,644,0.0105208199140954,0.00825858017296768,0.00226223974112769,EPCI
247600588,CC des Villes Soeurs,1975_1982,1978.5,7,42397,41621,3112,4477,-776,1365,-2141,-0.00263548633919264,0.00463587481056437,-0.00727136114975701,EPCI
247600588,CC des Villes Soeurs,1982_1990,1986,8,41621,41313,3522,4409,-308,887,-1195,-0.000928022517241778,0.00267258432725148,-0.00360060684449326,EPCI
247600588,CC des Villes Soeurs,1990_1999,1994.5,9,41313,40819,3793,4505,-494,712,-1206,-0.0013357250271101,0.00192517453300079,-0.0032608995601109,EPCI
247600588,CC des Villes Soeurs,1999_2006,2002.5,7,40819,40459,2945,3410,-360,465,-825,-0.00126470581622884,0.00163357834596225,-0.00289828416219109,EPCI
247600604,CC de Londinières,2006_2011,2008.5,5,4964,5235,243,293,271,50,221,0.0106877052100132,0.00197190133026073,0.00871580387975243,EPCI
247600604,CC de Londinières,2011_2016,2013.5,5,5235,5300,254,319,65,65,0,0.00247104325435843,0.00247104325435843,0,EPCI
247600604,CC de Londinières,1968_1975,1971.5,7,5913,5425,349,676,-488,327,-815,-0.0122296619585319,0.00819487594352446,-0.0204245379020564,EPCI
247600604,CC de Londinières,1975_1982,1978.5,7,5425,5014,390,413,-411,23,-434,-0.011191744013757,0.000626301976438956,-0.011818045990196,EPCI
247600604,CC de Londinières,1982_1990,1986,8,5014,4747,408,397,-267,-11,-256,-0.00681680447680144,-0.000280842132003056,-0.00653596234479839,EPCI
247600604,CC de Londinières,1990_1999,1994.5,9,4747,4726,458,448,-21,-10,-11,-0.000492507656541741,-0.000234527455496067,-0.000257980201045674,EPCI
247600604,CC de Londinières,1999_2006,2002.5,7,4726,4964,312,364,238,52,186,0.00704364611293262,0.00153894789022057,0.00550469822271205,EPCI
247600620,CC Yvetot Normandie,2006_2011,2008.5,5,24527,25955,1148,1537,1428,389,1039,0.0113822337811951,0.00310062250762247,0.0082816112735726,EPCI
247600620,CC Yvetot Normandie,2011_2016,2013.5,5,25955,26683,1214,1424,728,210,518,0.00554781026293538,0.00160032988353905,0.00394748037939633,EPCI
247600620,CC Yvetot Normandie,1968_1975,1971.5,7,17309,19009,1183,2460,1700,1277,423,0.0134736703953515,0.0101211041734493,0.00335256622190217,EPCI
247600620,CC Yvetot Normandie,1975_1982,1978.5,7,19009,21270,1384,2285,2261,901,1360,0.0161845853421914,0.00644949641455746,0.0097350889276339,EPCI
247600620,CC Yvetot Normandie,1982_1990,1986,8,21270,22917,1530,2772,1647,1242,405,0.00936626195214596,0.00706308278358548,0.00230317916856048,EPCI
247600620,CC Yvetot Normandie,1990_1999,1994.5,9,22917,23672,1796,2560,755,764,-9,0.00360804023749672,0.00365104998867218,-4.30097511754574e-05,EPCI
247600620,CC Yvetot Normandie,1999_2006,2002.5,7,23672,24527,1510,2041,855,531,324,0.00508167333564669,0.00315598659792794,0.00192568673771874,EPCI
247600646,CC Caux - Austreberthe,2006_2011,2008.5,5,24458,24855,1022,1750,397,728,-331,0.003225506543171,0.00591478277941684,-0.00268927623624584,EPCI
247600646,CC Caux - Austreberthe,2011_2016,2013.5,5,24855,25031,1124,1721,176,597,-421,0.00141221967567562,0.00479031333169514,-0.00337809365601952,EPCI
247600646,CC Caux - Austreberthe,1968_1975,1971.5,7,18788,20582,1178,2752,1794,1574,220,0.0131136016399978,0.011505467659619,0.00160813398037877,EPCI
247600646,CC Caux - Austreberthe,1975_1982,1978.5,7,20582,23244,1301,2724,2662,1423,1239,0.0175275685848508,0.00936954549069975,0.00815802309415108,EPCI
247600646,CC Caux - Austreberthe,1982_1990,1986,8,23244,24317,1414,3214,1073,1800,-727,0.00565702336801266,0.00948988076647044,-0.00383285739845778,EPCI
247600646,CC Caux - Austreberthe,1990_1999,1994.5,9,24317,25055,1718,3246,738,1528,-790,0.0033274920943589,0.0068894416262607,-0.0035619495319018,EPCI
247600646,CC Caux - Austreberthe,1999_2006,2002.5,7,25055,24458,1301,2276,-597,975,-1572,-0.00343922194464619,0.00561681975884428,-0.00905604170349046,EPCI
247600729,CC Falaises du Talou,2006_2011,2008.5,5,21832,22788,919,1385,956,466,490,0.00860829978532851,0.00419609592046348,0.00441220386486503,EPCI
247600729,CC Falaises du Talou,2011_2016,2013.5,5,22788,23591,961,1335,803,374,429,0.0069502822265517,0.00323711774935284,0.00371316447719885,EPCI
247600729,CC Falaises du Talou,1968_1975,1971.5,7,15968,16587,1029,1902,619,873,-254,0.00544800619824959,0.00768353701304021,-0.00223553081479062,EPCI
247600729,CC Falaises du Talou,1975_1982,1978.5,7,16587,18237,1090,1556,1650,466,1184,0.0136397905521546,0.0038522075135176,0.00978758303863699,EPCI
247600729,CC Falaises du Talou,1982_1990,1986,8,18237,19988,1246,2070,1751,824,927,0.011525866287591,0.00542393707651341,0.00610192921107759,EPCI
247600729,CC Falaises du Talou,1990_1999,1994.5,9,19988,20093,1516,2112,105,596,-491,0.000582325287849628,0.00330538925293693,-0.00272306396508731,EPCI
247600729,CC Falaises du Talou,1999_2006,2002.5,7,20093,21832,1252,1877,1739,625,1114,0.0119284818338559,0.00428711969301893,0.00764136214083694,EPCI
247600786,CA de la Région Dieppoise,2006_2011,2008.5,5,51624,49373,2781,2899,-2251,118,-2369,-0.00887695798808119,0.000465340312125091,-0.00934229830020628,EPCI
247600786,CA de la Région Dieppoise,2011_2016,2013.5,5,49373,47223,2979,2440,-2150,-539,-1611,-0.00886500288462999,-0.00222243560689096,-0.00664256727773903,EPCI
247600786,CA de la Région Dieppoise,1968_1975,1971.5,7,51969,53292,3806,6903,1323,3097,-1774,0.00359771904375839,0.00842187141233539,-0.004824152368577,EPCI
247600786,CA de la Région Dieppoise,1975_1982,1978.5,7,53292,51710,3985,5973,-1582,1988,-3570,-0.00429575241626612,0.00539820215141406,-0.00969395456768018,EPCI
247600786,CA de la Région Dieppoise,1982_1990,1986,8,51710,52917,4315,6802,1207,2487,-1280,0.00288834599276155,0.00595138068268267,-0.00306303468992112,EPCI
247600786,CA de la Région Dieppoise,1990_1999,1994.5,9,52917,52675,4774,6662,-242,1888,-2130,-0.000509169063547366,0.00397236029742738,-0.00448152936097475,EPCI
247600786,CA de la Région Dieppoise,1999_2006,2002.5,7,52675,51624,3719,4590,-1051,871,-1922,-0.00287504185087517,0.00238264648155307,-0.00525768833242824,EPCI
247700032,CC Moret Seine et Loing,2006_2011,2008.5,5,38733,38861,1599,2189,128,590,-462,0.000660063177779335,0.00304247871007662,-0.00238241553229729,EPCI
247700032,CC Moret Seine et Loing,2011_2016,2013.5,5,38861,39055,1577,2088,194,511,-317,0.00099644252773512,0.00262465016326106,-0.00162820763552594,EPCI
247700032,CC Moret Seine et Loing,1968_1975,1971.5,7,25097,27511,2151,2614,2414,463,1951,0.013206098555145,0.00253290125560569,0.0106731972995393,EPCI
247700032,CC Moret Seine et Loing,1975_1982,1978.5,7,27511,29427,2253,2339,1916,86,1830,0.0096645019317545,0.000433792884201924,0.00923070904755257,EPCI
247700032,CC Moret Seine et Loing,1982_1990,1986,8,29427,34368,2455,3285,4941,830,4111,0.0195910951682465,0.00329095506772812,0.0163001401005184,EPCI
247700032,CC Moret Seine et Loing,1990_1999,1994.5,9,34368,37598,2865,4101,3230,1236,1994,0.0100305227652122,0.00383830530582114,0.00619221745939107,EPCI
247700032,CC Moret Seine et Loing,1999_2006,2002.5,7,37598,38733,2200,3111,1135,911,224,0.00425776612025053,0.00341746690356672,0.000840299216683805,EPCI
247700057,CA Melun Val de Seine,2006_2011,2008.5,5,123244,125773,4109,10069,2529,5960,-3431,0.00407077612032714,0.00959344629385122,-0.00552267017352408,EPCI
247700057,CA Melun Val de Seine,2011_2016,2013.5,5,125773,130998,4331,10296,5225,5965,-740,0.00817389758366538,0.00933154049503617,-0.00115764291137079,EPCI
247700057,CA Melun Val de Seine,1968_1975,1971.5,7,70162,93123,4397,11686,22961,7289,15672,0.041273940775193,0.0131024674147634,0.0281714733604296,EPCI
247700057,CA Melun Val de Seine,1975_1982,1978.5,7,93123,101751,4707,11742,8628,7035,1593,0.0127386616936094,0.0103867043364096,0.00235195735719978,EPCI
247700057,CA Melun Val de Seine,1982_1990,1986,8,101751,114646,5814,14669,12895,8855,4040,0.0150268430029559,0.0103189371687611,0.00470790583419478,EPCI
247700057,CA Melun Val de Seine,1990_1999,1994.5,9,114646,119292,7200,17017,4646,9817,-5171,0.00442366108607462,0.00934719777916369,-0.00492353669308907,EPCI
247700057,CA Melun Val de Seine,1999_2006,2002.5,7,119292,123244,5704,13286,3952,7582,-3630,0.00466683608575469,0.00895342894792309,-0.0042865928621684,EPCI
247700065,CC du Pays de l'Ourcq,2006_2011,2008.5,5,16720,17611,629,1360,891,731,160,0.0104377166899521,0.00856337923721097,0.00187433745274111,EPCI
247700065,CC du Pays de l'Ourcq,2011_2016,2013.5,5,17611,17849,641,1281,238,640,-402,0.00268836267030959,0.00722921054200897,-0.00454084787169938,EPCI
247700065,CC du Pays de l'Ourcq,1968_1975,1971.5,7,8970,10288,834,1063,1318,229,1089,0.0197776788549098,0.00343633418647522,0.0163413446684346,EPCI
247700065,CC du Pays de l'Ourcq,1975_1982,1978.5,7,10288,11343,873,1167,1055,294,761,0.0140437926938168,0.00391362564168924,0.0101301670521276,EPCI
247700065,CC du Pays de l'Ourcq,1982_1990,1986,8,11343,13600,971,1507,2257,536,1721,0.022942852137235,0.00544854618766414,0.0174943059495709,EPCI
247700065,CC du Pays de l'Ourcq,1990_1999,1994.5,9,13600,15606,1111,2086,2006,975,1031,0.0154047443177727,0.00748735080250668,0.00791739351526604,EPCI
247700065,CC du Pays de l'Ourcq,1999_2006,2002.5,7,15606,16720,954,1641,1114,687,427,0.00989869284534595,0.00610449011198624,0.00379420273335971,EPCI
247700107,CC Pays de Montereau,2006_2011,2008.5,5,38376,38962,1674,2895,586,1221,-635,0.00303550744237646,0.00632483717942263,-0.00328932973704617,EPCI
247700107,CC Pays de Montereau,2011_2016,2013.5,5,38962,42129,1796,2870,3167,1074,2093,0.0157526913483044,0.00534208730915027,0.0104106040391541,EPCI
247700107,CC Pays de Montereau,1968_1975,1971.5,7,32484,35592,2509,4775,3108,2266,842,0.0131388854840313,0.00957938047194818,0.00355950501208313,EPCI
247700107,CC Pays de Montereau,1975_1982,1978.5,7,35592,35689,2391,4091,97,1700,-1603,0.000388879101427708,0.00681540693223819,-0.00642652783081048,EPCI
247700107,CC Pays de Montereau,1982_1990,1986,8,35689,36855,2690,4291,1166,1601,-435,0.00402668246131421,0.00552891819945459,-0.00150223573814038,EPCI
247700107,CC Pays de Montereau,1990_1999,1994.5,9,36855,37818,2975,5225,963,2250,-1287,0.0028700981030183,0.0067058366892951,-0.0038357385862768,EPCI
247700107,CC Pays de Montereau,1999_2006,2002.5,7,37818,38376,2312,3988,558,1676,-1118,0.00209463131598553,0.00629140158708198,-0.00419677027109645,EPCI
247700339,CA Val d'Europe Agglomération,2006_2011,2008.5,5,24735,30860,386,2532,6125,2146,3979,0.0452418775992332,0.0158512766249721,0.029390600974261,EPCI
247700339,CA Val d'Europe Agglomération,2011_2016,2013.5,5,30860,35711,522,2627,4851,2105,2746,0.0296300711716357,0.0128574108052553,0.0167726603663805,EPCI
247700339,CA Val d'Europe Agglomération,1968_1975,1971.5,7,3094,4040,416,275,946,-141,1087,0.0388469747339366,-0.00579008820030134,0.044637062934238,EPCI
247700339,CA Val d'Europe Agglomération,1975_1982,1978.5,7,4040,4912,526,354,872,-172,1044,0.0283129017351331,-0.00558465492940699,0.0338975566645401,EPCI
247700339,CA Val d'Europe Agglomération,1982_1990,1986,8,4912,7098,540,576,2186,36,2150,0.0470916699454733,0.000775526129019689,0.0463161438164536,EPCI
247700339,CA Val d'Europe Agglomération,1990_1999,1994.5,9,7098,14237,574,1314,7139,740,6399,0.0804058904745484,0.00833455091065497,0.0720713395638934,EPCI
247700339,CA Val d'Europe Agglomération,1999_2006,2002.5,7,14237,24735,447,2401,10498,1954,8544,0.0821077064158891,0.0152827641776193,0.0668249422382698,EPCI
247700438,CC Pays Créçois,2006_2011,2008.5,5,32694,34980,1010,2313,2286,1303,983,0.0136087463186452,0.00775686633998017,0.00585187997866501,EPCI
247700438,CC Pays Créçois,2011_2016,2013.5,5,34980,36287,1080,2093,1307,1013,294,0.00736359506914397,0.00570720872612306,0.00165638634302091,EPCI
247700438,CC Pays Créçois,1968_1975,1971.5,7,12222,18754,1231,1375,6532,144,6388,0.0630765024598086,0.00139054138919358,0.061685961070615,EPCI
247700438,CC Pays Créçois,1975_1982,1978.5,7,18754,22372,1391,1768,3618,377,3241,0.0255206602607121,0.00265928383590062,0.0228613764248115,EPCI
247700438,CC Pays Créçois,1982_1990,1986,8,22372,26512,1590,2107,4140,517,3623,0.0214502288192104,0.00267868799505599,0.0187715408241545,EPCI
247700438,CC Pays Créçois,1990_1999,1994.5,9,26512,30189,1747,3239,3677,1492,2185,0.0145357602201364,0.00589811102758865,0.00863764919254772,EPCI
247700438,CC Pays Créçois,1999_2006,2002.5,7,30189,32694,1504,3003,2505,1499,1006,0.0114527946609839,0.00685338890092411,0.00459940576005981,EPCI
247700594,CA Marne et Gondoire,2006_2011,2008.5,5,83643,94744,2106,7018,11101,4912,6189,0.02523735854984,0.011167093522819,0.014070265027021,EPCI
247700594,CA Marne et Gondoire,2011_2016,2013.5,5,94744,103782,2223,7511,9038,5288,3750,0.0183898540501708,0.0107596313584093,0.00763022269176151,EPCI
247700594,CA Marne et Gondoire,1968_1975,1971.5,7,31418,36887,2563,4033,5469,1470,3999,0.0231902664024004,0.00623325865999791,0.0169570077424025,EPCI
247700594,CA Marne et Gondoire,1975_1982,1978.5,7,36887,43516,2553,4388,6629,1835,4794,0.0238908495809265,0.00661332161427064,0.0172775279666558,EPCI
247700594,CA Marne et Gondoire,1982_1990,1986,8,43516,54001,2923,5611,10485,2688,7797,0.0273516062261754,0.00701202837729704,0.0203395778488783,EPCI
247700594,CA Marne et Gondoire,1990_1999,1994.5,9,54001,69200,3377,7637,15199,4260,10939,0.0279385268002161,0.00783065492262127,0.0201078718775949,EPCI
247700594,CA Marne et Gondoire,1999_2006,2002.5,7,69200,83643,2989,8257,14443,5268,9175,0.0274495374234895,0.0100120586545,0.0174374787689896,EPCI
247700644,CC l'Orée de la Brie,2006_2011,2008.5,5,23687,25436,787,1695,1749,908,841,0.0143498078088331,0.00744975728440278,0.00690005052443033,EPCI
247700644,CC l'Orée de la Brie,2011_2016,2013.5,5,25436,26714,804,1729,1278,925,353,0.0098526769721865,0.00713124115749023,0.00272143581469627,EPCI
247700644,CC l'Orée de la Brie,1968_1975,1971.5,7,8921,12121,757,1244,3200,487,2713,0.0447631461921847,0.00681239131112311,0.0379507548810616,EPCI
247700644,CC l'Orée de la Brie,1975_1982,1978.5,7,12121,14838,746,1323,2717,577,2140,0.0293145949049463,0.00622544028713802,0.0230891546178082,EPCI
247700644,CC l'Orée de la Brie,1982_1990,1986,8,14838,17066,872,1573,2228,701,1527,0.0176408846206986,0.0055503860498697,0.0120904985708289,EPCI
247700644,CC l'Orée de la Brie,1990_1999,1994.5,9,17066,21410,1119,2337,4344,1218,3126,0.0255167768289228,0.00715456587882781,0.018362210950095,EPCI
247700644,CC l'Orée de la Brie,1999_2006,2002.5,7,21410,23687,1025,2116,2277,1091,1186,0.0145430606203447,0.00696815069688014,0.00757490992346457,EPCI
247700701,CC Brie Nangissienne,2006_2011,2008.5,5,25394,26687,895,1770,1293,875,418,0.00998221921496789,0.00675517541616157,0.00322704379880633,EPCI
247700701,CC Brie Nangissienne,2011_2016,2013.5,5,26687,27614,830,1833,927,1003,-76,0.00685263962832283,0.00741445258598468,-0.00056181295766185,EPCI
247700701,CC Brie Nangissienne,1968_1975,1971.5,7,13195,16460,984,1965,3265,981,2284,0.0320891326583692,0.0096414821249189,0.0224476505334503,EPCI
247700701,CC Brie Nangissienne,1975_1982,1978.5,7,16460,18142,1135,1711,1682,576,1106,0.0139965467218146,0.00479310993565114,0.00920343678616347,EPCI
247700701,CC Brie Nangissienne,1982_1990,1986,8,18142,21664,1388,2279,3522,891,2631,0.0224255305935082,0.00567323900023162,0.0167522915932765,EPCI
247700701,CC Brie Nangissienne,1990_1999,1994.5,9,21664,24554,1556,2887,2890,1331,1559,0.0140108983624525,0.00645277014547553,0.00755812821697698,EPCI
247700701,CC Brie Nangissienne,1999_2006,2002.5,7,24554,25394,1255,2334,840,1079,-239,0.00481701496309706,0.00618757041093062,-0.00137055544783357,EPCI
247800550,CC du Pays Houdanais (C.C.P.H.),2006_2011,2008.5,5,26868,28502,1039,1551,1634,512,1122,0.0118776401062564,0.00372175748739489,0.00815588261886147,EPCI
247800550,CC du Pays Houdanais (C.C.P.H.),2011_2016,2013.5,5,28502,29261,1071,1398,759,327,432,0.0052701006030853,0.00227051765113161,0.00299958295195369,EPCI
247800550,CC du Pays Houdanais (C.C.P.H.),1968_1975,1971.5,7,12643,15401,1310,1306,2758,-4,2762,0.0285909130256445,-4.14661537717832e-05,0.0286323791794163,EPCI
247800550,CC du Pays Houdanais (C.C.P.H.),1975_1982,1978.5,7,15401,19052,1350,1453,3651,103,3548,0.0308579093184487,0.00087054633245692,0.0299873629859918,EPCI
247800550,CC du Pays Houdanais (C.C.P.H.),1982_1990,1986,8,19052,22992,1571,1933,3940,362,3578,0.0237750050045795,0.00218440401311111,0.0215906009914684,EPCI
247800550,CC du Pays Houdanais (C.C.P.H.),1990_1999,1994.5,9,22992,25433,1772,2440,2441,668,1773,0.0112743275433875,0.00308531372346697,0.00818901381992056,EPCI
247800550,CC du Pays Houdanais (C.C.P.H.),1999_2006,2002.5,7,25433,26868,1397,2142,1435,745,690,0.00787202905765816,0.0040868722285403,0.00378515682911786,EPCI
247800584,CA Versailles Grand Parc (C.A.V.G.P.),2006_2011,2008.5,5,262489,262925,7780,17735,436,9955,-9519,0.000331983897330135,0.00758004517871902,-0.00724806128138888,EPCI
247800584,CA Versailles Grand Parc (C.A.V.G.P.),2011_2016,2013.5,5,262925,264484,8047,17091,1559,9044,-7485,0.00118308680954082,0.00686326947112714,-0.00568018266158631,EPCI
247800584,CA Versailles Grand Parc (C.A.V.G.P.),1968_1975,1971.5,7,222674,259781,11545,31968,37107,20423,16684,0.0222627910688009,0.0122530245505732,0.0100097665182277,EPCI
247800584,CA Versailles Grand Parc (C.A.V.G.P.),1975_1982,1978.5,7,259781,259353,11877,28040,-428,16163,-16591,-0.000235529440338667,0.00889453818736885,-0.00913006762770751,EPCI
247800584,CA Versailles Grand Parc (C.A.V.G.P.),1982_1990,1986,8,259353,262031,13447,31405,2678,17958,-15280,0.00128491845900847,0.0086163426762039,-0.00733142421719543,EPCI
247800584,CA Versailles Grand Parc (C.A.V.G.P.),1990_1999,1994.5,9,262031,255445,14962,33563,-6586,18601,-25187,-0.00282441438081038,0.00797706223769418,-0.0108014766185046,EPCI
247800584,CA Versailles Grand Parc (C.A.V.G.P.),1999_2006,2002.5,7,255445,262489,11219,25132,7044,13913,-6869,0.00389356804780472,0.0076904049189533,-0.00379683687114858,EPCI
247800618,CC Coeur d'Yvelines,2006_2011,2008.5,5,46498,48022,1635,2431,1524,796,728,0.00647083362966572,0.00337977924489102,0.0030910543847747,EPCI
247800618,CC Coeur d'Yvelines,2011_2016,2013.5,5,48022,49307,1807,2282,1285,475,810,0.00529533489891709,0.00195741951516391,0.00333791538375319,EPCI
247800618,CC Coeur d'Yvelines,1968_1975,1971.5,7,19672,27558,1861,2342,7886,481,7405,0.049335023728021,0.00300914867019758,0.0463258750578234,EPCI
247800618,CC Coeur d'Yvelines,1975_1982,1978.5,7,27558,34347,2061,2756,6789,695,6094,0.0319603623227185,0.00327182969719979,0.0286885326255187,EPCI
247800618,CC Coeur d'Yvelines,1982_1990,1986,8,34347,38985,2266,3156,4638,890,3748,0.0159587874183722,0.00306238050934697,0.0128964069090252,EPCI
247800618,CC Coeur d'Yvelines,1990_1999,1994.5,9,38985,42864,2763,4137,3879,1374,2505,0.0105952200035202,0.00375298589451837,0.00684223410900183,EPCI
247800618,CC Coeur d'Yvelines,1999_2006,2002.5,7,42864,46498,2443,3472,3634,1029,2605,0.0116931202473833,0.00331101286036254,0.0083821073870208,EPCI
247900798,CC du Thouarsais,2006_2011,2008.5,5,36133,36349,1901,2024,216,123,93,0.0011927343589524,0.000679195954403448,0.000513538404548949,EPCI
247900798,CC du Thouarsais,2011_2016,2013.5,5,36349,35944,2004,1916,-405,-88,-317,-0.00223839535178527,-0.000486367385079269,-0.001752027966706,EPCI
247900798,CC du Thouarsais,1968_1975,1971.5,7,35948,36405,2926,4018,457,1092,-635,0.00180629768678342,0.00431614239380196,-0.00250984470701854,EPCI
247900798,CC du Thouarsais,1975_1982,1978.5,7,36405,36709,2964,3383,304,419,-115,0.00118868145918172,0.00163834714275375,-0.000449665683572031,EPCI
247900798,CC du Thouarsais,1982_1990,1986,8,36709,36422,3247,3490,-287,243,-530,-0.000980639974314634,0.000830297957346537,-0.00181093793166117,EPCI
247900798,CC du Thouarsais,1990_1999,1994.5,9,36422,35852,3738,3458,-570,-280,-290,-0.00175109106771532,-0.000860185085895243,-0.000890905981820073,EPCI
247900798,CC du Thouarsais,1999_2006,2002.5,7,35852,36133,2716,2843,281,127,154,0.0011159395845195,0.000504357036419845,0.000611582548099654,EPCI
248000499,CC du Val de Somme,2006_2011,2008.5,5,24920,25648,1511,1575,728,64,664,0.00577559519662274,0.000507744632670131,0.00526785056395261,EPCI
248000499,CC du Val de Somme,2011_2016,2013.5,5,25648,26476,1569,1536,828,-33,861,0.006374846668604,-0.000254069975922623,0.00662891664452662,EPCI
248000499,CC du Val de Somme,1968_1975,1971.5,7,19633,20711,2096,2417,1078,321,757,0.00766539215237971,0.00228255183758246,0.00538284031479726,EPCI
248000499,CC du Val de Somme,1975_1982,1978.5,7,20711,21977,2197,2094,1266,-103,1369,0.0085119497822761,-0.000692520400927676,0.00920447018320377,EPCI
248000499,CC du Val de Somme,1982_1990,1986,8,21977,23085,2412,2390,1108,-22,1130,0.00616726525111688,-0.000122454725202682,0.00628971997631957,EPCI
248000499,CC du Val de Somme,1990_1999,1994.5,9,23085,24194,2584,2620,1109,36,1073,0.00522712651373025,0.000169681293502515,0.00505744522022774,EPCI
248000499,CC du Val de Somme,1999_2006,2002.5,7,24194,24920,1999,2171,726,172,554,0.00423265037980269,0.00100277667400284,0.00322987370579985,EPCI
248000531,CA Amiens Métropole,2006_2011,2008.5,5,178861,178053,6754,11514,-808,4760,-5568,-0.000905131937919523,0.00533221290160511,-0.00623734483952464,EPCI
248000531,CA Amiens Métropole,2011_2016,2013.5,5,178053,179958,6803,11237,1905,4434,-2529,0.00213071305956314,0.0049593604756446,-0.00282864741608146,EPCI
248000531,CA Amiens Métropole,1968_1975,1971.5,7,147709,166910,11338,22886,19201,11548,7653,0.0176119536367163,0.0105923045985522,0.00701964903816415,EPCI
248000531,CA Amiens Métropole,1975_1982,1978.5,7,166910,171097,10826,21359,4187,10533,-6346,0.00354568571692471,0.0089196817903912,-0.00537399607346649,EPCI
248000531,CA Amiens Métropole,1982_1990,1986,8,171097,173866,11725,23071,2769,11346,-8577,0.00200879498606077,0.0082310537782035,-0.00622225879214273,EPCI
248000531,CA Amiens Métropole,1990_1999,1994.5,9,173866,178385,12539,22972,4519,10433,-5914,0.00285509563453079,0.00659154962493024,-0.00373645399039945,EPCI
248000531,CA Amiens Métropole,1999_2006,2002.5,7,178385,178861,9439,17109,476,7670,-7194,0.000380762753736885,0.00613539983437376,-0.00575463708063687,EPCI
248000747,CC du Pays du Coquelicot,2006_2011,2008.5,5,27501,28061,1597,1667,560,70,490,0.00403980697201201,0.000504975871501501,0.00353483110051051,EPCI
248000747,CC du Pays du Coquelicot,2011_2016,2013.5,5,28061,28499,1570,1617,438,47,391,0.00310246009476489,0.000332912384598059,0.00276954771016683,EPCI
248000747,CC du Pays du Coquelicot,1968_1975,1971.5,7,28246,28470,2370,3363,224,993,-769,0.00112907215731717,0.00500521719739262,-0.00387614504007546,EPCI
248000747,CC du Pays du Coquelicot,1975_1982,1978.5,7,28470,27709,2491,2493,-761,2,-763,-0.00386303792860188,1.01525306927776e-05,-0.00387319045929465,EPCI
248000747,CC du Pays du Coquelicot,1982_1990,1986,8,27709,26841,2531,2709,-868,178,-1046,-0.00397043451568757,0.000814213529714732,-0.0047846480454023,EPCI
248000747,CC du Pays du Coquelicot,1990_1999,1994.5,9,26841,26911,2832,2586,70,-246,316,0.000289436958965217,-0.00101716417007776,0.00130660112904298,EPCI
248000747,CC du Pays du Coquelicot,1999_2006,2002.5,7,26911,27501,2138,2314,590,176,414,0.00310298183977453,0.000925635260678505,0.00217734657909603,EPCI
248100158,CC du Sor et de l'Agout,2006_2011,2008.5,5,20530,21938,973,1164,1408,191,1217,0.0133550043485848,0.00181165186830945,0.0115433524802754,EPCI
248100158,CC du Sor et de l'Agout,2011_2016,2013.5,5,21938,22777,1063,1147,839,84,755,0.0075344344589976,0.000754341471461023,0.00678009298753657,EPCI
248100158,CC du Sor et de l'Agout,1968_1975,1971.5,7,13814,14101,1369,1090,287,-279,566,0.00294191126498511,-0.00285990676979389,0.005801818034779,EPCI
248100158,CC du Sor et de l'Agout,1975_1982,1978.5,7,14101,15786,1359,1118,1685,-241,1926,0.0162561093173068,-0.00232505777179284,0.0185811670890997,EPCI
248100158,CC du Sor et de l'Agout,1982_1990,1986,8,15786,17565,1433,1560,1779,127,1652,0.0134375854170232,0.000959287997730157,0.0124782974192931,EPCI
248100158,CC du Sor et de l'Agout,1990_1999,1994.5,9,17565,18878,1651,1718,1313,67,1246,0.00804204683527376,0.0004103710113963,0.00763167582387746,EPCI
248100158,CC du Sor et de l'Agout,1999_2006,2002.5,7,18878,20530,1369,1498,1652,129,1523,0.0120563861730814,0.000941449041360469,0.0111149371317209,EPCI
248100430,CA de Castres Mazamet,2006_2011,2008.5,5,79754,79220,4235,4310,-534,75,-609,-0.00134271873609571,0.000188584092148273,-0.00153130282824398,EPCI
248100430,CA de Castres Mazamet,2011_2016,2013.5,5,79220,77849,4313,3990,-1371,-323,-1048,-0.00348545947711743,-0.000821154931516359,-0.00266430454560107,EPCI
248100430,CA de Castres Mazamet,1968_1975,1971.5,7,78963,85085,6132,8994,6122,2862,3260,0.0107244372613033,0.00501361310713005,0.00571082415417329,EPCI
248100430,CA de Castres Mazamet,1975_1982,1978.5,7,85085,84191,6142,8152,-894,2010,-2904,-0.00150782346865253,0.00339007289931944,-0.00489789636797196,EPCI
248100430,CA de Castres Mazamet,1982_1990,1986,8,84191,82670,6916,8449,-1521,1533,-3054,-0.00227631125388428,0.00229427031703129,-0.00457058157091557,EPCI
248100430,CA de Castres Mazamet,1990_1999,1994.5,9,82670,79878,7549,8409,-2792,860,-3652,-0.00381009073543426,0.0011735952838372,-0.00498368601927146,EPCI
248100430,CA de Castres Mazamet,1999_2006,2002.5,7,79878,79754,5835,5825,-124,-10,-114,-0.000221914449184735,-1.7896326547156e-05,-0.000204018122637579,EPCI
248100497,CC Val 81,2006_2011,2008.5,5,5254,5507,441,270,253,-171,424,0.00945043984704119,-0.00638745143811875,0.0158378912851599,EPCI
248100497,CC Val 81,2011_2016,2013.5,5,5507,5581,466,241,74,-225,299,0.00267315883975328,-0.00812784782357415,0.0108010066633274,EPCI
248100497,CC Val 81,1968_1975,1971.5,7,5874,5201,555,346,-673,-209,-464,-0.0172333373639862,-0.00535180907737463,-0.0118815282866116,EPCI
248100497,CC Val 81,1975_1982,1978.5,7,5201,5073,519,351,-128,-168,40,-0.00355346518969601,-0.00466392306147602,0.00111045787178,EPCI
248100497,CC Val 81,1982_1990,1986,8,5073,4976,600,311,-97,-289,192,-0.00241034084568825,-0.00718132478766912,0.00477098394198087,EPCI
248100497,CC Val 81,1990_1999,1994.5,9,4976,4834,719,369,-142,-350,208,-0.00321172834792205,-0.00791623184346984,0.00470450349554779,EPCI
248100497,CC Val 81,1999_2006,2002.5,7,4834,5254,610,342,420,-268,688,0.0119733143347383,-0.00764011486121393,0.0196134291959522,EPCI
248100737,CA de l'Albigeois (C2A),2006_2011,2008.5,5,78888,80747,3993,3980,1859,-13,1872,0.00466920385483727,-3.26517752086522e-05,0.00470185563004592,EPCI
248100737,CA de l'Albigeois (C2A),2011_2016,2013.5,5,80747,81798,4154,3856,1051,-298,1349,0.00258974435396175,-0.00073429478352103,0.00332403913748278,EPCI
248100737,CA de l'Albigeois (C2A),1968_1975,1971.5,7,58411,65062,4726,6366,6651,1640,5011,0.0155244765864511,0.00382801708040592,0.0116964595060451,EPCI
248100737,CA de l'Albigeois (C2A),1975_1982,1978.5,7,65062,68439,4816,6260,3377,1444,1933,0.00725507375065249,0.00310225836421149,0.004152815386441,EPCI
248100737,CA de l'Albigeois (C2A),1982_1990,1986,8,68439,72019,5646,6305,3580,659,2921,0.00639374521843239,0.00117694918964998,0.0052167960287824,EPCI
248100737,CA de l'Albigeois (C2A),1990_1999,1994.5,9,72019,73506,6411,6303,1487,-108,1595,0.00227336490066921,-0.000165113254386197,0.0024384781550554,EPCI
248100737,CA de l'Albigeois (C2A),1999_2006,2002.5,7,73506,78888,5270,5227,5382,-43,5425,0.0101457064023436,-8.1060084596948e-05,0.0102267664869405,EPCI
248100745,CC Thoré Montagne Noire,2006_2011,2008.5,5,5106,5084,330,184,-22,-146,124,-0.000863220309217483,-0.00572864387026148,0.00486542356104399,EPCI
248100745,CC Thoré Montagne Noire,2011_2016,2013.5,5,5084,5081,315,216,-3,-99,96,-0.000118045175242498,-0.00389549078300244,0.00377744560775994,EPCI
248100745,CC Thoré Montagne Noire,1968_1975,1971.5,7,7023,6076,607,508,-947,-99,-848,-0.020479374487806,-0.00214092721678225,-0.0183384472710238,EPCI
248100745,CC Thoré Montagne Noire,1975_1982,1978.5,7,6076,5623,549,372,-453,-177,-276,-0.0110077175476747,-0.00430102871068085,-0.00670668883699386,EPCI
248100745,CC Thoré Montagne Noire,1982_1990,1986,8,5623,5615,575,453,-8,-122,114,-0.000177951804656185,-0.00271376502100681,0.00253581321635063,EPCI
248100745,CC Thoré Montagne Noire,1990_1999,1994.5,9,5615,5241,606,413,-374,-193,-181,-0.00762955366087004,-0.00393717608702652,-0.00369237757384352,EPCI
248100745,CC Thoré Montagne Noire,1999_2006,2002.5,7,5241,5106,441,264,-135,-177,42,-0.00372105977766912,-0.00487872281961063,0.0011576630419415,EPCI
248200016,CC des Deux Rives,2006_2011,2008.5,5,17694,18475,981,884,781,-97,878,0.00867599370577277,-0.00107755619649162,0.00975354990226439,EPCI
248200016,CC des Deux Rives,2011_2016,2013.5,5,18475,18766,1017,866,291,-151,442,0.00313054094724818,-0.00162443877331435,0.00475497972056253,EPCI
248200016,CC des Deux Rives,1968_1975,1971.5,7,14714,14089,1327,1190,-625,-137,-488,-0.00618153953093292,-0.0013549934651805,-0.00482654606575243,EPCI
248200016,CC des Deux Rives,1975_1982,1978.5,7,14089,14588,1339,1007,499,-332,831,0.00498451325568294,-0.00331634950077502,0.00830086275645797,EPCI
248200016,CC des Deux Rives,1982_1990,1986,8,14588,16282,1473,1276,1694,-197,1891,0.0138273417634784,-0.00160802026411172,0.0154353620275902,EPCI
248200016,CC des Deux Rives,1990_1999,1994.5,9,16282,16248,1684,1532,-34,-152,118,-0.000232237348031461,-0.00103823755590536,0.000806000207873894,EPCI
248200016,CC des Deux Rives,1999_2006,2002.5,7,16248,17694,1267,1178,1446,-89,1535,0.0122538672755674,-0.000754214514194676,0.0130080817897621,EPCI
248200057,CC du Quercy Caussadais,2006_2011,2008.5,5,18419,19531,1039,1019,1112,-20,1132,0.0117930372087933,-0.000212104985769664,0.012005142194563,EPCI
248200057,CC du Quercy Caussadais,2011_2016,2013.5,5,19531,20277,1128,986,746,-142,888,0.00752503018513862,-0.00143237839985212,0.00895740858499074,EPCI
248200057,CC du Quercy Caussadais,1968_1975,1971.5,7,15847,15831,1486,1545,-16,59,-75,-0.000144298854922953,0.000532102027528389,-0.000676400882451342,EPCI
248200057,CC du Quercy Caussadais,1975_1982,1978.5,7,15831,16260,1568,1273,429,-295,724,0.00382702744326746,-0.00263163891786457,0.00645866636113203,EPCI
248200057,CC du Quercy Caussadais,1982_1990,1986,8,16260,16616,1718,1412,356,-306,662,0.00271091571134052,-0.0023301691226691,0.00504108483400962,EPCI
248200057,CC du Quercy Caussadais,1990_1999,1994.5,9,16616,16896,1956,1510,280,-446,726,0.00185848272562938,-0.00296029748439538,0.00481878021002476,EPCI
248200057,CC du Quercy Caussadais,1999_2006,2002.5,7,16896,18419,1503,1274,1523,-229,1752,0.0124057251658543,-0.00186533884634315,0.0142710640121974,EPCI
248200065,CC de la Lomagne Tarn-et-Garonnaise,2006_2011,2008.5,5,9499,9891,786,485,392,-301,693,0.00812053872668161,-0.00623541366513053,0.0143559523918121,EPCI
248200065,CC de la Lomagne Tarn-et-Garonnaise,2011_2016,2013.5,5,9891,9946,795,471,55,-324,379,0.00110965672091234,-0.0065368868650109,0.00764654358592325,EPCI
248200065,CC de la Lomagne Tarn-et-Garonnaise,1968_1975,1971.5,7,9735,9453,954,789,-282,-165,-117,-0.00419055037686289,-0.00245191777369637,-0.00173863260316652,EPCI
248200065,CC de la Lomagne Tarn-et-Garonnaise,1975_1982,1978.5,7,9453,9322,947,616,-131,-331,200,-0.00199157895424218,-0.00503215751033711,0.00304057855609493,EPCI
248200065,CC de la Lomagne Tarn-et-Garonnaise,1982_1990,1986,8,9322,9154,1109,665,-168,-444,276,-0.00227070001631102,-0.00600113575739342,0.00373043574108239,EPCI
248200065,CC de la Lomagne Tarn-et-Garonnaise,1990_1999,1994.5,9,9154,9357,1320,799,203,-521,724,0.00244005922878721,-0.00626241802068046,0.00870247724946767,EPCI
248200065,CC de la Lomagne Tarn-et-Garonnaise,1999_2006,2002.5,7,9357,9499,1146,585,142,-561,703,0.0021540027686171,-0.00850982783939574,0.0106638306080128,EPCI
248200099,CA Grand Montauban,2006_2011,2008.5,5,68384,72517,2865,4662,4133,1797,2336,0.0118055696945132,0.00513298058094367,0.00667258911356951,EPCI
248200099,CA Grand Montauban,2011_2016,2013.5,5,72517,77392,3250,4693,4875,1443,3432,0.0130975105247255,0.00387686311531875,0.00922064740940677,EPCI
248200099,CA Grand Montauban,1968_1975,1971.5,7,53455,56134,4256,6215,2679,1959,720,0.00701038868762249,0.00512629766295351,0.00188409102466898,EPCI
248200099,CA Grand Montauban,1975_1982,1978.5,7,56134,59851,4084,5295,3717,1211,2506,0.00920156948810469,0.00299787480497573,0.00620369468312896,EPCI
248200099,CA Grand Montauban,1982_1990,1986,8,59851,62048,4624,5832,2197,1208,989,0.00451643583569372,0.00248332020460538,0.00203311563108834,EPCI
248200099,CA Grand Montauban,1990_1999,1994.5,9,62048,63790,5059,6754,1742,1695,47,0.00308119929890993,0.0029980670560576,8.31322428523342e-05,EPCI
248200099,CA Grand Montauban,1999_2006,2002.5,7,63790,68384,3917,5639,4594,1722,2872,0.00998414671867809,0.00374242504344007,0.00624172167523802,EPCI
248200107,CC du Quercy Rouergue et des Gorges de l'Aveyron,2006_2011,2008.5,5,7642,7744,556,287,102,-269,371,0.002655319322028,-0.00700275389828954,0.00965807322031755,EPCI
248200107,CC du Quercy Rouergue et des Gorges de l'Aveyron,2011_2016,2013.5,5,7744,7668,579,247,-76,-332,256,-0.00197056084873581,-0.00860823949710908,0.00663767864837327,EPCI
248200107,CC du Quercy Rouergue et des Gorges de l'Aveyron,1968_1975,1971.5,7,8868,7892,935,582,-976,-353,-623,-0.0165191380947077,-0.00597464728220474,-0.010544490812503,EPCI
248200107,CC du Quercy Rouergue et des Gorges de l'Aveyron,1975_1982,1978.5,7,7892,7924,879,458,32,-421,453,0.00057824435826781,-0.00760752733846087,0.00818577169672868,EPCI
248200107,CC du Quercy Rouergue et des Gorges de l'Aveyron,1982_1990,1986,8,7924,7478,991,534,-446,-457,11,-0.00721518867485482,-0.0073931417587638,0.000177953083908975,EPCI
248200107,CC du Quercy Rouergue et des Gorges de l'Aveyron,1990_1999,1994.5,9,7478,7385,1090,608,-93,-482,389,-0.00138952932795744,-0.00720164662446759,0.00581211729651015,EPCI
248200107,CC du Quercy Rouergue et des Gorges de l'Aveyron,1999_2006,2002.5,7,7385,7642,792,469,257,-323,580,0.00489887946993051,-0.00615695746609943,0.0110558369360299,EPCI
248300394,CA Sud Sainte-Baume,2006_2011,2008.5,5,61212,58718,3572,2702,-2494,-870,-1624,-0.00828487467415939,-0.00289007256075328,-0.00539480211340612,EPCI
248300394,CA Sud Sainte-Baume,2011_2016,2013.5,5,58718,61073,3745,2527,2355,-1218,3573,0.00789571730299699,-0.00408364487263284,0.0119793621756298,EPCI
248300394,CA Sud Sainte-Baume,1968_1975,1971.5,7,24923,29900,2627,2171,4977,-456,5433,0.0263508319630208,-0.00241430166267581,0.0287651336256966,EPCI
248300394,CA Sud Sainte-Baume,1975_1982,1978.5,7,29900,36103,3021,2169,6203,-852,7055,0.0272969878583622,-0.00374932027330721,0.0310463081316694,EPCI
248300394,CA Sud Sainte-Baume,1982_1990,1986,8,36103,45451,4047,3489,9348,-558,9906,0.0292005720808448,-0.00174303799969099,0.0309436100805358,EPCI
248300394,CA Sud Sainte-Baume,1990_1999,1994.5,9,45451,53531,5417,4634,8080,-783,8863,0.0183469527460538,-0.0017779287128911,0.0201248814589449,EPCI
248300394,CA Sud Sainte-Baume,1999_2006,2002.5,7,53531,61212,4950,4041,7681,-909,8590,0.0193392442479752,-0.0022886828565824,0.0216279271045576,EPCI
248300410,CC de la Vallée du Gapeau,2006_2011,2008.5,5,27245,30333,1230,1509,3088,279,2809,0.0217054513288348,0.00196108190438631,0.0197443694244485,EPCI
248300410,CC de la Vallée du Gapeau,2011_2016,2013.5,5,30333,30409,1174,1457,76,283,-207,0.00050060295014509,0.00186408730119817,-0.00136348435105308,EPCI
248300410,CC de la Vallée du Gapeau,1968_1975,1971.5,7,9403,10665,782,837,1262,55,1207,0.0181540405403164,0.000791182432422666,0.0173628581078938,EPCI
248300410,CC de la Vallée du Gapeau,1975_1982,1978.5,7,10665,14239,936,874,3574,-62,3636,0.0421523997074869,-0.000731239166721932,0.0428836388742088,EPCI
248300410,CC de la Vallée du Gapeau,1982_1990,1986,8,14239,22792,1250,1877,8553,627,7926,0.0605664103527808,0.00443997887188046,0.0561264314809003,EPCI
248300410,CC de la Vallée du Gapeau,1990_1999,1994.5,9,22792,26065,1784,2303,3273,519,2754,0.0150210116851932,0.00238188361277583,0.0126391280724174,EPCI
248300410,CC de la Vallée du Gapeau,1999_2006,2002.5,7,26065,27245,1714,2011,1180,297,883,0.00634527504701965,0.00159707346522444,0.00474820158179521,EPCI
248300493,CA Dracénoise,2006_2011,2008.5,5,98319,102997,4686,5800,4678,1114,3564,0.00933986025304412,0.00222415654593654,0.00711570370710758,EPCI
248300493,CA Dracénoise,2011_2016,2013.5,5,102997,107622,4993,5865,4625,872,3753,0.00882374699977029,0.00166363402892966,0.00716011297084063,EPCI
248300493,CA Dracénoise,1968_1975,1971.5,7,42580,49393,4004,4331,6813,327,6486,0.0214298264336781,0.00102855617845483,0.0204012702552233,EPCI
248300493,CA Dracénoise,1975_1982,1978.5,7,49393,61886,4727,4743,12493,16,12477,0.0327366094583237,4.19263388564139e-05,0.0326946831194673,EPCI
248300493,CA Dracénoise,1982_1990,1986,8,61886,75002,5848,6946,13116,1098,12018,0.0243185883070285,0.00203581960667256,0.0222827687003559,EPCI
248300493,CA Dracénoise,1990_1999,1994.5,9,75002,85279,7126,8353,10277,1227,9050,0.014370437671837,0.00171572706269767,0.0126547106091393,EPCI
248300493,CA Dracénoise,1999_2006,2002.5,7,85279,98319,6301,7164,13040,863,12177,0.020535009172429,0.00135902706409557,0.0191759821083334,EPCI
248300543,Métropole Toulon-Provence-Méditerranée,2006_2011,2008.5,5,421129,422405,22300,24120,1276,1820,-544,0.000605256972951995,0.000863297563301435,-0.00025804059034944,EPCI
248300543,Métropole Toulon-Provence-Méditerranée,2011_2016,2013.5,5,422405,433221,22961,23869,10816,908,9908,0.00506949079732677,0.000425582252586234,0.00464390854474054,EPCI
248300543,Métropole Toulon-Provence-Méditerranée,1968_1975,1971.5,7,317240,352007,25148,34997,34767,9849,24918,0.0149669679559383,0.00423993060655324,0.0107270373493851,EPCI
248300543,Métropole Toulon-Provence-Méditerranée,1975_1982,1978.5,7,352007,378927,27974,33136,26920,5162,21758,0.0105831109216572,0.00202934690109935,0.00855376402055785,EPCI
248300543,Métropole Toulon-Provence-Méditerranée,1982_1990,1986,8,378927,394042,33659,40919,15115,7260,7855,0.00490121286806633,0.0023541386319657,0.00254707423610063,EPCI
248300543,Métropole Toulon-Provence-Méditerranée,1990_1999,1994.5,9,394042,406845,39138,44857,12803,5719,7084,0.00355907127594723,0.00158980931243788,0.00196926196350935,EPCI
248300543,Métropole Toulon-Provence-Méditerranée,1999_2006,2002.5,7,406845,421129,30736,33785,14284,3049,11235,0.00494173063299086,0.00105484014981722,0.00388689048317364,EPCI
248300550,CC Coeur du Var,2006_2011,2008.5,5,35657,39608,1859,2299,3951,440,3511,0.0212395426735315,0.00236532492441251,0.0188742177491189,EPCI
248300550,CC Coeur du Var,2011_2016,2013.5,5,39608,42883,2072,2406,3275,334,2941,0.0160157711167737,0.00163336413832134,0.0143824069784523,EPCI
248300550,CC Coeur du Var,1968_1975,1971.5,7,16320,17823,1877,1496,1503,-381,1884,0.0126650174633012,-0.00321049344878094,0.0158755109120821,EPCI
248300550,CC Coeur du Var,1975_1982,1978.5,7,17823,20296,2064,1298,2473,-766,3239,0.0187353541542856,-0.00580318693173586,0.0245385410860215,EPCI
248300550,CC Coeur du Var,1982_1990,1986,8,20296,25480,2494,2106,5184,-388,5572,0.0288418488854132,-0.00215868776380022,0.0310005366492134,EPCI
248300550,CC Coeur du Var,1990_1999,1994.5,9,25480,28916,2804,2843,3436,39,3397,0.0141549395344169,0.000160664331153161,0.0139942752032638,EPCI
248300550,CC Coeur du Var,1999_2006,2002.5,7,28916,35657,2485,2597,6741,112,6629,0.0303883523223654,0.000504894742635354,0.02988345757973,EPCI
248400053,CA Ventoux-Comtat-Venaissin (COVE),2006_2011,2008.5,5,64931,68363,3417,4087,3432,670,2762,0.0103545562053355,0.00202143142703229,0.00833312477830325,EPCI
248400053,CA Ventoux-Comtat-Venaissin (COVE),2011_2016,2013.5,5,68363,69413,3369,4175,1050,806,244,0.00305313680866459,0.00234364596931777,0.000709490839346819,EPCI
248400053,CA Ventoux-Comtat-Venaissin (COVE),1968_1975,1971.5,7,42083,46987,3475,4918,4904,1443,3461,0.0158713629422731,0.00467014207294047,0.0112012208693326,EPCI
248400053,CA Ventoux-Comtat-Venaissin (COVE),1975_1982,1978.5,7,46987,51221,3894,3875,4234,-19,4253,0.0124017917582184,-5.56528208328177e-05,0.0124574445790512,EPCI
248400053,CA Ventoux-Comtat-Venaissin (COVE),1982_1990,1986,8,51221,54796,4807,5166,3575,359,3216,0.00846911101155023,0.000850464574306723,0.00761864643724351,EPCI
248400053,CA Ventoux-Comtat-Venaissin (COVE),1990_1999,1994.5,9,54796,60597,5853,6573,5801,720,5081,0.0112436497963646,0.00139552281561498,0.00984812698074962,EPCI
248400053,CA Ventoux-Comtat-Venaissin (COVE),1999_2006,2002.5,7,60597,64931,4559,5238,4334,679,3655,0.00991739471805841,0.0015537404276792,0.00836365429037921,EPCI
248400160,CC Aygues-Ouvèze en Provence (CCAOP),2006_2011,2008.5,5,17140,18418,731,1014,1278,283,995,0.0144866356150652,0.00320791696327345,0.0112787186517918,EPCI
248400160,CC Aygues-Ouvèze en Provence (CCAOP),2011_2016,2013.5,5,18418,19077,745,1078,659,333,326,0.00705577020566706,0.00356535884444177,0.00349041136122528,EPCI
248400160,CC Aygues-Ouvèze en Provence (CCAOP),1968_1975,1971.5,7,9186,10213,800,854,1027,54,973,0.0152553111640934,0.000802129311451844,0.0144531818526416,EPCI
248400160,CC Aygues-Ouvèze en Provence (CCAOP),1975_1982,1978.5,7,10213,12131,834,929,1918,95,1823,0.0248908364401039,0.00123286207602183,0.0236579743640821,EPCI
248400160,CC Aygues-Ouvèze en Provence (CCAOP),1982_1990,1986,8,12131,14531,1060,1374,2400,314,2086,0.0228215331162451,0.0029858172493754,0.0198357158668697,EPCI
248400160,CC Aygues-Ouvèze en Provence (CCAOP),1990_1999,1994.5,9,14531,16177,1199,1639,1646,440,1206,0.0119942703220193,0.00320624480053978,0.00878802552147949,EPCI
248400160,CC Aygues-Ouvèze en Provence (CCAOP),1999_2006,2002.5,7,16177,17140,942,1344,963,402,561,0.00829484643383349,0.0034626461748713,0.00483220025896219,EPCI
248400236,CC du Pays Réuni d'Orange,2006_2011,2008.5,5,44229,44325,2211,3229,96,1018,-922,0.000433727917660276,0.00459932312685584,-0.00416559520919557,EPCI
248400236,CC du Pays Réuni d'Orange,2011_2016,2013.5,5,44325,44972,2260,3232,647,972,-325,0.0029024483561042,0.00436040154889225,-0.00145795319278805,EPCI
248400236,CC du Pays Réuni d'Orange,1968_1975,1971.5,7,35032,36912,2551,4566,1880,2015,-135,0.00749577830482417,0.00803403898096846,-0.000538260676144289,EPCI
248400236,CC du Pays Réuni d'Orange,1975_1982,1978.5,7,36912,38415,2583,3796,1503,1213,290,0.00571790041391607,0.00461464617570206,0.00110325423821401,EPCI
248400236,CC du Pays Réuni d'Orange,1982_1990,1986,8,38415,40232,2941,4861,1817,1920,-103,0.0057935544147496,0.00612197274425935,-0.000328418329509746,EPCI
248400236,CC du Pays Réuni d'Orange,1990_1999,1994.5,9,40232,41853,3622,5169,1621,1547,74,0.00439862122454859,0.00419782050239153,0.000200800722157061,EPCI
248400236,CC du Pays Réuni d'Orange,1999_2006,2002.5,7,41853,44229,3044,4237,2376,1193,1183,0.00791936553472539,0.00397634809887516,0.00394301743585022,EPCI
248400251,CA du Grand Avignon (COGA),2006_2011,2008.5,5,187483,188185,7281,12714,702,5433,-4731,0.000747748804319715,0.00578706446420087,-0.00503931565988115,EPCI
248400251,CA du Grand Avignon (COGA),2011_2016,2013.5,5,188185,193712,7953,13038,5527,5085,442,0.00580619064886956,0.00534186347919336,0.000464327169676198,EPCI
248400251,CA du Grand Avignon (COGA),1968_1975,1971.5,7,125423,141088,8930,14480,15665,5550,10115,0.0169552479362349,0.00600712582483906,0.0109481221113959,EPCI
248400251,CA du Grand Avignon (COGA),1975_1982,1978.5,7,141088,152835,9495,14014,11747,4519,7228,0.0114905288697544,0.00442033710414747,0.00707019176560697,EPCI
248400251,CA du Grand Avignon (COGA),1982_1990,1986,8,152835,163682,10970,17352,10847,6382,4465,0.00860766131866986,0.00506445049651987,0.00354321082214999,EPCI
248400251,CA du Grand Avignon (COGA),1990_1999,1994.5,9,163682,171934,12674,19803,8252,7129,1123,0.00547997835665037,0.00473421785077078,0.000745760505879589,EPCI
248400251,CA du Grand Avignon (COGA),1999_2006,2002.5,7,171934,187483,9856,15850,15549,5994,9555,0.0124450158580087,0.00479744196108459,0.00764757389692413,EPCI
248400285,CC Territoriale Sud-Luberon,2006_2011,2008.5,5,22670,23698,1020,1261,1028,241,787,0.00890909017226771,0.00208860966100829,0.00682048051125942,EPCI
248400285,CC Territoriale Sud-Luberon,2011_2016,2013.5,5,23698,24814,1064,1265,1116,201,915,0.00924595288968999,0.00166526570862696,0.00758068718106303,EPCI
248400285,CC Territoriale Sud-Luberon,1968_1975,1971.5,7,10933,11429,981,943,496,-38,534,0.00635845058631346,-0.000487139359435305,0.00684558994574876,EPCI
248400285,CC Territoriale Sud-Luberon,1975_1982,1978.5,7,11429,13248,1055,811,1819,-244,2063,0.0213231011209589,-0.00286027304756129,0.0241833741685202,EPCI
248400285,CC Territoriale Sud-Luberon,1982_1990,1986,8,13248,17441,1329,1435,4193,106,4087,0.0349696936907955,0.000884041862920182,0.0340856518278753,EPCI
248400285,CC Territoriale Sud-Luberon,1990_1999,1994.5,9,17441,21179,1676,2101,3738,425,3313,0.0218107138775669,0.00247981631834295,0.019330897559224,EPCI
248400285,CC Territoriale Sud-Luberon,1999_2006,2002.5,7,21179,22670,1416,1736,1491,320,1171,0.00976628762739318,0.00209605099984294,0.00767023662755024,EPCI
248400293,CC des Sorgues du Comtat,2006_2011,2008.5,5,46977,47707,1850,2898,730,1048,-318,0.00308876391525259,0.00443428025093797,-0.00134551633568538,EPCI
248400293,CC des Sorgues du Comtat,2011_2016,2013.5,5,47707,48329,1929,2984,622,1055,-433,0.00259409022637858,0.00439994403348778,-0.0018058538071092,EPCI
248400293,CC des Sorgues du Comtat,1968_1975,1971.5,7,29210,32700,1984,3564,3490,1580,1910,0.0162541068697228,0.00735859279488885,0.00889551407483399,EPCI
248400293,CC des Sorgues du Comtat,1975_1982,1978.5,7,32700,37410,2216,3350,4710,1134,3576,0.0194092384257516,0.00467305230887523,0.0147361861168764,EPCI
248400293,CC des Sorgues du Comtat,1982_1990,1986,8,37410,40113,2475,4060,2703,1585,1118,0.0087584354706447,0.00513581954161001,0.00362261592903469,EPCI
248400293,CC des Sorgues du Comtat,1990_1999,1994.5,9,40113,44371,2978,4796,4258,1818,2440,0.0112725766410602,0.00481295075938173,0.00645962588167845,EPCI
248400293,CC des Sorgues du Comtat,1999_2006,2002.5,7,44371,46977,2597,4135,2606,1538,1068,0.00818647273707174,0.00483146395610757,0.00335500878096417,EPCI
248400319,CC du Pays des Sorgues et des Monts de Vaucluse,2006_2011,2008.5,5,30278,32296,1529,1677,2018,148,1870,0.0129880225671271,0.000952540802742718,0.0120354817643843,EPCI
248400319,CC du Pays des Sorgues et des Monts de Vaucluse,2011_2016,2013.5,5,32296,33238,1607,1726,942,119,823,0.00576664669139371,0.000728482968445702,0.00503816372294801,EPCI
248400319,CC du Pays des Sorgues et des Monts de Vaucluse,1968_1975,1971.5,7,15597,18164,1423,1701,2567,278,2289,0.0220047570846038,0.00238306290203345,0.0196216941825704,EPCI
248400319,CC du Pays des Sorgues et des Monts de Vaucluse,1975_1982,1978.5,7,18164,20957,1607,1638,2793,31,2762,0.0206431983439788,0.00022912250220671,0.0204140758417721,EPCI
248400319,CC du Pays des Sorgues et des Monts de Vaucluse,1982_1990,1986,8,20957,25348,2059,2328,4391,269,4122,0.024063349042313,0.00147416098665047,0.0225891880556625,EPCI
248400319,CC du Pays des Sorgues et des Monts de Vaucluse,1990_1999,1994.5,9,25348,27722,2457,2799,2374,342,2032,0.009997027535251,0.00144017835596287,0.00855684917928814,EPCI
248400319,CC du Pays des Sorgues et des Monts de Vaucluse,1999_2006,2002.5,7,27722,30278,2046,2276,2556,230,2326,0.0126789989762037,0.00114091148846904,0.0115380874877347,EPCI
248400335,CC Vaison Ventoux,2006_2011,2008.5,5,16600,16899,992,870,299,-122,421,0.00357673193772268,-0.00145940232910424,0.00503613426682691,EPCI
248400335,CC Vaison Ventoux,2011_2016,2013.5,5,16899,16840,959,817,-59,-142,83,-0.000699243368634139,-0.00168292471772962,0.000983681349095484,EPCI
248400335,CC Vaison Ventoux,1968_1975,1971.5,7,11745,12566,1098,1161,821,63,758,0.00969918310585016,0.000744273490461097,0.00895490961538907,EPCI
248400335,CC Vaison Ventoux,1975_1982,1978.5,7,12566,13878,1083,1015,1312,-68,1380,0.0142882722527284,-0.000740550696025559,0.015028822948754,EPCI
248400335,CC Vaison Ventoux,1982_1990,1986,8,13878,14639,1399,1310,761,-89,850,0.00669535782581443,-0.000783031335739138,0.00747838916155357,EPCI
248400335,CC Vaison Ventoux,1990_1999,1994.5,9,14639,15533,1593,1550,894,-43,937,0.00660813722795561,-0.000317841052351333,0.00692597828030695,EPCI
248400335,CC Vaison Ventoux,1999_2006,2002.5,7,15533,16600,1313,1141,1067,-172,1239,0.00953602406782728,-0.00153720350484189,0.0110732275726692,EPCI
248500191,CC de l'Île de Noirmoutier,2006_2011,2008.5,5,9813,9508,658,412,-305,-246,-59,-0.00629500048444276,-0.00507727907925547,-0.00121772140518729,EPCI
248500191,CC de l'Île de Noirmoutier,2011_2016,2013.5,5,9508,9435,676,279,-73,-397,324,-0.00154028667445683,-0.00837662753095014,0.00683634085649331,EPCI
248500191,CC de l'Île de Noirmoutier,1968_1975,1971.5,7,7966,8094,788,926,128,138,-10,0.00227981794100018,0.00245792871764082,-0.000178110776640639,EPCI
248500191,CC de l'Île de Noirmoutier,1975_1982,1978.5,7,8094,8482,896,762,388,-134,522,0.00671145362557368,-0.00231787315934761,0.00902932678492129,EPCI
248500191,CC de l'Île de Noirmoutier,1982_1990,1986,8,8482,9170,870,836,688,-34,722,0.00979655200270657,-0.000484131930366313,0.0102806839330729,EPCI
248500191,CC de l'Île de Noirmoutier,1990_1999,1994.5,9,9170,9592,1047,862,422,-185,607,0.00501164219485206,-0.00219704693376216,0.00720868912861422,EPCI
248500191,CC de l'Île de Noirmoutier,1999_2006,2002.5,7,9592,9813,916,661,221,-255,476,0.00325938879350907,-0.00376083322327969,0.00702022201678876,EPCI
248500258,CC Océan Marais de Monts,2006_2011,2008.5,5,17089,18262,1140,763,1173,-377,1550,0.0133660205037842,-0.00429581392150609,0.0176618344252903,EPCI
248500258,CC Océan Marais de Monts,2011_2016,2013.5,5,18262,19104,1335,707,842,-628,1470,0.00905582591393239,-0.00675422645362178,0.0158100523675542,EPCI
248500258,CC Océan Marais de Monts,1968_1975,1971.5,7,11486,12080,1041,1137,594,96,498,0.00722918962983887,0.00116835387956992,0.00606083575026895,EPCI
248500258,CC Océan Marais de Monts,1975_1982,1978.5,7,12080,12475,1126,1002,395,-124,519,0.00460707280991435,-0.00144627095804906,0.00605334376796341,EPCI
248500258,CC Océan Marais de Monts,1982_1990,1986,8,12475,13596,1379,1052,1121,-327,1448,0.010814178836299,-0.00315453744823351,0.0139687162845325,EPCI
248500258,CC Océan Marais de Monts,1990_1999,1994.5,9,13596,15155,1602,1261,1559,-341,1900,0.0121346882709033,-0.00265421982064016,0.0147889080915434,EPCI
248500258,CC Océan Marais de Monts,1999_2006,2002.5,7,15155,17089,1456,1174,1934,-282,2216,0.0173058217966899,-0.00252339283695272,0.0198292146336427,EPCI
248500340,CC Pays de Chantonnay,2006_2011,2008.5,5,20374,21611,820,1496,1237,676,561,0.0118583323105153,0.00648038208723388,0.00537795022328137,EPCI
248500340,CC Pays de Chantonnay,2011_2016,2013.5,5,21611,22295,907,1404,684,497,187,0.00625145805838701,0.00454236060675196,0.00170909745163504,EPCI
248500340,CC Pays de Chantonnay,1968_1975,1971.5,7,15823,16622,1297,1958,799,661,138,0.00706232735100842,0.00584255116272412,0.00121977618828431,EPCI
248500340,CC Pays de Chantonnay,1975_1982,1978.5,7,16622,17593,1111,2109,971,998,-27,0.00814354783363469,0.00836999046134647,-0.000226442627711777,EPCI
248500340,CC Pays de Chantonnay,1982_1990,1986,8,17593,18478,1287,2188,885,901,-16,0.00615382490532568,0.00626508049683439,-0.000111255591508713,EPCI
248500340,CC Pays de Chantonnay,1990_1999,1994.5,9,18478,18793,1383,1953,315,570,-255,0.0018799454220273,0.00340180600176368,-0.00152186057973638,EPCI
248500340,CC Pays de Chantonnay,1999_2006,2002.5,7,18793,20374,1133,1800,1581,667,914,0.0116061371642611,0.00489645381945739,0.00670968334480368,EPCI
248500415,CC du Pays de la Châtaigneraie,2006_2011,2008.5,5,15048,15657,865,882,609,17,592,0.007966164242589,0.000222372400860448,0.00774379184172855,EPCI
248500415,CC du Pays de la Châtaigneraie,2011_2016,2013.5,5,15657,15605,839,823,-52,-16,-36,-0.000665123828344827,-0.000204653485644562,-0.000460470342700265,EPCI
248500415,CC du Pays de la Châtaigneraie,1968_1975,1971.5,7,15557,15249,1146,1852,-308,706,-1014,-0.00285260513526875,0.00653876371915499,-0.00939136885442374,EPCI
248500415,CC du Pays de la Châtaigneraie,1975_1982,1978.5,7,15249,15438,1093,1683,189,590,-401,0.00176127428113837,0.00549815780884465,-0.00373688352770628,EPCI
248500415,CC du Pays de la Châtaigneraie,1982_1990,1986,8,15438,15342,1227,1605,-96,378,-474,-0.000779425713670956,0.00306898874757939,-0.00384841446125035,EPCI
248500415,CC du Pays de la Châtaigneraie,1990_1999,1994.5,9,15342,14966,1341,1400,-376,59,-435,-0.00275322555662216,0.000432022095321031,-0.00318524765194319,EPCI
248500415,CC du Pays de la Châtaigneraie,1999_2006,2002.5,7,14966,15048,1181,1251,82,70,12,0.000780894788350972,0.00066661750225083,0.000114277286100142,EPCI
248500464,CC du Pays de Pouzauges,2006_2011,2008.5,5,21883,22848,823,1535,965,712,253,0.00866805317974606,0.00639549623210279,0.00227255694764327,EPCI
248500464,CC du Pays de Pouzauges,2011_2016,2013.5,5,22848,23267,937,1344,419,407,12,0.00364110507366133,0.00353682521474979,0.000104279858911542,EPCI
248500464,CC du Pays de Pouzauges,1968_1975,1971.5,7,19694,20401,1173,2703,707,1530,-823,0.00505127179252551,0.0109313236811372,-0.00588005188861174,EPCI
248500464,CC du Pays de Pouzauges,1975_1982,1978.5,7,20401,20992,1206,2561,591,1355,-764,0.004087974996557,0.00937259918838364,-0.00528462419182664,EPCI
248500464,CC du Pays de Pouzauges,1982_1990,1986,8,20992,21274,1316,2449,282,1133,-851,0.00166942407289916,0.00670729600920124,-0.00503787193630208,EPCI
248500464,CC du Pays de Pouzauges,1990_1999,1994.5,9,21274,20892,1584,2174,-382,590,-972,-0.00201123688661964,0.00310636063640206,-0.0051175975230217,EPCI
248500464,CC du Pays de Pouzauges,1999_2006,2002.5,7,20892,21883,1204,1921,991,717,274,0.00664250265210775,0.00480592775132317,0.00183657490078459,EPCI
248500530,CC du Pays des Achards,2006_2011,2008.5,5,14502,16851,632,1296,2349,664,1685,0.03047997232966,0.00861587979007845,0.0218640925395816,EPCI
248500530,CC du Pays des Achards,2011_2016,2013.5,5,16851,18438,694,1254,1587,560,1027,0.0181637400444858,0.00640938527089608,0.0117543547735898,EPCI
248500530,CC du Pays des Achards,1968_1975,1971.5,7,9390,9333,717,996,-57,279,-336,-0.000869448472815781,0.00425572147220356,-0.00512516994501934,EPCI
248500530,CC du Pays des Achards,1975_1982,1978.5,7,9333,10731,758,918,1398,160,1238,0.0201401651030477,0.00230502604898973,0.017835139054058,EPCI
248500530,CC du Pays des Achards,1982_1990,1986,8,10731,11433,950,1178,702,228,474,0.00795234848345827,0.00258281403736252,0.00536953444609576,EPCI
248500530,CC du Pays des Achards,1990_1999,1994.5,9,11433,12151,1017,1157,718,140,578,0.00679045802611134,0.00132404474046739,0.00546641328564394,EPCI
248500530,CC du Pays des Achards,1999_2006,2002.5,7,12151,14502,839,1232,2351,393,1958,0.025589809942939,0.00427766708106127,0.0213121428618778,EPCI
248500563,"CC Vendée, Sèvre, Autise",2006_2011,2008.5,5,14998,15878,882,897,880,15,865,0.0114687969798506,0.00019549085761109,0.0112733061222395,EPCI
248500563,"CC Vendée, Sèvre, Autise",2011_2016,2013.5,5,15878,16328,949,888,450,-61,511,0.00560503419404812,-0.000759793524082078,0.0063648277181302,EPCI
248500563,"CC Vendée, Sèvre, Autise",1968_1975,1971.5,7,13802,13342,1184,1235,-460,51,-511,-0.00483065963944029,0.000535573133937946,-0.00536623277337824,EPCI
248500563,"CC Vendée, Sèvre, Autise",1975_1982,1978.5,7,13342,13949,1341,1147,607,-194,801,0.00637607931716722,-0.00203782436166465,0.00841390367883186,EPCI
248500563,"CC Vendée, Sèvre, Autise",1982_1990,1986,8,13949,14153,1394,1298,204,-96,300,0.00181649716595311,-0.000854822195742641,0.00267131936169575,EPCI
248500563,"CC Vendée, Sèvre, Autise",1990_1999,1994.5,9,14153,14149,1616,1348,-4,-268,264,-3.14067887838831e-05,-0.00210425484852017,0.00207284805973629,EPCI
248500563,"CC Vendée, Sèvre, Autise",1999_2006,2002.5,7,14149,14998,1221,1248,849,27,822,0.00835944791490517,0.000265848166905112,0.00809359974800006,EPCI
248500589,CA La Roche-sur-Yon Agglomération,2006_2011,2008.5,5,85569,91959,3072,5445,6390,2373,4017,0.0145081882859406,0.0053877825982061,0.00912040568773448,EPCI
248500589,CA La Roche-sur-Yon Agglomération,2011_2016,2013.5,5,91959,95416,3411,5181,3457,1770,1687,0.00740799517853841,0.00379292781776482,0.00361506736077359,EPCI
248500589,CA La Roche-sur-Yon Agglomération,1968_1975,1971.5,7,53049,64290,3283,8288,11241,5005,6236,0.0278358142240371,0.0123937594690246,0.0154420547550125,EPCI
248500589,CA La Roche-sur-Yon Agglomération,1975_1982,1978.5,7,64290,70666,3362,8164,6376,4802,1574,0.0136002901314571,0.0102428784835723,0.00335741164788481,EPCI
248500589,CA La Roche-sur-Yon Agglomération,1982_1990,1986,8,70666,73740,4137,7968,3074,3831,-757,0.00533679532879372,0.00665102892147324,-0.00131423359267952,EPCI
248500589,CA La Roche-sur-Yon Agglomération,1990_1999,1994.5,9,73740,79665,4666,8100,5925,3434,2491,0.0086241925464392,0.00499839277712611,0.00362579976931309,EPCI
248500589,CA La Roche-sur-Yon Agglomération,1999_2006,2002.5,7,79665,85569,4196,6823,5904,2627,3277,0.0102655797114923,0.00456769612162777,0.00569788358986456,EPCI
248500621,CC du Pays des Herbiers,2006_2011,2008.5,5,26136,27970,901,1975,1834,1074,760,0.0136561717798285,0.00799712567695517,0.00565904610287331,EPCI
248500621,CC du Pays des Herbiers,2011_2016,2013.5,5,27970,29466,998,1868,1496,870,626,0.0104753965977473,0.0060919752941445,0.00438342130360282,EPCI
248500621,CC du Pays des Herbiers,1968_1975,1971.5,7,17296,18720,1079,2455,1424,1376,48,0.0113665726996852,0.0109834297996958,0.00038314289998939,EPCI
248500621,CC du Pays des Herbiers,1975_1982,1978.5,7,18720,20772,1063,2837,2052,1774,278,0.014970009727145,0.0129419089941302,0.00202810073301477,EPCI
248500621,CC du Pays des Herbiers,1982_1990,1986,8,20772,22805,1152,2790,2033,1638,395,0.0117401160084398,0.0094590801878133,0.00228103582062653,EPCI
248500621,CC du Pays des Herbiers,1990_1999,1994.5,9,22805,23684,1412,2591,879,1179,-300,0.00421105328349825,0.00564827283418024,-0.00143721955068199,EPCI
248500621,CC du Pays des Herbiers,1999_2006,2002.5,7,23684,26136,1137,2447,2452,1310,1142,0.0141729196245819,0.00757199213221953,0.00660092749236237,EPCI
248500662,CC du Pays de Mortagne,2006_2011,2008.5,5,25710,26666,1024,1756,956,732,224,0.00732858850296858,0.00561142969055753,0.00171715881241105,EPCI
248500662,CC du Pays de Mortagne,2011_2016,2013.5,5,26666,27636,1187,1732,970,545,425,0.00717157846458649,0.00402939202391715,0.00314218644066934,EPCI
248500662,CC du Pays de Mortagne,1968_1975,1971.5,7,18584,19998,1512,2612,1414,1100,314,0.0105309604699075,0.00819240206287008,0.00233855840703746,EPCI
248500662,CC du Pays de Mortagne,1975_1982,1978.5,7,19998,22198,1475,2784,2200,1309,891,0.015021697846298,0.00893791021854733,0.0060837876277507,EPCI
248500662,CC du Pays de Mortagne,1982_1990,1986,8,22198,23669,1657,2949,1471,1292,179,0.00805274789565447,0.00707284179550345,0.000979906100151019,EPCI
248500662,CC du Pays de Mortagne,1990_1999,1994.5,9,23669,24265,1786,2639,596,853,-257,0.00276702202430124,0.00396018420592106,-0.00119316218161983,EPCI
248500662,CC du Pays de Mortagne,1999_2006,2002.5,7,24265,25710,1344,2308,1445,964,481,0.0082978145123187,0.00553570462967144,0.00276210988264726,EPCI
248600413,CA Grand Châtellerault,2006_2011,2008.5,5,84858,84495,4205,5172,-363,967,-1330,-0.000857014603357742,0.00228301135384831,-0.00314002595720605,EPCI
248600413,CA Grand Châtellerault,2011_2016,2013.5,5,84495,84904,4420,4686,409,266,143,0.000966235594080045,0.000628407501284332,0.000337828092795713,EPCI
248600413,CA Grand Châtellerault,1968_1975,1971.5,7,73448,76716,5684,8655,3268,2971,297,0.0062383233237806,0.00567137655904289,0.00056694676473771,EPCI
248600413,CA Grand Châtellerault,1975_1982,1978.5,7,76716,79599,5573,7439,2883,1866,1017,0.00528408872294928,0.00342008656157591,0.00186400216137337,EPCI
248600413,CA Grand Châtellerault,1982_1990,1986,8,79599,80747,6412,8043,1148,1631,-483,0.00179151281408263,0.00254525905903203,-0.000753746244949399,EPCI
248600413,CA Grand Châtellerault,1990_1999,1994.5,9,80747,81782,7323,8157,1035,834,201,0.0014161529972776,0.00114113198041499,0.000275021016862606,EPCI
248600413,CA Grand Châtellerault,1999_2006,2002.5,7,81782,84858,5916,6962,3076,1046,2030,0.00528852094223575,0.00179837220597484,0.00349014873626092,EPCI
248600447,CC du Pays Loudunais,2006_2011,2008.5,5,24299,24405,1526,1195,106,-331,437,0.000870945473487206,-0.00271965048796477,0.00359059596145197,EPCI
248600447,CC du Pays Loudunais,2011_2016,2013.5,5,24405,24441,1609,1162,36,-447,483,0.000294847590509129,-0.00366102424882168,0.00395587183933081,EPCI
248600447,CC du Pays Loudunais,1968_1975,1971.5,7,27612,26228,2371,2885,-1384,514,-1898,-0.0073192143357973,0.00271826312760102,-0.0100374774633983,EPCI
248600447,CC du Pays Loudunais,1975_1982,1978.5,7,26228,25673,2280,2166,-555,-114,-441,-0.00305072083774594,-0.000626634550455922,-0.00242408628729001,EPCI
248600447,CC du Pays Loudunais,1982_1990,1986,8,25673,25125,2357,2313,-548,-44,-504,-0.00269342739984713,-0.000216260594148309,-0.00247716680569882,EPCI
248600447,CC du Pays Loudunais,1990_1999,1994.5,9,25125,24625,2631,2324,-500,-307,-193,-0.00223097204331801,-0.00136981683459726,-0.000861155208720753,EPCI
248600447,CC du Pays Loudunais,1999_2006,2002.5,7,24625,24299,2131,1860,-326,-271,-55,-0.00190204450518006,-0.00158114742608526,-0.000320897079094795,EPCI
248700189,CC du Pays de Saint-Yrieix,2006_2011,2008.5,5,12323,12266,942,439,-57,-503,446,-0.000926815791124525,-0.00817874285851993,0.0072519270673954,EPCI
248700189,CC du Pays de Saint-Yrieix,2011_2016,2013.5,5,12266,12087,895,370,-179,-525,346,-0.00293582447930429,-0.00861065838902098,0.00567483390971668,EPCI
248700189,CC du Pays de Saint-Yrieix,1968_1975,1971.5,7,13817,13339,1464,1052,-478,-412,-66,-0.00501703569702761,-0.00432430691877693,-0.000692728778250673,EPCI
248700189,CC du Pays de Saint-Yrieix,1975_1982,1978.5,7,13339,13026,1392,808,-313,-584,271,-0.00338635546893351,-0.00631831180146061,0.0029319563325271,EPCI
248700189,CC du Pays de Saint-Yrieix,1982_1990,1986,8,13026,12961,1609,825,-65,-784,719,-0.000625118492342036,-0.00753989073840241,0.00691477224606037,EPCI
248700189,CC du Pays de Saint-Yrieix,1990_1999,1994.5,9,12961,12497,1794,924,-464,-870,406,-0.00404249955971914,-0.00757968667447338,0.00353718711475425,EPCI
248700189,CC du Pays de Saint-Yrieix,1999_2006,2002.5,7,12497,12323,1365,748,-174,-617,443,-0.00200102107508382,-0.00709557473176274,0.00509455365667892,EPCI
248719262,CC Gartempe - Saint-Pardoux,2006_2011,2008.5,5,5250,5322,425,246,72,-179,251,0.00272793324736087,-0.00678194515663327,0.00950987840399414,EPCI
248719262,CC Gartempe - Saint-Pardoux,2011_2016,2013.5,5,5322,5242,395,237,-80,-158,78,-0.00302463009278775,-0.00597364443325581,0.00294901434046806,EPCI
248719262,CC Gartempe - Saint-Pardoux,1968_1975,1971.5,7,7300,6595,788,483,-705,-305,-400,-0.014404189997031,-0.00623159992779354,-0.00817259006923743,EPCI
248719262,CC Gartempe - Saint-Pardoux,1975_1982,1978.5,7,6595,5961,783,282,-634,-501,-133,-0.0143353327346093,-0.0113280783912291,-0.00300725434338018,EPCI
248719262,CC Gartempe - Saint-Pardoux,1982_1990,1986,8,5961,5422,823,341,-539,-482,-57,-0.0117767919242769,-0.0105313797912829,-0.00124541213299404,EPCI
248719262,CC Gartempe - Saint-Pardoux,1990_1999,1994.5,9,5422,5153,876,353,-269,-523,254,-0.00563801105980077,-0.0109616348857837,0.00532362382598289,EPCI
248719262,CC Gartempe - Saint-Pardoux,1999_2006,2002.5,7,5153,5250,598,314,97,-284,381,0.00266769587889715,-0.00781057350110093,0.0104782693799981,EPCI
248719288,CC du Val de Vienne,2006_2011,2008.5,5,14486,15099,540,831,613,291,322,0.00832362043095158,0.00395134346722171,0.00437227696372987,EPCI
248719288,CC du Val de Vienne,2011_2016,2013.5,5,15099,16063,627,813,964,186,778,0.0124549192630248,0.00240312757564586,0.0100517916873789,EPCI
248719288,CC du Val de Vienne,1968_1975,1971.5,7,9473,10208,850,835,735,-15,750,0.0107323370003216,-0.000219027285720849,0.0109513642860425,EPCI
248719288,CC du Val de Vienne,1975_1982,1978.5,7,10208,12107,836,792,1899,-44,1943,0.0246726062352252,-0.000571666495181626,0.0252442727304068,EPCI
248719288,CC du Val de Vienne,1982_1990,1986,8,12107,13168,1078,1044,1061,-34,1095,0.0105560569350098,-0.000338271381517751,0.0108943283165276,EPCI
248719288,CC du Val de Vienne,1990_1999,1994.5,9,13168,13580,1134,1060,412,-74,486,0.00342902996189798,-0.000615893731020511,0.00404492369291849,EPCI
248719288,CC du Val de Vienne,1999_2006,2002.5,7,13580,14486,879,1035,906,156,750,0.00926905747082185,0.00159599665060509,0.00767306082021676,EPCI
248719312,CU Limoges Métropole,2006_2011,2008.5,5,203195,209461,8591,11556,6266,2965,3301,0.00609277699922761,0.00288303284435204,0.00320974415487557,EPCI
248719312,CU Limoges Métropole,2011_2016,2013.5,5,209461,207986,8909,11587,-1475,2678,-4153,-0.00141236063283456,0.00256427238964811,-0.00397663302248267,EPCI
248719312,CU Limoges Métropole,1968_1975,1971.5,7,161116,180916,12344,17996,19800,5652,14148,0.016696167717392,0.00476599696660099,0.011930170750791,EPCI
248719312,CU Limoges Métropole,1975_1982,1978.5,7,180916,188801,12994,16943,7885,3949,3936,0.00611299644548113,0.00306153747155422,0.00305145897392692,EPCI
248719312,CU Limoges Métropole,1982_1990,1986,8,188801,190272,14244,17026,1471,2782,-1311,0.000970605366327204,0.00183563842904302,-0.000865033062715816,EPCI
248719312,CU Limoges Métropole,1990_1999,1994.5,9,190272,195529,15706,17509,5257,1803,3454,0.00303282068364896,0.00104017038094333,0.00199265030270563,EPCI
248719312,CU Limoges Métropole,1999_2006,2002.5,7,195529,203195,12154,14821,7666,2667,4999,0.00550903395073488,0.00191659190537567,0.0035924420453592,EPCI
248719338,CC Briance-Combade,2006_2011,2008.5,5,5717,5712,514,230,-5,-284,279,-0.000174978138449688,-0.0099387582639423,0.00976378012549262,EPCI
248719338,CC Briance-Combade,2011_2016,2013.5,5,5712,5483,535,174,-229,-361,132,-0.0081499731357968,-0.0128477742446404,0.00469780110884357,EPCI
248719338,CC Briance-Combade,1968_1975,1971.5,7,8073,7424,858,440,-649,-418,-231,-0.011901067494732,-0.00766509431864093,-0.00423597317609104,EPCI
248719338,CC Briance-Combade,1975_1982,1978.5,7,7424,6443,905,261,-981,-644,-337,-0.0200426674458071,-0.0131574697605502,-0.00688519768525686,EPCI
248719338,CC Briance-Combade,1982_1990,1986,8,6443,5957,1020,361,-486,-659,173,-0.00975551217032,-0.013228153333829,0.00347264116350897,EPCI
248719338,CC Briance-Combade,1990_1999,1994.5,9,5957,5664,991,373,-293,-618,325,-0.00558839784593623,-0.0117871326579815,0.00619873481204531,EPCI
248719338,CC Briance-Combade,1999_2006,2002.5,7,5664,5717,666,332,53,-334,387,0.00133143355603615,-0.00839054354181275,0.0097219770978489,EPCI
248719353,CC des Portes de Vassivière,2006_2011,2008.5,5,5898,5646,584,170,-252,-414,162,-0.00869517252484675,-0.0142849262908197,0.00558975376597291,EPCI
248719353,CC des Portes de Vassivière,2011_2016,2013.5,5,5646,5610,509,178,-36,-331,295,-0.00127850407573149,-0.011755134696309,0.0104766306205775,EPCI
248719353,CC des Portes de Vassivière,1968_1975,1971.5,7,8799,8087,1012,500,-712,-512,-200,-0.0119819583779803,-0.00861623973248024,-0.00336571864550009,EPCI
248719353,CC des Portes de Vassivière,1975_1982,1978.5,7,8087,7292,998,346,-795,-652,-143,-0.0146741239539132,-0.012034627443964,-0.00263949650994917,EPCI
248719353,CC des Portes de Vassivière,1982_1990,1986,8,7292,6632,1110,400,-660,-710,50,-0.011788889903818,-0.0126819876238042,0.000893097719986212,EPCI
248719353,CC des Portes de Vassivière,1990_1999,1994.5,9,6632,5992,1130,393,-640,-737,97,-0.0112123534527478,-0.0129117257729299,0.0016993723201821,EPCI
248719353,CC des Portes de Vassivière,1999_2006,2002.5,7,5992,5898,822,254,-94,-568,474,-0.00225629869729949,-0.0136338048943203,0.0113775061970208,EPCI
248719361,CC de Noblat,2006_2011,2008.5,5,11498,11889,752,608,391,-144,535,0.00671051441408754,-0.00247139149777137,0.00918190591185891,EPCI
248719361,CC de Noblat,2011_2016,2013.5,5,11889,12020,768,591,131,-177,308,0.0021940686999411,-0.002964505037325,0.00515857373726609,EPCI
248719361,CC de Noblat,1968_1975,1971.5,7,12750,11999,1394,906,-751,-488,-263,-0.00863506730133778,-0.00561106903202775,-0.00302399826931004,EPCI
248719361,CC de Noblat,1975_1982,1978.5,7,11999,11940,1365,668,-59,-697,638,-0.000703924274378931,-0.00831585117359517,0.00761192689921624,EPCI
248719361,CC de Noblat,1982_1990,1986,8,11940,11839,1492,906,-101,-586,485,-0.00106130410987293,-0.00615766542955977,0.00509636131968684,EPCI
248719361,CC de Noblat,1990_1999,1994.5,9,11839,11268,1625,876,-571,-749,178,-0.0054774235133187,-0.00718492156125343,0.00170749804793473,EPCI
248719361,CC de Noblat,1999_2006,2002.5,7,11268,11498,1089,836,230,-253,483,0.00289077843460484,-0.00317985627806532,0.00607063471267015,EPCI
248900334,CA du Grand Sénonais,2006_2011,2008.5,5,57295,57078,2946,3672,-217,726,-943,-0.000758633377286544,0.00253810060788033,-0.00329673398516687,EPCI
248900334,CA du Grand Sénonais,2011_2016,2013.5,5,57078,58729,3021,3628,1651,607,1044,0.00571927070857226,0.00210272399763983,0.00361654671093243,EPCI
248900334,CA du Grand Sénonais,1968_1975,1971.5,7,41292,47066,4107,5475,5774,1368,4406,0.0188733339011609,0.00447154845458747,0.0144017854465734,EPCI
248900334,CA du Grand Sénonais,1975_1982,1978.5,7,47066,50775,4082,5230,3709,1148,2561,0.0108951005025637,0.00337222307278057,0.00752287742978314,EPCI
248900334,CA du Grand Sénonais,1982_1990,1986,8,50775,53979,4553,6014,3204,1461,1743,0.00767819916759449,0.00350120130582258,0.00417699786177191,EPCI
248900334,CA du Grand Sénonais,1990_1999,1994.5,9,53979,56294,5201,6362,2315,1161,1154,0.00467677719908854,0.00234545932101158,0.00233131787807697,EPCI
248900334,CA du Grand Sénonais,1999_2006,2002.5,7,56294,57295,4166,4759,1001,593,408,0.00252108723039246,0.00149351121640632,0.00102757601398614,EPCI
248900383,CC de l'Agglomération Migennoise,2006_2011,2008.5,5,15426,14928,783,1053,-498,270,-768,-0.00654166024861613,0.003546683267322,-0.0100883435159381,EPCI
248900383,CC de l'Agglomération Migennoise,2011_2016,2013.5,5,14928,15017,751,969,89,218,-129,0.00118955668058729,0.00291374557716887,-0.00172418889658158,EPCI
248900383,CC de l'Agglomération Migennoise,1968_1975,1971.5,7,12822,15115,1034,1904,2293,870,1423,0.0237819838200213,0.00902325596311318,0.0147587278569081,EPCI
248900383,CC de l'Agglomération Migennoise,1975_1982,1978.5,7,15115,15554,1207,1681,439,474,-35,0.00409840588042276,0.00442515805767742,-0.000326752177254662,EPCI
248900383,CC de l'Agglomération Migennoise,1982_1990,1986,8,15554,15828,1406,1962,274,556,-282,0.00218521952590667,0.00443424108176682,-0.00224902155586015,EPCI
248900383,CC de l'Agglomération Migennoise,1990_1999,1994.5,9,15828,15916,1502,1946,88,444,-356,0.000616230796842476,0.00310916447497795,-0.00249293367813547,EPCI
248900383,CC de l'Agglomération Migennoise,1999_2006,2002.5,7,15916,15426,1134,1436,-490,302,-792,-0.0044572504217737,0.00274712168852175,-0.00720437211029544,EPCI
248900524,CC de l'Aillantais,2006_2011,2008.5,5,9993,10304,517,573,311,56,255,0.00614828790263777,0.00110708721076436,0.00504120069187341,EPCI
248900524,CC de l'Aillantais,2011_2016,2013.5,5,10304,10425,557,531,121,-26,147,0.0023376477123378,-0.000502304467113907,0.00283995217945171,EPCI
248900524,CC de l'Aillantais,1968_1975,1971.5,7,7609,7681,930,582,72,-348,420,0.00134633261056161,-0.0065072742843811,0.00785360689494271,EPCI
248900524,CC de l'Aillantais,1975_1982,1978.5,7,7681,8181,848,575,500,-273,773,0.00904994038127782,-0.00494126744817769,0.0139912078294555,EPCI
248900524,CC de l'Aillantais,1982_1990,1986,8,8181,8494,931,727,313,-204,517,0.00470423525527375,-0.00306601914401228,0.00777025439928603,EPCI
248900524,CC de l'Aillantais,1990_1999,1994.5,9,8494,8953,1052,818,459,-234,693,0.00586475738388526,-0.00298987631335327,0.00885463369723852,EPCI
248900524,CC de l'Aillantais,1999_2006,2002.5,7,8953,9993,823,818,1040,-5,1045,0.015823337624796,-7.60737385807502e-05,0.0158994113633768,EPCI
248900664,CC de la Vanne et du Pays d'Othe,2006_2011,2008.5,5,8424,8754,477,491,330,14,316,0.00771479967778399,0.000327294531784775,0.00738750514599921,EPCI
248900664,CC de la Vanne et du Pays d'Othe,2011_2016,2013.5,5,8754,8722,503,443,-32,-60,28,-0.000732165705413901,-0.00137281069765106,0.000640644992237163,EPCI
248900664,CC de la Vanne et du Pays d'Othe,1968_1975,1971.5,7,7770,7132,895,592,-638,-303,-335,-0.0121651791892441,-0.00577750673094194,-0.00638767245830215,EPCI
248900664,CC de la Vanne et du Pays d'Othe,1975_1982,1978.5,7,7132,7075,757,531,-57,-226,169,-0.00114566557659923,-0.00454246351423555,0.00339679793763632,EPCI
248900664,CC de la Vanne et du Pays d'Othe,1982_1990,1986,8,7075,7496,856,678,421,-178,599,0.00725142786504729,-0.00306592437049505,0.0103173522355423,EPCI
248900664,CC de la Vanne et du Pays d'Othe,1990_1999,1994.5,9,7496,8052,922,772,556,-150,706,0.00798179299630331,-0.002153361419866,0.0101351544161693,EPCI
248900664,CC de la Vanne et du Pays d'Othe,1999_2006,2002.5,7,8052,8424,749,663,372,-86,458,0.00647289738613499,-0.00149642251399895,0.00796931990013394,EPCI
248900748,CC du Gâtinais en Bourgogne,2006_2011,2008.5,5,15437,16877,923,1049,1440,126,1314,0.0179969322439069,0.00157473157134185,0.016422200672565,EPCI
248900748,CC du Gâtinais en Bourgogne,2011_2016,2013.5,5,16877,17453,931,983,576,52,524,0.00673453676921487,0.000607979013887454,0.00612655775532742,EPCI
248900748,CC du Gâtinais en Bourgogne,1968_1975,1971.5,7,9130,9112,987,818,-18,-169,151,-0.000281884329144333,-0.00264658064585513,0.00236469631671079,EPCI
248900748,CC du Gâtinais en Bourgogne,1975_1982,1978.5,7,9112,10337,977,668,1225,-309,1534,0.0181829711894119,-0.00458656171226799,0.0227695329016799,EPCI
248900748,CC du Gâtinais en Bourgogne,1982_1990,1986,8,10337,12568,1187,1098,2231,-89,2320,0.0247288347949097,-0.000986493185453593,0.0257153279803633,EPCI
248900748,CC du Gâtinais en Bourgogne,1990_1999,1994.5,9,12568,13981,1453,1262,1413,-191,1604,0.0119087246697887,-0.001609742683602,0.0135184673533907,EPCI
248900748,CC du Gâtinais en Bourgogne,1999_2006,2002.5,7,13981,15437,1204,1084,1456,-120,1576,0.0142531874251768,-0.00117471324932776,0.0154279006745045,EPCI
248900896,CC Yonne Nord,2006_2011,2008.5,5,22227,23616,1264,1381,1389,117,1272,0.0121971219806536,0.00102740336338119,0.0111697186172724,EPCI
248900896,CC Yonne Nord,2011_2016,2013.5,5,23616,24568,1224,1368,952,144,808,0.00793538654424508,0.00120031056971774,0.00673507597452734,EPCI
248900896,CC Yonne Nord,1968_1975,1971.5,7,13400,13952,1642,1148,552,-494,1046,0.00578354049350671,-0.0051758496445513,0.010959390138058,EPCI
248900896,CC Yonne Nord,1975_1982,1978.5,7,13952,15223,1655,1037,1271,-618,1889,0.0125328250473793,-0.00609385198999245,0.0186266770373717,EPCI
248900896,CC Yonne Nord,1982_1990,1986,8,15223,18400,1935,1436,3177,-499,3676,0.0239758095144464,-0.00376579444372325,0.0277416039581697,EPCI
248900896,CC Yonne Nord,1990_1999,1994.5,9,18400,20293,2367,1911,1893,-456,2349,0.0109400016303076,-0.0026353094260012,0.0135753110563088,EPCI
248900896,CC Yonne Nord,1999_2006,2002.5,7,20293,22227,1840,1714,1934,-126,2060,0.0130894649096971,-0.000852777962058859,0.013942242871756,EPCI
248900938,CC du Jovinien,2006_2011,2008.5,5,21915,21902,1193,1369,-13,176,-189,-0.000118668361793861,0.00160658705197843,-0.00172525541377229,EPCI
248900938,CC du Jovinien,2011_2016,2013.5,5,21902,21639,1222,1222,-263,0,-263,-0.00241322640883435,0,-0.00241322640883435,EPCI
248900938,CC du Jovinien,1968_1975,1971.5,7,18395,20290,1990,2320,1895,330,1565,0.014105596084397,0.00245638348699262,0.0116492125974044,EPCI
248900938,CC du Jovinien,1975_1982,1978.5,7,20290,19376,1973,1971,-914,-2,-912,-0.00656307788070565,-1.43612207455266e-05,-0.00654871665996012,EPCI
248900938,CC du Jovinien,1982_1990,1986,8,19376,20018,2312,1986,642,-326,968,0.00408289765677194,-0.00207324709674089,0.00615614475351284,EPCI
248900938,CC du Jovinien,1990_1999,1994.5,9,20018,21074,2266,2277,1056,11,1045,0.00572836518133468,5.96704706389029e-05,0.00566869471069578,EPCI
248900938,CC du Jovinien,1999_2006,2002.5,7,21074,21915,1908,1830,841,-78,919,0.0056058371853549,-0.000519923068320669,0.00612576025367557,EPCI
249000241,CC du Sud Territoire,2006_2011,2008.5,5,23505,23678,1107,1436,173,329,-156,0.00146771253997313,0.00279119899220324,-0.00132348645223011,EPCI
249000241,CC du Sud Territoire,2011_2016,2013.5,5,23678,23610,1163,1283,-68,120,-188,-0.000575033783070444,0.00101476549953608,-0.00158979928260652,EPCI
249000241,CC du Sud Territoire,1968_1975,1971.5,7,20453,22260,1383,2681,1807,1298,509,0.012167973958797,0.00874047050277725,0.00342750345601974,EPCI
249000241,CC du Sud Territoire,1975_1982,1978.5,7,22260,23438,1571,2488,1178,917,261,0.00739395715557767,0.00575573744623491,0.00163821970934276,EPCI
249000241,CC du Sud Territoire,1982_1990,1986,8,23438,23785,1739,2591,347,852,-505,0.0018387500624566,0.00451474078735741,-0.00267599072490081,EPCI
249000241,CC du Sud Territoire,1990_1999,1994.5,9,23785,23547,2003,2638,-238,635,-873,-0.00111678771363832,0.00297966469815267,-0.00409645241179099,EPCI
249000241,CC du Sud Territoire,1999_2006,2002.5,7,23547,23505,1627,1957,-42,330,-372,-0.000255004528915581,0.00200360701290814,-0.00225861154182372,EPCI
249100074,CC du Pays de Limours (CCPL),2006_2011,2008.5,5,24845,26245,629,1402,1400,773,627,0.0110241165721057,0.00608688722159835,0.00493722935050732,EPCI
249100074,CC du Pays de Limours (CCPL),2011_2016,2013.5,5,26245,26882,693,1314,637,621,16,0.00480780517317059,0.00468704397572831,0.000120761197442276,EPCI
249100074,CC du Pays de Limours (CCPL),1968_1975,1971.5,7,8704,13144,654,1173,4440,519,3921,0.0606513934628576,0.00708965612775295,0.0535617373351047,EPCI
249100074,CC du Pays de Limours (CCPL),1975_1982,1978.5,7,13144,15816,706,1305,2672,599,2073,0.0267892208611789,0.00600551770054122,0.0207837031606376,EPCI
249100074,CC du Pays de Limours (CCPL),1982_1990,1986,8,15816,20889,824,1746,5073,922,4151,0.0353868006593165,0.00643142720439382,0.0289553734549227,EPCI
249100074,CC du Pays de Limours (CCPL),1990_1999,1994.5,9,20889,23644,1110,2323,2755,1213,1542,0.0138603628664375,0.00610258444899773,0.00775777841743982,EPCI
249100074,CC du Pays de Limours (CCPL),1999_2006,2002.5,7,23644,24845,883,1955,1201,1072,129,0.00710327256071497,0.00634030656543418,0.000762965995280792,EPCI
249100157,CC des Deux Vallées,2006_2011,2008.5,5,18706,18956,849,916,250,67,183,0.00265876347772442,0.000712548612030146,0.00194621486569428,EPCI
249100157,CC des Deux Vallées,2011_2016,2013.5,5,18956,18613,849,877,-343,28,-371,-0.00364538793926261,0.000297582688919397,-0.00394297062818201,EPCI
249100157,CC des Deux Vallées,1968_1975,1971.5,7,9590,11263,867,940,1673,73,1600,0.0232376148670979,0.00101395450406344,0.0222236603630344,EPCI
249100157,CC des Deux Vallées,1975_1982,1978.5,7,11263,13378,1021,1036,2115,15,2100,0.0248887586133506,0.000176516018534401,0.0247122425948162,EPCI
249100157,CC des Deux Vallées,1982_1990,1986,8,13378,16389,1239,1325,3011,86,2925,0.0256995334009253,0.000734028519588037,0.0249655048813373,EPCI
249100157,CC des Deux Vallées,1990_1999,1994.5,9,16389,18143,1564,1686,1754,122,1632,0.0113612131416192,0.000790232613043068,0.0105709805285761,EPCI
249100157,CC des Deux Vallées,1999_2006,2002.5,7,18143,18706,1316,1410,563,94,469,0.00437518854371088,0.000730493291489917,0.00364469525222097,EPCI
249100546,CC du Val d'Essonne (CCVE),2006_2011,2008.5,5,56304,57969,1710,3425,1665,1715,-50,0.00584557997479718,0.00602112291698328,-0.000175542942186102,EPCI
249100546,CC du Val d'Essonne (CCVE),2011_2016,2013.5,5,57969,59561,1844,3084,1592,1240,352,0.00543322925719414,0.00423191223550297,0.00120131702169117,EPCI
249100546,CC du Val d'Essonne (CCVE),1968_1975,1971.5,7,21958,31857,1735,3120,9899,1385,8514,0.0545992110807996,0.00763914611040584,0.0469600649703937,EPCI
249100546,CC du Val d'Essonne (CCVE),1975_1982,1978.5,7,31857,38390,1987,3200,6533,1213,5320,0.0270068008602298,0.00501442667127793,0.0219923741889518,EPCI
249100546,CC du Val d'Essonne (CCVE),1982_1990,1986,8,38390,45314,2349,4000,6924,1651,5273,0.020943682305308,0.00499393695639276,0.0159497453489152,EPCI
249100546,CC du Val d'Essonne (CCVE),1990_1999,1994.5,9,45314,51041,3109,5125,5727,2016,3711,0.0133115080635282,0.00468587397521789,0.00862563408831032,EPCI
249100546,CC du Val d'Essonne (CCVE),1999_2006,2002.5,7,51041,56304,2368,4608,5263,2240,3023,0.0141182122126668,0.00600889138445254,0.0081093208282143,EPCI
249100553,CC Entre Juine et Renarde (CCEJR),2006_2011,2008.5,5,26405,26762,752,1439,357,687,-330,0.00268952725130145,0.00517564487855489,-0.00248611762725344,EPCI
249100553,CC Entre Juine et Renarde (CCEJR),2011_2016,2013.5,5,26762,27440,851,1403,678,552,126,0.0050163061406403,0.00408407225609653,0.000932233884543773,EPCI
249100553,CC Entre Juine et Renarde (CCEJR),1968_1975,1971.5,7,11504,16001,937,1270,4497,333,4164,0.0482652251671454,0.00357400933525893,0.0446912158318864,EPCI
249100553,CC Entre Juine et Renarde (CCEJR),1975_1982,1978.5,7,16001,18858,1022,1397,2857,375,2482,0.0237470038480194,0.00311695010255768,0.0206300537454617,EPCI
249100553,CC Entre Juine et Renarde (CCEJR),1982_1990,1986,8,18858,22234,1101,1689,3376,588,2788,0.0207990242306124,0.00362257886481046,0.017176445365802,EPCI
249100553,CC Entre Juine et Renarde (CCEJR),1990_1999,1994.5,9,22234,24411,1299,2400,2177,1101,1076,0.0104330712794343,0.00527644073433952,0.00515663054509475,EPCI
249100553,CC Entre Juine et Renarde (CCEJR),1999_2006,2002.5,7,24411,26405,961,2144,1994,1183,811,0.0112802238309773,0.00669232938417558,0.00458789444680169,EPCI
249100595,CC Le Dourdannais en Hurepoix (CCDH),2006_2011,2008.5,5,24199,25132,937,1458,933,521,412,0.00759482035771275,0.00424105188249555,0.00335376847521721,EPCI
249100595,CC Le Dourdannais en Hurepoix (CCDH),2011_2016,2013.5,5,25132,26333,1072,1495,1201,423,778,0.00937991239900482,0.00330366606559454,0.00607624633341028,EPCI
249100595,CC Le Dourdannais en Hurepoix (CCDH),1968_1975,1971.5,7,11471,15702,1078,1676,4231,598,3633,0.0458733552943589,0.00648363660270069,0.0393897186916582,EPCI
249100595,CC Le Dourdannais en Hurepoix (CCDH),1975_1982,1978.5,7,15702,18176,1125,1624,2474,499,1975,0.0211219694518685,0.00426025172048601,0.0168617177313825,EPCI
249100595,CC Le Dourdannais en Hurepoix (CCDH),1982_1990,1986,8,18176,21187,1381,1943,3011,562,2449,0.0193454625539129,0.0036108103471601,0.0157346522067528,EPCI
249100595,CC Le Dourdannais en Hurepoix (CCDH),1990_1999,1994.5,9,21187,23122,1581,2530,1935,949,986,0.00975805335590163,0.00478573262777811,0.00497232072812352,EPCI
249100595,CC Le Dourdannais en Hurepoix (CCDH),1999_2006,2002.5,7,23122,24199,1377,2088,1077,711,366,0.00652501932111149,0.00430760328441065,0.00221741603670084,EPCI
249500109,CA de Cergy-Pontoise,2006_2011,2008.5,5,191445,197187,3829,17167,5742,13338,-7596,0.00592789201832544,0.0137698055974268,-0.00784191357910137,EPCI
249500109,CA de Cergy-Pontoise,2011_2016,2013.5,5,197187,204804,4219,17724,7617,13505,-5888,0.00760898373482477,0.0134907870997517,-0.00588180336492691,EPCI
249500109,CA de Cergy-Pontoise,1968_1975,1971.5,7,44292,72798,2998,7655,28506,4657,23849,0.0735634978854236,0.0120180035660008,0.0615454943194228,EPCI
249500109,CA de Cergy-Pontoise,1975_1982,1978.5,7,72798,106161,3315,12046,33363,8731,24632,0.0553742837583735,0.0144912888977118,0.0408829948606617,EPCI
249500109,CA de Cergy-Pontoise,1982_1990,1986,8,106161,163125,4337,22262,56964,17925,39039,0.0551627242656454,0.0173581881971367,0.0378045360685087,EPCI
249500109,CA de Cergy-Pontoise,1990_1999,1994.5,9,163125,182839,5697,26899,19714,21202,-1488,0.0127572668677387,0.0137201771395859,-0.000962910271847174,EPCI
249500109,CA de Cergy-Pontoise,1999_2006,2002.5,7,182839,191445,4873,21304,8606,16431,-7825,0.00659228794869682,0.0125863215529906,-0.00599403360429382,EPCI
249500430,CC Sausseron Impressionnistes,2006_2011,2008.5,5,18760,18819,609,985,59,376,-317,0.000628208081023152,0.00400349556719839,-0.00337528748617524,EPCI
249500430,CC Sausseron Impressionnistes,2011_2016,2013.5,5,18819,19428,700,964,609,264,345,0.00638999479945879,0.00277004700666194,0.00361994779279685,EPCI
249500430,CC Sausseron Impressionnistes,1968_1975,1971.5,7,12262,13925,961,1223,1663,262,1401,0.0183347311836872,0.00288857460620929,0.0154461565774779,EPCI
249500430,CC Sausseron Impressionnistes,1975_1982,1978.5,7,13925,14867,939,1125,942,186,756,0.00939503107485562,0.00185506983006703,0.00753996124478859,EPCI
249500430,CC Sausseron Impressionnistes,1982_1990,1986,8,14867,16887,1062,1384,2020,322,1698,0.0160524917600446,0.0025588625478883,0.0134936292121563,EPCI
249500430,CC Sausseron Impressionnistes,1990_1999,1994.5,9,16887,18486,1207,1822,1599,615,984,0.0101028699243917,0.00388571920168911,0.00621715072270258,EPCI
249500430,CC Sausseron Impressionnistes,1999_2006,2002.5,7,18486,18760,844,1311,274,467,-193,0.00210410406034778,0.00358619195687012,-0.00148208789652234,EPCI
249500455,CC de la Vallée de l'Oise et des Trois Forêts,2006_2011,2008.5,5,36321,37423,1146,2121,1102,975,127,0.00599578363799513,0.00530479949822619,0.000690984139768949,EPCI
249500455,CC de la Vallée de l'Oise et des Trois Forêts,2011_2016,2013.5,5,37423,38864,1227,2134,1441,907,534,0.0075851996968479,0.0047743068182103,0.0028108928786376,EPCI
249500455,CC de la Vallée de l'Oise et des Trois Forêts,1968_1975,1971.5,7,18887,25574,1426,2409,6687,983,5704,0.0442514746176794,0.0065050395617136,0.0377464350559658,EPCI
249500455,CC de la Vallée de l'Oise et des Trois Forêts,1975_1982,1978.5,7,25574,28118,1637,2573,2544,936,1608,0.0136398613415669,0.00501843955019915,0.00862142179136777,EPCI
249500455,CC de la Vallée de l'Oise et des Trois Forêts,1982_1990,1986,8,28118,30980,1774,2840,2862,1066,1796,0.0121901887864067,0.00454044068704035,0.0076497480993663,EPCI
249500455,CC de la Vallée de l'Oise et des Trois Forêts,1990_1999,1994.5,9,30980,35410,2036,3619,4430,1583,2847,0.014961083242941,0.0053461387750735,0.00961494446786749,EPCI
249500455,CC de la Vallée de l'Oise et des Trois Forêts,1999_2006,2002.5,7,35410,36321,1648,3000,911,1352,-441,0.00363542364759573,0.00539527197755151,-0.00175984832995578,EPCI
249500489,CC du Haut Val d'Oise,2006_2011,2008.5,5,32575,34587,1070,2560,2012,1490,522,0.0120586798053046,0.00893013564110531,0.00312854416419931,EPCI
249500489,CC du Haut Val d'Oise,2011_2016,2013.5,5,34587,38172,1046,2873,3585,1827,1758,0.0199206954627629,0.0101520531688892,0.00976864229387368,EPCI
249500489,CC du Haut Val d'Oise,1968_1975,1971.5,7,19930,24871,1681,2879,4941,1198,3743,0.0321453250387807,0.00779398894888873,0.0243513360898919,EPCI
249500489,CC du Haut Val d'Oise,1975_1982,1978.5,7,24871,27093,1596,2875,2222,1279,943,0.0122997307983137,0.00707981804277373,0.00521991275553997,EPCI
249500489,CC du Haut Val d'Oise,1982_1990,1986,8,27093,31686,1784,3645,4593,1861,2732,0.0197677893487076,0.00800954843848135,0.0117582409102263,EPCI
249500489,CC du Haut Val d'Oise,1990_1999,1994.5,9,31686,31128,2082,4011,-558,1929,-2487,-0.0019721868200091,0.00681782863046158,-0.00879001545047068,EPCI
249500489,CC du Haut Val d'Oise,1999_2006,2002.5,7,31128,32575,1518,3238,1447,1720,-273,0.00651216788853337,0.00774079389652896,-0.00122862600799558,EPCI
249500513,CC du Vexin-Val de Seine,2006_2011,2008.5,5,16226,17088,772,1033,862,261,601,0.0104060843509082,0.00315079816193391,0.00725528618897426,EPCI
249500513,CC du Vexin-Val de Seine,2011_2016,2013.5,5,17088,16629,773,990,-459,217,-676,-0.00543086000275983,0.00256753076383199,-0.00799839076659182,EPCI
249500513,CC du Vexin-Val de Seine,1968_1975,1971.5,7,10472,11284,1095,1264,812,169,643,0.0107257939479808,0.00223233888818812,0.00849345505979267,EPCI
249500513,CC du Vexin-Val de Seine,1975_1982,1978.5,7,11284,12414,1026,1206,1130,180,950,0.0137275224746185,0.00218668499595693,0.0115408374786616,EPCI
249500513,CC du Vexin-Val de Seine,1982_1990,1986,8,12414,13982,1084,1289,1568,205,1363,0.0149793221419494,0.00195839351983395,0.0130209286221155,EPCI
249500513,CC du Vexin-Val de Seine,1990_1999,1994.5,9,13982,15679,1409,1742,1697,333,1364,0.0128092837745566,0.00251354831875506,0.0102957354558015,EPCI
249500513,CC du Vexin-Val de Seine,1999_2006,2002.5,7,15679,16226,1172,1414,547,242,305,0.00491097042184485,0.00217267795628237,0.00273829246556249,EPCI
249710047,CC de Marie-Galante,2006_2011,2008.5,5,12009,11404,597,674,-605,77,-682,-0.0102851815525026,0.00130902310668215,-0.0115942046591847,EPCI
249710047,CC de Marie-Galante,2011_2016,2013.5,5,11404,10867,659,528,-537,-131,-406,-0.00960031924760085,-0.00234197732110933,-0.00725834192649152,EPCI
249710047,CC de Marie-Galante,1968_1975,1971.5,7,15867,15912,1073,3787,45,2714,-2669,0.000404661967818409,0.024405612903537,-0.0240009509357185,EPCI
249710047,CC de Marie-Galante,1975_1982,1978.5,7,15912,13757,932,2060,-2155,1128,-3283,-0.0205747840535423,0.0107695389384667,-0.031344322992009,EPCI
249710047,CC de Marie-Galante,1982_1990,1986,8,13757,13473,974,2037,-284,1063,-1347,-0.00260411622941792,0.00974709701363115,-0.0123512132430491,EPCI
249710047,CC de Marie-Galante,1990_1999,1994.5,9,13473,12488,971,1707,-985,736,-1721,-0.00840002095258108,0.00627656387928901,-0.0146765848318701,EPCI
249710047,CC de Marie-Galante,1999_2006,2002.5,7,12488,12009,968,1193,-479,225,-704,-0.00557182157706548,0.00261724395582408,-0.00818906553288956,EPCI
249710062,CA du Nord Basse-Terre,2006_2011,2008.5,5,75891,79078,2429,5312,3187,2883,304,0.00826125878438955,0.00747323786488706,0.000788020919502486,EPCI
249710062,CA du Nord Basse-Terre,2011_2016,2013.5,5,79078,78179,2684,5012,-899,2328,-3227,-0.00228411500030534,0.0059148161520699,-0.00819893115237524,EPCI
249710062,CA du Nord Basse-Terre,1968_1975,1971.5,7,45424,47072,2798,7113,1648,4315,-2667,0.00510408808722662,0.013364162679844,-0.00826007459261735,EPCI
249710062,CA du Nord Basse-Terre,1975_1982,1978.5,7,47072,49364,2269,6687,2292,4418,-2126,0.00681498405970626,0.0131363872494687,-0.00632140318976244,EPCI
249710062,CA du Nord Basse-Terre,1982_1990,1986,8,49364,54861,2690,7855,5497,5165,332,0.0132851360357138,0.0124827592549503,0.000802376780763505,EPCI
249710062,CA du Nord Basse-Terre,1990_1999,1994.5,9,54861,68324,3192,9903,13463,6711,6752,0.0246839921253985,0.0123044099497548,0.0123795821756437,EPCI
249710062,CA du Nord Basse-Terre,1999_2006,2002.5,7,68324,75891,2949,8597,7567,5648,1919,0.0151184308829821,0.0112843792291639,0.00383405165381826,EPCI
249710070,CA Grand Sud Caraïbe,2006_2011,2008.5,5,85732,83213,3291,5603,-2519,2312,-4831,-0.00594676077435152,0.00545808293382323,-0.0114048437081748,EPCI
249710070,CA Grand Sud Caraïbe,2011_2016,2013.5,5,83213,80163,3391,4720,-3050,1329,-4379,-0.0074404862744486,0.00324210041270236,-0.010682586687151,EPCI
249710070,CA Grand Sud Caraïbe,1968_1975,1971.5,7,84544,82870,5479,20522,-1674,15043,-16717,-0.00285292181025676,0.0256370984418712,-0.028490020252128,EPCI
249710070,CA Grand Sud Caraïbe,1975_1982,1978.5,7,82870,78403,3878,8661,-4467,4783,-9250,-0.00788459832823596,0.00844236261561509,-0.016326960943851,EPCI
249710070,CA Grand Sud Caraïbe,1982_1990,1986,8,78403,83081,4351,11350,4678,6999,-2321,0.0072705333633718,0.0108778244998374,-0.00360729113646557,EPCI
249710070,CA Grand Sud Caraïbe,1990_1999,1994.5,9,83081,83978,4968,12578,897,7610,-6713,0.00119391484418196,0.0101289765487455,-0.00893506170456358,EPCI
249710070,CA Grand Sud Caraïbe,1999_2006,2002.5,7,83978,85732,4333,9362,1754,5029,-3275,0.00295740619363483,0.00847935903522779,-0.00552195284159296,EPCI
249720053,CA de l'Espace Sud de la Martinique,2006_2011,2008.5,5,118139,121136,3986,7583,2997,3597,-600,0.00502296983820538,0.00602856940541367,-0.00100559956720828,EPCI
249720053,CA de l'Espace Sud de la Martinique,2011_2016,2013.5,5,121136,117168,4218,6252,-3968,2034,-6002,-0.00663888041797833,0.00340309545619151,-0.0100419758741698,EPCI
249720053,CA de l'Espace Sud de la Martinique,1968_1975,1971.5,7,79627,76742,4682,14741,-2885,10059,-12944,-0.00525813944942533,0.0183333187943741,-0.0235914582437995,EPCI
249720053,CA de l'Espace Sud de la Martinique,1975_1982,1978.5,7,76742,78329,4562,10074,1587,5512,-3925,0.00292838770201787,0.0101709344760696,-0.00724254677405175,EPCI
249720053,CA de l'Espace Sud de la Martinique,1982_1990,1986,8,78329,93345,4571,11789,15016,7218,7798,0.0221651260794382,0.010654493875958,0.0115106322034802,EPCI
249720053,CA de l'Espace Sud de la Martinique,1990_1999,1994.5,9,93345,106818,5474,14482,13473,9008,4465,0.0150932300598232,0.0100912800696866,0.00500194999013662,EPCI
249720053,CA de l'Espace Sud de la Martinique,1999_2006,2002.5,7,106818,118139,5277,11268,11321,5991,5330,0.0144948236969211,0.00767056697891127,0.00682425671800986,EPCI
249720061,CA du Centre de la Martinique,2006_2011,2008.5,5,168720,163654,5727,11763,-5066,6036,-11102,-0.00607866830635206,0.007242566501607,-0.0133212348079591,EPCI
249720061,CA du Centre de la Martinique,2011_2016,2013.5,5,163654,157449,6127,9584,-6205,3457,-9662,-0.00770076534920317,0.00429033776183648,-0.0119911031110396,EPCI
249720061,CA du Centre de la Martinique,1968_1975,1971.5,7,139660,147651,6707,27626,7991,20919,-12928,0.00798031481309613,0.0208910281035112,-0.0129107132904151,EPCI
249720061,CA du Centre de la Martinique,1975_1982,1978.5,7,147651,155571,7030,21345,7920,14315,-6395,0.0074923335646504,0.0135420145174205,-0.00604968095277012,EPCI
249720061,CA du Centre de la Martinique,1982_1990,1986,8,155571,163969,7076,22170,8398,15094,-6696,0.0065935381058253,0.011850781634833,-0.00525724352900765,EPCI
249720061,CA du Centre de la Martinique,1990_1999,1994.5,9,163969,166139,8578,23847,2170,15269,-13099,0.00146188994373353,0.0102864504842706,-0.0088245605405371,EPCI
249720061,CA du Centre de la Martinique,1999_2006,2002.5,7,166139,168720,7820,16727,2581,8907,-6326,0.00220467656150913,0.00760831233373183,-0.0054036357722227,EPCI
249730037,CC de l'Ouest Guyanais,2006_2011,2008.5,5,58137,78849,863,12259,20712,11396,9316,0.0628420159269845,0.0345764587439125,0.028265557183072,EPCI
249730037,CC de l'Ouest Guyanais,2011_2016,2013.5,5,78849,92995,921,13361,14146,12440,1706,0.0335528331569017,0.0295063795045849,0.00404645365231686,EPCI
249730037,CC de l'Ouest Guyanais,1968_1975,1971.5,7,8122,9233,518,1701,1111,1183,-72,0.0184841255984092,0.0196820167262989,-0.00119789112788971,EPCI
249730037,CC de l'Ouest Guyanais,1975_1982,1978.5,7,9233,11435,591,2158,2202,1567,635,0.0310280390802897,0.0220803529694886,0.00894768611080108,EPCI
249730037,CC de l'Ouest Guyanais,1982_1990,1986,8,11435,25989,750,5184,14554,4434,10120,0.108075047035265,0.0329259831355205,0.0751490638997445,EPCI
249730037,CC de l'Ouest Guyanais,1990_1999,1994.5,9,25989,37553,1043,11581,11564,10538,1026,0.0417455986195125,0.0380417777803894,0.00370382083912313,EPCI
249730037,CC de l'Ouest Guyanais,1999_2006,2002.5,7,37553,58137,1020,13276,20584,12256,8328,0.0644258811806149,0.0383600660585705,0.0260658151220443,EPCI
249730045,CA du Centre Littoral,2006_2011,2008.5,5,112876,121308,2208,13789,8432,11581,-3149,0.0145128829100376,0.0199328388260372,-0.00541995591599958,EPCI
249730045,CA du Centre Littoral,2011_2016,2013.5,5,121308,137964,2412,14559,16656,12147,4509,0.0260659291551755,0.0190095365902928,0.00705639256488269,EPCI
249730045,CA du Centre Littoral,1968_1975,1971.5,7,28257,35812,1924,7252,7555,5328,2227,0.0344282216149641,0.0242797570833261,0.010148464531638,EPCI
249730045,CA du Centre Littoral,1975_1982,1978.5,7,35812,49118,1951,7709,13306,5758,7548,0.0461687145958578,0.0199789161763828,0.026189798419475,EPCI
249730045,CA du Centre Littoral,1982_1990,1986,8,49118,66803,2615,12455,17685,9840,7845,0.0391886899702028,0.0218047333506811,0.0173839566195217,EPCI
249730045,CA du Centre Littoral,1990_1999,1994.5,9,66803,92059,3373,19573,25256,16200,9056,0.036273700336598,0.0232671026866047,0.0130065976499933,EPCI
249730045,CA du Centre Littoral,1999_2006,2002.5,7,92059,112876,2997,17292,20817,14295,6522,0.0295511031196403,0.0202926943889733,0.00925840873066695,EPCI
249730052,CC de l'Est Guyanais,2006_2011,2008.5,5,5737,6604,117,974,867,857,10,0.0285477131977907,0.0282184431493733,0.000329270048417422,EPCI
249730052,CC de l'Est Guyanais,2011_2016,2013.5,5,6604,6956,128,1030,352,902,-550,0.0104399338509549,0.0267523304930719,-0.016312396642117,EPCI
249730052,CC de l'Est Guyanais,1968_1975,1971.5,7,1680,1930,139,447,250,308,-58,0.0200157108062702,0.0246593557133249,-0.00464364490705468,EPCI
249730052,CC de l'Est Guyanais,1975_1982,1978.5,7,1930,2341,125,485,411,360,51,0.0279635824763971,0.0244936488844354,0.00346993359196168,EPCI
249730052,CC de l'Est Guyanais,1982_1990,1986,8,2341,2881,177,611,540,434,106,0.0262844073164277,0.0211248755098696,0.00515953180655802,EPCI
249730052,CC de l'Est Guyanais,1990_1999,1994.5,9,2881,4042,228,1159,1161,931,230,0.0383391469476313,0.0307439671044313,0.0075951798432,EPCI
249730052,CC de l'Est Guyanais,1999_2006,2002.5,7,4042,5737,209,1220,1695,1011,684,0.0513006535244429,0.0305987968809509,0.020701856643492,EPCI
249740077,CA CIVIS (Communauté Intercommunale des VIlles Solidaires),2006_2011,2008.5,5,163501,174310,4617,15121,10809,10504,305,0.0128855557736391,0.0125219611292724,0.000363594644366725,EPCI
249740077,CA CIVIS (Communauté Intercommunale des VIlles Solidaires),2011_2016,2013.5,5,174310,180729,4728,14873,6419,10145,-3726,0.00725888862626589,0.0114724139450798,-0.00421352531881394,EPCI
249740077,CA CIVIS (Communauté Intercommunale des VIlles Solidaires),1968_1975,1971.5,7,91612,101457,5525,20728,9845,15203,-5358,0.0146886614883459,0.0226827547595046,-0.0079940932711587,EPCI
249740077,CA CIVIS (Communauté Intercommunale des VIlles Solidaires),1975_1982,1978.5,7,101457,108065,4273,18801,6608,14528,-7920,0.00905472458989443,0.0199072395341989,-0.0108525149443045,EPCI
249740077,CA CIVIS (Communauté Intercommunale des VIlles Solidaires),1982_1990,1986,8,108065,125678,5705,21764,17613,16059,1554,0.0190530082976061,0.0173719559558995,0.00168105234170669,EPCI
249740077,CA CIVIS (Communauté Intercommunale des VIlles Solidaires),1990_1999,1994.5,9,125678,147627,6730,25013,21949,18283,3666,0.0180459782981446,0.0150318748564845,0.00301410344166012,EPCI
249740077,CA CIVIS (Communauté Intercommunale des VIlles Solidaires),1999_2006,2002.5,7,147627,163501,5994,20432,15874,14438,1436,0.014696994773213,0.0133674694806381,0.00132952529257489,EPCI
249740085,CA du Sud,2006_2011,2008.5,5,114101,122715,3398,10428,8614,7030,1584,0.0146625706493784,0.011966318976681,0.00269625167269739,EPCI
249740085,CA du Sud,2011_2016,2013.5,5,122715,127041,3566,10418,4326,6852,-2526,0.00695311651848285,0.0110131193676941,-0.00406000284921121,EPCI
249740085,CA du Sud,1968_1975,1971.5,7,60798,66958,3089,12818,6160,9729,-3569,0.0138824302252345,0.0219256759190433,-0.00804324569380876,EPCI
249740085,CA du Sud,1975_1982,1978.5,7,66958,71033,2712,11926,4075,9214,-5139,0.00847557323739134,0.0191641550452328,-0.0106885818078415,EPCI
249740085,CA du Sud,1982_1990,1986,8,71033,81488,3623,13211,10455,9588,867,0.0173120476766051,0.0158764144546427,0.00143563322196237,EPCI
249740085,CA du Sud,1990_1999,1994.5,9,81488,100646,4466,15592,19158,11126,8032,0.0237389019058685,0.0137863567493837,0.00995254515648479,EPCI
249740085,CA du Sud,1999_2006,2002.5,7,100646,114101,4181,13348,13455,9167,4288,0.0180865605196565,0.0123225195305605,0.00576404098909603,EPCI
249740093,CA Intercommunale de la Réunion Est (CIREST),2006_2011,2008.5,5,114279,122225,3095,11222,7946,8127,-181,0.0135349353447445,0.0138432443426552,-0.00030830899791074,EPCI
249740093,CA Intercommunale de la Réunion Est (CIREST),2011_2016,2013.5,5,122225,126777,3157,11342,4552,8185,-3633,0.00734001261227557,0.0131981553671959,-0.00585814275492029,EPCI
249740093,CA Intercommunale de la Réunion Est (CIREST),1968_1975,1971.5,7,61289,66204,3994,14260,4915,10266,-5351,0.0110810164554227,0.0231450081243885,-0.0120639916689658,EPCI
249740093,CA Intercommunale de la Réunion Est (CIREST),1975_1982,1978.5,7,66204,74313,3133,13261,8109,10128,-2019,0.016643415044747,0.020787335993735,-0.00414392094898806,EPCI
249740093,CA Intercommunale de la Réunion Est (CIREST),1982_1990,1986,8,74313,85132,3934,15612,10819,11678,-859,0.0171347809818663,0.0184952372960749,-0.00136045631420863,EPCI
249740093,CA Intercommunale de la Réunion Est (CIREST),1990_1999,1994.5,9,85132,101804,4555,18028,16672,13473,3199,0.020070581603632,0.0162194665274552,0.00385111507617674,EPCI
249740093,CA Intercommunale de la Réunion Est (CIREST),1999_2006,2002.5,7,101804,114279,4179,15841,12475,11662,813,0.0166504461920889,0.0155653309412538,0.00108511525083513,EPCI
249740101,CA Territoire de la Côte Ouest (TCO),2006_2011,2008.5,5,199457,211448,4829,18776,11991,13947,-1956,0.0117445177974536,0.0136603110433729,-0.00191579324591937,EPCI
249740101,CA Territoire de la Côte Ouest (TCO),2011_2016,2013.5,5,211448,214073,4977,17035,2625,12058,-9433,0.0024706416124014,0.0113489510713661,-0.00887830945896474,EPCI
249740101,CA Territoire de la Côte Ouest (TCO),1968_1975,1971.5,7,91864,109994,5717,24169,18130,18452,-322,0.026064840725063,0.0265277683981722,-0.000462927673109227,EPCI
249740101,CA Territoire de la Côte Ouest (TCO),1975_1982,1978.5,7,109994,122884,4493,23168,12890,18675,-5785,0.0159566842000649,0.0231180044558737,-0.0071613202558088,EPCI
249740101,CA Territoire de la Côte Ouest (TCO),1982_1990,1986,8,122884,148673,5866,26509,25789,20643,5146,0.0240993621900141,0.0192905166423072,0.00480884554770687,EPCI
249740101,CA Territoire de la Côte Ouest (TCO),1990_1999,1994.5,9,148673,179940,7083,32609,31267,25526,5741,0.0214347374473995,0.0174990599700106,0.00393567747738897,EPCI
249740101,CA Territoire de la Côte Ouest (TCO),1999_2006,2002.5,7,179940,199457,6416,26582,19517,20166,-649,0.0148194801516497,0.0153122732355468,-0.00049279308389715,EPCI
249740119,CA Intercommunale du Nord de la Réunion (CINOR),2006_2011,2008.5,5,190624,197883,4803,17129,7259,12326,-5067,0.00750261372200489,0.0127396634160948,-0.00523704969408993,EPCI
249740119,CA Intercommunale du Nord de la Réunion (CINOR),2011_2016,2013.5,5,197883,204304,4885,16852,6421,11967,-5546,0.00640706473422403,0.0119410284495342,-0.00553396371531015,EPCI
249740119,CA Intercommunale du Nord de la Réunion (CINOR),1968_1975,1971.5,7,110962,132062,6343,27892,21100,21549,-449,0.0251809168662378,0.0257167572298843,-0.00053584036364648,EPCI
249740119,CA Intercommunale du Nord de la Réunion (CINOR),1975_1982,1978.5,7,132062,139519,5102,24236,7457,19134,-11677,0.0078779092007546,0.0202140156426497,-0.0123361064418951,EPCI
249740119,CA Intercommunale du Nord de la Réunion (CINOR),1982_1990,1986,8,139519,156852,5887,26910,17333,21023,-3690,0.0147453929176842,0.0178845205855002,-0.00313912766781599,EPCI
249740119,CA Intercommunale du Nord de la Réunion (CINOR),1990_1999,1994.5,9,156852,176283,7270,30575,19431,23305,-3874,0.0130610007817453,0.015665000422962,-0.00260399964121669,EPCI
249740119,CA Intercommunale du Nord de la Réunion (CINOR),1999_2006,2002.5,7,176283,190624,6706,24953,14341,18247,-3906,0.011235830681471,0.0142960883093789,-0.00306025762790781,EPCI
ZZZZZZZZZ,Sans objet,2006_2011,2008.5,5,6413,6034,392,245,-379,-147,-232,-0.0121094906645277,-0.00469682091737618,-0.00741266974715153,EPCI
ZZZZZZZZZ,Sans objet,2011_2016,2013.5,5,6034,6239,420,190,205,-230,435,0.00670432854257941,-0.00752192958435738,0.0142262581269368,EPCI
ZZZZZZZZZ,Sans objet,1968_1975,1971.5,7,8088,7376,754,957,-712,203,-915,-0.0130780148424814,0.00372870366997714,-0.0168067185124585,EPCI
ZZZZZZZZZ,Sans objet,1975_1982,1978.5,7,7376,7116,720,656,-260,-64,-196,-0.0051134126884671,-0.00125868620023806,-0.00385472648822905,EPCI
ZZZZZZZZZ,Sans objet,1982_1990,1986,8,7116,6812,775,655,-304,-120,-184,-0.00544263577189008,-0.00214840885732503,-0.00329422691456505,EPCI
ZZZZZZZZZ,Sans objet,1990_1999,1994.5,9,6812,6383,762,657,-429,-105,-324,-0.00720145066736444,-0.0017625928206836,-0.00543885784668084,EPCI
ZZZZZZZZZ,Sans objet,1999_2006,2002.5,7,6383,6413,596,480,30,-116,146,0.000670077815158265,-0.00259096755194529,0.00326104536710356,EPCI
01,Ain,2006_2011,2008.5,5,566740,603827,21331,35939,37087,14608,22479,0.0127581167772293,0.0050252263564528,0.00773289042077646,DEP
01,Ain,2011_2016,2013.5,5,603827,638425,22821,36153,34598,13332,21266,0.0112056123072248,0.00431797280998675,0.00688763949723809,DEP
01,Ain,1968_1975,1971.5,7,339262,376477,27981,40085,37215,12104,25111,0.014980280004,0.00487226411845804,0.0101080158855419,DEP
01,Ain,1975_1982,1978.5,7,376477,418516,27016,38623,42039,11607,30432,0.0152375199699542,0.00420709089871923,0.0110304290712349,DEP
01,Ain,1982_1990,1986,8,418516,471019,31484,48281,52503,16797,35706,0.0148825728127455,0.00476130079301538,0.0101212720197301,DEP
01,Ain,1990_1999,1994.5,9,471019,515270,35945,55645,44251,19700,24551,0.0100268915565782,0.0044638485834126,0.00556304297316562,DEP
01,Ain,1999_2006,2002.5,7,515270,566740,28842,46823,51470,17981,33489,0.0136942922766286,0.00478408916701103,0.00891020310961751,DEP
02,Aisne,2006_2011,2008.5,5,536992,541256,26721,34890,4264,8169,-3905,0.00158308533604123,0.00303288557929663,-0.0014498002432554,DEP
02,Aisne,2011_2016,2013.5,5,541256,536136,27747,32986,-5120,5239,-10359,-0.00189909532731725,0.00194323445699513,-0.00384232978431237,DEP
02,Aisne,1968_1975,1971.5,7,525953,533807,42457,65861,7854,23404,-15550,0.00211974281020511,0.00631658527247775,-0.00419684246227265,DEP
02,Aisne,1975_1982,1978.5,7,533807,533927,41432,57586,120,16154,-16034,3.21112420373915e-05,0.00432270836560018,-0.00429059712356279,DEP
02,Aisne,1982_1990,1986,8,533927,537200,45322,63772,3273,18450,-15177,0.000764209253406367,0.00430787067685532,-0.00354366142344896,DEP
02,Aisne,1990_1999,1994.5,9,537200,535434,48292,63529,-1766,15237,-17003,-0.000365803261756947,0.00315614059988143,-0.00352194386163838,DEP
02,Aisne,1999_2006,2002.5,7,535434,536992,37591,48778,1558,11187,-9629,0.000415166704491377,0.00298104616376446,-0.00256587945927308,DEP
03,Allier,2006_2011,2008.5,5,343309,342729,21115,16779,-580,-4336,3756,-0.000338116593439297,-0.00252771301578068,0.00218959642234138,DEP
03,Allier,2011_2016,2013.5,5,342729,339384,21440,15826,-3345,-5614,2269,-0.00195964493273459,-0.0032889227660305,0.0013292778332959,DEP
03,Allier,1968_1975,1971.5,7,386533,378406,36773,36429,-8127,-344,-7783,-0.00303104746128846,-0.000128298305239723,-0.00290274915604874,DEP
03,Allier,1975_1982,1978.5,7,378406,369580,35808,29324,-8826,-6484,-2342,-0.00336581825420534,-0.00247269041018213,-0.000893127844023217,DEP
03,Allier,1982_1990,1986,8,369580,357710,38922,29716,-11870,-9206,-2664,-0.00407226369055513,-0.00315832009564032,-0.000913943594914817,DEP
03,Allier,1990_1999,1994.5,9,357710,344721,40374,30427,-12989,-9947,-3042,-0.00410125656528626,-0.00314074979250923,-0.000960506772777027,DEP
03,Allier,1999_2006,2002.5,7,344721,343309,30632,23872,-1412,-6760,5348,-0.000586182121085854,-0.00280636766185579,0.00222018554076994,DEP
04,Alpes-de-Haute-Provence,2006_2011,2008.5,5,154501,160959,8041,7734,6458,-307,6765,0.00822344939715958,-0.000390925822999069,0.00861437522015865,DEP
04,Alpes-de-Haute-Provence,2011_2016,2013.5,5,160959,162565,8698,7807,1606,-891,2497,0.00198762223204341,-0.00110272192325696,0.00309034415530037,DEP
04,Alpes-de-Haute-Provence,1968_1975,1971.5,7,104813,112178,8759,9973,7365,1214,6151,0.00974850805309857,0.00160688238648495,0.00814162566661362,DEP
04,Alpes-de-Haute-Provence,1975_1982,1978.5,7,112178,119068,9465,8479,6890,-986,7876,0.0085517682334888,-0.00122380892281857,0.00977557715630737,DEP
04,Alpes-de-Haute-Provence,1982_1990,1986,8,119068,130883,11004,11924,11815,920,10895,0.0118963346320922,0.000926333293400321,0.0109700013386918,DEP
04,Alpes-de-Haute-Provence,1990_1999,1994.5,9,130883,139561,13186,13407,8678,221,8457,0.00715861092725989,0.000182306178258174,0.00697630474900172,DEP
04,Alpes-de-Haute-Provence,1999_2006,2002.5,7,139561,154501,10803,10636,14940,-167,15107,0.0146344482964265,-0.000163584529150149,0.0147980328255766,DEP
05,Hautes-Alpes,2006_2011,2008.5,5,130752,138605,6227,7333,7853,1106,6747,0.0117334556101196,0.00165251520499074,0.0100809404051289,DEP
05,Hautes-Alpes,2011_2016,2013.5,5,138605,141107,6542,6976,2502,434,2068,0.00358447024151976,0.000621766620631324,0.00296270362088843,DEP
05,Hautes-Alpes,1968_1975,1971.5,7,91790,97358,7231,9511,5568,2280,3288,0.00844856752847445,0.0034595427379529,0.00498902479052155,DEP
05,Hautes-Alpes,1975_1982,1978.5,7,97358,105070,7660,8851,7712,1191,6521,0.0109497846288773,0.00169102612720343,0.00925875850167387,DEP
05,Hautes-Alpes,1982_1990,1986,8,105070,113300,8715,11378,8230,2663,5567,0.00947111649412635,0.00306459091419909,0.00640652557992727,DEP
05,Hautes-Alpes,1990_1999,1994.5,9,113300,121419,10099,12282,8119,2183,5936,0.00771944308961703,0.00207556894502204,0.00564387414459499,DEP
05,Hautes-Alpes,1999_2006,2002.5,7,121419,130752,8358,9973,9333,1615,7718,0.0106354478891362,0.00184037805003267,0.0087950698391035,DEP
06,Alpes-Maritimes,2006_2011,2008.5,5,1073184,1081244,54641,59868,8060,5227,2833,0.00149758012314849,0.000971197432220491,0.000526382690927999,DEP
06,Alpes-Maritimes,2011_2016,2013.5,5,1081244,1083704,56248,60473,2460,4225,-1765,0.00045461788396195,0.000780796975503755,-0.000326179091541805,DEP
06,Alpes-Maritimes,1968_1975,1971.5,7,722070,816681,67445,59036,94611,-8409,103020,0.0177451031554332,-0.00157717995195102,0.0193222831073842,DEP
06,Alpes-Maritimes,1975_1982,1978.5,7,816681,881198,76064,63231,64517,-12833,77350,0.010921173856004,-0.00217231774716895,0.0130934916031729,DEP
06,Alpes-Maritimes,1982_1990,1986,8,881198,971829,93206,85146,90631,-8060,98691,0.0123123704807753,-0.00109496426250454,0.0134073347432798,DEP
06,Alpes-Maritimes,1990_1999,1994.5,9,971829,1011326,103778,99741,39497,-4037,43534,0.00443622850105019,-0.000453428221351992,0.00488965672240218,DEP
06,Alpes-Maritimes,1999_2006,2002.5,7,1011326,1073184,79772,79123,61858,-649,62507,0.0085171505254753,-8.93599969451562e-05,0.00860651052242046,DEP
07,Ardèche,2006_2011,2008.5,5,306238,317277,15873,17102,11039,1229,9810,0.00710766679517527,0.000791314656333944,0.00631635213884133,DEP
07,Ardèche,2011_2016,2013.5,5,317277,325157,17232,16447,7880,-785,8665,0.00491864365831618,-0.000489991785758655,0.00540863544407483,DEP
07,Ardèche,1968_1975,1971.5,7,256927,257065,23038,26236,138,3198,-3060,7.67134210395426e-05,0.0017777501484381,-0.00170103672739855,DEP
07,Ardèche,1975_1982,1978.5,7,257065,267970,22719,21623,10905,-1096,12001,0.00595279973089635,-0.000598282302160697,0.00655108203305705,DEP
07,Ardèche,1982_1990,1986,8,267970,277581,24772,25560,9611,788,8823,0.00441443359904348,0.000361936705446495,0.00405249689359698,DEP
07,Ardèche,1990_1999,1994.5,9,277581,286023,27600,27691,8442,91,8351,0.00333437388490743,3.5942670401158e-05,0.00329843121450627,DEP
07,Ardèche,1999_2006,2002.5,7,286023,306238,22000,22942,20215,942,19273,0.00980350691919241,0.000456834208156282,0.00934667271103612,DEP
08,Ardennes,2006_2011,2008.5,5,285653,283110,13433,16983,-2543,3550,-6093,-0.00178685622354202,0.00249443161367447,-0.00428128783721649,DEP
08,Ardennes,2011_2016,2013.5,5,283110,275371,14072,15188,-7739,1116,-8855,-0.0055279116213568,0.000797150713197336,-0.00632506233455413,DEP
08,Ardennes,1968_1975,1971.5,7,309380,309306,23960,40001,-74,16041,-16115,-3.41732251607496e-05,0.00740773925410249,-0.00744191247926324,DEP
08,Ardennes,1975_1982,1978.5,7,309306,302338,23016,33058,-6968,10042,-17010,-0.00324977676652138,0.00468344694164864,-0.00793322370817003,DEP
08,Ardennes,1982_1990,1986,8,302338,296357,24230,35437,-5981,11207,-17188,-0.0024944821153573,0.00467407809175878,-0.00716856020711608,DEP
08,Ardennes,1990_1999,1994.5,9,296357,290130,25512,33885,-6227,8373,-14600,-0.00235674187691037,0.00316894166297905,-0.00552568353988943,DEP
08,Ardennes,1999_2006,2002.5,7,290130,285653,19891,25199,-4477,5308,-9785,-0.00221914988351379,0.00263105820453232,-0.00485020808804612,DEP
09,Ariège,2006_2011,2008.5,5,146289,152286,8555,7487,5997,-1068,7065,0.00806761212685236,-0.00143675333524734,0.00950436546209971,DEP
09,Ariège,2011_2016,2013.5,5,152286,153067,8898,6983,781,-1915,2696,0.00102360396409296,-0.00250986119236621,0.00353346515645917,DEP
09,Ariège,1968_1975,1971.5,7,138478,137857,14169,11178,-621,-2991,2370,-0.000641872801628529,-0.00309153228610456,0.00244965948447603,DEP
09,Ariège,1975_1982,1978.5,7,137857,135725,13731,9231,-2132,-4500,2368,-0.0022241138741651,-0.00469442421845355,0.00247031034428844,DEP
09,Ariège,1982_1990,1986,8,135725,136455,15301,10736,730,-4565,5295,0.000670738613435695,-0.00419441338401911,0.0048651519974548,DEP
09,Ariège,1990_1999,1994.5,9,136455,137205,16403,11701,750,-4702,5452,0.0006092152556465,-0.00381937350939979,0.00442858876504629,DEP
09,Ariège,1999_2006,2002.5,7,137205,146289,12519,9376,9084,-3143,12227,0.00920034528480596,-0.00318325464884909,0.012383599933655,DEP
10,Aube,2006_2011,2008.5,5,299704,303997,14411,18492,4293,4081,212,0.00284855184017996,0.0027078826135044,0.000140669226675553,DEP
10,Aube,2011_2016,2013.5,5,303997,308910,15061,17489,4913,2428,2485,0.00321157396865113,0.00158715684833807,0.00162441712031306,DEP
10,Aube,1968_1975,1971.5,7,270325,284823,22036,32668,14498,10632,3866,0.00749120485146171,0.00549361911855021,0.0019975857329115,DEP
10,Aube,1975_1982,1978.5,7,284823,289300,21862,28097,4477,6235,-1758,0.0022305235358282,0.00310639138840492,-0.00087586785257672,DEP
10,Aube,1982_1990,1986,8,289300,289207,24191,30909,-93,6718,-6811,-4.01888533789752e-05,0.00290310448387048,-0.00294329333724946,DEP
10,Aube,1990_1999,1994.5,9,289207,292131,26077,32204,2924,6127,-3203,0.00111836235759721,0.00234343576094327,-0.00122507340334606,DEP
10,Aube,1999_2006,2002.5,7,292131,299704,20120,24635,7573,4515,3058,0.00366283313937399,0.00218377018675209,0.0014790629526219,DEP
11,Aude,2006_2011,2008.5,5,341022,359967,18864,18729,18945,-135,19080,0.0108717464193624,-7.74708770975943e-05,0.01094921729646,DEP
11,Aude,2011_2016,2013.5,5,359967,368025,20256,18123,8058,-2133,10191,0.00443751876821108,-0.00117463732099705,0.00561215608920813,DEP
11,Aude,1968_1975,1971.5,7,278323,272366,25660,22982,-5957,-2678,-3279,-0.00308602265649705,-0.00138733736345461,-0.00169868529304244,DEP
11,Aude,1975_1982,1978.5,7,272366,280686,25799,19853,8320,-5946,14266,0.00430780298987621,-0.00307862939637067,0.00738643238624687,DEP
11,Aude,1982_1990,1986,8,280686,298712,29506,24861,18026,-4645,22671,0.00781075751310434,-0.00201270213293962,0.00982345964604396,DEP
11,Aude,1990_1999,1994.5,9,298712,309770,32572,28094,11058,-4478,15536,0.00404707717958153,-0.00163888692441364,0.00568596410399517,DEP
11,Aude,1999_2006,2002.5,7,309770,341022,26032,23325,31252,-2707,33959,0.0138256893387656,-0.00119755986944959,0.0150232492082152,DEP
12,Aveyron,2006_2011,2008.5,5,273377,275813,16065,13680,2436,-2385,4821,0.00177583591748332,-0.00173865708669857,0.00351449300418188,DEP
12,Aveyron,2011_2016,2013.5,5,275813,278697,16939,12689,2884,-4250,7134,0.00208257962552239,-0.00306898869919214,0.00515156832471453,DEP
12,Aveyron,1968_1975,1971.5,7,281568,278306,25497,25429,-3262,-68,-3194,-0.00166329428963419,-3.46732102069665e-05,-0.00162862107942722,DEP
12,Aveyron,1975_1982,1978.5,7,278306,278654,24797,22070,348,-2727,3075,0.000178536088585757,-0.00139904572865908,0.00157758181724483,DEP
12,Aveyron,1982_1990,1986,8,278654,270141,27326,22101,-8513,-5225,-3288,-0.00387084189340803,-0.00237579571162422,-0.00149504618178381,DEP
12,Aveyron,1990_1999,1994.5,9,270141,263808,29600,22355,-6333,-7245,912,-0.00263236025667513,-0.00301144008520627,0.000379079828531141,DEP
12,Aveyron,1999_2006,2002.5,7,263808,273377,22868,18356,9569,-4512,14081,0.00510300895230986,-0.00240618417732491,0.00750919312963478,DEP
13,Bouches-du-Rhône,2006_2011,2008.5,5,1937405,1975896,81744,127881,38491,46137,-7646,0.00394225383546809,0.00472535827094623,-0.000783104435478139,DEP
13,Bouches-du-Rhône,2011_2016,2013.5,5,1975896,2019717,85464,131633,43821,46169,-2348,0.00439672460075968,0.0046323082105035,-0.000235583609743816,DEP
13,Bouches-du-Rhône,1968_1975,1971.5,7,1470271,1632974,110482,160167,162703,49685,113018,0.0151067063594958,0.00461317065740368,0.0104935357020922,DEP
13,Bouches-du-Rhône,1975_1982,1978.5,7,1632974,1724199,115725,153209,91225,37484,53741,0.00779590282895137,0.00320330634848357,0.00459259648046781,DEP
13,Bouches-du-Rhône,1982_1990,1986,8,1724199,1759371,133457,185407,35172,51950,-16778,0.0025274090261358,0.00373305182837924,-0.00120564280224344,DEP
13,Bouches-du-Rhône,1990_1999,1994.5,9,1759371,1835719,152875,204324,76348,51449,24899,0.0047311424085601,0.00318819806383937,0.00154294434472072,DEP
13,Bouches-du-Rhône,1999_2006,2002.5,7,1835719,1937405,116225,167578,101686,51353,50333,0.0077316241778691,0.00390458958368027,0.00382703459418883,DEP
14,Calvados,2006_2011,2008.5,5,670827,684709,29153,41394,13882,12241,1641,0.00410493242863308,0.00361968576998253,0.000485246658650546,DEP
14,Calvados,2011_2016,2013.5,5,684709,693679,31652,38139,8970,6487,2483,0.00260646834713829,0.00188496768872755,0.000721500658410744,DEP
14,Calvados,1968_1975,1971.5,7,518950,560354,36254,70633,41404,34379,7025,0.0110262296070531,0.00915541367164717,0.00187081593540596,DEP
14,Calvados,1975_1982,1978.5,7,560354,589025,36588,64221,28671,27633,1038,0.00715402588993341,0.00689502275527641,0.000259003134657001,DEP
14,Calvados,1982_1990,1986,8,589025,617991,42471,70919,28966,28448,518,0.00601869835019708,0.00591106575524431,0.000107632594952775,DEP
14,Calvados,1990_1999,1994.5,9,617991,647873,48492,72887,29882,24395,5487,0.00526054335048554,0.00429459055736211,0.000965952793123423,DEP
14,Calvados,1999_2006,2002.5,7,647873,670827,39560,57941,22954,18381,4573,0.00498618845443599,0.00399281737304992,0.000993371081386067,DEP
15,Cantal,2006_2011,2008.5,5,149682,147577,9396,6706,-2105,-2690,585,-0.00282858604057545,-0.00361467764805129,0.000786091607475838,DEP
15,Cantal,2011_2016,2013.5,5,147577,145969,9968,6099,-1608,-3869,2261,-0.0021887617739067,-0.00526636772589865,0.00307760595199195,DEP
15,Cantal,1968_1975,1971.5,7,169330,166549,14893,17308,-2781,2415,-5196,-0.00236290582667154,0.00205193008680754,-0.00441483591347907,DEP
15,Cantal,1975_1982,1978.5,7,166549,162838,15003,13854,-3711,-1149,-2562,-0.00321392693760059,-0.00099509621430964,-0.00221883072329095,DEP
15,Cantal,1982_1990,1986,8,162838,158723,16197,13690,-4115,-2507,-1608,-0.00319429945963212,-0.00194607745936761,-0.00124822200026451,DEP
15,Cantal,1990_1999,1994.5,9,158723,150778,17225,12246,-7945,-4979,-2966,-0.00568952944283674,-0.00356553393277333,-0.00212399551006341,DEP
15,Cantal,1999_2006,2002.5,7,150778,149682,13214,9660,-1096,-3554,2458,-0.00104167317026427,-0.00337783434956132,0.00233616117929705,DEP
16,Charente,2006_2011,2008.5,5,347037,352705,18542,17909,5668,-633,6301,0.00324537706803363,-0.000362442428381314,0.00360781949641494,DEP
16,Charente,2011_2016,2013.5,5,352705,353288,19613,17071,583,-2542,3125,0.000330369524886187,-0.00144047912909209,0.00177084865397828,DEP
16,Charente,1968_1975,1971.5,7,331016,337064,27727,35068,6048,7341,-1293,0.00258993534908902,0.00314363680516907,-0.000553701456080044,DEP
16,Charente,1975_1982,1978.5,7,337064,340770,27029,30208,3706,3179,527,0.00156335499735505,0.00134104304818988,0.000222311949165167,DEP
16,Charente,1982_1990,1986,8,340770,341993,30878,32686,1223,1808,-585,0.000447913546508083,0.000662164915851688,-0.000214251369343605,DEP
16,Charente,1990_1999,1994.5,9,341993,339628,33479,32305,-2365,-1174,-1191,-0.000770743717396938,-0.00038260174385793,-0.000388141973539008,DEP
16,Charente,1999_2006,2002.5,7,339628,347037,26211,24910,7409,-1301,8710,0.00308768590161046,-0.00054218914266368,0.00362987504427414,DEP
17,Charente-Maritime,2006_2011,2008.5,5,598915,625682,33269,30522,26767,-2747,29514,0.00878285893748809,-0.000901352915951724,0.00968421185343982,DEP
17,Charente-Maritime,2011_2016,2013.5,5,625682,642191,36095,29030,16509,-7065,23574,0.00522229135821251,-0.00223487118818653,0.00745716254639903,DEP
17,Charente-Maritime,1968_1975,1971.5,7,483622,497859,39670,53356,14237,13686,551,0.00415335774735715,0.00399261460492589,0.000160743142431256,DEP
17,Charente-Maritime,1975_1982,1978.5,7,497859,513220,40271,44812,15361,4541,10820,0.00435053604319879,0.00128610013489784,0.00306443590830095,DEP
17,Charente-Maritime,1982_1990,1986,8,513220,527146,46298,48198,13926,1900,12026,0.00335222453909778,0.000457362245029857,0.00289486229406792,DEP
17,Charente-Maritime,1990_1999,1994.5,9,527146,557024,53698,49994,29878,-3704,33582,0.00614444199546571,-0.000761731479724379,0.00690617347519009,DEP
17,Charente-Maritime,1999_2006,2002.5,7,557024,598915,45137,41779,41891,-3358,45249,0.0104126031622644,-0.000834678604446874,0.0112472817667113,DEP
18,Cher,2006_2011,2008.5,5,314675,311694,17817,16445,-2981,-1372,-1609,-0.00190187371534523,-0.000875334027995186,-0.00102653968735004,DEP
18,Cher,2011_2016,2013.5,5,311694,307110,17997,15329,-4584,-2668,-1916,-0.00295880362905177,-0.00172209600399435,-0.00123670762505741,DEP
18,Cher,1968_1975,1971.5,7,304601,316350,28487,32767,11749,4280,7469,0.00542128112612272,0.00197489856326541,0.00344638256285732,DEP
18,Cher,1975_1982,1978.5,7,316350,320174,28181,26659,3824,-1522,5346,0.00171796006579195,-0.000683769670537485,0.00240172973632943,DEP
18,Cher,1982_1990,1986,8,320174,321559,30699,30284,1385,-415,1800,0.00053970103623513,-0.00016171547295132,0.00070141650918645,DEP
18,Cher,1990_1999,1994.5,9,321559,314428,32792,30618,-7131,-2174,-4957,-0.00248866773032153,-0.000758710369614219,-0.00172995736070731,DEP
18,Cher,1999_2006,2002.5,7,314428,314675,25989,23546,247,-2443,2690,0.000112184158431949,-0.00110957853866094,0.00122176269709289,DEP
19,Corrèze,2006_2011,2008.5,5,240363,242454,14976,11313,2091,-3663,5754,0.00173384557433498,-0.00303733923423674,0.00477118480857173,DEP
19,Corrèze,2011_2016,2013.5,5,242454,241535,15565,10454,-919,-5111,4192,-0.000759233942833504,-0.0042224642892514,0.0034632303464179,DEP
19,Corrèze,1968_1975,1971.5,7,237858,240363,23562,20649,2505,-2913,5418,0.00149775247104933,-0.00174169778369928,0.00323945025474861,DEP
19,Corrèze,1975_1982,1978.5,7,240363,241448,23673,17883,1085,-5790,6875,0.000643613935030096,-0.00343458496205001,0.0040781988970801,DEP
19,Corrèze,1982_1990,1986,8,241448,237908,26022,18927,-3540,-7095,3555,-0.00184455729415844,-0.00369693050905485,0.0018523732148964,DEP
19,Corrèze,1990_1999,1994.5,9,237908,232576,27595,18661,-5332,-8934,3602,-0.00251538565621601,-0.00421463905713312,0.00169925340091711,DEP
19,Corrèze,1999_2006,2002.5,7,232576,240363,20970,15680,7787,-5290,13077,0.00471583145954657,-0.00320364048041625,0.00791947193996282,DEP
21,Côte-d'Or,2006_2011,2008.5,5,517168,525931,21838,29776,8763,7938,825,0.00336610305524609,0.00304919845401615,0.000316904601229947,DEP
21,Côte-d'Or,2011_2016,2013.5,5,525931,533213,23119,28843,7282,5724,1558,0.00275397397364596,0.0021647551531378,0.000589218820508158,DEP
21,Côte-d'Or,1968_1975,1971.5,7,421192,456070,31581,53969,34878,22388,12490,0.0114301910486059,0.0073369779573424,0.00409321309126347,DEP
21,Côte-d'Or,1975_1982,1978.5,7,456070,473548,31090,47915,17478,16825,653,0.00538688217287242,0.00518562149894602,0.000201260673926404,DEP
21,Côte-d'Or,1982_1990,1986,8,473548,493866,34719,53677,20318,18958,1360,0.00526518073723503,0.00491275206302302,0.000352428674212011,DEP
21,Côte-d'Or,1990_1999,1994.5,9,493866,506755,39066,54764,12889,15698,-2809,0.00286670413259404,0.00349146725684392,-0.000624763124249877,DEP
21,Côte-d'Or,1999_2006,2002.5,7,506755,517168,31156,42189,10413,11033,-620,0.00290995734227306,0.00308321899138564,-0.00017326164911258,DEP
22,Côtes-d'Armor,2006_2011,2008.5,5,570861,594375,32806,32707,23514,-99,23613,0.00810561119372766,-3.41267120940307e-05,0.00813973790582169,DEP
22,Côtes-d'Armor,2011_2016,2013.5,5,594375,598953,35012,29728,4578,-5284,9862,0.00153571753436443,-0.0017725494651773,0.00330826699954173,DEP
22,Côtes-d'Armor,1968_1975,1971.5,7,506102,525556,46340,57001,19454,10661,8793,0.00540290329498427,0.0029608487728913,0.00244205452209297,DEP
22,Côtes-d'Armor,1975_1982,1978.5,7,525556,538869,47104,49256,13313,2152,11161,0.00358007161394247,0.000578706085270352,0.00300136552867212,DEP
22,Côtes-d'Armor,1982_1990,1986,8,538869,538395,52552,51636,-474,-916,442,-0.000109994848368378,-0.000212563884188679,0.000102569035820302,DEP
22,Côtes-d'Armor,1990_1999,1994.5,9,538395,542373,57647,51100,3978,-6547,10525,0.000818275172871141,-0.00134671884283242,0.00216499401570356,DEP
22,Côtes-d'Armor,1999_2006,2002.5,7,542373,570861,45353,44049,28488,-1304,29792,0.00733991909065135,-0.000335974954163485,0.00767589404481483,DEP
23,Creuse,2006_2011,2008.5,5,123401,122560,9555,5043,-841,-4512,3671,-0.00136676695688276,-0.00733276160458384,0.00596599464770108,DEP
23,Creuse,2011_2016,2013.5,5,122560,119502,9609,4626,-3058,-4983,1925,-0.00504077212365051,-0.00821392004321467,0.00317314791956417,DEP
23,Creuse,1968_1975,1971.5,7,156876,146214,18109,11918,-10662,-6191,-4471,-0.0100045301487708,-0.00580923336625773,-0.00419529678251305,DEP
23,Creuse,1975_1982,1978.5,7,146214,139968,17282,9075,-6246,-8207,1961,-0.00621737405789036,-0.0081693866303404,0.00195201257245005,DEP
23,Creuse,1982_1990,1986,8,139968,131349,18451,9506,-8619,-8945,326,-0.00791301621558793,-0.00821231349906417,0.000299297283476234,DEP
23,Creuse,1990_1999,1994.5,9,131349,124470,18704,9634,-6879,-9070,2191,-0.00595919313340687,-0.00785722949847366,0.00189803636506679,DEP
23,Creuse,1999_2006,2002.5,7,124470,123401,13766,7217,-1069,-6549,5480,-0.00123145654099721,-0.00754425527314381,0.0063127987321466,DEP
24,Dordogne,2006_2011,2008.5,5,404052,415168,25127,18687,11116,-6440,17556,0.00544269293702593,-0.00315319741943568,0.0085958903564616,DEP
24,Dordogne,2011_2016,2013.5,5,415168,414789,26137,17412,-379,-8725,8346,-0.000182643396881677,-0.00420465339786973,0.00402201000098805,DEP
24,Dordogne,1968_1975,1971.5,7,374073,373179,35994,32656,-894,-3338,2444,-0.000341765619144674,-0.00127607789340595,0.000934312274261278,DEP
24,Dordogne,1975_1982,1978.5,7,373179,377356,36295,27639,4177,-8656,12833,0.00159138514994006,-0.00329782855108479,0.00488921370102485,DEP
24,Dordogne,1982_1990,1986,8,377356,386365,40250,30902,9009,-9348,18357,0.00295353806968413,-0.00306467686484706,0.00601821493453119,DEP
24,Dordogne,1990_1999,1994.5,9,386365,388293,44556,31596,1928,-12960,14888,0.000553229725259952,-0.00371880562207934,0.0042720353473393,DEP
24,Dordogne,1999_2006,2002.5,7,388293,404052,35062,25544,15759,-9518,25277,0.00569951984946981,-0.00344235230200227,0.00914187215147208,DEP
25,Doubs,2006_2011,2008.5,5,516157,529103,20055,34913,12946,14858,-1912,0.00496672089574313,0.00570025792282955,-0.000733537027086425,DEP
25,Doubs,2011_2016,2013.5,5,529103,538549,21371,33516,9446,12145,-2699,0.00354534312549148,0.00455835192241098,-0.00101300879691949,DEP
25,Doubs,1968_1975,1971.5,7,426458,471082,26462,61333,44624,34871,9753,0.0143184393611093,0.0111890081337676,0.00312943122734177,DEP
25,Doubs,1975_1982,1978.5,7,471082,477163,26126,55675,6081,29549,-23468,0.00183396180687034,0.00891164897734119,-0.00707768717047085,DEP
25,Doubs,1982_1990,1986,8,477163,484770,29849,56789,7607,26940,-19333,0.00197900565933851,0.00700859898285518,-0.00502959332351668,DEP
25,Doubs,1990_1999,1994.5,9,484770,499062,34085,57653,14292,23568,-9276,0.00323363750427452,0.00533237956204464,-0.00209874205777012,DEP
25,Doubs,1999_2006,2002.5,7,499062,516157,27704,45988,17095,18284,-1189,0.00482311484523224,0.00515857454403195,-0.000335459698799715,DEP
26,Drôme,2006_2011,2008.5,5,468608,487993,20210,29466,19385,9256,10129,0.00813984252063449,0.00388663308594237,0.00425320943469212,DEP
26,Drôme,2011_2016,2013.5,5,487993,508006,21922,29650,20013,7728,12285,0.00807083440650636,0.00311654466064464,0.00495428974586172,DEP
26,Drôme,1968_1975,1971.5,7,342891,361847,26612,39705,18956,13093,5863,0.00771660041282951,0.0053298928679667,0.00238670754486281,DEP
26,Drôme,1975_1982,1978.5,7,361847,389781,26918,35783,27934,8865,19069,0.0106799958029205,0.00338935214408569,0.00729064365883476,DEP
26,Drôme,1982_1990,1986,8,389781,414072,30593,44129,24291,13536,10755,0.00758547867882786,0.00422695810780182,0.00335852057102604,DEP
26,Drôme,1990_1999,1994.5,9,414072,437778,34891,48122,23706,13231,10475,0.00620495601077753,0.00346316430349268,0.00274179170728485,DEP
26,Drôme,1999_2006,2002.5,7,437778,468608,28295,38889,30830,10594,20236,0.00976950816293631,0.0033570603139198,0.00641244784901652,DEP
27,Eure,2006_2011,2008.5,5,567221,588111,24498,38019,20890,13521,7369,0.00725956522106963,0.00469873534485795,0.00256082987621169,DEP
27,Eure,2011_2016,2013.5,5,588111,602825,25819,36938,14714,11119,3595,0.00495447973071306,0.00374397581390502,0.00121050391680804,DEP
27,Eure,1968_1975,1971.5,7,383385,422952,29452,50655,39567,21203,18364,0.014130184956656,0.00757202496110336,0.00655815999555261,DEP
27,Eure,1975_1982,1978.5,7,422952,462254,29904,46658,39302,16754,22548,0.0127745962954569,0.00544566653946578,0.00732892975599107,DEP
27,Eure,1982_1990,1986,8,462254,513818,35320,58237,51564,22917,28647,0.0133070857550368,0.00591417431246952,0.00739291144256728,DEP
27,Eure,1990_1999,1994.5,9,513818,541054,40899,63849,27236,22950,4286,0.00575538471538795,0.00484968715002766,0.000905697565360286,DEP
27,Eure,1999_2006,2002.5,7,541054,567221,33901,50872,26167,16971,9196,0.00676994308684575,0.00439074804627429,0.00237919504057147,DEP
28,Eure-et-Loir,2006_2011,2008.5,5,421114,430416,18542,28038,9302,9496,-194,0.0043792815501873,0.00447061466357542,-9.13331133881243e-05,DEP
28,Eure-et-Loir,2011_2016,2013.5,5,430416,433929,19097,26758,3513,7661,-4148,0.00162707091972925,0.00354824660291652,-0.00192117568318728,DEP
28,Eure-et-Loir,1968_1975,1971.5,7,302064,335151,23851,38663,33087,14812,18275,0.0149596869768165,0.00669697716627696,0.00826270981053953,DEP
28,Eure-et-Loir,1975_1982,1978.5,7,335151,362813,24221,36773,27662,12552,15110,0.0113939035634687,0.00517013511418766,0.00622376844928104,DEP
28,Eure-et-Loir,1982_1990,1986,8,362813,396073,27738,43933,33260,16195,17065,0.011024196979631,0.00536791551669043,0.00565628146294055,DEP
28,Eure-et-Loir,1990_1999,1994.5,9,396073,407665,32474,46881,11592,14407,-2815,0.00321038907427429,0.00398999960257675,-0.000779610528302461,DEP
28,Eure-et-Loir,1999_2006,2002.5,7,407665,421114,25959,37426,13449,11467,1982,0.00464759847786467,0.0039626746780931,0.000684923799771565,DEP
29,Finistère,2006_2011,2008.5,5,883001,899870,47708,49742,16869,2034,14835,0.00379196644952518,0.000457220923488897,0.00333474552603628,DEP
29,Finistère,2011_2016,2013.5,5,899870,908249,49250,46367,8379,-2883,11262,0.00185537140260017,-0.000638385935516922,0.00249375733811709,DEP
29,Finistère,1968_1975,1971.5,7,768929,804088,67079,88395,35159,21316,13843,0.00640759542041547,0.00388476077196667,0.0025228346484488,DEP
29,Finistère,1975_1982,1978.5,7,804088,828364,68939,77778,24276,8839,15437,0.00425817686397334,0.00155042121027601,0.00270775565369733,DEP
29,Finistère,1982_1990,1986,8,828364,838687,77802,85547,10323,7745,2578,0.00154931174289752,0.00116239653673751,0.000386915206160012,DEP
29,Finistère,1990_1999,1994.5,9,838687,852418,85570,87421,13731,1851,11880,0.00180601145075676,0.000243458393077763,0.001562553057679,DEP
29,Finistère,1999_2006,2002.5,7,852418,883001,66604,69974,30583,3370,27213,0.00504831663415062,0.000556283786976019,0.0044920328471746,DEP
2A,Corse-du-Sud,2006_2011,2008.5,5,135718,145846,6584,6821,10128,237,9891,0.014498511830245,0.000339272048160353,0.0141592397820846,DEP
2A,Corse-du-Sud,2011_2016,2013.5,5,145846,154303,7168,6844,8457,-324,8781,0.0113371703458731,-0.00043434352513455,0.0117715138710077,DEP
2A,Corse-du-Sud,1968_1975,1971.5,7,89566,100278,7994,8919,10712,925,9787,0.016269580726753,0.00140490684953758,0.0148646738772154,DEP
2A,Corse-du-Sud,1975_1982,1978.5,7,100278,108604,8649,8499,8326,-150,8476,0.011459723871762,-0.000206456711597922,0.0116661805833599,DEP
2A,Corse-du-Sud,1982_1990,1986,8,108604,118808,10413,11415,10204,1002,9202,0.0112883006017563,0.00110847483368874,0.0101798257680676,DEP
2A,Corse-du-Sud,1990_1999,1994.5,9,118808,118593,11722,12199,-215,477,-692,-0.000201233286455493,0.000446457105298932,-0.000647690391754425,DEP
2A,Corse-du-Sud,1999_2006,2002.5,7,118593,135718,9011,9132,17125,121,17004,0.0194556619566357,0.000137467742876083,0.0193181942137596,DEP
2B,Haute-Corse,2006_2011,2008.5,5,158400,168640,7529,7778,10240,249,9991,0.0126073683533459,0.000306565890623352,0.0123008024627225,DEP
2B,Haute-Corse,2011_2016,2013.5,5,168640,176152,7915,8019,7512,104,7408,0.00875429533107974,0.000121198976894608,0.00863309635418514,DEP
2B,Haute-Corse,1968_1975,1971.5,7,115702,125284,9308,10496,9582,1188,8394,0.0114313065555978,0.00141728158923504,0.0100140249663627,DEP
2B,Haute-Corse,1975_1982,1978.5,7,125284,131574,9716,9753,6290,37,6253,0.0070225821728136,4.13093068989035e-05,0.00698127286591469,DEP
2B,Haute-Corse,1982_1990,1986,8,131574,131563,11455,12025,-11,570,-581,-1.04507751922389e-05,0.00054154016905238,-0.000551990944244619,DEP
2B,Haute-Corse,1990_1999,1994.5,9,131563,141603,12896,13212,10040,316,9724,0.00820475861819525,0.000258237422644392,0.00794652119555086,DEP
2B,Haute-Corse,1999_2006,2002.5,7,141603,158400,10097,10159,16797,62,16735,0.0161426372251798,5.95846584486009e-05,0.0160830525667312,DEP
30,Gard,2006_2011,2008.5,5,683169,718357,31950,41871,35188,9921,25267,0.0100954977842525,0.00284635198128818,0.00724914580296427,DEP
30,Gard,2011_2016,2013.5,5,718357,742006,34422,41312,23649,6890,16759,0.00649916237832038,0.0018934935425019,0.00460566883581848,DEP
30,Gard,1968_1975,1971.5,7,478544,494575,39012,47143,16031,8131,7900,0.00471833175446945,0.0023931604700637,0.00232517128440576,DEP
30,Gard,1975_1982,1978.5,7,494575,530478,40196,42594,35903,2398,33505,0.0100616642575866,0.000672029381658709,0.00938963487592788,DEP
30,Gard,1982_1990,1986,8,530478,585049,47914,55927,54571,8013,46558,0.0123148506187964,0.00180826625878976,0.0105065843600067,DEP
30,Gard,1990_1999,1994.5,9,585049,623125,54456,63676,38076,9220,28856,0.00703032376424373,0.00170237380781403,0.00532794995642969,DEP
30,Gard,1999_2006,2002.5,7,623125,683169,44051,52975,60044,8924,51120,0.0132288986135889,0.00196613635380167,0.0112627622597872,DEP
31,Haute-Garonne,2006_2011,2008.5,5,1186330,1260226,41148,76427,73896,35279,38617,0.0121586348410221,0.00580470497126256,0.00635392986975953,DEP
31,Haute-Garonne,2011_2016,2013.5,5,1260226,1348183,43912,81672,87957,37760,50197,0.0135847839246281,0.00583195699027887,0.00775282693434927,DEP
31,Haute-Garonne,1968_1975,1971.5,7,690712,777431,51602,77486,86719,25884,60835,0.0170395366502709,0.00508598307932071,0.0119535535709502,DEP
31,Haute-Garonne,1975_1982,1978.5,7,777431,824501,52914,69021,47070,16107,30963,0.00843299630969319,0.00288570791502503,0.00554728839466816,DEP
31,Haute-Garonne,1982_1990,1986,8,824501,925962,60653,84859,101461,24206,77255,0.0146125903799283,0.0034861903858285,0.0111263999940998,DEP
31,Haute-Garonne,1990_1999,1994.5,9,925962,1046338,70973,109844,120376,38871,81505,0.0136724615736201,0.00441501839094328,0.00925744318267684,DEP
31,Haute-Garonne,1999_2006,2002.5,7,1046338,1186330,57682,96687,139992,39005,100987,0.0181001516910944,0.00504311972620675,0.0130570319648876,DEP
32,Gers,2006_2011,2008.5,5,181375,188893,10640,8327,7518,-2313,9831,0.0081558806494626,-0.00250925138896076,0.0106651320384234,DEP
32,Gers,2011_2016,2013.5,5,188893,190664,11358,8122,1771,-3236,5007,0.00186814269290991,-0.00341350070821936,0.00528164340112927,DEP
32,Gers,1968_1975,1971.5,7,181577,175366,16604,15198,-6211,-1406,-4805,-0.00495974360304663,-0.00112274988019378,-0.00383699372285285,DEP
32,Gers,1975_1982,1978.5,7,175366,174154,15696,11705,-1212,-3991,2779,-0.000990259833005269,-0.0032608308527426,0.00227057101973733,DEP
32,Gers,1982_1990,1986,8,174154,174587,17652,13278,433,-4374,4807,0.000310450614939839,-0.00313605309410359,0.00344650370904343,DEP
32,Gers,1990_1999,1994.5,9,174587,172335,19064,14003,-2252,-5061,2809,-0.00144150755743044,-0.0032395513979376,0.00179804384050716,DEP
32,Gers,1999_2006,2002.5,7,172335,181375,14984,11394,9040,-3590,12630,0.00733051682662911,-0.00291112338579629,0.0102416402124254,DEP
33,Gironde,2006_2011,2008.5,5,1393758,1463662,58653,84032,69904,25379,44525,0.00983561854280168,0.00357087095155877,0.00626474759124292,DEP
33,Gironde,2011_2016,2013.5,5,1463662,1566679,62538,85866,103017,23328,79689,0.0136962616353058,0.00310149190355391,0.0105947697317519,DEP
33,Gironde,1968_1975,1971.5,7,1009390,1061480,84333,111764,52090,27431,24659,0.00721417953129921,0.00379904316995717,0.00341513636134205,DEP
33,Gironde,1975_1982,1978.5,7,1061480,1127546,83795,102696,66066,18901,47165,0.00866294068495499,0.00247840404877447,0.00618453663618052,DEP
33,Gironde,1982_1990,1986,8,1127546,1213499,93705,116422,85953,22717,63236,0.0092253350294127,0.0024382154882688,0.0067871195411439,DEP
33,Gironde,1990_1999,1994.5,9,1213499,1287334,105074,130729,73835,25655,48180,0.00658441491516038,0.00228784674813353,0.00429656816702684,DEP
33,Gironde,1999_2006,2002.5,7,1287334,1393758,82470,109773,106424,27303,79121,0.0114118067579874,0.00292769074563378,0.00848411601235359,DEP
34,Hérault,2006_2011,2008.5,5,1001041,1062036,44842,62196,60995,17354,43641,0.0118997173252011,0.00338564955261153,0.00851406777258959,DEP
34,Hérault,2011_2016,2013.5,5,1062036,1132481,48613,64728,70445,16115,54330,0.0129274422817276,0.00295728202668806,0.00997016025503954,DEP
34,Hérault,1968_1975,1971.5,7,591397,648202,48468,59710,56805,11242,45563,0.0131883290823878,0.0026100377703407,0.0105782913120471,DEP
34,Hérault,1975_1982,1978.5,7,648202,706499,51052,57332,58297,6280,52017,0.0123787633543069,0.00133349287038865,0.0110452704839182,DEP
34,Hérault,1982_1990,1986,8,706499,794603,61872,73828,88104,11956,76148,0.0147985338964836,0.00200820928977524,0.0127903246067083,DEP
34,Hérault,1990_1999,1994.5,9,794603,896441,72844,91318,101838,18474,83364,0.0134890405593524,0.00244698968256914,0.0110420508767833,DEP
34,Hérault,1999_2006,2002.5,7,896441,1001041,61189,78914,104600,17725,86875,0.0158911216996716,0.00269283109107723,0.0131982906085943,DEP
35,Ille-et-Vilaine,2006_2011,2008.5,5,945851,996439,36417,63923,50588,27506,23082,0.0104750577039201,0.00569555897058643,0.00477949873333367,DEP
35,Ille-et-Vilaine,2011_2016,2013.5,5,996439,1051779,39094,63227,55340,24133,31207,0.0108687142945536,0.00473969429111786,0.00612902000343575,DEP
35,Ille-et-Vilaine,1968_1975,1971.5,7,652722,702199,49484,87186,49477,37702,11775,0.0104925978821968,0.00799547113516551,0.0024971267470313,DEP
35,Ille-et-Vilaine,1975_1982,1978.5,7,702199,749764,50429,79793,47565,29364,18201,0.0094070638405177,0.00580740087486517,0.00359966296565253,DEP
35,Ille-et-Vilaine,1982_1990,1986,8,749764,798718,55462,86403,48954,30941,18013,0.00793751787537911,0.0050168472562427,0.00292067061913641,DEP
35,Ille-et-Vilaine,1990_1999,1994.5,9,798718,867533,61103,95977,68815,34874,33941,0.00922513714023476,0.0046751061923788,0.00455003094785596,DEP
35,Ille-et-Vilaine,1999_2006,2002.5,7,867533,945851,49825,83967,78318,34142,44176,0.0124239004566924,0.00541608326811706,0.00700781718857534,DEP
36,Indre,2006_2011,2008.5,5,232959,230175,14784,11394,-2784,-3390,606,-0.00240162811403988,-0.00292439630265632,0.000522768188616439,DEP
36,Indre,2011_2016,2013.5,5,230175,223505,14805,10185,-6670,-4620,-2050,-0.0058639602763475,-0.00406169362469647,-0.00180226665165103,DEP
36,Indre,1968_1975,1971.5,7,247178,248523,23072,24623,1345,1551,-206,0.000775539393331526,0.000894320891492339,-0.000118781498160814,DEP
36,Indre,1975_1982,1978.5,7,248523,243191,22975,19696,-5332,-3279,-2053,-0.00309352711911182,-0.00190241474560533,-0.00119111237350648,DEP
36,Indre,1982_1990,1986,8,243191,237510,25425,19743,-5681,-5682,1,-0.00295031611033514,-0.00295083544075414,5.19330418999493e-07,DEP
36,Indre,1990_1999,1994.5,9,237510,231139,26787,20663,-6371,-6124,-247,-0.00301660384580282,-0.0028996518524088,-0.000116951993394019,DEP
36,Indre,1999_2006,2002.5,7,231139,232959,21085,16699,1820,-4386,6206,0.00112108669999134,-0.00270169575063846,0.0038227824506298,DEP
37,Indre-et-Loire,2006_2011,2008.5,5,580312,593683,25131,33772,13371,8641,4730,0.00456631738461621,0.00295097962160412,0.00161533776301209,DEP
37,Indre-et-Loire,2011_2016,2013.5,5,593683,606223,26560,33262,12540,6702,5838,0.00418923005466487,0.00223893300050749,0.00195029705415738,DEP
37,Indre-et-Loire,1968_1975,1971.5,7,437866,478597,33220,55569,40731,22349,18382,0.0127876399831974,0.00701654675761654,0.00577109322558089,DEP
37,Indre-et-Loire,1975_1982,1978.5,7,478597,506093,33981,47299,27496,13318,14178,0.00801214678269391,0.00388077432542615,0.00413137245726776,DEP
37,Indre-et-Loire,1982_1990,1986,8,506093,529345,38574,53823,23252,15249,8003,0.00563078691293195,0.0036927520056468,0.00193803490728515,DEP
37,Indre-et-Loire,1990_1999,1994.5,9,529345,554003,44496,57340,24658,12844,11814,0.00507167414156373,0.00264176261960599,0.00242991152195774,DEP
37,Indre-et-Loire,1999_2006,2002.5,7,554003,580312,35345,46766,26309,11421,14888,0.00664998332057065,0.00288682426182057,0.00376315905875008,DEP
38,Isère,2006_2011,2008.5,5,1169491,1215212,40619,79527,45721,38908,6813,0.0076994768488925,0.00655215864125258,0.00114731820763992,DEP
38,Isère,2011_2016,2013.5,5,1215212,1252912,43516,78056,37700,34540,3160,0.00612908541424684,0.00561534775087761,0.000513737663369231,DEP
38,Isère,1968_1975,1971.5,7,767678,860339,54161,97686,92661,43525,49136,0.0164126783594132,0.00770941200282167,0.00870326635659151,DEP
38,Isère,1975_1982,1978.5,7,860339,936771,54390,92085,76432,37695,38737,0.012233128279036,0.00603317681701724,0.00619995146201876,DEP
38,Isère,1982_1990,1986,8,936771,1016228,62380,111355,79457,48975,30482,0.0102287290619989,0.00630469317758531,0.00392403588441359,DEP
38,Isère,1990_1999,1994.5,9,1016228,1094006,71171,124743,77778,53572,24206,0.0082279377232084,0.0056672462612528,0.0025606914619556,DEP
38,Isère,1999_2006,2002.5,7,1094006,1169491,56449,104889,75485,48440,27045,0.00957734675371813,0.00614594524408964,0.00343140150962849,DEP
39,Jura,2006_2011,2008.5,5,257399,261294,12522,14865,3895,2343,1552,0.00300827580736884,0.00180959954214768,0.00119867626522117,DEP
39,Jura,2011_2016,2013.5,5,261294,260517,13159,13339,-777,180,-957,-0.000595441048416023,0.000137940011216067,-0.00073338105963209,DEP
39,Jura,1968_1975,1971.5,7,233441,238856,19302,26488,5415,7186,-1771,0.00328129905237051,0.00435446260209317,-0.00107316354972265,DEP
39,Jura,1975_1982,1978.5,7,238856,242925,18892,22725,4069,3833,236,0.00241604162699938,0.00227591240016923,0.000140129226830143,DEP
39,Jura,1982_1990,1986,8,242925,248759,20559,25167,5834,4608,1226,0.00297087966236154,0.00234655699077168,0.00062432267158986,DEP
39,Jura,1990_1999,1994.5,9,248759,250857,22580,26813,2098,4233,-2135,0.000933602132613398,0.0018836691264788,-0.000950066993865398,DEP
39,Jura,1999_2006,2002.5,7,250857,257399,17524,21222,6542,3698,2844,0.00368453620266429,0.00208275984063781,0.00160177636202648,DEP
40,Landes,2006_2011,2008.5,5,362827,387929,19130,19477,25102,347,24755,0.0134691418267261,0.00018619202509258,0.0132829498016335,DEP
40,Landes,2011_2016,2013.5,5,387929,405010,20584,18975,17081,-1609,18690,0.008655125867572,-0.000815297554061434,0.00947042342163343,DEP
40,Landes,1968_1975,1971.5,7,277381,288323,24798,27550,10942,2752,8190,0.00554235477461917,0.00139394629315957,0.00414840848145961,DEP
40,Landes,1975_1982,1978.5,7,288323,297424,25593,22894,9101,-2699,11800,0.00444949124783389,-0.00131954476188371,0.00576903600971761,DEP
40,Landes,1982_1990,1986,8,297424,311461,28936,26211,14037,-2725,16762,0.00578107121530658,-0.00112227819774243,0.006903349413049,DEP
40,Landes,1990_1999,1994.5,9,311461,327334,32801,28634,15873,-4167,20040,0.00553827168074794,-0.0014539140738157,0.00699218575456365,DEP
40,Landes,1999_2006,2002.5,7,327334,362827,25955,24509,35493,-1446,36939,0.0148151118030992,-0.000603573991132942,0.0154186857942322,DEP
41,Loir-et-Cher,2006_2011,2008.5,5,325182,331280,17535,18977,6098,1442,4656,0.00372269480906962,0.000880309267739978,0.00284238554132964,DEP
41,Loir-et-Cher,2011_2016,2013.5,5,331280,332769,17918,17804,1489,-114,1603,0.000897325622486012,-6.87005513521862e-05,0.000966026173838198,DEP
41,Loir-et-Cher,1968_1975,1971.5,7,267900,283690,22927,30376,15790,7449,8341,0.00821474538948697,0.00387534125435645,0.00433940413513051,DEP
41,Loir-et-Cher,1975_1982,1978.5,7,283690,296224,23078,26380,12534,3302,9232,0.00619537417396865,0.00163213064643725,0.0045632435275314,DEP
41,Loir-et-Cher,1982_1990,1986,8,296224,305937,26842,28828,9713,1986,7727,0.00404105231115426,0.000826266847519032,0.00321478546363523,DEP
41,Loir-et-Cher,1990_1999,1994.5,9,305937,314968,30192,31444,9031,1252,7779,0.00323765747875582,0.00044884809693304,0.00278880938182278,DEP
41,Loir-et-Cher,1999_2006,2002.5,7,314968,325182,24557,25446,10214,889,9325,0.00456954857969927,0.000397721625940146,0.00417182695375912,DEP
42,Loire,2006_2011,2008.5,5,741269,749053,34761,46340,7784,11579,-3795,0.00209141589916628,0.00311106175442528,-0.001019645855259,DEP
42,Loire,2011_2016,2013.5,5,749053,761997,36571,46120,12944,9549,3395,0.00343245274897663,0.00253217639832956,0.00090027635064707,DEP
42,Loire,1968_1975,1971.5,7,722443,742396,58879,85024,19953,26145,-6192,0.00389962230108276,0.00510978925784638,-0.00121016695676362,DEP
42,Loire,1975_1982,1978.5,7,742396,739521,56264,74020,-2875,17756,-20631,-0.000554148433420165,0.00342242072480294,-0.00397656915822311,DEP
42,Loire,1982_1990,1986,8,739521,746288,60303,78158,6767,17855,-11088,0.00113926163729894,0.00300598737017475,-0.00186672573287581,DEP
42,Loire,1990_1999,1994.5,9,746288,728524,65263,78436,-17764,13173,-30937,-0.0026732000852393,0.00198232744443016,-0.00465552752966946,DEP
42,Loire,1999_2006,2002.5,7,728524,741269,49764,62021,12745,12257,488,0.00248064498696121,0.00238566226796262,9.49827189985933e-05,DEP
43,Haute-Loire,2006_2011,2008.5,5,219484,224907,11850,11863,5423,13,5410,0.00489346337618413,1.1730596328673e-05,0.00488173277985545,DEP
43,Haute-Loire,2011_2016,2013.5,5,224907,227339,12446,11134,2432,-1312,3744,0.00215337761964052,-0.00116169055796396,0.00331506817760448,DEP
43,Haute-Loire,1968_1975,1971.5,7,208337,205491,20051,19828,-2846,-223,-2623,-0.00196303123704322,-0.000153814464462628,-0.00180921677258059,DEP
43,Haute-Loire,1975_1982,1978.5,7,205491,205895,19385,17015,404,-2370,2774,0.000280624046029132,-0.00164623512150753,0.00192685916753666,DEP
43,Haute-Loire,1982_1990,1986,8,205895,206568,21041,18616,673,-2425,3098,0.000407998947591581,-0.00147012993745852,0.0018781288850501,DEP
43,Haute-Loire,1990_1999,1994.5,9,206568,209113,22041,19572,2545,-2469,5014,0.0013614948489058,-0.00132083724241588,0.00268233209132168,DEP
43,Haute-Loire,1999_2006,2002.5,7,209113,219484,16721,16862,10371,141,10230,0.00693890069770764,9.43385400035462e-05,0.00684456215770409,DEP
44,Loire-Atlantique,2006_2011,2008.5,5,1234325,1296526,48631,83872,62201,35241,26960,0.00988132461254398,0.00559842704571731,0.00428289756682667,DEP
44,Loire-Atlantique,2011_2016,2013.5,5,1296526,1380852,52632,83453,84326,30821,53505,0.0126822097309613,0.00463532464622963,0.00804688508473172,DEP
44,Loire-Atlantique,1968_1975,1971.5,7,862082,934882,65444,116039,72800,50595,22205,0.011648742037826,0.00809571570609621,0.00355302633172974,DEP
44,Loire-Atlantique,1975_1982,1978.5,7,934882,995822,65356,109064,60940,43708,17232,0.009061986076631,0.00649952883881503,0.00256245723781597,DEP
44,Loire-Atlantique,1982_1990,1986,8,995822,1052466,73323,116626,56644,43303,13341,0.00693930796928788,0.00530493702764764,0.00163437094164024,DEP
44,Loire-Atlantique,1990_1999,1994.5,9,1052466,1134551,82379,125680,82085,43301,38784,0.00837946794718736,0.00442028801341487,0.00395917993377249,DEP
44,Loire-Atlantique,1999_2006,2002.5,7,1134551,1234325,66370,110243,99774,43873,55901,0.0121138257444013,0.00532673719490168,0.00678708854949966,DEP
45,Loiret,2006_2011,2008.5,5,645325,659587,27254,43059,14262,15805,-1543,0.00438153411672637,0.0048555705170986,-0.000474036400372233,DEP
45,Loiret,2011_2016,2013.5,5,659587,674330,28997,42393,14743,13396,1347,0.00443093243078141,0.00402609854458033,0.000404833886201082,DEP
45,Loiret,1968_1975,1971.5,7,430629,490189,34694,54274,59560,19580,39980,0.018678602893331,0.00614048093773373,0.0125381219555973,DEP
45,Loiret,1975_1982,1978.5,7,490189,535669,35796,52424,45480,16628,28852,0.0127557264340172,0.00466363718436321,0.00809208924965403,DEP
45,Loiret,1982_1990,1986,8,535669,580612,40994,62779,44943,21785,23158,0.0101216668552124,0.00490622594043128,0.00521544091478116,DEP
45,Loiret,1990_1999,1994.5,9,580612,618126,46463,69046,37514,22583,14931,0.00698087578500983,0.00420240757724788,0.00277846820776195,DEP
45,Loiret,1999_2006,2002.5,7,618126,645325,37994,57187,27199,19193,8006,0.00617063838616572,0.00435431679641452,0.00181632158975119,DEP
46,Lot,2006_2011,2008.5,5,169531,174754,10034,7570,5223,-2464,7687,0.00608714577862779,-0.00287166900220924,0.00895881478083703,DEP
46,Lot,2011_2016,2013.5,5,174754,173347,10701,6919,-1407,-3782,2375,-0.001615474662084,-0.00434237752096781,0.0027269028588838,DEP
46,Lot,1968_1975,1971.5,7,151198,150778,14564,12987,-420,-1577,1157,-0.000397303883587496,-0.00149178148670829,0.00109447760312079,DEP
46,Lot,1975_1982,1978.5,7,150778,154533,14676,11114,3755,-3562,7317,0.00352034038368321,-0.00333940145051387,0.00685974183419708,DEP
46,Lot,1982_1990,1986,8,154533,155816,16101,12409,1283,-3692,4975,0.00103405403614554,-0.00297562548826915,0.00400967952441469,DEP
46,Lot,1990_1999,1994.5,9,155816,160197,17725,12978,4381,-4747,9128,0.00308569364170208,-0.00334348041934713,0.00642917406104921,DEP
46,Lot,1999_2006,2002.5,7,160197,169531,13895,10606,9334,-3289,12623,0.00812302750526928,-0.00286229242177316,0.0109853199270424,DEP
47,Lot-et-Garonne,2006_2011,2008.5,5,322292,330866,17344,17007,8574,-337,8911,0.00526490971279792,-0.000206936619222405,0.00547184633202032,DEP
47,Lot-et-Garonne,2011_2016,2013.5,5,330866,332833,18709,16531,1967,-2178,4145,0.00118618358233569,-0.00131342544093906,0.00249960902327475,DEP
47,Lot-et-Garonne,1968_1975,1971.5,7,290592,292616,24971,28275,2024,3304,-1280,0.000992055725433483,0.00161944274547047,-0.000627387020036985,DEP
47,Lot-et-Garonne,1975_1982,1978.5,7,292616,298522,24773,23904,5906,-869,6775,0.00285871588730569,-0.000420627176781009,0.00327934306408669,DEP
47,Lot-et-Garonne,1982_1990,1986,8,298522,305989,27627,27466,7467,-161,7628,0.00309296357610656,-6.6689049920069e-05,0.00315965262602662,DEP
47,Lot-et-Garonne,1990_1999,1994.5,9,305989,305380,30722,27611,-609,-3111,2502,-0.000221336705689912,-0.00113067075763763,0.000909334051947716,DEP
47,Lot-et-Garonne,1999_2006,2002.5,7,305380,322292,24278,22465,16912,-1813,18725,0.0077298744339509,-0.000828657896685962,0.00855853233063686,DEP
48,Lozère,2006_2011,2008.5,5,76800,77156,4575,3878,356,-697,1053,0.000925369131737908,-0.00181174799107113,0.00273711712280904,DEP
48,Lozère,2011_2016,2013.5,5,77156,76422,4762,3414,-734,-1348,614,-0.0019099204814752,-0.00350759238287272,0.00159767190139751,DEP
48,Lozère,1968_1975,1971.5,7,77258,74825,7397,7035,-2433,-362,-2071,-0.0045607703201439,-0.000678585637440235,-0.00388218468270367,DEP
48,Lozère,1975_1982,1978.5,7,74825,74294,7055,6392,-531,-663,132,-0.0010168910408147,-0.00126967751423757,0.000252786473422864,DEP
48,Lozère,1982_1990,1986,8,74294,72825,7522,6413,-1469,-1109,-360,-0.00249324817038332,-0.00188224113067059,-0.000611007039712727,DEP
48,Lozère,1990_1999,1994.5,9,72825,73509,8100,6439,684,-1661,2345,0.00103926687023415,-0.00252371677113877,0.00356298364137291,DEP
48,Lozère,1999_2006,2002.5,7,73509,76800,6463,5292,3291,-1171,4462,0.0062762985719802,-0.00223322565414428,0.00850952422612448,DEP
49,Maine-et-Loire,2006_2011,2008.5,5,766419,790181,30866,51532,23762,20666,3096,0.00612528642423715,0.00532721021981673,0.000798076204420429,DEP
49,Maine-et-Loire,2011_2016,2013.5,5,790181,810934,32722,49588,20753,16866,3887,0.00519839232736175,0.00422474268748052,0.000973649639881227,DEP
49,Maine-et-Loire,1968_1975,1971.5,7,584933,629466,41876,83300,44533,41424,3109,0.0105372051464019,0.00980156706228082,0.000735638084121066,DEP
49,Maine-et-Loire,1975_1982,1978.5,7,629466,674997,42486,78931,45531,36445,9086,0.0100265618400699,0.00802569779406003,0.00200086404600986,DEP
49,Maine-et-Loire,1982_1990,1986,8,674997,705599,47201,83009,30602,35808,-5206,0.00555774239426277,0.00650322330742308,-0.000945480913160315,DEP
49,Maine-et-Loire,1990_1999,1994.5,9,705599,732657,53257,83069,27058,29812,-2754,0.00418992718494038,0.00461638366610402,-0.000426456481163641,DEP
49,Maine-et-Loire,1999_2006,2002.5,7,732657,766419,44311,70025,33762,25714,8048,0.00645666427831504,0.00491756013425132,0.00153910414406372,DEP
50,Manche,2006_2011,2008.5,5,493087,500084,25469,26702,6997,1233,5764,0.00282206560124498,0.000497299826544957,0.00232476577470003,DEP
50,Manche,2011_2016,2013.5,5,500084,498362,26929,25271,-1722,-1658,-64,-0.000689634837706898,-0.000664003810056932,-2.5631027649966e-05,DEP
50,Manche,1968_1975,1971.5,7,452705,452275,33729,52619,-430,18890,-19320,-0.000135747544847131,0.00596342121433095,-0.00609916875917808,DEP
50,Manche,1975_1982,1978.5,7,452275,466482,33525,46670,14207,13145,1062,0.00442820887220408,0.00409719192124464,0.000331016950959437,DEP
50,Manche,1982_1990,1986,8,466482,480123,39144,53718,13641,14574,-933,0.003609358947398,0.00385622735132164,-0.000246868403923637,DEP
50,Manche,1990_1999,1994.5,9,480123,481983,42845,53252,1860,10407,-8547,0.000429705924212653,0.00240427395337693,-0.00197456802916427,DEP
50,Manche,1999_2006,2002.5,7,481983,493087,34364,39508,11104,5144,5960,0.0032591259171697,0.00150981121378971,0.00174931470337999,DEP
51,Marne,2006_2011,2008.5,5,565910,566617,23973,35359,707,11386,-10679,0.00024973828285324,0.00402195203474822,-0.00377221375189498,DEP
51,Marne,2011_2016,2013.5,5,566617,570883,24966,34339,4266,9373,-5107,0.00150126467252476,0.00329848893004561,-0.00179722425752085,DEP
51,Marne,1968_1975,1971.5,7,485302,530454,34896,67693,45152,32797,12355,0.0127899384932535,0.00929021112604613,0.00349972736720736,DEP
51,Marne,1975_1982,1978.5,7,530454,543670,34813,60442,13216,25629,-12413,0.00352178718458895,0.00682959168839515,-0.0033078045038062,DEP
51,Marne,1982_1990,1986,8,543670,558276,39056,66233,14606,27177,-12571,0.00331937428803863,0.00617627242407408,-0.00285689813603544,DEP
51,Marne,1990_1999,1994.5,9,558276,565284,42940,65762,7008,22822,-15814,0.00138704950610502,0.00451701538646244,-0.00312996588035742,DEP
51,Marne,1999_2006,2002.5,7,565284,565910,33667,50317,626,16650,-16024,0.000158126105456624,0.00420575024896612,-0.0040476241435095,DEP
52,Haute-Marne,2006_2011,2008.5,5,187652,182375,10146,10036,-5277,-110,-5167,-0.00568859369105534,-0.000118579743417868,-0.00557001394763748,DEP
52,Haute-Marne,2011_2016,2013.5,5,182375,178084,10139,9292,-4291,-847,-3444,-0.00475061153008205,-0.000937722667438708,-0.00381288886264334,DEP
52,Haute-Marne,1968_1975,1971.5,7,214340,212304,16226,26945,-2036,10719,-12755,-0.00136254653094725,0.00717344610276207,-0.00853599263370932,DEP
52,Haute-Marne,1975_1982,1978.5,7,212304,210670,15660,22317,-1634,6657,-8291,-0.00110314560927116,0.00449427192222651,-0.00559741753149767,DEP
52,Haute-Marne,1982_1990,1986,8,210670,204067,16992,23525,-6603,6533,-13136,-0.00397265763975685,0.00393054253529176,-0.00790320017504861,DEP
52,Haute-Marne,1990_1999,1994.5,9,204067,194873,18285,21579,-9194,3294,-12488,-0.00510915994436201,0.00183049519868702,-0.00693965514304903,DEP
52,Haute-Marne,1999_2006,2002.5,7,194873,187652,14100,15275,-7221,1175,-8396,-0.00537960363683776,0.000875368269392656,-0.00625497190623042,DEP
53,Mayenne,2006_2011,2008.5,5,299000,307031,13271,19724,8031,6453,1578,0.00531510457530526,0.00427074708310856,0.0010443574921967,DEP
53,Mayenne,2011_2016,2013.5,5,307031,307688,14141,17936,657,3795,-3138,0.000427603967413148,0.00246994985743211,-0.00204234589001896,DEP
53,Mayenne,1968_1975,1971.5,7,252762,261789,19521,32330,9027,12809,-3782,0.00502551450160871,0.0071310308243166,-0.00210551632270789,DEP
53,Mayenne,1975_1982,1978.5,7,261789,271784,19102,29740,9995,10638,-643,0.00536703655518944,0.00571230964223164,-0.000345273087042202,DEP
53,Mayenne,1982_1990,1986,8,271784,278037,20820,30538,6253,9718,-3465,0.00284736671865082,0.00442518947254897,-0.00157782275389815,DEP
53,Mayenne,1990_1999,1994.5,9,278037,285338,22746,31751,7301,9005,-1704,0.00288417838690247,0.0035573245273328,-0.000673146140430326,DEP
53,Mayenne,1999_2006,2002.5,7,285338,299000,18291,27600,13662,9309,4353,0.00670367412200479,0.00456774281962689,0.0021359313023779,DEP
54,Meurthe-et-Moselle,2006_2011,2008.5,5,725302,733124,31007,42746,7822,11739,-3917,0.0021476500111961,0.0032231224087741,-0.001075472397578,DEP
54,Meurthe-et-Moselle,2011_2016,2013.5,5,733124,733821,31960,41003,697,9043,-8346,0.00019007291773554,0.00246603930427903,-0.00227596638654349,DEP
54,Meurthe-et-Moselle,1968_1975,1971.5,7,705554,722693,48702,88960,17139,40258,-23119,0.00343462808089035,0.00806763856003755,-0.0046330104791472,DEP
54,Meurthe-et-Moselle,1975_1982,1978.5,7,722693,716964,48161,76524,-5729,28363,-34092,-0.0011363370520826,0.00562575105746533,-0.00676208810954793,DEP
54,Meurthe-et-Moselle,1982_1990,1986,8,716964,711943,52243,82031,-5021,29788,-34809,-0.00087808651952237,0.00520940873203194,-0.00608749525155431,DEP
54,Meurthe-et-Moselle,1990_1999,1994.5,9,711943,713779,56048,79766,1836,23718,-21882,0.000286211905274447,0.0036973714429735,-0.00341115953769905,DEP
54,Meurthe-et-Moselle,1999_2006,2002.5,7,713779,725302,43624,60243,11523,16619,-5096,0.00229043751465929,0.00330337421297603,-0.00101293669831674,DEP
55,Meuse,2006_2011,2008.5,5,193696,193557,9696,11153,-139,1457,-1596,-0.000143565088411513,0.0015048513224142,-0.00164841641082571,DEP
55,Meuse,2011_2016,2013.5,5,193557,189055,9963,10096,-4502,133,-4635,-0.00469575325834326,0.00013872394121716,-0.00483447719956042,DEP
55,Meuse,1968_1975,1971.5,7,209372,203799,17226,24659.2028536997,-5573,7433.20285369969,-13006.2028536997,-0.00384663412045361,0.0051305960382728,-0.00897723015872641,DEP
55,Meuse,1975_1982,1978.5,7,203799,199983,16807,20475.4536245267,-3816,3668.45362452668,-7484.45362452668,-0.0026966220037894,0.00259235659428187,-0.00528897859807126,DEP
55,Meuse,1982_1990,1986,8,199983,196223,17107,22433.6537552888,-3760,5326.65375528876,-9086.65375528876,-0.00236976208935491,0.00335715482244768,-0.00572691691180259,DEP
55,Meuse,1990_1999,1994.5,9,196223,192198,18396,21216,-4025,2820,-6845,-0.00230020345992832,0.00161157111975102,-0.00391177457967934,DEP
55,Meuse,1999_2006,2002.5,7,192198,193696,14017,16051,1498,2034,-536,0.00110973373566736,0.00150680802292885,-0.000397074287261486,DEP
56,Morbihan,2006_2011,2008.5,5,694821,727083,35882,40448,32262,4566,27696,0.00911859948944849,0.00129054383698536,0.00782805565246312,DEP
56,Morbihan,2011_2016,2013.5,5,727083,747548,38920,38111,20465,-809,21274,0.00556701423654271,-0.000220069118854779,0.00578708335539749,DEP
56,Morbihan,1968_1975,1971.5,7,540474,563588,47518,66512,23114,18994,4120,0.0060003526812864,0.00493080811751986,0.00106954456376655,DEP
56,Morbihan,1975_1982,1978.5,7,563588,590889,47528,59171,27301,11643,15658,0.0067806990311281,0.00289175044208727,0.00388894858904083,DEP
56,Morbihan,1982_1990,1986,8,590889,619838,54138,65145,28949,11007,17942,0.00599665475961797,0.00228005039687433,0.00371660436274364,DEP
56,Morbihan,1990_1999,1994.5,9,619838,643873,59127,66199,24035,7072,16963,0.00423598520862711,0.00124638599523241,0.0029895992133947,DEP
56,Morbihan,1999_2006,2002.5,7,643873,694821,48284,54794,50948,6510,44438,0.0109383563679752,0.00139767409820835,0.0095406822697669,DEP
57,Moselle,2006_2011,2008.5,5,1036776,1045146,44240,59666,8370,15426,-7056,0.00160943182278817,0.00296620015511711,-0.00135676833232895,DEP
57,Moselle,2011_2016,2013.5,5,1045146,1045271,46856,56805,125,9949,-9824,2.39189587680766e-05,0.00190375776626875,-0.00187983880750068,DEP
57,Moselle,1968_1975,1971.5,7,971314,1006373,62371,123890,35059,61519,-26460,0.00507831735095743,0.00891106435190821,-0.00383274700095079,DEP
57,Moselle,1975_1982,1978.5,7,1006373,1007189,63104,104659,816,41555,-40739,0.000115792991624009,0.00589678647908784,-0.00578099348746383,DEP
57,Moselle,1982_1990,1986,8,1007189,1011302,69927,118573,4113,48646,-44533,0.000509545681113499,0.00602658867090865,-0.00551704298979515,DEP
57,Moselle,1990_1999,1994.5,9,1011302,1023447,76507,112967,12145,36460,-24315,0.00132729475531557,0.00398461644946938,-0.00265732169415381,DEP
57,Moselle,1999_2006,2002.5,7,1023447,1036776,61418,83932,13329,22514,-9185,0.00185021761834236,0.00312520064966314,-0.00127498303132078,DEP
58,Nièvre,2006_2011,2008.5,5,222220,218341,14345,10305,-3879,-4040,161,-0.00351576941895926,-0.00366169333658041,0.00014592391762115,DEP
58,Nièvre,2011_2016,2013.5,5,218341,209161,14806,9369,-9180,-5437,-3743,-0.00855395901661893,-0.00506621733914566,-0.00348774167747327,DEP
58,Nièvre,1968_1975,1971.5,7,247702,245212,24345,23293,-2490,-1052,-1438,-0.00144228294315552,-0.000609350062730764,-0.000832932880424751,DEP
58,Nièvre,1975_1982,1978.5,7,245212,239635,24410,19718,-5577,-4692,-885,-0.00328120648571162,-0.00276052014182516,-0.000520686343886459,DEP
58,Nièvre,1982_1990,1986,8,239635,233278,26617,20895,-6357,-5722,-635,-0.00335511609847849,-0.00301997393668302,-0.000335142161795477,DEP
58,Nièvre,1990_1999,1994.5,9,233278,225198,28152,20428,-8080,-7724,-356,-0.00390910173193759,-0.00373686903186707,-0.000172232700070518,DEP
58,Nièvre,1999_2006,2002.5,7,225198,222220,20957,15280,-2978,-5677,2699,-0.00189992614749712,-0.00362185384128313,0.00172192769378601,DEP
59,Nord,2006_2011,2008.5,5,2565257,2579208,109104,183172,13951,74068,-60117,0.00108532985003773,0.00576218273475698,-0.00467685288471925,DEP
59,Nord,2011_2016,2013.5,5,2579208,2603723,110932,180146,24515,69214,-44699,0.00189378471307089,0.00534678421906949,-0.0034529995059986,DEP
59,Nord,1968_1975,1971.5,7,2418847,2511478,192646,333036,92631,140390,-47759,0.00538307181751829,0.00815849394329537,-0.00277542212577707,DEP
59,Nord,1975_1982,1978.5,7,2511478,2520526,189565,304918,9048,115353,-106305,0.000513872764067447,0.00655136659521134,-0.00603749383114389,DEP
59,Nord,1982_1990,1986,8,2520526,2531855,198022,336921,11329,138899,-127570,0.0005607353731516,0.00687488592068003,-0.00631415054752843,DEP
59,Nord,1990_1999,1994.5,9,2531855,2555020,203853,330885,23165,127032,-103867,0.00101249175229823,0.00555229234957688,-0.00453980059727866,DEP
59,Nord,1999_2006,2002.5,7,2555020,2565257,154929,256116,10237,101187,-90950,0.000571394200886477,0.00564791100958288,-0.0050765168086964,DEP
60,Oise,2006_2011,2008.5,5,792975,805642,30173,55376,12667,25203,-12536,0.00317458431630335,0.00631633761141497,-0.00314175329511162,DEP
60,Oise,2011_2016,2013.5,5,805642,823542,31668,54203,17900,22535,-4635,0.00440468725088339,0.00554523056975738,-0.00114054331887399,DEP
60,Oise,1968_1975,1971.5,7,540988,606320,40232,74825,65332,34593,30739,0.016420617854398,0.00869464325961533,0.00772597459478264,DEP
60,Oise,1975_1982,1978.5,7,606320,661781,40184,69663,55461,29479,25982,0.0125823262506157,0.006687841826543,0.00589448442407273,DEP
60,Oise,1982_1990,1986,8,661781,725603,46170,84764,63822,38594,25228,0.0115750215393846,0.00699956725409748,0.00457545428528713,DEP
60,Oise,1990_1999,1994.5,9,725603,766441,51977,95381,40838,43404,-2566,0.00610239853963135,0.00648583442416766,-0.000383435884536315,DEP
60,Oise,1999_2006,2002.5,7,766441,792975,41529,75806,26534,34277,-7743,0.00487383485250059,0.00629608944143977,-0.00142225458893918,DEP
61,Orne,2006_2011,2008.5,5,292879,290891,15407,16217,-1988,810,-2798,-0.00136125822290489,0.00055463740470471,-0.0019158956276096,DEP
61,Orne,2011_2016,2013.5,5,290891,285308,16381,14357,-5583,-2024,-3559,-0.00386836414165592,-0.00140239459478982,-0.0024659695468661,DEP
61,Orne,1968_1975,1971.5,7,288503,293523,22450,34751,5020,12301,-7281,0.00246739849480715,0.00604610933956628,-0.00357871084475913,DEP
61,Orne,1975_1982,1978.5,7,293523,295472,21692,30190,1949,8498,-6549,0.00094588663173889,0.00412424042920323,-0.00317835379746434,DEP
61,Orne,1982_1990,1986,8,295472,293204,24336,31159,-2268,6823,-9091,-0.000962719440408932,0.00289622343117731,-0.00385894287158625,DEP
61,Orne,1990_1999,1994.5,9,293204,292337,26808,31071,-867,4263,-5130,-0.000328986549766319,0.00161761206649806,-0.00194659861626438,DEP
61,Orne,1999_2006,2002.5,7,292337,292879,21016,23530,542,2514,-1972,0.000264650449991688,0.00122754839719392,-0.00096289794720223,DEP
62,Pas-de-Calais,2006_2011,2008.5,5,1453387,1462807,70128,98795,9420,28667,-19247,0.00129293472198766,0.00393466663218899,-0.00264173191020133,DEP
62,Pas-de-Calais,2011_2016,2013.5,5,1462807,1470725,71567,94329,7918,22762,-14844,0.00108023981176908,0.00310538249500982,-0.00202514268324074,DEP
62,Pas-de-Calais,1968_1975,1971.5,7,1397099,1402295,106622,181796,5196,75174,-69978,0.00053046011102853,0.00767452047468413,-0.0071440603636556,DEP
62,Pas-de-Calais,1975_1982,1978.5,7,1402295,1412413,108211,158902,10118,50691,-40573,0.00102758604054354,0.00514818778228825,-0.00412060174174471,DEP
62,Pas-de-Calais,1982_1990,1986,8,1412413,1433203,117408,181671,20790,64263,-43473,0.00182819542065271,0.00565104965451685,-0.00382285423386413,DEP
62,Pas-de-Calais,1990_1999,1994.5,9,1433203,1441568,124867,174680,8365,49813,-41448,0.000646832484059834,0.00385184298009235,-0.00320501049603252,DEP
62,Pas-de-Calais,1999_2006,2002.5,7,1441568,1453387,97902,136671,11819,38769,-26950,0.00116714981114963,0.00382851603591335,-0.00266136622476372,DEP
63,Puy-de-Dôme,2006_2011,2008.5,5,623463,635469,29699,34568,12006,4869,7137,0.00382206312824351,0.00155002710073444,0.00227203602750908,DEP
63,Puy-de-Dôme,2011_2016,2013.5,5,635469,650700,30558,33986,15231,3428,11803,0.0047483172085665,0.00106869091924141,0.00367962628932509,DEP
63,Puy-de-Dôme,1968_1975,1971.5,7,547743,580033,45732,62571,32290,16839,15451,0.00821625533498804,0.00428471736097441,0.00393153797401363,DEP
63,Puy-de-Dôme,1975_1982,1978.5,7,580033,594365,45153,54018,14332,8865,5467,0.00349303078971475,0.00216059991283988,0.00133243087687486,DEP
63,Puy-de-Dôme,1982_1990,1986,8,594365,598213,49405,56683,3848,7278,-3430,0.000806984068976391,0.00152630718659308,-0.000719323117616689,DEP
63,Puy-de-Dôme,1990_1999,1994.5,9,598213,604266,53724,55961,6053,2237,3816,0.00111925039567851,0.00041364003554152,0.000705610360136986,DEP
63,Puy-de-Dôme,1999_2006,2002.5,7,604266,623463,41561,45989,19197,4428,14769,0.00447784179064303,0.00103286364791204,0.003444978142731,DEP
64,Pyrénées-Atlantiques,2006_2011,2008.5,5,636849,656608,31850,32644,19759,794,18965,0.00612963180901249,0.000246314472207901,0.00588331733680459,DEP
64,Pyrénées-Atlantiques,2011_2016,2013.5,5,656608,673986,33723,31962,17378,-1761,19139,0.00523810117460011,-0.000530803094054022,0.00576890426865413,DEP
64,Pyrénées-Atlantiques,1968_1975,1971.5,7,508734,534748,41834,53156,26014,11322,14692,0.00714977003360984,0.00311177428771164,0.0040379957458982,DEP
64,Pyrénées-Atlantiques,1975_1982,1978.5,7,534748,555696,43231,45462,20948,2231,18717,0.00550449066315295,0.00058623824085804,0.00491825242229491,DEP
64,Pyrénées-Atlantiques,1982_1990,1986,8,555696,578516,51289,51172,22820,-117,22937,0.00504327745876165,-2.58572945957543e-05,0.00506913475335741,DEP
64,Pyrénées-Atlantiques,1990_1999,1994.5,9,578516,600018,57588,55194,21502,-2394,23896,0.00406305980148125,-0.000452374903020469,0.00451543470450172,DEP
64,Pyrénées-Atlantiques,1999_2006,2002.5,7,600018,636849,45157,44935,36831,-222,37053,0.00854673427478336,-5.15157071217699e-05,0.00859824998190513,DEP
65,Hautes-Pyrénées,2006_2011,2008.5,5,227736,229228,12929,10955,1492,-1974,3466,0.00130686882748421,-0.00172906103582696,0.00303592986331117,DEP
65,Hautes-Pyrénées,2011_2016,2013.5,5,229228,227829,13717,10471,-1399,-3246,1847,-0.0012236095514595,-0.00283905404148502,0.00161544449002552,DEP
65,Hautes-Pyrénées,1968_1975,1971.5,7,225730,227222,19522,21434,1492,1912,-420,0.000941574195725936,0.00120662859398659,-0.000265054398260652,DEP
65,Hautes-Pyrénées,1975_1982,1978.5,7,227222,227922,19184,16787,700,-2397,3097,0.000439518276270201,-0.00150503615459953,0.00194455443086973,DEP
65,Hautes-Pyrénées,1982_1990,1986,8,227922,224759,21193,18773,-3163,-2420,-743,-0.00174531867139405,-0.00133533708023193,-0.000409981591162117,DEP
65,Hautes-Pyrénées,1990_1999,1994.5,9,224759,222368,23573,19779,-2391,-3794,1403,-0.00118763308406045,-0.00188451690544765,0.000696883821387205,DEP
65,Hautes-Pyrénées,1999_2006,2002.5,7,222368,227736,18577,15321,5368,-3256,8624,0.0034134405945363,-0.00207044757373513,0.00548388816827143,DEP
66,Pyrénées-Orientales,2006_2011,2008.5,5,432112,452530,24262,23879,20418,-383,20801,0.00927661258364099,-0.000174010315385175,0.00945062289902616,DEP
66,Pyrénées-Orientales,2011_2016,2013.5,5,452530,474369,25970,24218,21839,-1752,23591,0.00947085549144155,-0.000759784734695069,0.0102306402261366,DEP
66,Pyrénées-Orientales,1968_1975,1971.5,7,281976,299506,25894,25964,17530,70,17460,0.00865329513854563,3.45539452195205e-05,0.0086187411933261,DEP
66,Pyrénées-Orientales,1975_1982,1978.5,7,299506,334557,28525,24256,35051,-4269,39320,0.0159360482673143,-0.00194091438341744,0.0178769626507318,DEP
66,Pyrénées-Orientales,1982_1990,1986,8,334557,363796,33604,31233,29239,-2371,31610,0.0105282867464653,-0.000853742189400092,0.0113820289358654,DEP
66,Pyrénées-Orientales,1990_1999,1994.5,9,363796,392803,40120,36013,29007,-4107,33114,0.0085603142770323,-0.00121202505380672,0.00977233933083902,DEP
66,Pyrénées-Orientales,1999_2006,2002.5,7,392803,432112,33420,30223,39309,-3197,42506,0.0137184750148263,-0.00111572323443485,0.0148341982492611,DEP
67,Bas-Rhin,2006_2011,2008.5,5,1079016,1099269,41240,66335,20253,25095,-4842,0.00372610447721766,0.00461692548539857,-0.000890821008180907,DEP
67,Bas-Rhin,2011_2016,2013.5,5,1099269,1121407,43554,64800,22138,21246,892,0.00399570833003815,0.0038347104155746,0.000160997914463548,DEP
67,Bas-Rhin,1968_1975,1971.5,7,827367,882121,66361,100690,54754,34329,20425,0.00919643912403623,0.00576587205846221,0.00343056706557402,DEP
67,Bas-Rhin,1975_1982,1978.5,7,882121,915676,65178,88415,33555,23237,10318,0.00534758405786029,0.00370322785732378,0.00164435620053651,DEP
67,Bas-Rhin,1982_1990,1986,8,915676,953053,71090,103957,37377,32867,4510,0.00501351653155724,0.00440857339654578,0.000604943135011455,DEP
67,Bas-Rhin,1990_1999,1994.5,9,953053,1026120,75309,118023,73067,42714,30353,0.00824149366084948,0.00481786798732019,0.00342362567352928,DEP
67,Bas-Rhin,1999_2006,2002.5,7,1026120,1079016,57034,92348,52896,35314,17582,0.00720653092198598,0.00481116592897408,0.0023953649930119,DEP
68,Haut-Rhin,2006_2011,2008.5,5,736477,753056,28907,45289,16579,16382,197,0.00446224381070182,0.00440922118987377,5.30226208280511e-05,DEP
68,Haut-Rhin,2011_2016,2013.5,5,753056,762743,31701,43920,9687,12219,-2532,0.00255958054958771,0.0032286068685261,-0.000669026318938381,DEP
68,Haut-Rhin,1968_1975,1971.5,7,585018,635209,48663,70085,50191,21422,28769,0.0118281866080872,0.00504838344560664,0.00677980316248051,DEP
68,Haut-Rhin,1975_1982,1978.5,7,635209,650372,47433,64748,15163,17315,-2152,0.00337574622329173,0.0038548470524498,-0.000479100829158069,DEP
68,Haut-Rhin,1982_1990,1986,8,650372,671319,50934,76333,20947,25399,-4452,0.00397035191661321,0.00481419622523793,-0.000843844308624721,DEP
68,Haut-Rhin,1990_1999,1994.5,9,671319,708025,53991,81623,36706,27632,9074,0.00593252479850581,0.00446595993113694,0.00146656486736887,DEP
68,Haut-Rhin,1999_2006,2002.5,7,708025,736477,41148,63253,28452,22105,6347,0.00564424087527593,0.00438513793575054,0.00125910293952539,DEP
69,Rhône,2006_2011,2008.5,5,1669655,1744236,58343,125897,74581,67554,7027,0.00877822848068499,0.00795114636146195,0.000827082119223039,DEP
69,Rhône,2011_2016,2013.5,5,1744236,1835903,61040,131429,91667,70389,21278,0.0102966132513931,0.00790653463244469,0.00239007861894839,DEP
69,Rhône,1968_1975,1971.5,7,1326383,1429647,90874,169838,103264,78964,24300,0.0107678276516949,0.00823395125782885,0.00253387639386608,DEP
69,Rhône,1975_1982,1978.5,7,1429647,1445208,88267,155750,15561,67483,-51922,0.00154772437530393,0.00671197763759623,-0.0051642532622923,DEP
69,Rhône,1982_1990,1986,8,1445208,1508966,96229,177335,63758,81106,-17348,0.00541101094991214,0.00688330019924675,-0.00147228924933461,DEP
69,Rhône,1990_1999,1994.5,9,1508966,1578869,106651,200159,69903,93508,-23605,0.00504424847501661,0.00674760148208021,-0.0017033530070636,DEP
69,Rhône,1999_2006,2002.5,7,1578869,1669655,82856,162904,90786,80048,10738,0.00801887321779171,0.00707041573962716,0.000948457478164556,DEP
70,Haute-Saône,2006_2011,2008.5,5,235867,239695,11443,14164,3828,2721,1107,0.0032250282437658,0.00229239860273949,0.000932629641026318,DEP
70,Haute-Saône,2011_2016,2013.5,5,239695,237242,11760,12605,-2453,845,-3298,-0.00205519810202892,0.000707966733067443,-0.00276316483509636,DEP
70,Haute-Saône,1968_1975,1971.5,7,214396,222254,18611,25808,7858,7197,661,0.00515554427049381,0.00472186970154542,0.000433674568948384,DEP
70,Haute-Saône,1975_1982,1978.5,7,222254,231962,18019,22759,9708,4740,4968,0.00612621657009504,0.00299116878267929,0.00313504778741576,DEP
70,Haute-Saône,1982_1990,1986,8,231962,229650,19654,24657,-2312,5003,-7315,-0.00125136069136433,0.00270785360678882,-0.00395921429815316,DEP
70,Haute-Saône,1990_1999,1994.5,9,229650,229732,21164,23748,82,2584,-2502,3.96676052376588e-05,0.00125001331626964,-0.00121034571103198,DEP
70,Haute-Saône,1999_2006,2002.5,7,229732,235867,16109,19376,6135,3267,2868,0.00377204986997626,0.002008685725381,0.00176336414459526,DEP
71,Saône-et-Loire,2006_2011,2008.5,5,549361,555999,29635,29175,6638,-460,7098,0.00240502967058753,-0.000166663701185638,0.00257169337177317,DEP
71,Saône-et-Loire,2011_2016,2013.5,5,555999,555023,31068,28013,-976,-3055,2079,-0.00035132654209391,-0.00109969527264026,0.000748368730546352,DEP
71,Saône-et-Loire,1968_1975,1971.5,7,550364,569810,47935,61597,19446,13662,5784,0.00497276542131675,0.00349367073876527,0.00147909468255148,DEP
71,Saône-et-Loire,1975_1982,1978.5,7,569810,571852,46918,52843,2042,5925,-3883,0.000511165559811566,0.00148318116644639,-0.000972015606634824,DEP
71,Saône-et-Loire,1982_1990,1986,8,571852,559413,51028,54980,-12439,3952,-16391,-0.00274524951178623,0.000872194394290472,-0.0036174439060767,DEP
71,Saône-et-Loire,1990_1999,1994.5,9,559413,544893,54281,53573,-14520,-708,-13812,-0.0029177987678457,-0.000142272832481733,-0.00277552593536397,DEP
71,Saône-et-Loire,1999_2006,2002.5,7,544893,549361,41952,40594,4468,-1358,5826,0.00116730069402671,-0.000354788348811161,0.00152208904283787,DEP
72,Sarthe,2006_2011,2008.5,5,553484,565718,25242,34749,12234,9507,2727,0.00438214886636024,0.0034053530548052,0.00097679581155504,DEP
72,Sarthe,2011_2016,2013.5,5,565718,567561,27065,33035,1843,5970,-4127,0.000650713970054451,0.00210784720630769,-0.00145713323625324,DEP
72,Sarthe,1968_1975,1971.5,7,461839,490385,33391,60162,28546,26771,1775,0.00860458723227486,0.00806955106828383,0.000535036163991028,DEP
72,Sarthe,1975_1982,1978.5,7,490385,504768,33584,50981,14383,17397,-3014,0.00413827064875494,0.00500545744812554,-0.000867186799370603,DEP
72,Sarthe,1982_1990,1986,8,504768,513654,38133,54068,8886,15935,-7049,0.00218375207851018,0.00391605777302045,-0.00173230569451027,DEP
72,Sarthe,1990_1999,1994.5,9,513654,529851,43574,58114,16197,14540,1657,0.00345550631172253,0.00310199801027633,0.000353508301446208,DEP
72,Sarthe,1999_2006,2002.5,7,529851,553484,35252,47582,23633,12330,11303,0.00625332948191781,0.00326253765971509,0.00299079182220273,DEP
73,Savoie,2006_2011,2008.5,5,403090,418949,16186,24811,15859,8625,7234,0.00774772591103123,0.00421364121209688,0.00353408469893436,DEP
73,Savoie,2011_2016,2013.5,5,418949,429681,17208,23934,10732,6726,4006,0.00507159296429749,0.00317848809894381,0.00189310486535368,DEP
73,Savoie,1968_1975,1971.5,7,288921,305118,22042,33266,16197,11224,4973,0.00782262274933321,0.00542082593927986,0.00240179681005335,DEP
73,Savoie,1975_1982,1978.5,7,305118,323675,21726,30136,18557,8410,10147,0.00847014740505947,0.00383865601533384,0.00463149138972563,DEP
73,Savoie,1982_1990,1986,8,323675,348261,24758,35455,24586,10697,13889,0.00919353741197382,0.00399997029593606,0.00519356711603776,DEP
73,Savoie,1990_1999,1994.5,9,348261,373258,27827,40226,24997,12399,12598,0.00773169984538669,0.00383507406420569,0.003896625781181,DEP
73,Savoie,1999_2006,2002.5,7,373258,403090,22547,32953,29832,10406,19426,0.0110448333935751,0.00385265943595945,0.00719217395761564,DEP
74,Haute-Savoie,2006_2011,2008.5,5,696255,746994,23178,46188,50739,23010,27729,0.0141676594086588,0.00642499542744713,0.0077426639812117,DEP
74,Haute-Savoie,2011_2016,2013.5,5,746994,801416,25542,49233,54422,23691,30731,0.0141639738619395,0.00616586499509771,0.00799810886684175,DEP
74,Haute-Savoie,1968_1975,1971.5,7,378550,447795,26407,49781,69245,23374,45871,0.0242884703438493,0.00819869601873252,0.0160897743251168,DEP
74,Haute-Savoie,1975_1982,1978.5,7,447795,494505,27711,48574,46710,20863,25847,0.0142754669926883,0.00637613076147413,0.0078993362312142,DEP
74,Haute-Savoie,1982_1990,1986,8,494505,568286,32738,60436,73781,27698,46083,0.017535415239492,0.0065829404765922,0.0109524747628998,DEP
74,Haute-Savoie,1990_1999,1994.5,9,568286,631679,38204,74340,63393,36136,27257,0.0118200377415756,0.00673779256115936,0.00508224518041622,DEP
74,Haute-Savoie,1999_2006,2002.5,7,631679,696255,31625,60965,64576,29340,35236,0.014002068944178,0.00636181712744955,0.00764025181672844,DEP
75,Paris,2006_2011,2008.5,5,2181371,2249975,70280,155704,68604,85424,-16820,0.00621232229419411,0.00773542970758611,-0.001523107413392,DEP
75,Paris,2011_2016,2013.5,5,2249975,2190327,69309,145731,-59648,76422,-136070,-0.00535923922059911,0.00686634555587153,-0.0122255847764706,DEP
75,Paris,1968_1975,1971.5,7,2590771,2299830,195077,262006,-290941,66929,-357870,-0.0168732123208307,0.00388156783478739,-0.0207547801556181,DEP
75,Paris,1975_1982,1978.5,7,2299830,2176243,174171,220479,-123587,46308,-169895,-0.00785969431419942,0.00294502434966418,-0.0108047186638636,DEP
75,Paris,1982_1990,1986,8,2176243,2152423,177141,254976,-23820,77835,-101655,-0.00137478052607354,0.00449227717241536,-0.0058670576984889,DEP
75,Paris,1990_1999,1994.5,9,2152423,2125246,168412,274423,-27177,106011,-133188,-0.0014108509172126,0.00550339318484841,-0.00691424410206101,DEP
75,Paris,1999_2006,2002.5,7,2125246,2181371,110144,222029,56125,111885,-55760,0.00373065847957355,0.00743705521580554,-0.003706396736232,DEP
76,Seine-Maritime,2006_2011,2008.5,5,1243834,1251282,55173,80396,7448,25223,-17775,0.00119472929056563,0.00404600656497542,-0.00285127727440979,DEP
76,Seine-Maritime,2011_2016,2013.5,5,1251282,1255755,57431,78007,4473,20576,-16103,0.00071392664009351,0.00328409446603265,-0.00257016782593914,DEP
76,Seine-Maritime,1968_1975,1971.5,7,1113977,1172743,77327,147809,58766,70482,-11716,0.00737117064705894,0.0088407386847158,-0.00146956803765685,DEP
76,Seine-Maritime,1975_1982,1978.5,7,1172743,1193108,78408,131084,20365,52676,-32311,0.00246248663297721,0.00636945474484202,-0.0039069681118648,DEP
76,Seine-Maritime,1982_1990,1986,8,1193108,1223429,89036,152135,30321,63099,-32778,0.00314191360586458,0.00653842573188381,-0.00339651212601923,DEP
76,Seine-Maritime,1990_1999,1994.5,9,1223429,1239138,97560,150181,15709,52621,-36912,0.00141860578327679,0.00475195460702834,-0.00333334882375155,DEP
76,Seine-Maritime,1999_2006,2002.5,7,1239138,1243834,76304,112085,4696,35781,-31085,0.00054051292571855,0.00411841844019068,-0.00357790551447213,DEP
77,Seine-et-Marne,2006_2011,2008.5,5,1273488,1338427,40814,96247,64939,55433,9506,0.00999672700332166,0.00853337082454503,0.00146335617877663,DEP
77,Seine-et-Marne,2011_2016,2013.5,5,1338427,1397665,43072,97738,59238,54666,4572,0.00869920874266472,0.00802780217303943,0.000671406569625293,DEP
77,Seine-et-Marne,1968_1975,1971.5,7,604340,755762,48073,82037,151422,33964,117458,0.0324569659079284,0.00728010718453645,0.0251768587233919,DEP
77,Seine-et-Marne,1975_1982,1978.5,7,755762,887112,50607,86119,131350,35512,95838,0.0231561395544615,0.0062605316167342,0.0168956079377273,DEP
77,Seine-et-Marne,1982_1990,1986,8,887112,1078166,60492,117975,191054,57483,133571,0.0246803248262419,0.00742564464490074,0.0172546801813412,DEP
77,Seine-et-Marne,1990_1999,1994.5,9,1078166,1193767,70493,148647,115601,78154,37447,0.0113812125289461,0.00769446011701674,0.00368675241192934,DEP
77,Seine-et-Marne,1999_2006,2002.5,7,1193767,1273488,57382,123705,79721,66323,13398,0.00927788073426172,0.00771862977055532,0.00155925096370641,DEP
78,Yvelines,2006_2011,2008.5,5,1395804,1413635,41374,100412,17831,59038,-41207,0.00254198695593488,0.00841645594215039,-0.00587446898621551,DEP
78,Yvelines,2011_2016,2013.5,5,1413635,1431808,43008,98332,18173,55324,-37151,0.00255798209583058,0.00778725589994668,-0.0052292738041161,DEP
78,Yvelines,1968_1975,1971.5,7,854382,1082255,49627,124610,227873,74983,152890,0.0343516601329803,0.0113036232100831,0.0230480369228972,DEP
78,Yvelines,1975_1982,1978.5,7,1082255,1196111,53143,130983,113856,77840,36016,0.014392392078785,0.00983965534897257,0.00455273672981238,DEP
78,Yvelines,1982_1990,1986,8,1196111,1307150,62144,156777,111039,94633,16406,0.0111585136949011,0.0095098445275045,0.00164866916739656,DEP
78,Yvelines,1990_1999,1994.5,9,1307150,1354304,73447,178259,47154,104812,-57658,0.00394537084613633,0.00876961040686349,-0.00482423956072716,DEP
78,Yvelines,1999_2006,2002.5,7,1354304,1395804,58320,138328,41500,80008,-38508,0.00432115568562375,0.00833077166494903,-0.00400961597932528,DEP
79,Deux-Sèvres,2006_2011,2008.5,5,359711,370939,17657,20642,11228,2985,8243,0.00616627313459883,0.00163932359340733,0.0045269495411915,DEP
79,Deux-Sèvres,2011_2016,2013.5,5,370939,374743,19051,19307,3804,256,3548,0.00204264918829256,0.000137465350211066,0.00190518383808149,DEP
79,Deux-Sèvres,1968_1975,1971.5,7,325608,335829,25466,38858,10221,13392,-3171,0.00442517630224293,0.00579805900006235,-0.00137288269781942,DEP
79,Deux-Sèvres,1975_1982,1978.5,7,335829,342812,24943,32899,6983,7956,-973,0.00294433894802948,0.003354598406204,-0.000410259458174522,DEP
79,Deux-Sèvres,1982_1990,1986,8,342812,345965,27986,33637,3153,5651,-2498,0.0011450828481232,0.00205228771796518,-0.000907204869841979,DEP
79,Deux-Sèvres,1990_1999,1994.5,9,345965,344392,31668,33780,-1573,2112,-3685,-0.000506212985581289,0.000679670582039213,-0.0011858835676205,DEP
79,Deux-Sèvres,1999_2006,2002.5,7,344392,359711,24805,28166,15319,3361,11958,0.00623656514845128,0.00136830703465923,0.00486825811379205,DEP
80,Somme,2006_2011,2008.5,5,564319,571211,27031,34995,6892,7964,-1072,0.00243074430049006,0.0028088287302819,-0.000378084429791838,DEP
80,Somme,2011_2016,2013.5,5,571211,572744,27724,33370,1533,5646,-4113,0.000536179084831279,0.0019747339288698,-0.00143855484403852,DEP
80,Somme,1968_1975,1971.5,7,511491,538462,42851,68052,26971,25201,1770,0.00736800224373946,0.00688446941323933,0.000483532830500124,DEP
80,Somme,1975_1982,1978.5,7,538462,544570,42539,58277,6108,15738,-9630,0.00161266533442617,0.00415522708467567,-0.00254256175024951,DEP
80,Somme,1982_1990,1986,8,544570,547825,46320,63115,3255,16795,-13540,0.000745202583201765,0.00384506217661249,-0.00309985959341072,DEP
80,Somme,1990_1999,1994.5,9,547825,555551,48723,63480,7726,14757,-7031,0.00155726919351551,0.00297445269074662,-0.00141718349723111,DEP
80,Somme,1999_2006,2002.5,7,555551,564319,38028,50280,8768,12252,-3484,0.00223954409747873,0.00312943593548237,-0.000889891838003638,DEP
81,Tarn,2006_2011,2008.5,5,365335,377675,19487,19813,12340,326,12014,0.00666597870349373,0.000176102840951293,0.00648987586254243,DEP
81,Tarn,2011_2016,2013.5,5,377675,386448,20329,19286,8773,-1043,9816,0.00460321856813462,-0.000547265127842745,0.00515048369597736,DEP
81,Tarn,1968_1975,1971.5,7,332011,338024,28499,31232,6013,2733,3280,0.00256740414917989,0.00116692425406763,0.00140047989511226,DEP
81,Tarn,1975_1982,1978.5,7,338024,339345,27852,27649,1321,-203,1524,0.000557353851319498,-8.56493806342604e-05,0.000643003231953758,DEP
81,Tarn,1982_1990,1986,8,339345,342723,31155,29886,3378,-1269,4647,0.00123892329862652,-0.000465421452325947,0.00170434475095246,DEP
81,Tarn,1990_1999,1994.5,9,342723,343402,34351,30990,679,-3361,4040,0.000219938831417243,-0.00108868101972512,0.00130861985114236,DEP
81,Tarn,1999_2006,2002.5,7,343402,365335,27023,25209,21933,-1814,23747,0.0088839397787297,-0.000734758891105443,0.00961869866983514,DEP
82,Tarn-et-Garonne,2006_2011,2008.5,5,226849,244545,11448,14474,17696,3026,14670,0.015136360338919,0.00258830393227672,0.0125480564066422,DEP
82,Tarn-et-Garonne,2011_2016,2013.5,5,244545,256897,12238,14398,12352,2160,10192,0.00990389923959833,0.00173189947842717,0.00817199976117117,DEP
82,Tarn-et-Garonne,1968_1975,1971.5,7,183572,183314,16222,17700,-258,1478,-1736,-0.000200898625367651,0.00115088437323019,-0.00135178299859784,DEP
82,Tarn-et-Garonne,1975_1982,1978.5,7,183314,190485,15938,14891,7171,-1047,8218,0.00549689879038584,-0.000802573285948121,0.00629947207633396,DEP
82,Tarn-et-Garonne,1982_1990,1986,8,190485,200220,17697,17289,9735,-408,10143,0.00624986323518106,-0.000261935716482165,0.00651179895166323,DEP
82,Tarn-et-Garonne,1990_1999,1994.5,9,200220,206034,19821,20049,5814,228,5586,0.00318555666063336,0.000124923790613073,0.00306063287002029,DEP
82,Tarn-et-Garonne,1999_2006,2002.5,7,206034,226849,15850,17044,20815,1194,19621,0.0138440092592149,0.000794126690151459,0.0130498825690635,DEP
83,Var,2006_2011,2008.5,5,985099,1012735,51080,55072,27636,3992,23644,0.0055488837571116,0.000801532202865448,0.00474735155424615,DEP
83,Var,2011_2016,2013.5,5,1012735,1055821,54308,55177,43086,869,42217,0.00836762883231956,0.000168766408004588,0.00819886242431497,DEP
83,Var,1968_1975,1971.5,7,555926,626093,47013,57841,70167,10828,59339,0.0171255216771049,0.00264276866218724,0.0144827530149177,DEP
83,Var,1975_1982,1978.5,7,626093,708331,53118,56112,82238,2994,79244,0.0177867003478818,0.000647551993501277,0.0171391483543805,DEP
83,Var,1982_1990,1986,8,708331,815449,66352,76946,107118,10594,96524,0.017759276325982,0.00175639736923256,0.0160028789567494,DEP
83,Var,1990_1999,1994.5,9,815449,898441,81740,90939,82992,9199,73793,0.0108273243708259,0.00120012238393131,0.00962720198689459,DEP
83,Var,1999_2006,2002.5,7,898441,985099,68948,73447,86658,4499,82159,0.0132413438395367,0.000687447274736037,0.0125538965648006,DEP
84,Vaucluse,2006_2011,2008.5,5,534291,546630,24166,34480,12339,10314,2025,0.00457674593067448,0.00382563883045438,0.0007511071002201,DEP
84,Vaucluse,2011_2016,2013.5,5,546630,559014,25392,35203,12384,9811,2573,0.0044905244897242,0.00355753680302682,0.000932987686697381,DEP
84,Vaucluse,1968_1975,1971.5,7,353966,390446,27273,40652,36480,13379,23101,0.0141113253426255,0.00517531309646344,0.00893601224616205,DEP
84,Vaucluse,1975_1982,1978.5,7,390446,427343,29389,37163,36897,7774,29123,0.0129831723471572,0.00273548477726644,0.0102476875698907,DEP
84,Vaucluse,1982_1990,1986,8,427343,467075,34610,48377,39732,13767,25965,0.0111748365506343,0.00387204205156003,0.00730279449907431,DEP
84,Vaucluse,1990_1999,1994.5,9,467075,499685,41198,55822,32610,14624,17986,0.00752685829238731,0.00337543010327728,0.00415142818911003,DEP
84,Vaucluse,1999_2006,2002.5,7,499685,534291,33062,45009,34606,11947,22659,0.00961200635429593,0.0033183447932374,0.00629366156105853,DEP
85,Vendée,2006_2011,2008.5,5,597185,641657,29125,38184,44472,9059,35413,0.014469067037731,0.00294736639446854,0.0115217006432624,DEP
85,Vendée,2011_2016,2013.5,5,641657,670597,31809,35834,28940,4025,24915,0.00886192992727186,0.00123252480847509,0.00762940511879677,DEP
85,Vendée,1968_1975,1971.5,7,421250,450641,32662,52834,29391,20172,9219,0.00968149854018185,0.0066447275884641,0.00303677095171775,DEP
85,Vendée,1975_1982,1978.5,7,450641,483027,33957,51008,32386,17051,15335,0.00996381712239303,0.00524587926122162,0.0047179378611714,DEP
85,Vendée,1982_1990,1986,8,483027,509356,39555,52521,26329,12966,13363,0.00665638465419227,0.00327800840997596,0.00337837624421631,DEP
85,Vendée,1990_1999,1994.5,9,509356,539664,45388,52762,30308,7374,22934,0.00644283757993747,0.00156755590320902,0.00487528167672845,DEP
85,Vendée,1999_2006,2002.5,7,539664,597185,38352,47544,57521,9192,48329,0.0145737803799071,0.0023289266398725,0.0122448537400346,DEP
86,Vienne,2006_2011,2008.5,5,418460,428447,19633,24471,9987,4838,5149,0.00472829069367231,0.00229052471973432,0.00243776597393799,DEP
86,Vienne,2011_2016,2013.5,5,428447,436069,20588,23620,7622,3032,4590,0.00353291500472341,0.00140537894178974,0.00212753606293367,DEP
86,Vienne,1968_1975,1971.5,7,340256,357366,26964,38372,17110,11408,5702,0.00703350417686077,0.00468955088542535,0.00234395329143542,DEP
86,Vienne,1975_1982,1978.5,7,357366,371428,26549,33731,14062,7182,6880,0.00552873733962711,0.00282373713363689,0.00270500020599022,DEP
86,Vienne,1982_1990,1986,8,371428,380005,30019,35813,8577,5794,2783,0.00285774735175814,0.00193048713490576,0.000927260216852386,DEP
86,Vienne,1990_1999,1994.5,9,380005,399024,33721,37411,19019,3690,15329,0.00544109985394869,0.00105566320316897,0.00438543665077972,DEP
86,Vienne,1999_2006,2002.5,7,399024,418460,27505,32171,19436,4666,14770,0.00681738190497239,0.00163664869153124,0.00518073321344115,DEP
87,Haute-Vienne,2006_2011,2008.5,5,367156,376058,19781,19307,8902,-474,9376,0.00480280888119533,-0.000255732578037136,0.00505854145923247,DEP
87,Haute-Vienne,2011_2016,2013.5,5,376058,374978,20184,18818,-1080,-1366,286,-0.000575040446857189,-0.000727319676302704,0.000152279229445515,DEP
87,Haute-Vienne,1968_1975,1971.5,7,341589,352149,30692,30899,10560,207,10353,0.00435891849666681,8.54447091676164e-05,0.00427347378749919,DEP
87,Haute-Vienne,1975_1982,1978.5,7,352149,355737,31430,26947,3588,-4483,8071,0.00144923660101171,-0.00181073792707232,0.00325997452808402,DEP
87,Haute-Vienne,1982_1990,1986,8,355737,353593,35032,28449,-2144,-6583,4439,-0.000755359522129573,-0.00231927786109094,0.00156391833896137,DEP
87,Haute-Vienne,1990_1999,1994.5,9,353593,353893,37570,29377,300,-8193,8493,9.42348142205507e-05,-0.00257355277636324,0.00266778759058379,DEP
87,Haute-Vienne,1999_2006,2002.5,7,353893,367156,28235,25205,13263,-3030,16293,0.00526986835008403,-0.00120392830436211,0.00647379665444613,DEP
88,Vosges,2006_2011,2008.5,5,379975,378830,19210,21214,-1145,2004,-3149,-0.000603398969752811,0.00105607994356736,-0.00165947891332018,DEP
88,Vosges,2011_2016,2013.5,5,378830,369641,20432,18564,-9189,-1868,-7321,-0.00489901872850984,-0.000995904558151745,-0.0039031141703581,DEP
88,Vosges,1968_1975,1971.5,7,388201,397957,30859,47356,9756,16497,-6741,0.00355210991731547,0.0060064736885971,-0.00245436377128163,DEP
88,Vosges,1975_1982,1978.5,7,397957,395769,31070,41038,-2188,9968,-12156,-0.000787297280249844,0.00358673642117479,-0.00437403370142463,DEP
88,Vosges,1982_1990,1986,8,395769,386258,33759,42869,-9511,9110,-18621,-0.00303602788594626,0.00290802376626752,-0.00594405165221378,DEP
88,Vosges,1990_1999,1994.5,9,386258,380952,35787,42158,-5306,6371,-11677,-0.00153572590133111,0.00184397092298916,-0.00337969682432027,DEP
88,Vosges,1999_2006,2002.5,7,380952,379975,27787,30758,-977,2971,-3948,-0.000366778699601777,0.00111535262693642,-0.0014821313265382,DEP
89,Yonne,2006_2011,2008.5,5,340088,342463,19667,19724,2375,57,2318,0.00139281206682362,3.3427489603767e-05,0.00135938457721986,DEP
89,Yonne,2011_2016,2013.5,5,342463,340544,19905,18501,-1919,-1404,-515,-0.00112322544867471,-0.00082178662320964,-0.000301438825465074,DEP
89,Yonne,1968_1975,1971.5,7,283376,299851,29272,31164,16475,1892,14583,0.0081056812861442,0.000930861850888305,0.00717481943525589,DEP
89,Yonne,1975_1982,1978.5,7,299851,311019,29015,28513,11168,-502,11670,0.00523771468277912,-0.000235434524601998,0.00547314920738111,DEP
89,Yonne,1982_1990,1986,8,311019,323096,32712,32450,12077,-262,12339,0.00477329217694944,-0.000103552417848866,0.00487684459479831,DEP
89,Yonne,1990_1999,1994.5,9,323096,333221,36065,34335,10125,-1730,11855,0.00343437743175956,-0.000586812143895708,0.00402118957565527,DEP
89,Yonne,1999_2006,2002.5,7,333221,340088,28009,27080,6867,-929,7796,0.00291831775606233,-0.000394803727301864,0.00331312148336419,DEP
90,Territoire de Belfort,2006_2011,2008.5,5,141201,143348,5879,9210,2147,3331,-1184,0.00302272588641639,0.00468965995698789,-0.0016669340705715,DEP
90,Territoire de Belfort,2011_2016,2013.5,5,143348,144089,6398,8537,741,2139,-1398,0.00103171662339063,0.00297819413958511,-0.00194647751619447,DEP
90,Territoire de Belfort,1968_1975,1971.5,7,118450,128125,8745,15156,9675,6411,3264,0.0112796291278237,0.00747428447942919,0.00380534464839446,DEP
90,Territoire de Belfort,1975_1982,1978.5,7,128125,131999,8924,14128,3874,5204,-1330,0.00426449532094697,0.00572855798921219,-0.00146406266826522,DEP
90,Territoire de Belfort,1982_1990,1986,8,131999,134097,9652,15455,2098,5803,-3705,0.00197307794573121,0.00545746964684375,-0.00348439170111254,DEP
90,Territoire de Belfort,1990_1999,1994.5,9,134097,137408,10373,16168,3311,5795,-2484,0.00271380723550241,0.00474977738741663,-0.00203597015191422,DEP
90,Territoire de Belfort,1999_2006,2002.5,7,137408,141201,8394,12768,3793,4374,-581,0.00389754789454,0.00449456221743157,-0.000597014322891574,DEP
91,Essonne,2006_2011,2008.5,5,1198273,1225191,35222,90896,26918,55674,-28756,0.00445296444723375,0.00920998375196121,-0.00475701930472746,DEP
91,Essonne,2011_2016,2013.5,5,1225191,1287330,37444,93516,62139,56072,6067,0.0099438256706752,0.00897295085222002,0.00097087481845518,DEP
91,Essonne,1968_1975,1971.5,7,673325,923063,39244,103801,249738,64557,185181,0.0460980002884395,0.0119162826827347,0.0341817176057048,DEP
91,Essonne,1975_1982,1978.5,7,923063,988000,43823,103957,64937,60134,4803,0.00975948904855906,0.0090376382408496,0.000721850807709458,DEP
91,Essonne,1982_1990,1986,8,988000,1084824,52076,124574,96824,72498,24326,0.0117548443839941,0.00880156477888545,0.00295327960510866,DEP
91,Essonne,1990_1999,1994.5,9,1084824,1134238,61979,149514,49414,87535,-38121,0.00496152312515164,0.00878914734205181,-0.00382762421690018,DEP
91,Essonne,1999_2006,2002.5,7,1134238,1198273,49329,120322,64035,70993,-6958,0.00787661483923019,0.0087324825061524,-0.00085586766692221,DEP
92,Hauts-de-Seine,2006_2011,2008.5,5,1536100,1581628,47364,125966,45528,78602,-33074,0.00585868727703232,0.0101147543786086,-0.00425606710157632,DEP
92,Hauts-de-Seine,2011_2016,2013.5,5,1581628,1603268,49021,123129,21640,74108,-52468,0.0027215667308822,0.00932023416322633,-0.00659866743234414,DEP
92,Hauts-de-Seine,1968_1975,1971.5,7,1461619,1438930,88158,162753,-22689,74595,-97284,-0.00223249621088883,0.00733981466134482,-0.00957231087223365,DEP
92,Hauts-de-Seine,1975_1982,1978.5,7,1438930,1387039,86126,147548,-51891,61422,-113313,-0.00523319070405082,0.00619438899663158,-0.0114275797006824,DEP
92,Hauts-de-Seine,1982_1990,1986,8,1387039,1391658,93170,172040,4619,78870,-74251,0.000415659223891529,0.00709743299162695,-0.00668177376773543,DEP
92,Hauts-de-Seine,1990_1999,1994.5,9,1391658,1428881,96100,201947,37223,105847,-68624,0.00293716931989296,0.00835210920674611,-0.00541493988685315,DEP
92,Hauts-de-Seine,1999_2006,2002.5,7,1428881,1536100,70173,171214,107219,101041,6178,0.0103900507746071,0.00979137205455259,0.000598678720054492,DEP
93,Seine-Saint-Denis,2006_2011,2008.5,5,1491970,1529928,41606,140547,37958,98941,-60983,0.00503730098128252,0.0131301858999176,-0.00809288491863513,DEP
93,Seine-Saint-Denis,2011_2016,2013.5,5,1529928,1606660,42526,144520,76732,101994,-25262,0.00983541578564617,0.0130734686655007,-0.00323805287985448,DEP
93,Seine-Saint-Denis,1968_1975,1971.5,7,1249606,1322127,72222,159001,72521,86779,-14258,0.00809163341082408,0.00968248997887375,-0.00159085656804967,DEP
93,Seine-Saint-Denis,1975_1982,1978.5,7,1322127,1324301,72713,153562,2174,80849,-78675,0.000234737501565219,0.00872966525485113,-0.00849492775328591,DEP
93,Seine-Saint-Denis,1982_1990,1986,8,1324301,1381197,78508,188629,56896,110121,-53225,0.00527206636916233,0.0102039725224713,-0.00493190615330894,DEP
93,Seine-Saint-Denis,1990_1999,1994.5,9,1381197,1382861,82871,209605,1664,126734,-125070,0.00013378972443201,0.0101897277260615,-0.0100559380016295,DEP
93,Seine-Saint-Denis,1999_2006,2002.5,7,1382861,1491970,60361,178924,109109,118563,-9454,0.0109080425516863,0.0118531949615117,-0.000945152409825426,DEP
94,Val-de-Marne,2006_2011,2008.5,5,1298340,1333702,40156,104428,35362,64272,-28910,0.00538886976510455,0.00979450929084327,-0.00440563952573872,DEP
94,Val-de-Marne,2011_2016,2013.5,5,1333702,1378151,41256,105327,44449,64071,-19622,0.00657838544080036,0.00948241205825822,-0.00290402661745787,DEP
94,Val-de-Marne,1968_1975,1971.5,7,1121319,1215713,70440,140172,94394,69732,24662,0.0116133552740458,0.00857917335815586,0.00303418191588998,DEP
94,Val-de-Marne,1975_1982,1978.5,7,1215713,1193655,70354,128181,-22058,57827,-79885,-0.00261239708702887,0.00684863026346988,-0.00946102735049875,DEP
94,Val-de-Marne,1982_1990,1986,8,1193655,1215538,77351,145834,21883,68483,-46600,0.0022734238988229,0.00711469583069455,-0.00484127193187165,DEP
94,Val-de-Marne,1990_1999,1994.5,9,1215538,1227250,81857,169029,11712,87172,-75460,0.00106602522538424,0.00793438788825092,-0.00686836266286668,DEP
94,Val-de-Marne,1999_2006,2002.5,7,1227250,1298340,59650,137132,71090,77482,-6392,0.00807681885282796,0.00880303950421742,-0.000726220651389456,DEP
95,Val-d'Oise,2006_2011,2008.5,5,1157052,1180365,33442,94634,23313,61192,-37879,0.00399763363739125,0.0104929952189442,-0.00649536158155292,DEP
95,Val-d'Oise,2011_2016,2013.5,5,1180365,1221923,34924,97973,41558,63049,-21491,0.006944428414559,0.0105356193057782,-0.0035911908912192,DEP
95,Val-d'Oise,1968_1975,1971.5,7,693269,840885,42367,93866,147616,51499,96117,0.0279604445190396,0.00975459931366531,0.0182058452053743,DEP
95,Val-d'Oise,1975_1982,1978.5,7,840885,920598,44272,97452,79713,53180,26533,0.0130224271087556,0.00868782599630701,0.00433460111244855,DEP
95,Val-d'Oise,1982_1990,1986,8,920598,1049598,52408,128858,129000,76450,52550,0.0165274739680363,0.00979477042524324,0.0067327035427931,DEP
95,Val-d'Oise,1990_1999,1994.5,9,1049598,1105464,60006,149455,55866,89449,-33583,0.0057786236038242,0.00925235568572066,-0.00347373208189647,DEP
95,Val-d'Oise,1999_2006,2002.5,7,1105464,1157052,46771,121650,51588,74879,-23291,0.00653702147674151,0.00948836223844552,-0.00295134076170401,DEP
971,Guadeloupe,2006_2011,2008.5,5,400736,404635,14026,28868,3899,14842,-10943,0.00193839021428954,0.00737870929994496,-0.00544031908565542,DEP
971,Guadeloupe,2011_2016,2013.5,5,404635,394110,14855,25404,-10525,10549,-21074,-0.00525720587477541,0.00526919380266088,-0.0105263996774363,DEP
971,Guadeloupe,1968_1975,1971.5,7,305312,315848,19202,75711,10536,56509,-45973,0.00485846146890379,0.0260579725841196,-0.0211995111152158,DEP
971,Guadeloupe,1975_1982,1978.5,7,315848,317269,14706,41890,1421,27184,-25763,0.000641478412632068,0.0122716039190641,-0.0116301255064321,DEP
971,Guadeloupe,1982_1990,1986,8,317269,353431,17036,50657,36162,33621,2541,0.0135837167304549,0.0126292279241918,0.000954488806263089,DEP
971,Guadeloupe,1990_1999,1994.5,9,353431,386566,20049,58091,33135,38042,-4907,0.0100068863935667,0.011488817630423,-0.00148193123685625,DEP
971,Guadeloupe,1999_2006,2002.5,7,386566,400736,17955,44943,14170,26988,-12818,0.00515613874785426,0.00982031563352792,-0.00466417688567367,DEP
972,Martinique,2006_2011,2008.5,5,397732,392291,13901,26083,-5441,12182,-17623,-0.00275110880732388,0.00615953087498979,-0.00891063968231367,DEP
972,Martinique,2011_2016,2013.5,5,392291,376480,14838,21400,-15811,6562,-22373,-0.00819404158718862,0.00340075269718118,-0.0115947942843698,DEP
972,Martinique,1968_1975,1971.5,7,320030,324832,16566,60888,4802,44322,-39520,0.00212989131758601,0.0196586928317466,-0.0175288015141606,DEP
972,Martinique,1975_1982,1978.5,7,324832,328566,16967,44559,3734,27592,-23858,0.00163413451417482,0.012075265001369,-0.0104411304871941,DEP
972,Martinique,1982_1990,1986,8,328566,359572,16786,47536,31006,30750,256,0.0113358573994697,0.0112422632727116,9.35941267581845e-05,DEP
972,Martinique,1990_1999,1994.5,9,359572,381427,20361,53254,21855,32893,-11038,0.00657765473092931,0.00989973905579765,-0.00332208432486834,DEP
972,Martinique,1999_2006,2002.5,7,381427,397732,18524,38538,16305,20014,-3709,0.00599776199939495,0.00736211031314876,-0.00136434831375381,DEP
973,Guyane,2006_2011,2008.5,5,205954,237549,3635,31163,31595,27528,4067,0.0289555051171251,0.0252282685508536,0.00372723656627149,DEP
973,Guyane,2011_2016,2013.5,5,237549,269352,3890,32740,31803,28850,2953,0.025447426782077,0.0230845600309066,0.00236286675117044,DEP
973,Guyane,1968_1975,1971.5,7,44392,55125,2909,10846,10733,7937,2796,0.0314183211125187,0.0232336918541006,0.00818462925841819,DEP
973,Guyane,1975_1982,1978.5,7,55125,73022,2984,11640,17897,8656,9241,0.0409828837825261,0.0198216372588448,0.0211612465236813,DEP
973,Guyane,1982_1990,1986,8,73022,114678,3933,20756,41656,16823,24833,0.0580429514309646,0.0234409586115594,0.0346019928194052,DEP
973,Guyane,1990_1999,1994.5,9,114678,157213,5285,37793,42535,32508,10027,0.0356741806927794,0.0272645178314534,0.00840966286132594,DEP
973,Guyane,1999_2006,2002.5,7,157213,205954,4757,37335,48741,32578,16163,0.0393325754122644,0.0262895025087862,0.0130430729034782,DEP
974,La Réunion,2006_2011,2008.5,5,781962,828581,20742,72676,46619,51934,-5315,0.01164901807418,0.0129771145812751,-0.0013280965070951,DEP
974,La Réunion,2011_2016,2013.5,5,828581,852924,21313,70520,24343,49207,-24864,0.00580797065529293,0.011740246150228,-0.00593227549493503,DEP
974,La Réunion,1968_1975,1971.5,7,416525,476675,24668,99867,60150,75199,-15049,0.0194566366220896,0.0243245156665755,-0.0048678790444859,DEP
974,La Réunion,1975_1982,1978.5,7,476675,515814,19713,91392,39139,71679,-32540,0.0113368257079916,0.0207622149243242,-0.00942538921633269,DEP
974,La Réunion,1982_1990,1986,8,515814,597823,25015,104006,82009,78991,3018,0.0186146939695355,0.0179296576149884,0.000685036354547162,DEP
974,La Réunion,1990_1999,1994.5,9,597823,706300,30104,121817,108477,91713,16764,0.0186999560118617,0.0158100709432956,0.00288988506856614,DEP
974,La Réunion,1999_2006,2002.5,7,706300,781962,27476,101156,75662,73680,1982,0.0146442007864502,0.014260589383649,0.000383611402801199,DEP
01,Guadeloupe,2006_2011,2008.5,5,400736,404635,14026,28868,3899,14842,-10943,0.00193839021428954,0.00737870929994496,-0.00544031908565542,REG
01,Guadeloupe,2011_2016,2013.5,5,404635,394110,14855,25404,-10525,10549,-21074,-0.00525720587477541,0.00526919380266088,-0.0105263996774363,REG
01,Guadeloupe,1968_1975,1971.5,7,305312,315848,19202,75711,10536,56509,-45973,0.00485846146890379,0.0260579725841196,-0.0211995111152158,REG
01,Guadeloupe,1975_1982,1978.5,7,315848,317269,14706,41890,1421,27184,-25763,0.000641478412632068,0.0122716039190641,-0.0116301255064321,REG
01,Guadeloupe,1982_1990,1986,8,317269,353431,17036,50657,36162,33621,2541,0.0135837167304549,0.0126292279241918,0.000954488806263089,REG
01,Guadeloupe,1990_1999,1994.5,9,353431,386566,20049,58091,33135,38042,-4907,0.0100068863935667,0.011488817630423,-0.00148193123685625,REG
01,Guadeloupe,1999_2006,2002.5,7,386566,400736,17955,44943,14170,26988,-12818,0.00515613874785426,0.00982031563352792,-0.00466417688567367,REG
02,Martinique,2006_2011,2008.5,5,397732,392291,13901,26083,-5441,12182,-17623,-0.00275110880732388,0.00615953087498979,-0.00891063968231367,REG
02,Martinique,2011_2016,2013.5,5,392291,376480,14838,21400,-15811,6562,-22373,-0.00819404158718862,0.00340075269718118,-0.0115947942843698,REG
02,Martinique,1968_1975,1971.5,7,320030,324832,16566,60888,4802,44322,-39520,0.00212989131758601,0.0196586928317466,-0.0175288015141606,REG
02,Martinique,1975_1982,1978.5,7,324832,328566,16967,44559,3734,27592,-23858,0.00163413451417482,0.012075265001369,-0.0104411304871941,REG
02,Martinique,1982_1990,1986,8,328566,359572,16786,47536,31006,30750,256,0.0113358573994697,0.0112422632727116,9.35941267581845e-05,REG
02,Martinique,1990_1999,1994.5,9,359572,381427,20361,53254,21855,32893,-11038,0.00657765473092931,0.00989973905579765,-0.00332208432486834,REG
02,Martinique,1999_2006,2002.5,7,381427,397732,18524,38538,16305,20014,-3709,0.00599776199939495,0.00736211031314876,-0.00136434831375381,REG
03,Guyane,2006_2011,2008.5,5,205954,237549,3635,31163,31595,27528,4067,0.0289555051171251,0.0252282685508536,0.00372723656627149,REG
03,Guyane,2011_2016,2013.5,5,237549,269352,3890,32740,31803,28850,2953,0.025447426782077,0.0230845600309066,0.00236286675117044,REG
03,Guyane,1968_1975,1971.5,7,44392,55125,2909,10846,10733,7937,2796,0.0314183211125187,0.0232336918541006,0.00818462925841819,REG
03,Guyane,1975_1982,1978.5,7,55125,73022,2984,11640,17897,8656,9241,0.0409828837825261,0.0198216372588448,0.0211612465236813,REG
03,Guyane,1982_1990,1986,8,73022,114678,3933,20756,41656,16823,24833,0.0580429514309646,0.0234409586115594,0.0346019928194052,REG
03,Guyane,1990_1999,1994.5,9,114678,157213,5285,37793,42535,32508,10027,0.0356741806927794,0.0272645178314534,0.00840966286132594,REG
03,Guyane,1999_2006,2002.5,7,157213,205954,4757,37335,48741,32578,16163,0.0393325754122644,0.0262895025087862,0.0130430729034782,REG
04,La Réunion,2006_2011,2008.5,5,781962,828581,20742,72676,46619,51934,-5315,0.01164901807418,0.0129771145812751,-0.0013280965070951,REG
04,La Réunion,2011_2016,2013.5,5,828581,852924,21313,70520,24343,49207,-24864,0.00580797065529293,0.011740246150228,-0.00593227549493503,REG
04,La Réunion,1968_1975,1971.5,7,416525,476675,24668,99867,60150,75199,-15049,0.0194566366220896,0.0243245156665755,-0.0048678790444859,REG
04,La Réunion,1975_1982,1978.5,7,476675,515814,19713,91392,39139,71679,-32540,0.0113368257079916,0.0207622149243242,-0.00942538921633269,REG
04,La Réunion,1982_1990,1986,8,515814,597823,25015,104006,82009,78991,3018,0.0186146939695355,0.0179296576149884,0.000685036354547162,REG
04,La Réunion,1990_1999,1994.5,9,597823,706300,30104,121817,108477,91713,16764,0.0186999560118617,0.0158100709432956,0.00288988506856614,REG
04,La Réunion,1999_2006,2002.5,7,706300,781962,27476,101156,75662,73680,1982,0.0146442007864502,0.014260589383649,0.000383611402801199,REG
11,Île-de-France,2006_2011,2008.5,5,11532398,11852851,350258,908834,320453,558576,-238123,0.00549667911393903,0.00958116489078775,-0.00408448577684872,REG
11,Île-de-France,2011_2016,2013.5,5,11852851,12117132,360560,906266,264281,545706,-281425,0.00442011795342001,0.00912697048932394,-0.00470685253590393,REG
11,Île-de-France,1968_1975,1971.5,7,9248631,9878565,605208,1128246,629934,523038,106896,0.0094575451198402,0.00785265676148768,0.00160488835835252,REG
11,Île-de-France,1975_1982,1978.5,7,9878565,10073059,595209,1068281,194494,473072,-278578,0.00278919342349449,0.00678421602331888,-0.0039950225998244,REG
11,Île-de-France,1982_1990,1986,8,10073059,10660554,653290,1289663,587495,636373,-48878,0.00711090743136089,0.00770251575727015,-0.000591608325909254,REG
11,Île-de-France,1990_1999,1994.5,9,10660554,10952011,695165,1480879,291457,785714,-494257,0.00300146261820178,0.00809138637808593,-0.00508992375988415,REG
11,Île-de-France,1999_2006,2002.5,7,10952011,11532398,512130,1213304,580387,701174,-120787,0.00740401797495105,0.00894490210767699,-0.00154088413272594,REG
24,Centre-Val de Loire,2006_2011,2008.5,5,2519567,2556835,121063,151685,37268,30622,6646,0.00294093691871411,0.00241647983054802,0.000524457088166094,REG
24,Centre-Val de Loire,2011_2016,2013.5,5,2556835,2577866,125374,145731,21031,20357,674,0.00163969471288383,0.00158714589273816,5.25488201456755e-05,REG
24,Centre-Val de Loire,1968_1975,1971.5,7,1990238,2152500,166251,236272,162262,70021,92241,0.0112594482989008,0.00485879521599224,0.00640065308290856,REG
24,Centre-Val de Loire,1975_1982,1978.5,7,2152500,2264164,168232,209231,111664,40999,70665,0.00725125516881864,0.00266239979461953,0.00458885537419911,REG
24,Centre-Val de Loire,1982_1990,1986,8,2264164,2371036,190272,239390,106872,49118,57754,0.00578182491932422,0.00265730665082872,0.0031245182684955,REG
24,Centre-Val de Loire,1990_1999,1994.5,9,2371036,2440329,213204,255992,69293,42788,26505,0.0032057804302581,0.00197954963776837,0.00122623079248973,REG
24,Centre-Val de Loire,1999_2006,2002.5,7,2440329,2519567,170929,207070,79238,36141,43097,0.00457531997134653,0.00208683509281449,0.00248848487853203,REG
27,Bourgogne-Franche-Comté,2006_2011,2008.5,5,2779461,2816174,135384,162132,36713,26748,9965,0.00262788728793462,0.00191460052781508,0.000713286760119534,REG
27,Bourgogne-Franche-Comté,2011_2016,2013.5,5,2816174,2818338,141586,152723,2164,11137,-8973,0.000153636470154872,0.000790688247742518,-0.000637051777587646,REG
27,Bourgogne-Franche-Comté,1968_1975,1971.5,7,2495379,2631260,206253,298808,135881,92555,43326,0.0076033594832341,0.00517900911069783,0.00242435037253627,REG
27,Bourgogne-Franche-Comté,1975_1982,1978.5,7,2631260,2680103,203394,264276,48843,60882,-12039,0.00263094168350264,0.00327942574319775,-0.000648484059695111,REG
27,Bourgogne-Franche-Comté,1982_1990,1986,8,2680103,2706929,224790,284070,26826,59280,-32454,0.00124571968638398,0.00275278696074117,-0.00150706727435718,REG
27,Bourgogne-Franche-Comté,1990_1999,1994.5,9,2706929,2727126,245766,287482,20197,41716,-21519,0.000826288457854485,0.00170666184620774,-0.000880373388353254,REG
27,Bourgogne-Franche-Comté,1999_2006,2002.5,7,2727126,2779461,191805,224497,52335,32692,19643,0.0027192213361158,0.00169861056501954,0.00102061077109626,REG
28,Normandie,2006_2011,2008.5,5,3267848,3315077,149700,202728,47229,53028,-5799,0.00287395929190804,0.00322683760679454,-0.000352878314886504,REG
28,Normandie,2011_2016,2013.5,5,3315077,3335929,158212,192712,20852,34500,-13648,0.0012548567097781,0.00207618245191561,-0.000821325742137515,REG
28,Normandie,1968_1975,1971.5,7,2757520,2901847,199212,356467,144327,157255,-12928,0.00731457976289351,0.00796977863195258,-0.000655198869059064,REG
28,Normandie,1975_1982,1978.5,7,2901847,3006341,200117,318823,104494,118706,-14212,0.00506654803344264,0.00575563813097252,-0.000689090097529876,REG
28,Normandie,1982_1990,1986,8,3006341,3128565,230307,366168,122224,135861,-13637,0.00499376602922452,0.00555093963948548,-0.000557173610260953,REG
28,Normandie,1990_1999,1994.5,9,3128565,3202385,256604,371240,73820,114636,-40816,0.00259462820639178,0.00402923054819735,-0.00143460234180557,REG
28,Normandie,1999_2006,2002.5,7,3202385,3267848,205145,283936,65463,78791,-13328,0.00289501385230362,0.00348442687375853,-0.000589413021454908,REG
32,Hauts-de-France,2006_2011,2008.5,5,5912930,5960124,263157,407228,47194,144071,-96877,0.00159122621577601,0.00485759952818293,-0.00326637331240693,REG
32,Hauts-de-France,2011_2016,2013.5,5,5960124,6006870,269638,395034,46746,125396,-78650,0.00156372694501727,0.00419469267953164,-0.00263096573451437,REG
32,Hauts-de-France,1968_1975,1971.5,7,5394378,5592362,424808,723570,197984,298762,-100778,0.00516248537737796,0.00779029849036383,-0.00262781311298588,REG
32,Hauts-de-France,1975_1982,1978.5,7,5592362,5673217,421931,649346,80855,227415,-146560,0.00205275986213871,0.00577364892768876,-0.00372088906555005,REG
32,Hauts-de-France,1982_1990,1986,8,5673217,5775686,453242,730243,102469,277001,-174532,0.00224009380107471,0.00605557020163654,-0.00381547640056183,REG
32,Hauts-de-France,1990_1999,1994.5,9,5775686,5854014,477712,727955,78328,250243,-171915,0.00149784760615979,0.00478533702517929,-0.0032874894190195,REG
32,Hauts-de-France,1999_2006,2002.5,7,5854014,5912930,369979,567651,58916,197672,-138756,0.00143158068503224,0.00480316751258899,-0.00337158682755675,REG
44,Grand Est,2006_2011,2008.5,5,5490161,5539081,236263,327273,48920,91010,-42090,0.00177577910832949,0.00330363157500137,-0.00152785246667188,REG
44,Grand Est,2011_2016,2013.5,5,5539081,5555186,248704,311496,16105,62792,-46687,0.00058082928745562,0.00226460308090117,-0.00168377379344555,REG
44,Grand Est,1968_1975,1971.5,7,4966173,5185039,371300,622947.2028537,218866,251647.2028537,-32781.2028536997,0.0061801387358531,0.00710578448057365,-0.000925645744720549,REG
44,Grand Est,1975_1982,1978.5,7,5185039,5231931,367104,539773.453624527,46892,172669.453624527,-125777.453624527,0.00128697925424248,0.00473901741568178,-0.0034520381614393,REG
44,Grand Est,1982_1990,1986,8,5231931,5278005,399529,602300.653755289,46074,202771.653755289,-156697.653755289,0.00109657072133906,0.00482600726278491,-0.00372943654144584,REG
44,Grand Est,1990_1999,1994.5,9,5278005,5386939,428852,609183,108934,180331,-71397,0.00227248203416131,0.00376190131366095,-0.00148941927949965,REG
44,Grand Est,1999_2006,2002.5,7,5386939,5490161,332806,462011,103222,129205,-25983,0.00271514521418426,0.0033986004669419,-0.000683455252757644,REG
52,Pays de la Loire,2006_2011,2008.5,5,3450413,3601113,147135,228061,150700,80926,69774,0.00858646004348329,0.00461093474106788,0.00397552530241542,REG
52,Pays de la Loire,2011_2016,2013.5,5,3601113,3737632,158369,219846,136519,61477,75042,0.00746961773979882,0.00336370534350246,0.00410591239629636,REG
52,Pays de la Loire,1968_1975,1971.5,7,2582866,2767163,192894,344665,184297,151771,32526,0.00989477164235186,0.00814847440235807,0.0017462972399938,REG
52,Pays de la Loire,1975_1982,1978.5,7,2767163,2930398,194485,319724,163235,125239,37996,0.00822156183799239,0.00630783951375825,0.00191372232423413,REG
52,Pays de la Loire,1982_1990,1986,8,2930398,3059112,219032,336762,128714,117730,10984,0.00538776556022658,0.00492799259913821,0.000459772961088372,REG
52,Pays de la Loire,1990_1999,1994.5,9,3059112,3222061,247344,351376,162949,104032,58917,0.00578293913293759,0.00369201850810845,0.00209092062482914,REG
52,Pays de la Loire,1999_2006,2002.5,7,3222061,3450413,202576,302994,228352,100418,127934,0.00982981507496428,0.00432267013294284,0.00550714494202144,REG
53,Bretagne,2006_2011,2008.5,5,3094534,3217767,152813,186820,123233,34007,89226,0.00784064036126542,0.00216367902076191,0.0056769613405035,REG
53,Bretagne,2011_2016,2013.5,5,3217767,3306529,162276,177433,88762,15157,73605,0.00545710765565977,0.000931855757383059,0.00452525189827671,REG
53,Bretagne,1968_1975,1971.5,7,2468227,2595431,210421,299094,127204,88673,38531,0.00720476062832365,0.00502238718275638,0.00218237344556727,REG
53,Bretagne,1975_1982,1978.5,7,2595431,2707886,214000,265998,112455,51998,60457,0.00607777592840275,0.00281029916611166,0.0032674767622911,REG
53,Bretagne,1982_1990,1986,8,2707886,2795638,239954,288731,87752,48777,38975,0.00399446778521484,0.00222032723082578,0.00177414055438906,REG
53,Bretagne,1990_1999,1994.5,9,2795638,2906197,263447,300697,110559,37250,73309,0.00431874438063984,0.00145508939280234,0.0028636549878375,REG
53,Bretagne,1999_2006,2002.5,7,2906197,3094534,210066,252784,188337,42718,145619,0.00901063580165928,0.00204376378606053,0.00696687201559876,REG
75,Nouvelle-Aquitaine,2006_2011,2008.5,5,5574821,5773078,285517,301054,198257,15537,182720,0.00701351589782151,0.000549635052000448,0.00646388084582106,REG
75,Nouvelle-Aquitaine,2011_2016,2013.5,5,5773078,5935603,302396,293672,162525,-8724,171249,0.00556809180155571,-0.00029888345101844,0.00586697525257415,REG
75,Nouvelle-Aquitaine,1968_1975,1971.5,7,4676995,4817190,404120,482521,140195,78401,61794,0.00422819381233541,0.00236452529035207,0.00186366852198334,REG
75,Nouvelle-Aquitaine,1975_1982,1978.5,7,4817190,4961927,404864,418150,144737,13286,131451,0.00423801263246881,0.000389024477742254,0.00384898815472656,REG
75,Nouvelle-Aquitaine,1982_1990,1986,8,4961927,5113789,456493,459389,151862,2896,148966,0.00377541441193063,7.19969454962473e-05,0.00370341746643439,REG
75,Nouvelle-Aquitaine,1990_1999,1994.5,9,5113789,5259366,507176,484926,145577,-22250,167827,0.00312374324230191,-0.00047743316005425,0.00360117640235616,REG
75,Nouvelle-Aquitaine,1999_2006,2002.5,7,5259366,5574821,399551,402354,315455,2803,312652,0.00835610785601215,7.42488479193611e-05,0.00828185900809279,REG
76,Occitanie,2006_2011,2008.5,5,5310966,5573466,254799,309286,262500,54487,208013,0.00969537513628471,0.00201246440019331,0.0076829107360914,REG
76,Occitanie,2011_2016,2013.5,5,5573466,5808435,272115,312335,234969,40220,194749,0.00829300782553011,0.00141952672370747,0.00687348110182264,REG
76,Occitanie,1968_1975,1971.5,7,3892344,4057772,333110,375478,165428,42368,123060,0.0059637855023158,0.00152739357401477,0.00443639192830103,REG
76,Occitanie,1975_1982,1978.5,7,4057772,4251833,337415,332895,194061,-4520,198581,0.00669605177183397,-0.000155962063519664,0.00685201383535363,REG
76,Occitanie,1982_1990,1986,8,4251833,4545648,387496,401593,293815,14097,279718,0.00838749301812203,0.000402424958141913,0.00798506805998011,REG
76,Occitanie,1990_1999,1994.5,9,4545648,4847335,439602,467239,301687,27637,274050,0.00716541378623692,0.000656410587165605,0.00650900319907131,REG
76,Occitanie,1999_2006,2002.5,7,4847335,5310966,354553,394722,463631,40169,423462,0.0131347514714779,0.00113799515532351,0.0119967563161544,REG
84,Auvergne-Rhône-Alpes,2006_2011,2008.5,5,7357284,7634223,302561,475186,276939,172625,104314,0.0074174384011847,0.00462352830047234,0.00279391010071236,REG
84,Auvergne-Rhône-Alpes,2011_2016,2013.5,5,7634223,7916889,320264,478067,282666,157803,124863,0.00729793311866622,0.00407419265113203,0.00322374046753419,REG
84,Auvergne-Rhône-Alpes,1968_1975,1971.5,7,5734998,6111163,447443,677757,376165,230314,145851,0.00911697976478765,0.00558204000251832,0.00353493976226933,REG
84,Auvergne-Rhône-Alpes,1975_1982,1978.5,7,6111163,6348625,440360,610805,237462,170445,67017,0.00546073507825473,0.00391959551596941,0.00154113956228532,REG
84,Auvergne-Rhône-Alpes,1982_1990,1986,8,6348625,6671915,488822,699414,323290,210592,112698,0.00622789709835736,0.00405686939199255,0.00217102770636481,REG
84,Auvergne-Rhône-Alpes,1990_1999,1994.5,9,6671915,6954285,540916,767568,282370,226652,55718,0.00461629922931706,0.00370539877792672,0.000910900451390331,REG
84,Auvergne-Rhône-Alpes,1999_2006,2002.5,7,6954285,7357284,424506,628769,402999,204263,198736,0.00808001519160007,0.004095414983863,0.00398460020773707,REG
93,Provence-Alpes-Côte d'Azur,2006_2011,2008.5,5,4815232,4916069,225899,292368,100837,66469,34368,0.00415360250553842,0.00273794147922522,0.0014156610263132,REG
93,Provence-Alpes-Côte d'Azur,2011_2016,2013.5,5,4916069,5021928,236652,297269,105859,60617,45242,0.00427002997042325,0.00244510534500747,0.00182492462541578,REG
93,Provence-Alpes-Côte d'Azur,1968_1975,1971.5,7,3298836,3675730,268203,337180,376894,68977,307917,0.0155746215581676,0.00285037881000421,0.0127242427481634,REG
93,Provence-Alpes-Côte d'Azur,1975_1982,1978.5,7,3675730,3965209,291421,327045,289479,35624,253855,0.0108883964193662,0.00133995292937831,0.00954844348998792,REG
93,Provence-Alpes-Côte d'Azur,1982_1990,1986,8,3965209,4257907,347344,419178,292698,71834,220864,0.00894213917932518,0.00219458153389379,0.00674755764543139,REG
93,Provence-Alpes-Côte d'Azur,1990_1999,1994.5,9,4257907,4506151,402876,476515,248244,73639,174605,0.00631604342520808,0.00187358857329441,0.00444245485191367,REG
93,Provence-Alpes-Côte d'Azur,1999_2006,2002.5,7,4506151,4815232,317168,385766,309081,68598,240483,0.00952231930144998,0.00211340088663122,0.00740891841481875,REG
94,Corse,2006_2011,2008.5,5,294118,314486,14113,14599,20368,486,19882,0.0134817730023602,0.000321688024310048,0.0131600849780502,REG
94,Corse,2011_2016,2013.5,5,314486,330455,15083,14863,15969,-220,16189,0.00995541521522392,-0.000137152692551147,0.0100925679077751,REG
94,Corse,1968_1975,1971.5,7,205268,225562,17302,19415,20294,2113,18181,0.0135594818790663,0.00141180571649094,0.0121476761625754,REG
94,Corse,1975_1982,1978.5,7,225562,240178,18365,18252,14616,-113,14729,0.00900966623596133,-6.96560129080207e-05,0.00907932224886935,REG
94,Corse,1982_1990,1986,8,240178,250371,21868,23440,10193,1572,8621,0.00520895752967121,0.000803343592332301,0.00440561393733891,REG
94,Corse,1990_1999,1994.5,9,250371,260196,24618,25411,9825,793,9032,0.00428597812748732,0.000345931873292361,0.00394004625419496,REG
94,Corse,1999_2006,2002.5,7,260196,294118,19108,19291,33922,183,33739,0.0176606884154662,9.52746294449123e-05,0.0175654137860213,REG
