TERR,LIB_TERR,periode,periode_milieu,periode_nb_annees,POPULATION_debut,POPULATION_fin,DECES,NAISSANCES,EVOL_DEMO_TOT,EVOL_DEMO_SN,EVOL_DEMO_SMA,TX_EVOL_DEMO_AN_TOT,TX_EVOL_DEMO_AN_SN,TX_EVOL_DEMO_AN_SMA,NIV_TERR
200000172,CC Faucigny-Glières,2010_2015,2012.5,5,24735,26234,756,1804,1499,1048,451,0.011836915252353,0.00827557517309267,0.0035613400792603,EPCI
200000172,CC Faucigny-Glières,1968_1975,1971.5,7,11364,14354,923,1528,2990,605,2385,0.033931278568673,0.00686569348964787,0.0270655850790251,EPCI
200000172,CC Faucigny-Glières,1975_1982,1978.5,7,14354,16155,879,1740,1801,861,940,0.0170292218522823,0.00814112160733762,0.00888810024494467,EPCI
200000172,CC Faucigny-Glières,1982_1990,1986,8,16155,18924,1059,2130,2769,1071,1698,0.0199719937501752,0.00772481231724004,0.0122471814329352,EPCI
200000172,CC Faucigny-Glières,1990_1999,1994.5,9,18924,21157,1136,2547,2233,1411,822,0.0124704334342953,0.0078798842703944,0.00459054916390092,EPCI
200000172,CC Faucigny-Glières,1999_2010,2004.5,11,21157,24735,1454,3679,3578,2225,1353,0.0143057641247293,0.00889612218488615,0.00540964193984313,EPCI
200000438,CC du Pays de Pontchâteau Saint-Gildas-des-Bois,2010_2015,2012.5,5,31849,34808,1611,2461,2959,850,2109,0.0179270467128374,0.005149709261883,0.0127773374509544,EPCI
200000438,CC du Pays de Pontchâteau Saint-Gildas-des-Bois,1968_1975,1971.5,7,20591,21486,2040,2671,895,631,264,0.00609672024974572,0.00429835807551905,0.00179836217422667,EPCI
200000438,CC du Pays de Pontchâteau Saint-Gildas-des-Bois,1975_1982,1978.5,7,21486,24644,1914,2618,3158,704,2454,0.0197834204355125,0.00441023685452844,0.0153731835809841,EPCI
200000438,CC du Pays de Pontchâteau Saint-Gildas-des-Bois,1982_1990,1986,8,24644,25736,2143,2696,1092,553,539,0.00543437880476327,0.00275202516395063,0.00268235364081264,EPCI
200000438,CC du Pays de Pontchâteau Saint-Gildas-des-Bois,1990_1999,1994.5,9,25736,25304,2330,2316,-432,-14,-418,-0.00187915483279444,-6.08985362479679e-05,-0.00181825629654647,EPCI
200000438,CC du Pays de Pontchâteau Saint-Gildas-des-Bois,1999_2010,2004.5,11,25304,31849,3149,4401,6545,1252,5293,0.0211332554454995,0.00404260287513604,0.0170906525703635,EPCI
200000545,CC des Portes de Romilly-sur-Seine,2010_2015,2012.5,5,17659,18671,1201,1152,1012,-49,1061,0.0112075289176146,-0.000542657032572247,0.0117501859501868,EPCI
200000545,CC des Portes de Romilly-sur-Seine,1968_1975,1971.5,7,20192,21090,1548,2430,898,882,16,0.00623543246282887,0.00612433344344662,0.000111099019382252,EPCI
200000545,CC des Portes de Romilly-sur-Seine,1975_1982,1978.5,7,21090,20003,1546,1993,-1087,447,-1534,-0.00753103176282721,0.00309693762464008,-0.0106279693874673,EPCI
200000545,CC des Portes de Romilly-sur-Seine,1982_1990,1986,8,20003,19633,1755,2221,-370,466,-836,-0.00233108359347622,0.00293590528259438,-0.0052669888760706,EPCI
200000545,CC des Portes de Romilly-sur-Seine,1990_1999,1994.5,9,19633,18670,2024,2113,-963,89,-1052,-0.00557262238706546,0.000515019099116123,-0.00608764148618159,EPCI
200000545,CC des Portes de Romilly-sur-Seine,1999_2010,2004.5,11,18670,17659,2517,2347,-1011,-170,-841,-0.00504834036372603,-0.000848880179855021,-0.00419946018387101,EPCI
200000628,CC Rhône Lez Provence,2010_2015,2012.5,5,24078,24103,970,1701,25,731,-706,0.000207572253023036,0.00606941267839358,-0.00586184042537054,EPCI
200000628,CC Rhône Lez Provence,1968_1975,1971.5,7,17992,17667,1270,2010,-325,740,-1065,-0.00260071541134832,0.00592162893660848,-0.0085223443479568,EPCI
200000628,CC Rhône Lez Provence,1975_1982,1978.5,7,17667,20834,1275,2080,3167,805,2362,0.0238350159690479,0.00605847422010848,0.0177765417489394,EPCI
200000628,CC Rhône Lez Provence,1982_1990,1986,8,20834,22802,1419,2620,1968,1201,767,0.0113466382419722,0.00692444742307351,0.00442219081889873,EPCI
200000628,CC Rhône Lez Provence,1990_1999,1994.5,9,22802,23385,1588,2850,583,1262,-679,0.0028091092591116,0.00608078196397742,-0.00327167270486582,EPCI
200000628,CC Rhône Lez Provence,1999_2010,2004.5,11,23385,24078,2085,3390,693,1305,-612,0.00265841545770118,0.00500610703073599,-0.00234769157303481,EPCI
200000800,CC Coeur de Sologne,2010_2015,2012.5,5,10642,10655,595,516,13,-79,92,0.000244195686194049,-0.00148395840071768,0.00172815408691173,EPCI
200000800,CC Coeur de Sologne,1968_1975,1971.5,7,8767,9309,853,830,542,-23,565,0.00860639553911535,-0.000365216046862829,0.00897161158597818,EPCI
200000800,CC Coeur de Sologne,1975_1982,1978.5,7,9309,9420,855,736,111,-119,230,0.00169477944009788,-0.00181692570605088,0.00351170514614876,EPCI
200000800,CC Coeur de Sologne,1982_1990,1986,8,9420,9242,961,884,-178,-77,-101,-0.00238175612463354,-0.00103031023368979,-0.00135144589094375,EPCI
200000800,CC Coeur de Sologne,1990_1999,1994.5,9,9242,9487,1080,964,245,-116,361,0.00291135511587171,-0.00137843752424946,0.00428979264012117,EPCI
200000800,CC Coeur de Sologne,1999_2010,2004.5,11,9487,10642,1277,1241,1155,-36,1191,0.0104989122695873,-0.000327238823987137,0.0108261510935745,EPCI
200000925,CC de la Plaine Dijonnaise,2010_2015,2012.5,5,21714,22037,627,1226,323,599,-276,0.00295749379260091,0.00548464019123202,-0.00252714639863112,EPCI
200000925,CC de la Plaine Dijonnaise,1968_1975,1971.5,7,9869,11480,679,1262,1611,583,1028,0.0218361160570209,0.00790220711436571,0.0139339089426551,EPCI
200000925,CC de la Plaine Dijonnaise,1975_1982,1978.5,7,11480,14688,702,1353,3208,651,2557,0.0358304704189043,0.00727108361680383,0.0285593868021005,EPCI
200000925,CC de la Plaine Dijonnaise,1982_1990,1986,8,14688,17681,871,1867,2993,996,1997,0.0234532749478298,0.00780469824525174,0.015648576702578,EPCI
200000925,CC de la Plaine Dijonnaise,1990_1999,1994.5,9,17681,18710,1017,2031,1029,1014,15,0.00630507422191973,0.00621316351897629,9.19107029434358e-05,EPCI
200000925,CC de la Plaine Dijonnaise,1999_2010,2004.5,11,18710,21714,1347,2814,3004,1467,1537,0.0136283096214389,0.00665536957877859,0.00697294004266032,EPCI
200000933,CC Sauldre et Sologne,2010_2015,2012.5,5,14642,14040,967,659,-602,-308,-294,-0.00836158834518197,-0.00427802194404659,-0.00408356640113538,EPCI
200000933,CC Sauldre et Sologne,1968_1975,1971.5,7,15389,15151,1541,1325,-238,-216,-22,-0.00222415604898563,-0.0020185617923567,-0.000205594256628923,EPCI
200000933,CC Sauldre et Sologne,1975_1982,1978.5,7,15151,15549,1528,1180,398,-348,746,0.00371112516345695,-0.00324490340925382,0.00695602857271077,EPCI
200000933,CC Sauldre et Sologne,1982_1990,1986,8,15549,14867,1678,1376,-682,-302,-380,-0.00559085470469745,-0.00247571571967541,-0.00311513898502204,EPCI
200000933,CC Sauldre et Sologne,1990_1999,1994.5,9,14867,14945,1744,1345,78,-399,477,0.000581591737227383,-0.00297506542504777,0.00355665716227515,EPCI
200000933,CC Sauldre et Sologne,1999_2010,2004.5,11,14945,14642,2171,1670,-303,-501,198,-0.00186032966598904,-0.00307599063584326,0.00121566096985422,EPCI
200004802,CC du Pays de Fayence,2010_2015,2012.5,5,25837,27519,1393,1306,1682,-87,1769,0.0126937102030136,-0.000656571217397254,0.0133502814204108,EPCI
200004802,CC du Pays de Fayence,1968_1975,1971.5,7,7399,8896,836,549,1497,-287,1784,0.0266719061037051,-0.00511345160438434,0.0317853577080894,EPCI
200004802,CC du Pays de Fayence,1975_1982,1978.5,7,8896,11340,993,621,2444,-372,2816,0.0352846011010517,-0.00537065123142031,0.040655252332472,EPCI
200004802,CC du Pays de Fayence,1982_1990,1986,8,11340,14935,1325,1083,3595,-242,3837,0.0350206665209347,-0.00235744125120061,0.0373781077721353,EPCI
200004802,CC du Pays de Fayence,1990_1999,1994.5,9,14935,19799,1796,1689,4864,-107,4971,0.0318206741831828,-0.000700002495394852,0.0325206766785777,EPCI
200004802,CC du Pays de Fayence,1999_2010,2004.5,11,19799,25837,2564,2537,6038,-27,6065,0.0244929743815605,-0.000109524728105686,0.0246024991096662,EPCI
200005932,CC des Portes de Sologne,2010_2015,2012.5,5,14986,15338,627,792,352,165,187,0.00465419274642587,0.00218165284988713,0.00247253989653874,EPCI
200005932,CC des Portes de Sologne,1968_1975,1971.5,7,8155,8472,787,706,317,-81,398,0.00546277716692689,-0.00139585157893085,0.00685862874585774,EPCI
200005932,CC des Portes de Sologne,1975_1982,1978.5,7,8472,11061,810,867,2589,57,2532,0.0388289968707105,0.000854867833769988,0.0379741290369405,EPCI
200005932,CC des Portes de Sologne,1982_1990,1986,8,11061,12812,911,1157,1751,246,1505,0.0185393620106509,0.00260461625049692,0.0159347457601539,EPCI
200005932,CC des Portes de Sologne,1990_1999,1994.5,9,12812,13887,958,1340,1075,382,693,0.00899251623294584,0.00319548018696308,0.00579703604598276,EPCI
200005932,CC des Portes de Sologne,1999_2010,2004.5,11,13887,14986,1217,1846,1099,629,470,0.00694796051151236,0.00397658522451436,0.00297137528699801,EPCI
200005957,CC de la Région de Rambervillers,2010_2015,2012.5,5,13536,13452,746,786,-84,40,-124,-0.00124422710396288,0.000592489097125181,-0.00183671620108806,EPCI
200005957,CC de la Région de Rambervillers,1968_1975,1971.5,7,14254,13621,1148,1599,-633,451,-1084,-0.00646825442613463,0.00460850354847823,-0.0110767579746129,EPCI
200005957,CC de la Région de Rambervillers,1975_1982,1978.5,7,13621,13258,1155,1286,-363,131,-494,-0.00385136093277827,0.00138988507491447,-0.00524124600769274,EPCI
200005957,CC de la Région de Rambervillers,1982_1990,1986,8,13258,12868,1242,1549,-390,307,-697,-0.00372523583383066,0.00293242923329747,-0.00665766506712814,EPCI
200005957,CC de la Région de Rambervillers,1990_1999,1994.5,9,12868,13260,1285,1633,392,348,44,0.00333982877236072,0.00296495003260595,0.000374878739754775,EPCI
200005957,CC de la Région de Rambervillers,1999_2010,2004.5,11,13260,13536,1581,1862,276,281,-5,0.00187455643430212,0.001908515789996,-3.39593556938789e-05,EPCI
200006682,"CA Beaune, Côte et Sud - Communauté Beaune-Chagny-Nolay",2010_2015,2012.5,5,52951,52364,2626,2860,-587,234,-821,-0.00222704151355713,0.000887781455148838,-0.00311482296870596,EPCI
200006682,"CA Beaune, Côte et Sud - Communauté Beaune-Chagny-Nolay",1968_1975,1971.5,7,42415,44658,3687,5111,2243,1424,819,0.00738879044052854,0.00469087721235517,0.00269791322817337,EPCI
200006682,"CA Beaune, Côte et Sud - Communauté Beaune-Chagny-Nolay",1975_1982,1978.5,7,44658,47277,3454,4568,2619,1114,1505,0.00817472590042168,0.00347714572473072,0.00469758017569096,EPCI
200006682,"CA Beaune, Côte et Sud - Communauté Beaune-Chagny-Nolay",1982_1990,1986,8,47277,49492,3922,5453,2215,1531,684,0.00573980001954833,0.0039673290428571,0.00177247097669122,EPCI
200006682,"CA Beaune, Côte et Sud - Communauté Beaune-Chagny-Nolay",1990_1999,1994.5,9,49492,51116,4446,5742,1624,1296,328,0.00359383343259512,0.00286798530088871,0.000725848131706403,EPCI
200006682,"CA Beaune, Côte et Sud - Communauté Beaune-Chagny-Nolay",1999_2010,2004.5,11,51116,52951,5517,6718,1835,1201,634,0.00321145460319294,0.00210188391195353,0.00110957069123941,EPCI
200006716,CC du Nogentais,2010_2015,2012.5,5,16583,16805,933,1050,222,117,105,0.00266321746872245,0.00140358758486723,0.00125962988385521,EPCI
200006716,CC du Nogentais,1968_1975,1971.5,7,11893,11913,1226,1239,20,13,7,0.000240064392576178,0.000156041855174516,8.40225374016623e-05,EPCI
200006716,CC du Nogentais,1975_1982,1978.5,7,11913,12469,1254,1076,556,-178,734,0.00653775315897298,-0.00209302169477912,0.0086307748537521,EPCI
200006716,CC du Nogentais,1982_1990,1986,8,12469,13593,1539,1468,1124,-71,1195,0.0108470813912958,-0.000685180408169038,0.0115322617994648,EPCI
200006716,CC du Nogentais,1990_1999,1994.5,9,13593,15292,1528,1841,1699,313,1386,0.0131720933858444,0.00242664227767468,0.0107454511081697,EPCI
200006716,CC du Nogentais,1999_2010,2004.5,11,15292,16583,2045,2222,1291,177,1114,0.00739523416436239,0.00101390894430065,0.00638132522006173,EPCI
200006930,CC du Haut-Allier,2010_2015,2012.5,5,5370,5217,429,187,-153,-242,89,-0.00576439862599565,-0.00911754553915652,0.00335314691316087,EPCI
200006930,CC du Haut-Allier,1968_1975,1971.5,7,7444,6621,750,578,-823,-172,-651,-0.0165981251892714,-0.00346886698973837,-0.013129258199533,EPCI
200006930,CC du Haut-Allier,1975_1982,1978.5,7,6621,6147,693,495,-474,-198,-276,-0.0105556451505482,-0.00440932012617836,-0.00614632502436983,EPCI
200006930,CC du Haut-Allier,1982_1990,1986,8,6147,5647,723,479,-500,-244,-256,-0.0105489315092354,-0.00514787857650688,-0.00540105293272853,EPCI
200006930,CC du Haut-Allier,1990_1999,1994.5,9,5647,5279,745,435,-368,-310,-58,-0.00745956550516314,-0.00628387311576242,-0.00117569238940071,EPCI
200006930,CC du Haut-Allier,1999_2010,2004.5,11,5279,5370,954,523,91,-431,522,0.00155495520737303,-0.00736467796019535,0.00891963316756838,EPCI
200006971,CC du Perche,2010_2015,2012.5,5,19686,18338,1169,836,-1348,-333,-1015,-0.0140863090219222,-0.00347977811891698,-0.0106065309030052,EPCI
200006971,CC du Perche,1968_1975,1971.5,7,19526,20916,1544,2524,1390,980,410,0.00987234256046254,0.00696035662536208,0.00291198593510046,EPCI
200006971,CC du Perche,1975_1982,1978.5,7,20916,20446,1538,2220,-470,682,-1152,-0.00324147105090689,0.00470358139727339,-0.00794505244818028,EPCI
200006971,CC du Perche,1982_1990,1986,8,20446,19694,1708,1943,-752,235,-987,-0.00467320189194376,0.00146037559123242,-0.00613357748317618,EPCI
200006971,CC du Perche,1990_1999,1994.5,9,19694,19742,2027,2011,48,-16,64,0.00027051715762294,-9.01723858743135e-05,0.000360689543497254,EPCI
200006971,CC du Perche,1999_2010,2004.5,11,19742,19686,2489,2396,-56,-93,37,-0.000258205094659458,-0.000428804889345172,0.000170599794685714,EPCI
200007052,CC de la Marche Berrichonne,2010_2015,2012.5,5,5936,5734,525,177,-202,-348,146,-0.00690050907083073,-0.0118880057259856,0.00498749665515488,EPCI
200007052,CC de la Marche Berrichonne,1968_1975,1971.5,7,9872,8798,994,747,-1074,-247,-827,-0.0163193785575437,-0.00375315316919302,-0.0125662253883507,EPCI
200007052,CC de la Marche Berrichonne,1975_1982,1978.5,7,8798,8049,913,488,-749,-425,-324,-0.012630494773423,-0.00716683615314391,-0.00546365862027913,EPCI
200007052,CC de la Marche Berrichonne,1982_1990,1986,8,8049,7159,979,420,-890,-559,-331,-0.0145404458864082,-0.00913270702303618,-0.00540773886337205,EPCI
200007052,CC de la Marche Berrichonne,1990_1999,1994.5,9,7159,6209,1064,356,-950,-708,-242,-0.0156944770672037,-0.0116965155406108,-0.00399796152659295,EPCI
200007052,CC de la Marche Berrichonne,1999_2010,2004.5,11,6209,5936,1243,402,-273,-841,568,-0.0040793247228248,-0.0125667109593247,0.00848738623649994,EPCI
200007177,CC Pays de Nérondes,2010_2015,2012.5,5,5126,5015,340,254,-111,-86,-25,-0.00436886990582897,-0.00338489019730893,-0.000983979708520037,EPCI
200007177,CC Pays de Nérondes,1968_1975,1971.5,7,5743,5243,666,438,-500,-228,-272,-0.0129282553871993,-0.00589528445656289,-0.00703297093063643,EPCI
200007177,CC Pays de Nérondes,1975_1982,1978.5,7,5243,5065,606,313,-178,-293,115,-0.00492209173710489,-0.0081020948256839,0.003180003088579,EPCI
200007177,CC Pays de Nérondes,1982_1990,1986,8,5065,4987,611,401,-78,-210,132,-0.00193807090259679,-0.00521788319929905,0.00327981229670226,EPCI
200007177,CC Pays de Nérondes,1990_1999,1994.5,9,4987,5053,706,438,66,-268,334,0.00146191196918233,-0.0059362486021343,0.00739816057131663,EPCI
200007177,CC Pays de Nérondes,1999_2010,2004.5,11,5053,5126,818,643,73,-175,248,0.00130480521238874,-0.00312795770093191,0.00443276291332064,EPCI
200010650,CA du Grand Dole,2010_2015,2012.5,5,54259,53814,2479,3074,-445,595,-1040,-0.00164568854999547,0.00220041502752204,-0.00384610357751751,EPCI
200010650,CA du Grand Dole,1968_1975,1971.5,7,50550,52653,3239,6437,2103,3198,-1095,0.00583988194710394,0.00888061933753609,-0.00304073739043215,EPCI
200010650,CA du Grand Dole,1975_1982,1978.5,7,52653,51857,3276,5346,-796,2070,-2866,-0.00217381763286673,0.00565301821612327,-0.00782683584899,EPCI
200010650,CA du Grand Dole,1982_1990,1986,8,51857,52900,3773,5916,1043,2143,-1100,0.00249227663074803,0.00512075629884278,-0.00262847966809475,EPCI
200010650,CA du Grand Dole,1990_1999,1994.5,9,52900,52293,4230,5904,-607,1674,-2281,-0.00128149151684243,0.00353412981745341,-0.00481562133429584,EPCI
200010650,CA du Grand Dole,1999_2010,2004.5,11,52293,54259,5226,6978,1966,1752,214,0.00336075821565696,0.00299493814538707,0.000365820070269882,EPCI
200010700,CA Caux Seine Agglo,2010_2015,2012.5,5,75415,76842,3281,4906,1427,1625,-198,0.00375607070992157,0.00427723539146639,-0.000521164681544829,EPCI
200010700,CA Caux Seine Agglo,1968_1975,1971.5,7,59464,64453,3941,8033,4989,4092,897,0.0115757996229278,0.00949452236059739,0.00208127726233037,EPCI
200010700,CA Caux Seine Agglo,1975_1982,1978.5,7,64453,68874,4154,7152,4421,2998,1423,0.00952254972776534,0.00645749922728805,0.00306505050047729,EPCI
200010700,CA Caux Seine Agglo,1982_1990,1986,8,68874,72304,4781,9134,3430,4353,-923,0.00609357881745742,0.00773333778203853,-0.00163975896458111,EPCI
200010700,CA Caux Seine Agglo,1990_1999,1994.5,9,72304,73255,5482,8753,951,3271,-2320,0.00145294920765249,0.00499747303704657,-0.00354452382939408,EPCI
200010700,CA Caux Seine Agglo,1999_2010,2004.5,11,73255,75415,7079,10530,2160,3451,-1291,0.00264528253528051,0.00422632871724678,-0.00158104618196627,EPCI
200011773,CA Annemasse-les Voirons-Agglomération,2010_2015,2012.5,5,80287,89215,2418,6309,8928,3891,5037,0.0213122237940453,0.00928829108228385,0.0120239327117614,EPCI
200011773,CA Annemasse-les Voirons-Agglomération,1968_1975,1971.5,7,40419,53638,2546,5401,13219,2855,10364,0.0412506543776905,0.0089091926959911,0.0323414616816994,EPCI
200011773,CA Annemasse-les Voirons-Agglomération,1975_1982,1978.5,7,53638,58040,2745,5612,4402,2867,1535,0.0113315288414502,0.00738016655802763,0.00395136228342254,EPCI
200011773,CA Annemasse-les Voirons-Agglomération,1982_1990,1986,8,58040,65657,3486,6905,7617,3419,4198,0.0155333821648809,0.00697238199051171,0.00856100017436916,EPCI
200011773,CA Annemasse-les Voirons-Agglomération,1990_1999,1994.5,9,65657,68307,4220,8504,2650,4284,-1634,0.00440612624718528,0.00712296031809123,-0.00271683407090594,EPCI
200011773,CA Annemasse-les Voirons-Agglomération,1999_2010,2004.5,11,68307,80287,5259,11195,11980,5936,6044,0.0147989324704467,0.00733275986181734,0.00746617260862938,EPCI
200011781,CC Portes du Berry entre Loire et Val d'Aubois,2010_2015,2012.5,5,10092,9915,591,486,-177,-105,-72,-0.00353259939837203,-0.00209560981259358,-0.00143698958577845,EPCI
200011781,CC Portes du Berry entre Loire et Val d'Aubois,1968_1975,1971.5,7,10717,10339,1174,923,-378,-251,-127,-0.00511659584796831,-0.00339752793079377,-0.00171906791717454,EPCI
200011781,CC Portes du Berry entre Loire et Val d'Aubois,1975_1982,1978.5,7,10339,9950,1120,735,-389,-385,-4,-0.0054636768746672,-0.00540749510731844,-5.61817673487633e-05,EPCI
200011781,CC Portes du Berry entre Loire et Val d'Aubois,1982_1990,1986,8,9950,9828,1143,752,-122,-391,269,-0.00154094858159681,-0.004938613896757,0.00339766531516019,EPCI
200011781,CC Portes du Berry entre Loire et Val d'Aubois,1990_1999,1994.5,9,9828,9862,1168,807,34,-361,395,0.000383799536980867,-0.00407504802500273,0.0044588475619836,EPCI
200011781,CC Portes du Berry entre Loire et Val d'Aubois,1999_2010,2004.5,11,9862,10092,1348,1225,230,-123,353,0.00209801985903124,-0.00112198453330801,0.00322000439233925,EPCI
200012060,CC Petite Montagne,2010_2015,2012.5,5,6706,6688,436,322,-18,-114,96,-0.000537409995818194,-0.0034035966401819,0.0028661866443637,EPCI
200012060,CC Petite Montagne,1968_1975,1971.5,7,5864,5348,677,431,-516,-246,-270,-0.0130722779724874,-0.00623213252176727,-0.00684014545072018,EPCI
200012060,CC Petite Montagne,1975_1982,1978.5,7,5348,5204,606,358,-144,-248,104,-0.00389170740058287,-0.00670238496767049,0.00281067756708763,EPCI
200012060,CC Petite Montagne,1982_1990,1986,8,5204,5531,667,473,327,-194,521,0.00764672178123571,-0.00453658723412761,0.0121833090153633,EPCI
200012060,CC Petite Montagne,1990_1999,1994.5,9,5531,6106,674,627,575,-47,622,0.0110498550944966,-0.000903205546854507,0.0119530606413511,EPCI
200012060,CC Petite Montagne,1999_2010,2004.5,11,6106,6706,822,838,600,16,584,0.00855738447555976,0.00022819691934826,0.0083291875562115,EPCI
200013050,CC Sauer-Pechelbronn,2010_2015,2012.5,5,17589,17389,759,904,-200,145,-345,-0.00228456325404458,0.00165630835918232,-0.0039408716132269,EPCI
200013050,CC Sauer-Pechelbronn,1968_1975,1971.5,7,14941,15300,1275,1679,359,404,-45,0.0033977187086669,0.00382361659693991,-0.00042589788827301,EPCI
200013050,CC Sauer-Pechelbronn,1975_1982,1978.5,7,15300,15339,1228,1287,39,59,-20,0.000363748478665382,0.000550286160032245,-0.000186537681366863,EPCI
200013050,CC Sauer-Pechelbronn,1982_1990,1986,8,15339,16116,1328,1648,777,320,457,0.00619586074854484,0.00255170584238655,0.00364415490615829,EPCI
200013050,CC Sauer-Pechelbronn,1990_1999,1994.5,9,16116,16426,1338,1655,310,317,-7,0.0021192288411076,0.00216708239558422,-4.78535544766231e-05,EPCI
200013050,CC Sauer-Pechelbronn,1999_2010,2004.5,11,16426,17589,1525,1986,1163,461,702,0.00623831056000324,0.00247279550142863,0.00376551505857461,EPCI
200015162,CC de l'Oriente,2010_2015,2012.5,5,5820,6087,280,258,267,-22,289,0.00901137773200489,-0.000742510524734485,0.00975388825673937,EPCI
200015162,CC de l'Oriente,1968_1975,1971.5,7,6143,7747,484,410,1604,-74,1678,0.0336970848699687,-0.00155460366607088,0.0352516885360396,EPCI
200015162,CC de l'Oriente,1975_1982,1978.5,7,7747,6790,463,347,-957,-116,-841,-0.0186600938799004,-0.00226182956120005,-0.0163982643187004,EPCI
200015162,CC de l'Oriente,1982_1990,1986,8,6790,5932,491,504,-858,13,-871,-0.0167444170824368,0.00025370328912783,-0.0169981203715646,EPCI
200015162,CC de l'Oriente,1990_1999,1994.5,9,5932,5698,600,500,-234,-100,-134,-0.00446181508422916,-0.00190675858300391,-0.00255505650122525,EPCI
200015162,CC de l'Oriente,1999_2010,2004.5,11,5698,5820,623,452,122,-171,293,0.00192776718288812,-0.00270203433011367,0.00462980151300179,EPCI
200016905,CC du Pays de Lamastre,2010_2015,2012.5,5,6751,6629,423,254,-122,-169,47,-0.00364069231044051,-0.00504325410216759,0.00140256179172708,EPCI
200016905,CC du Pays de Lamastre,1968_1975,1971.5,7,8888,7936,812,846,-952,34,-986,-0.0160544008824478,0.000573371460087422,-0.0166277723425352,EPCI
200016905,CC du Pays de Lamastre,1975_1982,1978.5,7,7936,7491,780,531,-445,-249,-196,-0.00820997965775949,-0.00459389872984745,-0.00361608092791205,EPCI
200016905,CC du Pays de Lamastre,1982_1990,1986,8,7491,6783,781,571,-708,-210,-498,-0.0123336614100157,-0.00365828940127584,-0.00867537200873985,EPCI
200016905,CC du Pays de Lamastre,1990_1999,1994.5,9,6783,6478,805,570,-305,-235,-70,-0.00509891851364075,-0.00392867492034615,-0.0011702435932946,EPCI
200016905,CC du Pays de Lamastre,1999_2010,2004.5,11,6478,6751,950,636,273,-314,587,0.00375967001379141,-0.00432430910011173,0.00808397911390313,EPCI
200017341,CC Lodévois et Larzac,2010_2015,2012.5,5,14180,14480,899,753,300,-146,446,0.00419595162832964,-0.00204202979245376,0.0062379814207834,EPCI
200017341,CC Lodévois et Larzac,1968_1975,1971.5,7,11494,11590,1114,1110,96,-4,100,0.00118892010096916,-4.95383375403817e-05,0.00123845843850954,EPCI
200017341,CC Lodévois et Larzac,1975_1982,1978.5,7,11590,12413,1209,1034,823,-175,998,0.00984841574514772,-0.00209413457521367,0.0119425503203614,EPCI
200017341,CC Lodévois et Larzac,1982_1990,1986,8,12413,12008,1389,1223,-405,-166,-239,-0.00413781756942044,-0.00169599436178714,-0.0024418232076333,EPCI
200017341,CC Lodévois et Larzac,1990_1999,1994.5,9,12008,11836,1439,1211,-172,-228,56,-0.00160175579472821,-0.00212325768138391,0.000521501886655697,EPCI
200017341,CC Lodévois et Larzac,1999_2010,2004.5,11,11836,14180,1823,1642,2344,-181,2525,0.0165617211309179,-0.00127887010439255,0.0178405912353105,EPCI
200017846,CA Étampois Sud-Essonne,2010_2015,2012.5,5,51002,53435,1905,3884,2433,1979,454,0.00936379139511678,0.00761649945373453,0.00174729194138225,EPCI
200017846,CA Étampois Sud-Essonne,1968_1975,1971.5,7,31951,37218,2592,4364,5267,1772,3495,0.0220377553498576,0.00741425906207476,0.0146234962877829,EPCI
200017846,CA Étampois Sud-Essonne,1975_1982,1978.5,7,37218,39846,2614,3910,2628,1296,1332,0.0097947300794432,0.00483027784739665,0.00496445223204656,EPCI
200017846,CA Étampois Sud-Essonne,1982_1990,1986,8,39846,44720,3100,4962,4874,1862,3012,0.0145293908445812,0.00555062079454455,0.00897877005003661,EPCI
200017846,CA Étampois Sud-Essonne,1990_1999,1994.5,9,44720,46966,3509,6160,2246,2651,-405,0.00545963945347294,0.00644412475118289,-0.000984485297709947,EPCI
200017846,CA Étampois Sud-Essonne,1999_2010,2004.5,11,46966,51002,4185,7671,4036,3486,550,0.00752278338123569,0.0064976270730891,0.00102515630814659,EPCI
200018083,CC de Desvres-Samer,2010_2015,2012.5,5,21766,22668,1030,1416,902,386,516,0.00815408876703816,0.00348944375174804,0.00466464501529012,EPCI
200018083,CC de Desvres-Samer,1968_1975,1971.5,7,17942,18141,1316,2270,199,954,-755,0.00157699026085623,0.0075600437630997,-0.00598305350224347,EPCI
200018083,CC de Desvres-Samer,1975_1982,1978.5,7,18141,18091,1439,1988,-50,549,-599,-0.000394206982867407,0.00432839267188413,-0.00472259965475153,EPCI
200018083,CC de Desvres-Samer,1982_1990,1986,8,18091,18942,1603,2202,851,599,252,0.00576242699587959,0.00405604438370373,0.00170638261217586,EPCI
200018083,CC de Desvres-Samer,1990_1999,1994.5,9,18942,19717,1767,2147,775,380,395,0.00446544373234148,0.00218950789456743,0.00227593583777404,EPCI
200018083,CC de Desvres-Samer,1999_2010,2004.5,11,19717,21766,2177,2981,2049,804,1245,0.00902850524002297,0.00354266384235162,0.00548584139767135,EPCI
200018166,CC Le Grésivaudan,2010_2015,2012.5,5,97705,100871,3053,5570,3166,2517,649,0.00639833000857415,0.00508673298533832,0.00131159702323583,EPCI
200018166,CC Le Grésivaudan,1968_1975,1971.5,7,43843,49736,3409,4673,5893,1264,4629,0.0181795501833062,0.00389936389473936,0.0142801862885668,EPCI
200018166,CC Le Grésivaudan,1975_1982,1978.5,7,49736,58648,3467,4835,8912,1368,7544,0.023825754987723,0.00365727477818728,0.0201684802095357,EPCI
200018166,CC Le Grésivaudan,1982_1990,1986,8,58648,70887,4104,6744,12239,2640,9599,0.0239745760629118,0.00517140949473707,0.0188031665681747,EPCI
200018166,CC Le Grésivaudan,1990_1999,1994.5,9,70887,85681,4983,9068,14794,4085,10709,0.0212837849604022,0.00587699483325963,0.0154067901271426,EPCI
200018166,CC Le Grésivaudan,1999_2010,2004.5,11,85681,97705,6478,12830,12024,6352,5672,0.0120098769738313,0.00634453913321492,0.00566533784061635,EPCI
200018406,CC du Romorantinais et du Monestois,2010_2015,2012.5,5,31950,33314,1862,1768,1364,-94,1458,0.00839616134579613,-0.00057862108981293,0.00897478243560906,EPCI
200018406,CC du Romorantinais et du Monestois,1968_1975,1971.5,7,24011,27357,2219,2935,3346,716,2630,0.0188119535164568,0.00402551067477079,0.014786442841686,EPCI
200018406,CC du Romorantinais et du Monestois,1975_1982,1978.5,7,27357,29592,2256,2649,2235,393,1842,0.0112819691770758,0.00198380934523078,0.00929815983184502,EPCI
200018406,CC du Romorantinais et du Monestois,1982_1990,1986,8,29592,30801,2808,2810,1209,2,1207,0.00501793568733033,8.30096887895837e-06,0.00500963471845138,EPCI
200018406,CC du Romorantinais et du Monestois,1990_1999,1994.5,9,30801,32023,3017,3286,1222,269,953,0.00433238416258863,0.000953691767378349,0.00337869239521028,EPCI
200018406,CC du Romorantinais et du Monestois,1999_2010,2004.5,11,32023,31950,4009,3967,-73,-42,-31,-0.000207452460498581,-0.000119356210149868,-8.80962503487123e-05,EPCI
200018521,CC du Val de Bouzanne,2010_2015,2012.5,5,6054,6057,376,283,3,-93,96,9.90883887868055e-05,-0.00307174005239097,0.00317082844117778,EPCI
200018521,CC du Val de Bouzanne,1968_1975,1971.5,7,7055,6502,741,521,-553,-220,-333,-0.0115932406410072,-0.00461213913385458,-0.00698110150715262,EPCI
200018521,CC du Val de Bouzanne,1975_1982,1978.5,7,6502,6182,689,474,-320,-215,-105,-0.00718378354747529,-0.00482660457095996,-0.00235717897651533,EPCI
200018521,CC du Val de Bouzanne,1982_1990,1986,8,6182,5935,791,413,-247,-378,131,-0.00508388504560053,-0.00778019654751823,0.00269631150191769,EPCI
200018521,CC du Val de Bouzanne,1990_1999,1994.5,9,5935,5825,829,425,-110,-404,294,-0.00207651090754291,-0.00762645824224849,0.00554994733470558,EPCI
200018521,CC du Val de Bouzanne,1999_2010,2004.5,11,5825,6054,890,683,229,-207,436,0.00351162509948777,-0.0031742637362182,0.00668588883570597,EPCI
200018653,CA Cap Excellence,2010_2015,2012.5,5,105212,102858,3514,7538,-2354,4024,-6378,-0.00451536813094533,0.00771870915842141,-0.0122340772893667,EPCI
200018653,CA Cap Excellence,1968_1975,1971.5,7,76831,85842,5485,31374,9011,25889,-16878,0.0159690485502502,0.0458797800374461,-0.0299107314871959,EPCI
200018653,CA Cap Excellence,1975_1982,1978.5,7,85842,91950,3633,13444,6108,9811,-3703,0.00986787724891225,0.0158503182202158,-0.00598244097130355,EPCI
200018653,CA Cap Excellence,1982_1990,1986,8,91950,103670,4225,16024,11720,11799,-79,0.0151089821290848,0.0152108259506034,-0.000101843821518574,EPCI
200018653,CA Cap Excellence,1990_1999,1994.5,9,103670,107391,5172,17294,3721,12122,-8401,0.00392586413320317,0.0127893912987608,-0.0088635271655576,EPCI
200018653,CA Cap Excellence,1999_2010,2004.5,11,107391,105212,7093,19464,-2179,12371,-14550,-0.00186181171446254,0.0105702031755925,-0.012432014890055,EPCI
200022986,CC du Grand Pic Saint-Loup,2010_2015,2012.5,5,44473,47285,1493,2123,2812,630,2182,0.0123376600619198,0.0027641272542708,0.00957353280764903,EPCI
200022986,CC du Grand Pic Saint-Loup,1968_1975,1971.5,7,7847,10964,726,777,3117,51,3066,0.0489437420495402,0.00080081194883752,0.0481429301007027,EPCI
200022986,CC du Grand Pic Saint-Loup,1975_1982,1978.5,7,10964,18282,817,1197,7318,380,6938,0.0757766084882072,0.0039348334552499,0.0718417750329573,EPCI
200022986,CC du Grand Pic Saint-Loup,1982_1990,1986,8,18282,29288,1216,2295,11006,1079,9927,0.0606772437678063,0.00594864128888451,0.0547286024789217,EPCI
200022986,CC du Grand Pic Saint-Loup,1990_1999,1994.5,9,29288,37445,1927,3332,8157,1405,6752,0.0276755242506495,0.00476696231116372,0.0229085619394857,EPCI
200022986,CC du Grand Pic Saint-Loup,1999_2010,2004.5,11,37445,44473,3009,4413,7028,1404,5624,0.0157600891266911,0.0031484298710692,0.0126116592556219,EPCI
200023075,CC du Pays de Maîche,2010_2015,2012.5,5,18010,18651,741,1208,641,467,174,0.00701903974757712,0.0051137153855203,0.00190532436205682,EPCI
200023075,CC du Pays de Maîche,1968_1975,1971.5,7,16079,16566,998,2251,487,1253,-766,0.00427171636820933,0.0109906788693353,-0.00671896250112597,EPCI
200023075,CC du Pays de Maîche,1975_1982,1978.5,7,16566,16343,978,1893,-223,915,-1138,-0.0019342313966777,0.00793642030475379,-0.00987065170143149,EPCI
200023075,CC du Pays de Maîche,1982_1990,1986,8,16343,16338,1070,1806,-5,736,-741,-3.82477924399938e-05,0.00563007504716708,-0.00566832283960708,EPCI
200023075,CC du Pays de Maîche,1990_1999,1994.5,9,16338,16388,1223,1912,50,689,-639,0.000339577283866355,0.00467937497167837,-0.00433979768781201,EPCI
200023075,CC du Pays de Maîche,1999_2010,2004.5,11,16388,18010,1527,2476,1622,949,673,0.0086167119287357,0.00504146709024055,0.00357524483849515,EPCI
200023125,CC Les Portes Briardes entre Villes et Forêts,2010_2015,2012.5,5,44871,46180,1207,2710,1309,1503,-194,0.0057675883763324,0.00662237229154133,-0.000854783915208927,EPCI
200023125,CC Les Portes Briardes entre Villes et Forêts,1968_1975,1971.5,7,13429,31460,1093,3306,18031,2213,15818,0.129318479983924,0.0158716541625214,0.113446825821403,EPCI
200023125,CC Les Portes Briardes entre Villes et Forêts,1975_1982,1978.5,7,31460,33822,1310,3396,2362,2086,276,0.0103957471369591,0.00918100276363113,0.00121474437332799,EPCI
200023125,CC Les Portes Briardes entre Villes et Forêts,1982_1990,1986,8,33822,40692,1611,4012,6870,2401,4469,0.0233842263925244,0.00817256587604818,0.0152116605164762,EPCI
200023125,CC Les Portes Briardes entre Villes et Forêts,1990_1999,1994.5,9,40692,44544,2094,4990,3852,2896,956,0.0101002165097326,0.00759351687751443,0.00250669963221816,EPCI
200023125,CC Les Portes Briardes entre Villes et Forêts,1999_2010,2004.5,11,44544,44871,2507,6243,327,3736,-3409,0.000665152173238592,0.00759941443186355,-0.00693426225862496,EPCI
200023240,CC Pays de Nemours,2010_2015,2012.5,5,29796,30218,1477,1795,422,318,104,0.00281668281856717,0.00212252401967858,0.000694158798888592,EPCI
200023240,CC Pays de Nemours,1968_1975,1971.5,7,19068,22673,1496,2637,3605,1141,2464,0.0250461207323836,0.00792721879490974,0.0171189019374738,EPCI
200023240,CC Pays de Nemours,1975_1982,1978.5,7,22673,25157,1662,2596,2484,934,1550,0.0149624618092097,0.00562598201682844,0.00933647979238124,EPCI
200023240,CC Pays de Nemours,1982_1990,1986,8,25157,27486,2029,2882,2329,853,1476,0.0111290467130845,0.00407603127791371,0.00705301543517074,EPCI
200023240,CC Pays de Nemours,1990_1999,1994.5,9,27486,29517,2399,3464,2031,1065,966,0.00795251956685128,0.00417008042279498,0.0037824391440563,EPCI
200023240,CC Pays de Nemours,1999_2010,2004.5,11,29517,29796,3058,4054,279,996,-717,0.000855619266438845,0.00305446877911502,-0.00219884951267617,EPCI
200023299,CC Coeur de Tarentaise,2010_2015,2012.5,5,9553,9297,406,550,-256,144,-400,-0.0054179643639628,0.00304760495472908,-0.00846556931869188,EPCI
200023299,CC Coeur de Tarentaise,1968_1975,1971.5,7,8574,9260,625,1061,686,436,250,0.0110563431865656,0.00702706359962476,0.0040292795869408,EPCI
200023299,CC Coeur de Tarentaise,1975_1982,1978.5,7,9260,9196,610,946,-64,336,-400,-0.000990286736014534,0.0051990053640763,-0.00618929210009084,EPCI
200023299,CC Coeur de Tarentaise,1982_1990,1986,8,9196,9763,695,989,567,294,273,0.00750692716978141,0.00389248075470147,0.00361444641507994,EPCI
200023299,CC Coeur de Tarentaise,1990_1999,1994.5,9,9763,9687,782,1259,-76,477,-553,-0.000867950868025935,0.00544753373747857,-0.0063154846055045,EPCI
200023299,CC Coeur de Tarentaise,1999_2010,2004.5,11,9687,9553,922,1443,-134,521,-655,-0.0012655202944446,0.00492041845825102,-0.00618593875269562,EPCI
200023307,CA du Grand Villeneuvois,2010_2015,2012.5,5,48329,47994,2746,2554,-335,-192,-143,-0.00139019108107785,-0.000796766231543127,-0.000593424849534725,EPCI
200023307,CA du Grand Villeneuvois,1968_1975,1971.5,7,39910,41870,3261,4439,1960,1178,782,0.00687245927305469,0.00413048827737675,0.00274197099567794,EPCI
200023307,CA du Grand Villeneuvois,1975_1982,1978.5,7,41870,44329,3452,3673,2459,221,2238,0.0081861116681945,0.000735718047446516,0.00745039362074798,EPCI
200023307,CA du Grand Villeneuvois,1982_1990,1986,8,44329,45126,4048,4177,797,129,668,0.0022299184102208,0.000360927822984295,0.0018689905872365,EPCI
200023307,CA du Grand Villeneuvois,1990_1999,1994.5,9,45126,45358,4609,4277,232,-332,564,0.000569938982909468,-0.000815602337611825,0.00138554132052129,EPCI
200023307,CA du Grand Villeneuvois,1999_2010,2004.5,11,45358,48329,5495,5617,2971,122,2849,0.00578441346777803,0.000237528927320404,0.00554688454045762,EPCI
200023372,CC de la Vallée de Chamonix-Mont-Blanc,2010_2015,2012.5,5,13345,13150,485,834,-195,349,-544,-0.00293967551384211,0.00526126540682511,-0.00820094092066722,EPCI
200023372,CC de la Vallée de Chamonix-Mont-Blanc,1968_1975,1971.5,7,9728,10584,661,1415,856,754,102,0.0121207396017804,0.0106764458641851,0.00144429373759533,EPCI
200023372,CC de la Vallée de Chamonix-Mont-Blanc,1975_1982,1978.5,7,10584,11250,588,1189,666,601,65,0.00875592536066416,0.00790136808071946,0.0008545572799447,EPCI
200023372,CC de la Vallée de Chamonix-Mont-Blanc,1982_1990,1986,8,11250,12596,714,1547,1346,833,513,0.0142266458635021,0.00880445468372752,0.00542219117977457,EPCI
200023372,CC de la Vallée de Chamonix-Mont-Blanc,1990_1999,1994.5,9,12596,13744,805,1907,1148,1102,46,0.00973856552679275,0.00934834426003973,0.00039022126675302,EPCI
200023372,CC de la Vallée de Chamonix-Mont-Blanc,1999_2010,2004.5,11,13744,13345,1034,2023,-399,989,-1388,-0.00267465149125001,0.00662964993695805,-0.00930430142820807,EPCI
200023414,Métropole Rouen Normandie,2010_2015,2012.5,5,486252,489428,20743,32232,3176,11489,-8313,0.00130291891249046,0.00471323532292282,-0.00341031641043236,EPCI
200023414,Métropole Rouen Normandie,1968_1975,1971.5,7,442723,470139,29002,60867,27416,31865,-4449,0.00862038671076437,0.0100192815340862,-0.00139889482332181,EPCI
200023414,Métropole Rouen Normandie,1975_1982,1978.5,7,470139,468987,28960,53130,-1152,24170,-25322,-0.000350416611054394,0.00735205684825061,-0.007702473459305,EPCI
200023414,Métropole Rouen Normandie,1982_1990,1986,8,468987,477680,32895,61346,8693,28451,-19758,0.00229838759342682,0.00752230822737679,-0.00522392063394997,EPCI
200023414,Métropole Rouen Normandie,1990_1999,1994.5,9,477680,485149,36233,60958,7469,24725,-17256,0.00172537653133564,0.00571159924183609,-0.00398622271050045,EPCI
200023414,Métropole Rouen Normandie,1999_2010,2004.5,11,485149,486252,44399,69769,1103,25370,-24267,0.000206471110747453,0.00474902273768166,-0.00454255162693421,EPCI
200023620,CC de la Gascogne Toulousaine,2010_2015,2012.5,5,18113,20878,619,1359,2765,740,2025,0.0288207177651527,0.00771332048687632,0.0211073972782764,EPCI
200023620,CC de la Gascogne Toulousaine,1968_1975,1971.5,7,7433,8238,680,646,805,-34,839,0.014798145682271,-0.000625014848692191,0.0154231605309632,EPCI
200023620,CC de la Gascogne Toulousaine,1975_1982,1978.5,7,8238,9410,671,619,1172,-52,1224,0.019183884643742,-0.000851162117299133,0.0200350467610411,EPCI
200023620,CC de la Gascogne Toulousaine,1982_1990,1986,8,9410,10993,774,880,1583,106,1477,0.0196258223139481,0.00131417382519172,0.0183116484887563,EPCI
200023620,CC de la Gascogne Toulousaine,1990_1999,1994.5,9,10993,12804,898,1319,1811,421,1390,0.0170886932634535,0.00397257861066479,0.0131161146527887,EPCI
200023620,CC de la Gascogne Toulousaine,1999_2010,2004.5,11,12804,18113,1205,2138,5309,933,4376,0.0320363038419982,0.00563003795151334,0.0264062658904848,EPCI
200023737,CA du Grand Cahors,2010_2015,2012.5,5,41283,40669,2165,1945,-614,-220,-394,-0.00299244597784054,-0.00107221191388423,-0.00192023406395631,EPCI
200023737,CA du Grand Cahors,1968_1975,1971.5,7,29486,31816,2459,3282,2330,823,1507,0.0109240555517924,0.00385858271207089,0.00706547283972154,EPCI
200023737,CA du Grand Cahors,1975_1982,1978.5,7,31816,34108,2528,3048,2292,520,1772,0.00998706299317798,0.00226582580997057,0.0077212371832074,EPCI
200023737,CA du Grand Cahors,1982_1990,1986,8,34108,36070,2779,3403,1962,624,1338,0.00701568718634382,0.0022312888910696,0.00478439829527423,EPCI
200023737,CA du Grand Cahors,1990_1999,1994.5,9,36070,37858,3231,3484,1788,253,1535,0.00539012174570153,0.000762696197797811,0.00462742554790372,EPCI
200023737,CA du Grand Cahors,1999_2010,2004.5,11,37858,41283,4069,4401,3425,332,3093,0.00790457519848697,0.000766224515590562,0.00713835068289641,EPCI
200023778,CC du Pays de Saint-Gilles-Croix-de-Vie,2010_2015,2012.5,5,44856,47820,2735,2024,2964,-711,3675,0.0128795567758631,-0.00308952930757039,0.0159690860834334,EPCI
200023778,CC du Pays de Saint-Gilles-Croix-de-Vie,1968_1975,1971.5,7,22217,24604,1733,2652,2387,919,1468,0.0146855411543305,0.00565396410591946,0.00903157704841106,EPCI
200023778,CC du Pays de Saint-Gilles-Croix-de-Vie,1975_1982,1978.5,7,24604,27017,1974,2411,2413,437,1976,0.0134550389208778,0.00243673933212748,0.0110182995887504,EPCI
200023778,CC du Pays de Saint-Gilles-Croix-de-Vie,1982_1990,1986,8,27017,30171,2509,2646,3154,137,3017,0.0138975479895991,0.000603666478939466,0.0132938815106596,EPCI
200023778,CC du Pays de Saint-Gilles-Croix-de-Vie,1990_1999,1994.5,9,30171,34668,3359,3096,4497,-263,4760,0.0155570901709627,-0.000909832046911986,0.0164669222178747,EPCI
200023778,CC du Pays de Saint-Gilles-Croix-de-Vie,1999_2010,2004.5,11,34668,44856,5129,4626,10188,-503,10691,0.0236982897867857,-0.00117002746002682,0.0248683172468125,EPCI
200023794,CC de Blaye,2010_2015,2012.5,5,20019,20308,1143,1119,289,-24,313,0.00287072756847784,-0.000238399521257675,0.00310912708973551,EPCI
200023794,CC de Blaye,1968_1975,1971.5,7,17251,16637,1748,1748,-614,0,-614,-0.00516390413050005,0,-0.00516390413050005,EPCI
200023794,CC de Blaye,1975_1982,1978.5,7,16637,18033,1770,1560,1396,-210,1606,0.0115771137268199,-0.00174154289586832,0.0133186566226882,EPCI
200023794,CC de Blaye,1982_1990,1986,8,18033,17812,1878,1786,-221,-92,-129,-0.00154019084500778,-0.000641165419641249,-0.000899025425366534,EPCI
200023794,CC de Blaye,1990_1999,1994.5,9,17812,18565,2068,1839,753,-229,982,0.00461123251384898,-0.00140235357990892,0.00601358609375791,EPCI
200023794,CC de Blaye,1999_2010,2004.5,11,18565,20019,2455,2406,1454,-49,1503,0.00687843349724004,-0.000231804154996398,0.00711023765223644,EPCI
200023919,CC Gâtinais Val de Loing,2010_2015,2012.5,5,19149,19013,1084,1122,-136,38,-174,-0.00142449228922825,0.000398019904343188,-0.00182251219357144,EPCI
200023919,CC Gâtinais Val de Loing,1968_1975,1971.5,7,14598,14933,1730,1456,335,-274,609,0.00324654379414824,-0.00265538208834811,0.00590192588249635,EPCI
200023919,CC Gâtinais Val de Loing,1975_1982,1978.5,7,14933,14935,1849,1112,2,-737,739,1.91319820057601e-05,-0.00705013536912258,0.00706926735112834,EPCI
200023919,CC Gâtinais Val de Loing,1982_1990,1986,8,14935,16826,2210,1428,1891,-782,2673,0.0150138240782898,-0.00620878393930333,0.0212226080175931,EPCI
200023919,CC Gâtinais Val de Loing,1990_1999,1994.5,9,16826,18217,2104,1935,1391,-169,1560,0.00886460605815143,-0.0010770082126726,0.00994161427082403,EPCI
200023919,CC Gâtinais Val de Loing,1999_2010,2004.5,11,18217,19149,2502,2441,932,-61,993,0.00454623663681741,-0.000297554114641483,0.0048437907514589,EPCI
200026573,CC Haut-Jura Saint-Claude,2010_2015,2012.5,5,22837,21400,1105,1248,-1437,143,-1580,-0.0129141090781985,0.0012851201100782,-0.0141992291882767,EPCI
200026573,CC Haut-Jura Saint-Claude,1968_1975,1971.5,7,20913,21772,1781,2275,859,494,365,0.00576710399678304,0.00331658832876696,0.00245051566801608,EPCI
200026573,CC Haut-Jura Saint-Claude,1975_1982,1978.5,7,21772,21877,1831,2228,105,397,-292,0.000687538541174204,0.00259955048424913,-0.00191201194307493,EPCI
200026573,CC Haut-Jura Saint-Claude,1982_1990,1986,8,21877,23033,1898,2448,1156,550,606,0.00645727306999455,0.00307223199696973,0.00338504107302483,EPCI
200026573,CC Haut-Jura Saint-Claude,1990_1999,1994.5,9,23033,23330,1777,2811,297,1034,-737,0.00142458217813979,0.00495965647204223,-0.00353507429390244,EPCI
200026573,CC Haut-Jura Saint-Claude,1999_2010,2004.5,11,23330,22837,2107,3593,-493,1486,-1979,-0.00193975790446965,0.0058468159148923,-0.00778657381936195,EPCI
200027027,CC Arc Sud Bretagne,2010_2015,2012.5,5,25401,27011,1247,1499,1610,252,1358,0.01236697578163,0.0019357005571247,0.0104312752245053,EPCI
200027027,CC Arc Sud Bretagne,1968_1975,1971.5,7,17369,17799,1632,2179,430,547,-117,0.00349971946343564,0.00445196871278905,-0.000952249249353417,EPCI
200027027,CC Arc Sud Bretagne,1975_1982,1978.5,7,17799,18910,1568,2036,1111,468,643,0.00868731858446004,0.00365946453422799,0.00502785405023205,EPCI
200027027,CC Arc Sud Bretagne,1982_1990,1986,8,18910,19547,1799,2087,637,288,349,0.00414995472490065,0.00187627466369135,0.00227368006120931,EPCI
200027027,CC Arc Sud Bretagne,1990_1999,1994.5,9,19547,20377,1899,2012,830,113,717,0.00463124587252151,0.000630519016379434,0.00400072685614207,EPCI
200027027,CC Arc Sud Bretagne,1999_2010,2004.5,11,20377,25401,2512,3136,5024,624,4400,0.0202367443644349,0.00251348098793937,0.0177232633764955,EPCI
200027076,CC Arnon Boischaut Cher,2010_2015,2012.5,5,8397,8232,528,415,-165,-113,-52,-0.00396123366703871,-0.00271284487500227,-0.00124838879203644,EPCI
200027076,CC Arnon Boischaut Cher,1968_1975,1971.5,7,9097,8959,968,773,-138,-195,57,-0.002181342439186,-0.00308233170754543,0.000900989268359433,EPCI
200027076,CC Arnon Boischaut Cher,1975_1982,1978.5,7,8959,8584,1011,539,-375,-472,97,-0.00608975443266413,-0.00766497091257992,0.00157521647991579,EPCI
200027076,CC Arnon Boischaut Cher,1982_1990,1986,8,8584,8446,1003,597,-138,-406,268,-0.00202383039002751,-0.00595416766921138,0.00393033727918387,EPCI
200027076,CC Arnon Boischaut Cher,1990_1999,1994.5,9,8446,8134,1116,664,-312,-452,140,-0.00417350539940775,-0.00604623218119328,0.00187272678178553,EPCI
200027076,CC Arnon Boischaut Cher,1999_2010,2004.5,11,8134,8397,1327,908,263,-419,682,0.0028970694834467,-0.00461548332153676,0.00751255280498346,EPCI
200027100,CC Méditerranée Porte des Maures,2010_2015,2012.5,5,40482,42393,2170,1862,1911,-308,2219,0.00926784766230537,-0.00149371903714812,0.0107615666994535,EPCI
200027100,CC Méditerranée Porte des Maures,1968_1975,1971.5,7,20426,21288,1638,1814,862,176,686,0.00592245947039172,0.00120922606356026,0.00471323340683146,EPCI
200027100,CC Méditerranée Porte des Maures,1975_1982,1978.5,7,21288,25183,1797,1748,3895,-49,3944,0.02429406826629,-0.000305624992310195,0.0245996932586002,EPCI
200027100,CC Méditerranée Porte des Maures,1982_1990,1986,8,25183,29948,2203,2502,4765,299,4466,0.0218979898716101,0.00137408163097826,0.0205239082406318,EPCI
200027100,CC Méditerranée Porte des Maures,1990_1999,1994.5,9,29948,34640,2917,3141,4692,224,4468,0.0163033096282943,0.000778333622493163,0.0155249760058011,EPCI
200027100,CC Méditerranée Porte des Maures,1999_2010,2004.5,11,34640,40482,4307,4106,5842,-201,6043,0.01426887380344,-0.000490935233565806,0.0147598090370058,EPCI
200027183,CU Perpignan Méditerranée Métropole,2010_2015,2012.5,5,253270,266909,13096,15205,13639,2109,11530,0.010545549045613,0.00163065935458595,0.00891488969102705,EPCI
200027183,CU Perpignan Méditerranée Métropole,1968_1975,1971.5,7,153795,166833,13119,16544,13038,3425,9613,0.0116925099335219,0.00307154828365643,0.00862096164986546,EPCI
200027183,CU Perpignan Méditerranée Métropole,1975_1982,1978.5,7,166833,192592,14628,15262,25759,634,25125,0.0207233283013613,0.000510058237628131,0.0202132700637331,EPCI
200027183,CU Perpignan Méditerranée Métropole,1982_1990,1986,8,192592,207203,16994,19403,14611,2409,12202,0.00918253154626902,0.00151397703750339,0.00766855450876563,EPCI
200027183,CU Perpignan Méditerranée Métropole,1990_1999,1994.5,9,207203,221648,20296,21954,14445,1658,12787,0.00751605467648675,0.000862694264701629,0.00665336041178512,EPCI
200027183,CU Perpignan Méditerranée Métropole,1999_2010,2004.5,11,221648,253270,27031,30418,31622,3387,28235,0.0121979385799904,0.00130650869554195,0.0108914298844485,EPCI
200027217,CC Sarlat-Périgord Noir,2010_2015,2012.5,5,16844,16226,931,695,-618,-236,-382,-0.00744804805858335,-0.00284423841719364,-0.00460380964138971,EPCI
200027217,CC Sarlat-Périgord Noir,1968_1975,1971.5,7,13256,14228,1152,1394,972,242,730,0.0101600627632532,0.00252956295134493,0.00763049981190827,EPCI
200027217,CC Sarlat-Périgord Noir,1975_1982,1978.5,7,14228,14685,1192,1228,457,36,421,0.00452660147163586,0.000356581297546807,0.00417002017408905,EPCI
200027217,CC Sarlat-Périgord Noir,1982_1990,1986,8,14685,15639,1270,1366,954,96,858,0.00789868504083868,0.000794836230524647,0.00710384881031404,EPCI
200027217,CC Sarlat-Périgord Noir,1990_1999,1994.5,9,15639,15863,1519,1446,224,-73,297,0.00158142235070047,-0.000515374248219349,0.00209679659891982,EPCI
200027217,CC Sarlat-Périgord Noir,1999_2010,2004.5,11,15863,16844,1846,1588,981,-258,1239,0.00546991994275303,-0.00143857221736012,0.00690849216011316,EPCI
200027308,CC d'Auberive Vingeanne et Montsaugeonnais,2010_2015,2012.5,5,8531,8445,396,415,-86,19,-105,-0.00202435575575977,0.000447241387900413,-0.00247159714366018,EPCI
200027308,CC d'Auberive Vingeanne et Montsaugeonnais,1968_1975,1971.5,7,9204,8574,887,868,-630,-19,-611,-0.0100779881412736,-0.000303939324895553,-0.00977404881637803,EPCI
200027308,CC d'Auberive Vingeanne et Montsaugeonnais,1975_1982,1978.5,7,8574,8399,824,654,-175,-170,-5,-0.00294162449516622,-0.00285757808101861,-8.40464141476064e-05,EPCI
200027308,CC d'Auberive Vingeanne et Montsaugeonnais,1982_1990,1986,8,8399,8162,849,768,-237,-81,-156,-0.00357153361701612,-0.00122065072986627,-0.00235088288714985,EPCI
200027308,CC d'Auberive Vingeanne et Montsaugeonnais,1990_1999,1994.5,9,8162,8026,834,853,-136,19,-155,-0.00186525437339236,0.000260587008047461,-0.00212584138143982,EPCI
200027308,CC d'Auberive Vingeanne et Montsaugeonnais,1999_2010,2004.5,11,8026,8531,1071,1010,505,-61,566,0.00556271622901172,-0.00067193205934597,0.00623464828835769,EPCI
200027548,CC des Savanes,2010_2015,2012.5,5,30962,31151,420,3879,189,3459,-3270,0.00121788128155065,0.0222891605972682,-0.0210712793157176,EPCI
200027548,CC des Savanes,1968_1975,1971.5,7,6333,8150,328,1446,1817,1118,699,0.036691962687101,0.0225765626220027,0.0141154000650983,EPCI
200027548,CC des Savanes,1975_1982,1978.5,7,8150,10128,317,1288,1978,971,1007,0.0315276391836308,0.0154769148874143,0.0160507242962165,EPCI
200027548,CC des Savanes,1982_1990,1986,8,10128,19005,391,2506,8877,2115,6762,0.0818524244054391,0.0195018449495892,0.0623505794558498,EPCI
200027548,CC des Savanes,1990_1999,1994.5,9,19005,23559,641,5480,4554,4839,-285,0.0241544161715053,0.0256660561822385,-0.0015116400107332,EPCI
200027548,CC des Savanes,1999_2010,2004.5,11,23559,30962,890,8885,7403,7995,-592,0.0251522698934938,0.0271636360662547,-0.00201136617276082,EPCI
200029734,CC des 4B Sud Charente,2010_2015,2012.5,5,19843,20085,1164,939,242,-225,467,0.00242733476005852,-0.00225681950831887,0.00468415426837739,EPCI
200029734,CC des 4B Sud Charente,1968_1975,1971.5,7,21591,20599,1865,2158,-992,293,-1285,-0.00669662418475769,0.00197793436102218,-0.00867455854577988,EPCI
200029734,CC des 4B Sud Charente,1975_1982,1978.5,7,20599,20006,1768,1737,-593,-31,-562,-0.00416420588713062,-0.000217690358349156,-0.00394651552878147,EPCI
200029734,CC des 4B Sud Charente,1982_1990,1986,8,20006,19346,1890,1731,-660,-159,-501,-0.00418453891617876,-0.00100809346617034,-0.00317644545000842,EPCI
200029734,CC des 4B Sud Charente,1990_1999,1994.5,9,19346,18988,2043,1668,-358,-375,17,-0.00207323443787033,-0.00217168411788093,9.84496800106021e-05,EPCI
200029734,CC des 4B Sud Charente,1999_2010,2004.5,11,18988,19843,2515,2022,855,-493,1348,0.00401203579131626,-0.00231337268434961,0.00632540847566587,EPCI
200029999,CC Rives de l'Ain - Pays du Cerdon,2010_2015,2012.5,5,13423,14290,689,883,867,194,673,0.0125967466566932,0.00281864919423123,0.00977809746246196,EPCI
200029999,CC Rives de l'Ain - Pays du Cerdon,1968_1975,1971.5,7,9293,9280,897,883,-13,-14,1,-0.0001999631157239,-0.000215344893856508,1.53817781326077e-05,EPCI
200029999,CC Rives de l'Ain - Pays du Cerdon,1975_1982,1978.5,7,9280,9404,844,768,124,-76,200,0.00189802524246874,-0.00116330579377116,0.0030613310362399,EPCI
200029999,CC Rives de l'Ain - Pays du Cerdon,1982_1990,1986,8,9404,10319,1024,1015,915,-9,924,0.0116740820472447,-0.000114827036530276,0.011788909083775,EPCI
200029999,CC Rives de l'Ain - Pays du Cerdon,1990_1999,1994.5,9,10319,11200,1211,1232,881,21,860,0.00914454958340882,0.000217974507663547,0.00892657507574528,EPCI
200029999,CC Rives de l'Ain - Pays du Cerdon,1999_2010,2004.5,11,11200,13423,1445,1848,2223,403,1820,0.0165958309196694,0.00300860092695762,0.0135872299927118,EPCI
200030195,Métropole Nice Côte d'Azur,2010_2015,2012.5,5,538291,538574,27375,33484,283,6109,-5826,0.000105125482399604,0.00226929884091583,-0.00216417335851623,EPCI
200030195,Métropole Nice Côte d'Azur,1968_1975,1971.5,7,414300,461768,39056,33867,47468,-5189,52657,0.0156167220541521,-0.00170715367698229,0.0173238757311344,EPCI
200030195,Métropole Nice Côte d'Azur,1975_1982,1978.5,7,461768,477817,42869,36064,16049,-6805,22854,0.00489267502880231,-0.00207456250052961,0.00696723752933192,EPCI
200030195,Métropole Nice Côte d'Azur,1982_1990,1986,8,477817,508894,50053,46809,31077,-3244,34321,0.0079075923327887,-0.000825440986181631,0.00873303331897034,EPCI
200030195,Métropole Nice Côte d'Azur,1990_1999,1994.5,9,508894,520906,54723,53651,12012,-1072,13084,0.00259556931935179,-0.000231639219975451,0.00282720853932724,EPCI
200030195,Métropole Nice Côte d'Azur,1999_2010,2004.5,11,520906,538291,62995,68276,17385,5281,12104,0.00298897655601604,0.000907954281985661,0.00208102227403038,EPCI
200030385,CA de Blois Agglopolys,2010_2015,2012.5,5,103958,105425,4400,6669,1467,2269,-802,0.00280649650097886,0.00434079111160261,-0.00153429461062375,EPCI
200030385,CA de Blois Agglopolys,1968_1975,1971.5,7,75501,86763,5740,10633,11262,4893,6369,0.0200606147521982,0.00871573326074462,0.0113448814914536,EPCI
200030385,CA de Blois Agglopolys,1975_1982,1978.5,7,86763,90846,5703,9850,4083,4147,-64,0.00659098295007987,0.00669429495321607,-0.000103312003136202,EPCI
200030385,CA de Blois Agglopolys,1982_1990,1986,8,90846,97697,6477,10455,6851,3978,2873,0.00912955838118856,0.00530103389875465,0.00382852448243391,EPCI
200030385,CA de Blois Agglopolys,1990_1999,1994.5,9,97697,101314,7520,11466,3617,3946,-329,0.00404747484990398,0.00441563056613798,-0.000368155716234008,EPCI
200030385,CA de Blois Agglopolys,1999_2010,2004.5,11,101314,103958,9543,14210,2644,4667,-2023,0.0023447780075756,0.00413883470550504,-0.00179405669792944,EPCI
200030435,CC d'Aire-sur-l'Adour,2010_2015,2012.5,5,12894,12837,705,536,-57,-169,112,-0.000885699693400577,-0.00262602189797715,0.00174032220457657,EPCI
200030435,CC d'Aire-sur-l'Adour,1968_1975,1971.5,7,11897,11753,1010,1123,-144,113,-257,-0.00173816483072098,0.00136397656855188,-0.00310214139927286,EPCI
200030435,CC d'Aire-sur-l'Adour,1975_1982,1978.5,7,11753,12074,1041,904,321,-137,458,0.00385682608867843,-0.00164605973255123,0.00550288582122967,EPCI
200030435,CC d'Aire-sur-l'Adour,1982_1990,1986,8,12074,12311,1110,1059,237,-51,288,0.00243280338676311,-0.000523514652847757,0.00295631803961086,EPCI
200030435,CC d'Aire-sur-l'Adour,1990_1999,1994.5,9,12311,12192,1223,1007,-119,-216,97,-0.00107865924190442,-0.00195790248950719,0.000879243247602765,EPCI
200030435,CC d'Aire-sur-l'Adour,1999_2010,2004.5,11,12192,12894,1462,1212,702,-250,952,0.00510225310869816,-0.00181704170537684,0.006919294814075,EPCI
200030526,CC du Ried de Marckolsheim,2010_2015,2012.5,5,19289,20046,709,1134,757,425,332,0.00772864243333982,0.00433906609533609,0.00338957633800372,EPCI
200030526,CC du Ried de Marckolsheim,1968_1975,1971.5,7,14077,13756,1143,1544,-321,401,-722,-0.00328988603720126,0.0041097953299617,-0.00739968136716296,EPCI
200030526,CC du Ried de Marckolsheim,1975_1982,1978.5,7,13756,14127,1041,1332,371,291,80,0.00380906000823633,0.00298769935956003,0.000821360648676298,EPCI
200030526,CC du Ried de Marckolsheim,1982_1990,1986,8,14127,14492,1104,1426,365,322,43,0.00319370317552803,0.00281745869183569,0.000376244483692343,EPCI
200030526,CC du Ried de Marckolsheim,1990_1999,1994.5,9,14492,15893,1160,1606,1401,446,955,0.0103063020036518,0.00328094981700835,0.00702535218664344,EPCI
200030526,CC du Ried de Marckolsheim,1999_2010,2004.5,11,15893,19289,1440,2339,3396,899,2497,0.0177609947309361,0.00470174742730021,0.0130592473036359,EPCI
200030633,CC du Caudrésis et du Catésis,2010_2015,2012.5,5,65030,65508,3388,4452,478,1064,-586,0.00146578735899161,0.0032627567990943,-0.00179696944010269,EPCI
200030633,CC du Caudrésis et du Catésis,1968_1975,1971.5,7,74413,71832,7284,8299,-2581,1015,-3596,-0.00503024836105803,0.00197818755771945,-0.00700843591877748,EPCI
200030633,CC du Caudrésis et du Catésis,1975_1982,1978.5,7,71832,68321,6956,7219,-3511,263,-3774,-0.00713341736582196,0.0005343459889522,-0.00766776335477416,EPCI
200030633,CC du Caudrésis et du Catésis,1982_1990,1986,8,68321,64966,6806,7564,-3355,758,-4113,-0.00627437466772152,0.00141757853893678,-0.0076919532066583,EPCI
200030633,CC du Caudrésis et du Catésis,1990_1999,1994.5,9,64966,63146,6671,7200,-1820,529,-2349,-0.00315219365916386,0.000916214530603122,-0.00406840818976698,EPCI
200030633,CC du Caudrésis et du Catésis,1999_2010,2004.5,11,63146,65030,7455,9362,1884,1907,-23,0.00267622893710984,0.00270890052179854,-3.26715846887078e-05,EPCI
200030658,CC du Trièves,2010_2015,2012.5,5,9565,10002,422,545,437,123,314,0.0089749293347432,0.00252612427499637,0.00644880505974683,EPCI
200030658,CC du Trièves,1968_1975,1971.5,7,6153,5734,585,479,-419,-106,-313,-0.0100246152410424,-0.00253606018031143,-0.00748855506073093,EPCI
200030658,CC du Trièves,1975_1982,1978.5,7,5734,6121,615,480,387,-135,522,0.00937396501704724,-0.00326998779664438,0.0126439528136916,EPCI
200030658,CC du Trièves,1982_1990,1986,8,6121,6992,634,680,871,46,825,0.0167691951556825,0.000885629135661764,0.0158835660200208,EPCI
200030658,CC du Trièves,1990_1999,1994.5,9,6992,7707,738,788,715,50,665,0.0108767675207486,0.000760613113339064,0.0101161544074096,EPCI
200030658,CC du Trièves,1999_2010,2004.5,11,7707,9565,972,1056,1858,84,1774,0.0198287189057926,0.00089645446075704,0.0189322644450356,EPCI
200030674,CA Val de Garonne Agglomération,2010_2015,2012.5,5,59234,60338,3292,2972,1104,-320,1424,0.00370010581638902,-0.00107249443953305,0.00477260025592207,EPCI
200030674,CA Val de Garonne Agglomération,1968_1975,1971.5,7,51637,52720,4540,5173,1083,633,450,0.00296960347742958,0.00173569621533973,0.00123390726208985,EPCI
200030674,CA Val de Garonne Agglomération,1975_1982,1978.5,7,52720,54063,4490,4687,1343,197,1146,0.00360005655129614,0.000528079777070245,0.00307197677422589,EPCI
200030674,CA Val de Garonne Agglomération,1982_1990,1986,8,54063,55441,4963,4960,1378,-3,1381,0.00315112426596831,-6.86021248033739e-06,0.00315798447844865,EPCI
200030674,CA Val de Garonne Agglomération,1990_1999,1994.5,9,55441,54534,5576,4894,-907,-682,-225,-0.0018311028010739,-0.00137686009959471,-0.000454242701479193,EPCI
200030674,CA Val de Garonne Agglomération,1999_2010,2004.5,11,54534,59234,6909,6433,4700,-476,5176,0.00754388928284722,-0.000764019425241548,0.00830790870808876,EPCI
200032514,CC Berry-Loire-Vauvise,2010_2015,2012.5,5,5908,5721,445,276,-187,-169,-18,-0.00641210403462811,-0.00579489615963717,-0.000617207874990941,EPCI
200032514,CC Berry-Loire-Vauvise,1968_1975,1971.5,7,6641,6131,772,464,-510,-308,-202,-0.0113500517022889,-0.00685454102804896,-0.0044955106742399,EPCI
200032514,CC Berry-Loire-Vauvise,1975_1982,1978.5,7,6131,5771,704,327,-360,-377,17,-0.00860738438453457,-0.00901384420269314,0.000406459818158577,EPCI
200032514,CC Berry-Loire-Vauvise,1982_1990,1986,8,5771,5619,791,397,-152,-394,242,-0.00333089815907539,-0.00863403864918226,0.00530314049010687,EPCI
200032514,CC Berry-Loire-Vauvise,1990_1999,1994.5,9,5619,5635,832,388,16,-444,460,0.000315987175842025,-0.0087686441296162,0.00908463130545822,EPCI
200032514,CC Berry-Loire-Vauvise,1999_2010,2004.5,11,5635,5908,975,610,273,-365,638,0.00431019110275255,-0.00576270971613436,0.0100729008188869,EPCI
200033025,CA de Bar-le-Duc - Sud Meuse,2010_2015,2012.5,5,36591,35661,1957,1691,-930,-266,-664,-0.00513569775018652,-0.00146892000166625,-0.00366677774852027,EPCI
200033025,CA de Bar-le-Duc - Sud Meuse,1968_1975,1971.5,7,40847,41393,2843,5568.20285369969,546,2725.20285369969,-2179.20285369969,0.00189871531188457,0.00947689448042329,-0.00757817916853872,EPCI
200033025,CA de Bar-le-Duc - Sud Meuse,1975_1982,1978.5,7,41393,41587,2849,4507.45362452668,194,1658.45362452668,-1464.45362452668,0.000668199434307404,0.00571225656563811,-0.00504405713133071,EPCI
200033025,CA de Bar-le-Duc - Sud Meuse,1982_1990,1986,8,41587,40726,3024,4683.65375528876,-861,1659.65375528876,-2520.65375528876,-0.00261169723160759,0.00503427772138769,-0.00764597495299528,EPCI
200033025,CA de Bar-le-Duc - Sud Meuse,1990_1999,1994.5,9,40726,39144,3423,4334,-1582,911,-2493,-0.00439249743359038,0.00252943436283239,-0.00692193179642277,EPCI
200033025,CA de Bar-le-Duc - Sud Meuse,1999_2010,2004.5,11,39144,36591,4274,4357,-2553,83,-2636,-0.00611259122079066,0.000198725057315168,-0.00631131627810583,EPCI
200033090,CC Plaines et Monts de France,2010_2015,2012.5,5,22633,24121,561,1553,1488,992,496,0.0128161948182746,0.00854412987884971,0.00427206493942485,EPCI
200033090,CC Plaines et Monts de France,1968_1975,1971.5,7,7061,9266,580,739,2205,159,2046,0.0395870698272722,0.00285457782427949,0.0367324920029927,EPCI
200033090,CC Plaines et Monts de France,1975_1982,1978.5,7,9266,11940,655,947,2674,292,2382,0.036884279662764,0.00402775230423601,0.032856527358528,EPCI
200033090,CC Plaines et Monts de France,1982_1990,1986,8,11940,16347,781,1514,4407,733,3674,0.0400499967419152,0.00666136773583478,0.0333886290060805,EPCI
200033090,CC Plaines et Monts de France,1990_1999,1994.5,9,16347,18559,866,1909,2212,1043,1169,0.0142010517167117,0.00669606552465204,0.00750498619205967,EPCI
200033090,CC Plaines et Monts de France,1999_2010,2004.5,11,18559,22633,1101,3206,4074,2105,1969,0.018205015508596,0.00940637153794663,0.00879864397064936,EPCI
200033116,CC Cluses-Arve et Montagnes,2010_2015,2012.5,5,43685,45776,1394,3359,2091,1965,126,0.00939488597619187,0.00882876659168676,0.000566119384505107,EPCI
200033116,CC Cluses-Arve et Montagnes,1968_1975,1971.5,7,25560,29663,1291,3689,4103,2398,1705,0.0214951699919339,0.012562860745956,0.0089323092459779,EPCI
200033116,CC Cluses-Arve et Montagnes,1975_1982,1978.5,7,29663,32572,1505,3894,2909,2389,520,0.0134543554949174,0.0110493142926633,0.00240504120225405,EPCI
200033116,CC Cluses-Arve et Montagnes,1982_1990,1986,8,32572,36467,1637,4709,3895,3072,823,0.0142194884726281,0.0112149598428533,0.00300452862977482,EPCI
200033116,CC Cluses-Arve et Montagnes,1990_1999,1994.5,9,36467,40139,1946,5289,3672,3343,329,0.0107170975187105,0.00975687826934894,0.00096021924936159,EPCI
200033116,CC Cluses-Arve et Montagnes,1999_2010,2004.5,11,40139,43685,2750,6847,3546,4097,-551,0.00772572362522084,0.00892619562677095,-0.00120047200155011,EPCI
200033173,CC de la Haute Vallée de Chevreuse,2010_2015,2012.5,5,25406,25069,1190,1026,-337,-164,-173,-0.00266710564482275,-0.00129793865207992,-0.00136916699274284,EPCI
200033173,CC de la Haute Vallée de Chevreuse,1968_1975,1971.5,7,13656,17989,1098,1573,4333,475,3858,0.0401540030744041,0.00440183509354764,0.0357521679808564,EPCI
200033173,CC de la Haute Vallée de Chevreuse,1975_1982,1978.5,7,17989,21014,1109,1601,3025,492,2533,0.0224524051558166,0.00365176308649976,0.0188006420693168,EPCI
200033173,CC de la Haute Vallée de Chevreuse,1982_1990,1986,8,21014,21918,1301,1712,904,411,493,0.0052788008769229,0.00239998579691959,0.00287881508000331,EPCI
200033173,CC de la Haute Vallée de Chevreuse,1990_1999,1994.5,9,21918,24542,1742,2196,2624,454,2170,0.012643451995441,0.00218754847786975,0.0104559035175713,EPCI
200033173,CC de la Haute Vallée de Chevreuse,1999_2010,2004.5,11,24542,25406,2637,2655,864,18,846,0.00315035479252335,6.56323915109031e-05,0.00308472240101244,EPCI
200033181,CA Chartres Métropole,2010_2015,2012.5,5,133682,136373,5258,8703,2691,3445,-754,0.00399394127528341,0.0051130166084546,-0.0011190753331712,EPCI
200033181,CA Chartres Métropole,1968_1975,1971.5,7,84756,100596,6202,12715,15840,6513,9327,0.0247785751733995,0.0101883118752747,0.0145902632981248,EPCI
200033181,CA Chartres Métropole,1975_1982,1978.5,7,100596,111367,6619,12293,10771,5674,5097,0.0146373140953617,0.00771071582741458,0.00692659826794715,EPCI
200033181,CA Chartres Métropole,1982_1990,1986,8,111367,125156,7440,15189,13789,7749,6040,0.0146982099399411,0.00825994842444002,0.00643826151550106,EPCI
200033181,CA Chartres Métropole,1990_1999,1994.5,9,125156,129883,8629,16056,4727,7427,-2700,0.00412772747589085,0.00648543092097342,-0.00235770344508257,EPCI
200033181,CA Chartres Métropole,1999_2010,2004.5,11,129883,133682,10923,19573,3799,8650,-4851,0.00262432845197824,0.0059753727585185,-0.00335104430654026,EPCI
200033207,CC Vierzon-Sologne-Berry,2010_2015,2012.5,5,32596,32427,2354,1820,-169,-534,365,-0.00103909423847381,-0.00328329185411253,0.00224419761563871,EPCI
200033207,CC Vierzon-Sologne-Berry,1968_1975,1971.5,7,39100,40986,3593,4274,1886,681,1205,0.0067524209116907,0.00243817531328811,0.0043142455984026,EPCI
200033207,CC Vierzon-Sologne-Berry,1975_1982,1978.5,7,40986,39724,3433,3579,-1262,146,-1408,-0.00445789196123003,0.000515730765720748,-0.00497362272695078,EPCI
200033207,CC Vierzon-Sologne-Berry,1982_1990,1986,8,39724,37967,3557,3643,-1757,86,-1843,-0.00563881407759281,0.00027600342098633,-0.00591481749857914,EPCI
200033207,CC Vierzon-Sologne-Berry,1990_1999,1994.5,9,37967,35333,4126,3427,-2634,-699,-1935,-0.00795706141604802,-0.00211161197031798,-0.00584544944573004,EPCI
200033207,CC Vierzon-Sologne-Berry,1999_2010,2004.5,11,35333,32596,5001,3983,-2737,-1018,-1719,-0.00730300162499242,-0.00271627901141479,-0.00458672261357763,EPCI
200033298,CC des Coëvrons,2010_2015,2012.5,5,27436,27713,1478,1545,277,67,210,0.00201113914138085,0.000486448817590313,0.00152469032379053,EPCI
200033298,CC des Coëvrons,1968_1975,1971.5,7,24745,24353,1927,2723,-392,796,-1188,-0.00227860049373463,0.00462695406380807,-0.0069055545575427,EPCI
200033298,CC des Coëvrons,1975_1982,1978.5,7,24353,25011,1935,2445,658,510,148,0.00381593117818468,0.00295763662746837,0.000858294550716312,EPCI
200033298,CC des Coëvrons,1982_1990,1986,8,25011,25187,2300,2497,176,197,-21,0.000876916803991934,0.000981548922650063,-0.000104632118658129,EPCI
200033298,CC des Coëvrons,1990_1999,1994.5,9,25187,25931,2411,2641,744,230,514,0.00323981196972745,0.00100155477558779,0.00223825719413966,EPCI
200033298,CC des Coëvrons,1999_2010,2004.5,11,25931,27436,3049,3662,1505,613,892,0.00514197987665321,0.00209437452783284,0.00304760534882038,EPCI
200033579,CU d'Arras,2010_2015,2012.5,5,106067,107345,4655,6778,1278,2123,-845,0.00239826659422593,0.00398397494486827,-0.00158570835064234,EPCI
200033579,CU d'Arras,1968_1975,1971.5,7,89167,98056,6327,13295,8889,6968,1921,0.013667953715752,0.0107141749905906,0.0029537787251614,EPCI
200033579,CU d'Arras,1975_1982,1978.5,7,98056,99989,6235,11870,1933,5635,-3702,0.00279266881167994,0.00814107022959984,-0.00534840141791989,EPCI
200033579,CU d'Arras,1982_1990,1986,8,99989,101467,6910,12951,1478,6041,-4563,0.00183586345355447,0.00750368817518439,-0.00566782472162992,EPCI
200033579,CU d'Arras,1990_1999,1994.5,9,101467,103002,7535,12189,1535,4654,-3119,0.00166970163001867,0.00506240481179603,-0.00339270318177735,EPCI
200033579,CU d'Arras,1999_2010,2004.5,11,103002,106067,9765,14943,3065,5178,-2113,0.00266924377644262,0.00450941085625445,-0.00184016707981183,EPCI
200033827,CC de Fium'orbu Castellu,2010_2015,2012.5,5,12226,12823,590,615,597,25,572,0.00958072446595137,0.000401202867083391,0.00917952159886798,EPCI
200033827,CC de Fium'orbu Castellu,1968_1975,1971.5,7,8561,8808,664,765,247,101,146,0.00407160851817689,0.00166490874629905,0.00240669977187784,EPCI
200033827,CC de Fium'orbu Castellu,1975_1982,1978.5,7,8808,10160,714,778,1352,64,1288,0.0206092168171677,0.000975584228031605,0.019633632589136,EPCI
200033827,CC de Fium'orbu Castellu,1982_1990,1986,8,10160,10494,890,917,334,27,307,0.00405133745868702,0.000327503327498651,0.00372383413118837,EPCI
200033827,CC de Fium'orbu Castellu,1990_1999,1994.5,9,10494,10556,998,949,62,-49,111,0.000654742403244146,-0.000517457705789729,0.00117220010903388,EPCI
200033827,CC de Fium'orbu Castellu,1999_2010,2004.5,11,10556,12226,1248,1208,1670,-40,1710,0.0134413897879719,-0.000321949455999328,0.0137633392439713,EPCI
200033868,CC des Ballons des Hautes-Vosges,2010_2015,2012.5,5,16004,15370,1013,708,-634,-305,-329,-0.00805163720770064,-0.00387342168509258,-0.00417821552260806,EPCI
200033868,CC des Ballons des Hautes-Vosges,1968_1975,1971.5,7,18169,19014,1525,2333,845,808,37,0.00651523308047763,0.00622995068523778,0.000285282395239849,EPCI
200033868,CC des Ballons des Hautes-Vosges,1975_1982,1978.5,7,19014,18562,1478,1903,-452,425,-877,-0.00343111020859077,0.00322615451028999,-0.00665726471888077,EPCI
200033868,CC des Ballons des Hautes-Vosges,1982_1990,1986,8,18562,17345,1730,1819,-1217,89,-1306,-0.00844070052488699,0.000617273908557882,-0.00905797443344487,EPCI
200033868,CC des Ballons des Hautes-Vosges,1990_1999,1994.5,9,17345,16867,1780,1860,-478,80,-558,-0.00310020996534199,0.000518863592525857,-0.00361907355786785,EPCI
200033868,CC des Ballons des Hautes-Vosges,1999_2010,2004.5,11,16867,16004,2171,1814,-863,-357,-506,-0.00476319793740476,-0.00197040748974913,-0.00279279044765563,EPCI
200034023,CC Tarn-Agout,2010_2015,2012.5,5,28522,30725,1121,1870,2203,749,1454,0.0149914483907851,0.00509695635256381,0.00989449203822134,EPCI
200034023,CC Tarn-Agout,1968_1975,1971.5,7,15627,16519,1617,1511,892,-106,998,0.00796167636659528,-0.000946118491994507,0.00890779485858979,EPCI
200034023,CC Tarn-Agout,1975_1982,1978.5,7,16519,17709,1606,1369,1190,-237,1427,0.00998693290385799,-0.00198899420018012,0.0119759271040381,EPCI
200034023,CC Tarn-Agout,1982_1990,1986,8,17709,18882,1754,1595,1173,-159,1332,0.00804923509635991,-0.00109107278799763,0.00914030788435754,EPCI
200034023,CC Tarn-Agout,1990_1999,1994.5,9,18882,20514,1984,1933,1632,-51,1683,0.0092534949061045,-0.000289171715815766,0.00954266662192026,EPCI
200034023,CC Tarn-Agout,1999_2010,2004.5,11,20514,28522,2314,3645,8008,1331,6677,0.0304140790491934,0.00505508731449505,0.0253589917346983,EPCI
200034031,CC des Monts d'Alban et du Villefranchois,2010_2015,2012.5,5,6253,6327,279,288,74,9,65,0.00235573871832862,0.000286508763039967,0.00206922995528865,EPCI
200034031,CC des Monts d'Alban et du Villefranchois,1968_1975,1971.5,7,7513,6710,673,494,-803,-179,-624,-0.0160183062914189,-0.00357070588563385,-0.012447600405785,EPCI
200034031,CC des Monts d'Alban et du Villefranchois,1975_1982,1978.5,7,6710,6434,625,430,-276,-195,-81,-0.00598239410015211,-0.00422669148380312,-0.00175570261634899,EPCI
200034031,CC des Monts d'Alban et du Villefranchois,1982_1990,1986,8,6434,6114,644,412,-320,-232,-88,-0.00635661138794008,-0.00460854325625656,-0.00174806813168352,EPCI
200034031,CC des Monts d'Alban et du Villefranchois,1990_1999,1994.5,9,6114,5765,674,446,-349,-228,-121,-0.00650939590843624,-0.00425255663932225,-0.002256839269114,EPCI
200034031,CC des Monts d'Alban et du Villefranchois,1999_2010,2004.5,11,5765,6253,745,589,488,-156,644,0.00741427745391632,-0.00237013787461259,0.00978441532852891,EPCI
200034049,CC Centre Tarn,2010_2015,2012.5,5,10489,10970,548,637,481,89,392,0.00900776498115152,0.00166671742894488,0.00734104755220665,EPCI
200034049,CC Centre Tarn,1968_1975,1971.5,7,9251,8766,824,795,-485,-29,-456,-0.00766349195352811,-0.00045822941577797,-0.00720526253775014,EPCI
200034049,CC Centre Tarn,1975_1982,1978.5,7,8766,8955,727,639,189,-88,277,0.00305199552902646,-0.00142103495531391,0.00447303048434037,EPCI
200034049,CC Centre Tarn,1982_1990,1986,8,8955,8940,826,750,-15,-76,61,-0.000209533835625386,-0.00106163810050196,0.000852104264876571,EPCI
200034049,CC Centre Tarn,1990_1999,1994.5,9,8940,9233,936,864,293,-72,365,0.00358958647895391,-0.00088208268424806,0.00447166916320197,EPCI
200034049,CC Centre Tarn,1999_2010,2004.5,11,9233,10489,1073,1208,1256,135,1121,0.0116623047291986,0.00125351205289953,0.0104087926762991,EPCI
200034056,CC du Lautrécois et du Pays d'Agout,2010_2015,2012.5,5,13862,14502,650,748,640,98,542,0.00906792425049585,0.00138852590085718,0.00767939834963867,EPCI
200034056,CC du Lautrécois et du Pays d'Agout,1968_1975,1971.5,7,11066,10223,1080,834,-843,-246,-597,-0.0112557829557151,-0.00328460570237948,-0.00797117725333557,EPCI
200034056,CC du Lautrécois et du Pays d'Agout,1975_1982,1978.5,7,10223,10479,991,772,256,-219,475,0.00353955960100572,-0.00302798262742286,0.00656754222842857,EPCI
200034056,CC du Lautrécois et du Pays d'Agout,1982_1990,1986,8,10479,11077,1043,891,598,-152,750,0.00696132214351319,-0.00176943305320068,0.00873075519671387,EPCI
200034056,CC du Lautrécois et du Pays d'Agout,1990_1999,1994.5,9,11077,11508,1026,999,431,-27,458,0.0042502913261846,-0.000266259549436158,0.00451655087562075,EPCI
200034056,CC du Lautrécois et du Pays d'Agout,1999_2010,2004.5,11,11508,13862,1414,1551,2354,137,2217,0.0170629218943326,0.000993041758506186,0.0160698801358264,EPCI
200034064,CC du Cordais et du Causse (4 C),2010_2015,2012.5,5,4791,4691,270,164,-100,-106,6,-0.00420978959882268,-0.00446237697475204,0.000252587375929361,EPCI
200034064,CC du Cordais et du Causse (4 C),1968_1975,1971.5,7,5260,4827,550,319,-433,-231,-202,-0.0121972699910679,-0.00650708860955352,-0.00569018138151433,EPCI
200034064,CC du Cordais et du Causse (4 C),1975_1982,1978.5,7,4827,4679,521,228,-148,-293,145,-0.00443879711800788,-0.00878761861875884,0.00434882150075096,EPCI
200034064,CC du Cordais et du Causse (4 C),1982_1990,1986,8,4679,4494,558,276,-185,-282,97,-0.00502996192574245,-0.00766729331383444,0.00263733138809199,EPCI
200034064,CC du Cordais et du Causse (4 C),1990_1999,1994.5,9,4494,4492,571,319,-2,-252,250,-4.94584309960189e-05,-0.00623176230549838,0.00618230387450236,EPCI
200034064,CC du Cordais et du Causse (4 C),1999_2010,2004.5,11,4492,4791,655,432,299,-223,522,0.00587547703167091,-0.00438204474268432,0.0102575217743552,EPCI
200034098,CC des Montagnes du Giffre,2010_2015,2012.5,5,11478,11970,487,642,492,155,337,0.00842960266703408,0.00265566750689082,0.00577393516014326,EPCI
200034098,CC des Montagnes du Giffre,1968_1975,1971.5,7,6817,7419,566,664,602,98,504,0.0121626253846023,0.00197996227191201,0.0101826631126903,EPCI
200034098,CC des Montagnes du Giffre,1975_1982,1978.5,7,7419,8175,607,692,756,85,671,0.0139588763825653,0.00156945038692864,0.0123894259956367,EPCI
200034098,CC des Montagnes du Giffre,1982_1990,1986,8,8175,9114,711,937,939,226,713,0.0136841545747579,0.00329352389126229,0.0103906306834956,EPCI
200034098,CC des Montagnes du Giffre,1990_1999,1994.5,9,9114,10418,687,1183,1304,496,808,0.0149690851539355,0.00569376245119018,0.00927532270274529,EPCI
200034098,CC des Montagnes du Giffre,1999_2010,2004.5,11,10418,11478,949,1510,1060,561,499,0.00884773736284816,0.00468262326467719,0.00416511409817097,EPCI
200034130,CC Gally Mauldre,2010_2015,2012.5,5,22226,21822,538,858,-404,320,-724,-0.0036621059800499,0.00290067800399992,-0.00656278398404982,EPCI
200034130,CC Gally Mauldre,1968_1975,1971.5,7,8692,14134,622,1252,5442,630,4812,0.0719230854322865,0.00832626678102545,0.0635968186512611,EPCI
200034130,CC Gally Mauldre,1975_1982,1978.5,7,14134,18096,703,1402,3962,699,3263,0.0359315774557019,0.00633926618918112,0.0295923112665207,EPCI
200034130,CC Gally Mauldre,1982_1990,1986,8,18096,21347,864,1694,3251,830,2421,0.0208672762975808,0.00532754208766289,0.0155397342099179,EPCI
200034130,CC Gally Mauldre,1990_1999,1994.5,9,21347,21631,1022,1924,284,902,-618,0.0014695516679446,0.00466737888903532,-0.00319782722109072,EPCI
200034130,CC Gally Mauldre,1999_2010,2004.5,11,21631,22226,1277,2309,595,1032,-437,0.00246989096593975,0.00428391172579802,-0.00181402075985827,EPCI
200034197,CC de Montaigne Montravel et Gurson,2010_2015,2012.5,5,11884,12003,582,551,119,-31,150,0.00199471899886472,-0.000519632680376524,0.00251435167924124,EPCI
200034197,CC de Montaigne Montravel et Gurson,1968_1975,1971.5,7,10032,9513,850,794,-519,-56,-463,-0.00755995011223953,-0.000815717160472859,-0.00674423295176667,EPCI
200034197,CC de Montaigne Montravel et Gurson,1975_1982,1978.5,7,9513,9605,888,672,92,-216,308,0.00137587593516719,-0.00323031741300123,0.00460619334816843,EPCI
200034197,CC de Montaigne Montravel et Gurson,1982_1990,1986,8,9605,10098,894,769,493,-125,618,0.00627631255026095,-0.0015913571374901,0.00786766968775106,EPCI
200034197,CC de Montaigne Montravel et Gurson,1990_1999,1994.5,9,10098,10617,1075,891,519,-184,703,0.0055843240416209,-0.00197979888951493,0.00756412293113583,EPCI
200034197,CC de Montaigne Montravel et Gurson,1999_2010,2004.5,11,10617,11884,1334,1257,1267,-77,1344,0.0103014682977833,-0.000626056084395672,0.010927524382179,EPCI
200034205,CC de la Costa Verde,2010_2015,2012.5,5,9088,9951,499,439,863,-60,923,0.0183092331057992,-0.00127294784049589,0.0195821809462951,EPCI
200034205,CC de la Costa Verde,1968_1975,1971.5,7,5937,5740,423,539,-197,116,-313,-0.00480907703229361,0.00283174079058913,-0.00764081782288274,EPCI
200034205,CC de la Costa Verde,1975_1982,1978.5,7,5740,5896,485,481,156,-4,160,0.00383805289851669,-9.84116127824791e-05,0.00393646451129917,EPCI
200034205,CC de la Costa Verde,1982_1990,1986,8,5896,6911,627,642,1015,15,1000,0.0200534458114039,0.000296356342040452,0.0197570894693634,EPCI
200034205,CC de la Costa Verde,1990_1999,1994.5,9,6911,7739,675,660,828,-15,843,0.0126525001925495,-0.000229211960009954,0.0128817121525594,EPCI
200034205,CC de la Costa Verde,1999_2010,2004.5,11,7739,9088,826,753,1349,-73,1422,0.01471470000621,-0.000796273610417591,0.0155109736166276,EPCI
200034270,CC du Pays de Barr,2010_2015,2012.5,5,23163,24000,1029,1330,837,301,536,0.00712479188308723,0.00256220114314129,0.00456259073994595,EPCI
200034270,CC du Pays de Barr,1968_1975,1971.5,7,17770,18450,1740,1785,680,45,635,0.00537909111263324,0.000355969264806611,0.00502312184782663,EPCI
200034270,CC du Pays de Barr,1975_1982,1978.5,7,18450,18393,1735,1492,-57,-243,186,-0.000441932752923147,-0.0018840291045671,0.00144209635164395,EPCI
200034270,CC du Pays de Barr,1982_1990,1986,8,18393,18766,1914,1820,373,-94,467,0.00251272216042109,-0.000633232930508264,0.00314595509092935,EPCI
200034270,CC du Pays de Barr,1990_1999,1994.5,9,18766,20713,1910,2293,1947,383,1564,0.0110286836294899,0.00216948424760896,0.00885919938188098,EPCI
200034270,CC du Pays de Barr,1999_2010,2004.5,11,20713,23163,2349,2928,2450,579,1871,0.0102149707194505,0.00241406859043341,0.00780090212901713,EPCI
200034379,CC Pays d'Uzès,2010_2015,2012.5,5,27619,28243,1386,1289,624,-97,721,0.0044783374348023,-0.000696151812781768,0.00517448924758407,EPCI
200034379,CC Pays d'Uzès,1968_1975,1971.5,7,14989,15868,1301,1455,879,154,725,0.00817435823377166,0.00143214012286785,0.00674221811090382,EPCI
200034379,CC Pays d'Uzès,1975_1982,1978.5,7,15868,17926,1444,1364,2058,-80,2138,0.0175737280960071,-0.000683138118406496,0.0182568662144136,EPCI
200034379,CC Pays d'Uzès,1982_1990,1986,8,17926,20723,1777,1923,2797,146,2651,0.0182892391787763,0.00095467605295007,0.0173345631258263,EPCI
200034379,CC Pays d'Uzès,1990_1999,1994.5,9,20723,23140,1984,2066,2417,82,2335,0.0123330465787836,0.000418415316284758,0.0119146312624989,EPCI
200034379,CC Pays d'Uzès,1999_2010,2004.5,11,23140,27619,2789,2791,4479,2,4477,0.0162156346306894,7.24073883933442e-06,0.0162083938918501,EPCI
200034411,CC du Piémont Cévenol,2010_2015,2012.5,5,20303,21394,1074,1006,1091,-68,1159,0.0105233551876345,-0.00065590114826686,0.0111792563359013,EPCI
200034411,CC du Piémont Cévenol,1968_1975,1971.5,7,13473,13155,1308,1044,-318,-264,-54,-0.00340643749379099,-0.00282798584390196,-0.000578451649889037,EPCI
200034411,CC du Piémont Cévenol,1975_1982,1978.5,7,13155,13589,1296,1009,434,-287,721,0.00464772840382843,-0.00307349781543493,0.00772122621926336,EPCI
200034411,CC du Piémont Cévenol,1982_1990,1986,8,13589,15002,1545,1204,1413,-341,1754,0.0124421276122311,-0.00300266490854267,0.0154447925207737,EPCI
200034411,CC du Piémont Cévenol,1990_1999,1994.5,9,15002,16209,1692,1453,1207,-239,1446,0.00863519425843751,-0.00170986862283891,0.0103450628812764,EPCI
200034411,CC du Piémont Cévenol,1999_2010,2004.5,11,16209,20303,2160,2028,4094,-132,4226,0.0206839179913751,-0.000666897209296903,0.021350815200672,EPCI
200034601,CC Causses Aigoual Cévennes,2010_2015,2012.5,5,5609,5574,400,199,-35,-201,166,-0.00125112098801738,-0.00718500910261412,0.00593388811459674,EPCI
200034601,CC Causses Aigoual Cévennes,1968_1975,1971.5,7,5768,5173,622,372,-595,-250,-345,-0.0154329030036096,-0.0064844130267267,-0.00894848997688285,EPCI
200034601,CC Causses Aigoual Cévennes,1975_1982,1978.5,7,5173,5084,637,313,-89,-324,235,-0.0024761346933605,-0.00901424315335732,0.00653810845999682,EPCI
200034601,CC Causses Aigoual Cévennes,1982_1990,1986,8,5084,5113,637,444,29,-193,222,0.000711248163436817,-0.00473347915666572,0.00544472732010253,EPCI
200034601,CC Causses Aigoual Cévennes,1990_1999,1994.5,9,5113,5074,722,416,-39,-306,267,-0.000850399862772022,-0.00667236815405741,0.00582196829128538,EPCI
200034601,CC Causses Aigoual Cévennes,1999_2010,2004.5,11,5074,5609,809,487,535,-322,857,0.00915464882946382,-0.00550990079081748,0.0146645496202813,EPCI
200034635,CC du Kochersberg,2010_2015,2012.5,5,24036,24793,730,1097,757,367,390,0.00622100030078743,0.00301599354080447,0.00320500675998295,EPCI
200034635,CC du Kochersberg,1968_1975,1971.5,7,10460,13157,931,1168,2697,237,2460,0.0333136585566676,0.00292745164179837,0.0303862069148692,EPCI
200034635,CC du Kochersberg,1975_1982,1978.5,7,13157,15908,885,1055,2751,170,2581,0.0274952323000877,0.00169908741948924,0.0257961448805984,EPCI
200034635,CC du Kochersberg,1982_1990,1986,8,15908,17558,1027,1389,1650,362,1288,0.0124123465018278,0.00272319359615858,0.00968915290566919,EPCI
200034635,CC du Kochersberg,1990_1999,1994.5,9,17558,20480,1109,1750,2922,641,2281,0.017251462871015,0.00378445848744716,0.0134670043835678,EPCI
200034635,CC du Kochersberg,1999_2010,2004.5,11,20480,24036,1390,2578,3556,1188,2368,0.01466133891096,0.00489810760017449,0.00976323131078551,EPCI
200034692,CA du Gard Rhodanien,2010_2015,2012.5,5,71259,73424,3197,4239,2165,1042,1123,0.00600389771505006,0.0028896357593913,0.00311426195565876,EPCI
200034692,CA du Gard Rhodanien,1968_1975,1971.5,7,47499,49429,3259,5312,1930,2053,-123,0.00570602315814694,0.0060696712661532,-0.000363648108006256,EPCI
200034692,CA du Gard Rhodanien,1975_1982,1978.5,7,49429,54302,3248,4652,4873,1404,3469,0.0135225801367038,0.00389610147997787,0.00962647865672595,EPCI
200034692,CA du Gard Rhodanien,1982_1990,1986,8,54302,60728,4172,6331,6426,2159,4267,0.0140786611461723,0.00473013218403143,0.00934852896214086,EPCI
200034692,CA du Gard Rhodanien,1990_1999,1994.5,9,60728,64504,4749,6819,3776,2070,1706,0.00672499643520941,0.00368663734663228,0.00303835908857713,EPCI
200034692,CA du Gard Rhodanien,1999_2010,2004.5,11,64504,71259,6281,8589,6755,2308,4447,0.00909510130901925,0.00310754904829259,0.00598755226072666,EPCI
200034700,CA Durance-Lubéron-Verdon Agglomération,2010_2015,2012.5,5,59777,61168,3173,3268,1391,95,1296,0.0046112402703864,0.000314930140680595,0.0042963101297058,EPCI
200034700,CA Durance-Lubéron-Verdon Agglomération,1968_1975,1971.5,7,34808,39173,2728,3719,4365,991,3374,0.0170204374142846,0.00386420469130723,0.0131562327229774,EPCI
200034700,CA Durance-Lubéron-Verdon Agglomération,1975_1982,1978.5,7,39173,42620,2972,2941,3447,-31,3478,0.0121208539873703,-0.000109006809866109,0.0122298607972364,EPCI
200034700,CA Durance-Lubéron-Verdon Agglomération,1982_1990,1986,8,42620,46633,3619,4084,4013,465,3548,0.0113116000487481,0.00131071368618686,0.0100008863625612,EPCI
200034700,CA Durance-Lubéron-Verdon Agglomération,1990_1999,1994.5,9,46633,50183,4469,4852,3550,383,3167,0.00818530446219667,0.000883090594090514,0.00730221386810616,EPCI
200034700,CA Durance-Lubéron-Verdon Agglomération,1999_2010,2004.5,11,50183,59777,6247,6678,9594,431,9163,0.0160312015567619,0.0007201842683932,0.0153110172883687,EPCI
200034718,"CC de Vitry, Champagne et Der",2010_2015,2012.5,5,25510,25304,1331,1442,-206,111,-317,-0.0016202951322406,0.000873071648925761,-0.00249336678116636,EPCI
200034718,"CC de Vitry, Champagne et Der",1968_1975,1971.5,7,28001,30374,1824,4402,2373,2578,-205,0.0116887508079275,0.0126985248979508,-0.00100977409002324,EPCI
200034718,"CC de Vitry, Champagne et Der",1975_1982,1978.5,7,30374,29783,1881,3629,-591,1748,-2339,-0.00280309516809862,0.00829071125860642,-0.011093806426705,EPCI
200034718,"CC de Vitry, Champagne et Der",1982_1990,1986,8,29783,28996,2060,3913,-787,1853,-2640,-0.00334188735898922,0.00786850988082213,-0.0112103972398113,EPCI
200034718,"CC de Vitry, Champagne et Der",1990_1999,1994.5,9,28996,28195,2240,3413,-801,1173,-1974,-0.00310774229389321,0.0045510383404953,-0.00765878063438851,EPCI
200034718,"CC de Vitry, Champagne et Der",1999_2010,2004.5,11,28195,25510,2760,3628,-2685,868,-3553,-0.00905638935256614,0.00292772661379047,-0.0119841159663566,EPCI
200034726,CC Bastides de Lomagne,2010_2015,2012.5,5,10692,11127,729,533,435,-196,631,0.00800764886466632,-0.0036080440861485,0.0116156929508148,EPCI
200034726,CC Bastides de Lomagne,1968_1975,1971.5,7,10084,9282,950,697,-802,-253,-549,-0.0117691903396138,-0.00371272463331955,-0.00805646570629421,EPCI
200034726,CC Bastides de Lomagne,1975_1982,1978.5,7,9282,8825,897,478,-457,-419,-38,-0.00718668537878597,-0.00658910541293506,-0.000597579965850912,EPCI
200034726,CC Bastides de Lomagne,1982_1990,1986,8,8825,8417,986,535,-408,-451,43,-0.00589942124445686,-0.00652117397365207,0.000621752729195208,EPCI
200034726,CC Bastides de Lomagne,1990_1999,1994.5,9,8417,8393,1039,644,-24,-395,371,-0.000317221355634723,-0.00522093481148814,0.00490371345585342,EPCI
200034726,CC Bastides de Lomagne,1999_2010,2004.5,11,8393,10692,1451,1064,2299,-387,2686,0.0222528706945864,-0.00374591603253803,0.0259987867271244,EPCI
200034825,CA du Grand Guéret,2010_2015,2012.5,5,29159,29446,1844,1360,287,-484,771,0.00196081277280769,-0.00330673652278369,0.00526754929559138,EPCI
200034825,CA du Grand Guéret,1968_1975,1971.5,7,27155,28139,2594,2737,984,143,841,0.00509799692749358,0.000740867439666241,0.00435712948782733,EPCI
200034825,CA du Grand Guéret,1975_1982,1978.5,7,28139,30001,2494,2507,1862,13,1849,0.00919547814456378,6.42004381736462e-05,0.00913127770639014,EPCI
200034825,CA du Grand Guéret,1982_1990,1986,8,30001,29553,2858,2568,-448,-290,-158,-0.00187891423875253,-0.00121626144919248,-0.000662652789560043,EPCI
200034825,CA du Grand Guéret,1990_1999,1994.5,9,29553,28910,3146,2533,-643,-613,-30,-0.00244120490246602,-0.00232730731759202,-0.000113897584873998,EPCI
200034825,CA du Grand Guéret,1999_2010,2004.5,11,28910,29159,3886,3076,249,-810,1059,0.000779945542316307,-0.00253717224608919,0.0033171177884055,EPCI
200034833,CC des Bastides Dordogne-Périgord,2010_2015,2012.5,5,19085,18942,1369,670,-143,-699,556,-0.00150307073463918,-0.00734717792666284,0.00584410719202366,EPCI
200034833,CC des Bastides Dordogne-Périgord,1968_1975,1971.5,7,18849,18063,1693,1395,-786,-298,-488,-0.00606641241094252,-0.00229998842043368,-0.00376642399050884,EPCI
200034833,CC des Bastides Dordogne-Périgord,1975_1982,1978.5,7,18063,17874,1853,1109,-189,-744,555,-0.00150151505247764,-0.00591072592086437,0.00440921086838673,EPCI
200034833,CC des Bastides Dordogne-Périgord,1982_1990,1986,8,17874,18391,2102,1259,517,-843,1360,0.00357064355830272,-0.00582215187553036,0.00939279543383308,EPCI
200034833,CC des Bastides Dordogne-Périgord,1990_1999,1994.5,9,18391,18425,2352,1385,34,-967,1001,0.000205245899897788,-0.00583743485885768,0.00604268075875546,EPCI
200034833,CC des Bastides Dordogne-Périgord,1999_2010,2004.5,11,18425,19085,2859,1691,660,-1168,1828,0.0032046008918698,-0.0056711724874302,0.0088757733793,EPCI
200034874,CC Côtes de Meuse Woëvre,2010_2015,2012.5,5,5897,6019,219,348,122,129,-7,0.0041038750364224,0.00433934327621713,-0.000235468239794727,EPCI
200034874,CC Côtes de Meuse Woëvre,1968_1975,1971.5,7,5522,5096,575,459,-426,-116,-310,-0.0114036505361971,-0.00310521939483301,-0.00829843114136407,EPCI
200034874,CC Côtes de Meuse Woëvre,1975_1982,1978.5,7,5096,4855,576,365,-241,-211,-30,-0.00689707900724557,-0.00603852145447641,-0.000858557552769158,EPCI
200034874,CC Côtes de Meuse Woëvre,1982_1990,1986,8,4855,5107,589,521,252,-68,320,0.00634542820803064,-0.0017122584053416,0.00805768661337224,EPCI
200034874,CC Côtes de Meuse Woëvre,1990_1999,1994.5,9,5107,5218,548,554,111,6,105,0.00239197166036131,0.000129295765424936,0.00226267589493638,EPCI
200034874,CC Côtes de Meuse Woëvre,1999_2010,2004.5,11,5218,5897,549,755,679,206,473,0.0111829358487863,0.00339276109698081,0.00779017475180546,EPCI
200034882,CC Pays du Mont-Blanc,2010_2015,2012.5,5,44826,44219,1675,2485,-607,810,-1417,-0.00272303923446371,0.00363370968684614,-0.00635674892130984,EPCI
200034882,CC Pays du Mont-Blanc,1968_1975,1971.5,7,30334,32377,1839,3877,2043,2038,5,0.00935478480648211,0.00933189008106243,2.28947254196834e-05,EPCI
200034882,CC Pays du Mont-Blanc,1975_1982,1978.5,7,32377,34812,1967,3419,2435,1452,983,0.0104129644353355,0.00620929131831913,0.00420367311701633,EPCI
200034882,CC Pays du Mont-Blanc,1982_1990,1986,8,34812,38667,2256,4719,3855,2463,1392,0.0132145971509525,0.00844294495014165,0.00477165220081087,EPCI
200034882,CC Pays du Mont-Blanc,1990_1999,1994.5,9,38667,42078,2821,5277,3411,2456,955,0.00943742267066616,0.00679516566378074,0.00264225700688543,EPCI
200034882,CC Pays du Mont-Blanc,1999_2010,2004.5,11,42078,44826,3575,6471,2748,2896,-148,0.00576777807879991,0.00607841532612975,-0.000310637247329835,EPCI
200034957,CC du Frontonnais,2010_2015,2012.5,5,23486,25509,774,1516,2023,742,1281,0.0166626655570139,0.00611156591364524,0.0105510996433687,EPCI
200034957,CC du Frontonnais,1968_1975,1971.5,7,7336,9051,800,696,1715,-104,1819,0.0304665335031584,-0.00184753322701369,0.0323140667301721,EPCI
200034957,CC du Frontonnais,1975_1982,1978.5,7,9051,11437,892,716,2386,-176,2562,0.0339904033945759,-0.00250725523782287,0.0364976586323988,EPCI
200034957,CC du Frontonnais,1982_1990,1986,8,11437,13907,1061,973,2470,-88,2558,0.0247434868991379,-0.000881549330819486,0.0256250362299573,EPCI
200034957,CC du Frontonnais,1990_1999,1994.5,9,13907,16294,1232,1604,2387,372,2015,0.017756316377775,0.0027672181367961,0.0149890982409789,EPCI
200034957,CC du Frontonnais,1999_2010,2004.5,11,16294,23486,1662,2989,7192,1327,5865,0.0337955721009124,0.00623564018046591,0.0275599319204465,EPCI
200035087,CA Terre de Provence,2010_2015,2012.5,5,55329,58868,2498,3542,3539,1044,2495,0.0124772931075337,0.00368078383844734,0.00879650926908631,EPCI
200035087,CA Terre de Provence,1968_1975,1971.5,7,34569,36420,2819,3259,1851,440,1411,0.00747936714792319,0.00177791547546526,0.00570145167245793,EPCI
200035087,CA Terre de Provence,1975_1982,1978.5,7,36420,39377,2894,3097,2957,203,2754,0.0112143886598728,0.000769875176852951,0.0104445134830198,EPCI
200035087,CA Terre de Provence,1982_1990,1986,8,39377,43807,3400,4139,4430,739,3691,0.0134156596820265,0.00223796219074889,0.0111776974912776,EPCI
200035087,CA Terre de Provence,1990_1999,1994.5,9,43807,48426,3916,5183,4619,1267,3352,0.0112003975041037,0.00307228916165824,0.00812810834244549,EPCI
200035087,CA Terre de Provence,1999_2010,2004.5,11,48426,55329,5171,7034,6903,1863,5040,0.012188253581223,0.00328939829375901,0.00889885528746399,EPCI
200035103,CC de la Vallée de la Haute-Sarthe,2010_2015,2012.5,5,7851,7970,392,429,119,37,82,0.00301324684629112,0.00093689187657791,0.00207635496971321,EPCI
200035103,CC de la Vallée de la Haute-Sarthe,1968_1975,1971.5,7,7617,7210,609,676,-407,67,-474,-0.00781411554451028,0.00128635317317491,-0.00910046871768519,EPCI
200035103,CC de la Vallée de la Haute-Sarthe,1975_1982,1978.5,7,7210,6874,610,573,-336,-37,-299,-0.00679435228442782,-0.000748187602749492,-0.00604616468167833,EPCI
200035103,CC de la Vallée de la Haute-Sarthe,1982_1990,1986,8,6874,6704,755,600,-170,-155,-15,-0.00312533285357097,-0.00284956819002059,-0.00027576466355038,EPCI
200035103,CC de la Vallée de la Haute-Sarthe,1990_1999,1994.5,9,6704,6947,778,685,243,-93,336,0.00396400803776165,-0.00151708949593347,0.00548109753369512,EPCI
200035103,CC de la Vallée de la Haute-Sarthe,1999_2010,2004.5,11,6947,7851,913,1023,904,110,794,0.0111830682403609,0.00136077157792002,0.00982229666244084,EPCI
200035111,CC des Sources de l'Orne,2010_2015,2012.5,5,12135,12153,659,714,18,55,-37,0.000296486685511521,0.000905931539062981,-0.00060944485355146,EPCI
200035111,CC des Sources de l'Orne,1968_1975,1971.5,7,12082,11708,1083,1316,-374,233,-607,-0.00448197908850134,0.00279224900433372,-0.00727422809283507,EPCI
200035111,CC des Sources de l'Orne,1975_1982,1978.5,7,11708,11438,1038,1011,-270,-27,-243,-0.00332748352040213,-0.000332748352040213,-0.00299473516836192,EPCI
200035111,CC des Sources de l'Orne,1982_1990,1986,8,11438,11455,1119,1150,17,31,-14,0.000185663534882918,0.000338562916551204,-0.000152899381668286,EPCI
200035111,CC des Sources de l'Orne,1990_1999,1994.5,9,11455,11554,1238,1207,99,-31,130,0.000956610755324494,-0.000299544781970296,0.00125615553729479,EPCI
200035111,CC des Sources de l'Orne,1999_2010,2004.5,11,11554,12135,1370,1490,581,120,461,0.00447015618382229,0.000923268058620784,0.00354688812520151,EPCI
200035129,CC de Cèze Cévennes,2010_2015,2012.5,5,19428,19475,1475,840,47,-635,682,0.000483370240424996,-0.00653064048233772,0.00701401072276271,EPCI
200035129,CC de Cèze Cévennes,1968_1975,1971.5,7,22958,20115,2382,1397,-2843,-985,-1858,-0.0187085882795127,-0.00648187107116427,-0.0122267172083484,EPCI
200035129,CC de Cèze Cévennes,1975_1982,1978.5,7,20115,19330,2248,1071,-785,-1177,392,-0.00567064828655728,-0.00850236055194639,0.00283171226538911,EPCI
200035129,CC de Cèze Cévennes,1982_1990,1986,8,19330,18603,2690,1191,-727,-1499,772,-0.00478046642160457,-0.00985683516641712,0.00507636874481255,EPCI
200035129,CC de Cèze Cévennes,1990_1999,1994.5,9,18603,17458,2766,1305,-1145,-1461,316,-0.00703346654703285,-0.00897458045870305,0.0019411139116702,EPCI
200035129,CC de Cèze Cévennes,1999_2010,2004.5,11,17458,19428,3421,1730,1970,-1691,3661,0.00976714736164297,-0.00838388131397881,0.0181510286756218,EPCI
200035137,CC Marche Occitane - Val d'Anglin,2010_2015,2012.5,5,7408,6993,553,232,-415,-321,-94,-0.0114639520621355,-0.0088672978601096,-0.00259665420202586,EPCI
200035137,CC Marche Occitane - Val d'Anglin,1968_1975,1971.5,7,10673,9664,1123,778,-1009,-345,-664,-0.0140869157429272,-0.00481663620546074,-0.00927027953746646,EPCI
200035137,CC Marche Occitane - Val d'Anglin,1975_1982,1978.5,7,9664,8750,1088,509,-914,-579,-335,-0.0140931683956503,-0.00892772921343714,-0.0051654391822132,EPCI
200035137,CC Marche Occitane - Val d'Anglin,1982_1990,1986,8,8750,8236,1199,532,-514,-667,153,-0.00753880349004388,-0.00978284421762503,0.00224404072758115,EPCI
200035137,CC Marche Occitane - Val d'Anglin,1990_1999,1994.5,9,8236,7656,1237,580,-580,-657,77,-0.00808107502246802,-0.0091539073961405,0.00107283237367248,EPCI
200035137,CC Marche Occitane - Val d'Anglin,1999_2010,2004.5,11,7656,7408,1285,648,-248,-637,389,-0.00298908347757576,-0.00767760554522484,0.00468852206764908,EPCI
200035202,CC Charlieu-Belmont,2010_2015,2012.5,5,23377,23432,1250,1243,55,-7,62,0.000470105767804041,-5.98316431750598e-05,0.000529937410979101,EPCI
200035202,CC Charlieu-Belmont,1968_1975,1971.5,7,21180,21081,2002,2311,-99,309,-408,-0.000669087389007617,0.00208836366872074,-0.00275745105772836,EPCI
200035202,CC Charlieu-Belmont,1975_1982,1978.5,7,21081,22306,1932,2093,1225,161,1064,0.00810171984164954,0.00106479746490251,0.00703692237674703,EPCI
200035202,CC Charlieu-Belmont,1982_1990,1986,8,22306,22230,2141,2310,-76,169,-245,-0.00042653058448594,0.000948469326027946,-0.00137499991051389,EPCI
200035202,CC Charlieu-Belmont,1990_1999,1994.5,9,22230,22173,2158,2162,-57,4,-61,-0.000285225482725138,2.00158233491325e-05,-0.00030524130607427,EPCI
200035202,CC Charlieu-Belmont,1999_2010,2004.5,11,22173,23377,2639,2759,1204,120,1084,0.0048185996130925,0.000480259097650415,0.00433834051544209,EPCI
200035319,CA Var Esterel Méditerranée (Cavem),2010_2015,2012.5,5,107480,111657,6011,6068,4177,57,4120,0.00765452493131291,0.000104454853024859,0.00755007007828805,EPCI
200035319,CA Var Esterel Méditerranée (Cavem),1968_1975,1971.5,7,48565,59245,3753,5381,10680,1628,9052,0.0288039329491137,0.00439071187651283,0.0244132210726008,EPCI
200035319,CA Var Esterel Méditerranée (Cavem),1975_1982,1978.5,7,59245,67274,4536,5399,8029,863,7166,0.0183218867757107,0.0019693346976508,0.0163525520780599,EPCI
200035319,CA Var Esterel Méditerranée (Cavem),1982_1990,1986,8,67274,85830,6126,7828,18556,1702,16854,0.0309176680543422,0.00283584129276193,0.0280818267615802,EPCI
200035319,CA Var Esterel Méditerranée (Cavem),1990_1999,1994.5,9,85830,97252,7984,9743,11422,1759,9663,0.0139786843203764,0.00215273207140099,0.0118259522489754,EPCI
200035319,CA Var Esterel Méditerranée (Cavem),1999_2010,2004.5,11,97252,107480,11556,12069,10228,513,9715,0.00913228681188705,0.000458042934542242,0.0086742438773448,EPCI
200035327,CC Cazals-Salviac,2010_2015,2012.5,5,5429,5328,377,182,-101,-195,94,-0.00374876012558889,-0.00723770519296865,0.00348894506737976,EPCI
200035327,CC Cazals-Salviac,1968_1975,1971.5,7,5204,4666,608,313,-538,-295,-243,-0.0154684562173877,-0.00848177431994306,-0.00698668189744462,EPCI
200035327,CC Cazals-Salviac,1975_1982,1978.5,7,4666,4432,547,223,-234,-324,90,-0.00732322840465416,-0.0101398547141365,0.00281662630948237,EPCI
200035327,CC Cazals-Salviac,1982_1990,1986,8,4432,4573,586,286,141,-300,441,0.00392248478935553,-0.00834571231777772,0.0122681971071333,EPCI
200035327,CC Cazals-Salviac,1990_1999,1994.5,9,4573,4724,680,333,151,-347,498,0.00361612843522541,-0.00830991103988885,0.0119260394751143,EPCI
200035327,CC Cazals-Salviac,1999_2010,2004.5,11,4724,5429,788,437,705,-351,1056,0.0127256595350078,-0.00633575389615283,0.0190614134311606,EPCI
200035442,CC du Sud-Artois,2010_2015,2012.5,5,27294,27561,1497,1724,267,227,40,0.00194886299809283,0.00165689850399652,0.000291964494096304,EPCI
200035442,CC du Sud-Artois,1968_1975,1971.5,7,26227,24940,2636,3238,-1287,602,-1889,-0.00716229537637203,0.00335019566167518,-0.0105124910380472,EPCI
200035442,CC du Sud-Artois,1975_1982,1978.5,7,24940,24601,2700,2661,-339,-39,-300,-0.00195321110045243,-0.000224705701821961,-0.00172850539863047,EPCI
200035442,CC du Sud-Artois,1982_1990,1986,8,24601,24697,2883,2727,96,-156,252,0.00048695430488177,-0.000791300745432877,0.00127825505031465,EPCI
200035442,CC du Sud-Artois,1990_1999,1994.5,9,24697,25957,2806,2711,1260,-95,1355,0.00554415045340884,-0.000418011343709396,0.00596216179711823,EPCI
200035442,CC du Sud-Artois,1999_2010,2004.5,11,25957,27294,3369,3637,1337,268,1069,0.00457640125417003,0.000917333983633184,0.00365906727053684,EPCI
200035459,CA d'Agen,2010_2015,2012.5,5,95188,96924,4316,5458,1736,1142,594,0.00362119731272093,0.00238214708014245,0.00123905023257847,EPCI
200035459,CA d'Agen,1968_1975,1971.5,7,69061,73066,5406,7323,4005,1917,2088,0.00808579636177798,0.00387028005631171,0.00421551630546627,EPCI
200035459,CA d'Agen,1975_1982,1978.5,7,73066,76518,5494,6355,3452,861,2591,0.00661648787999858,0.00165028854712595,0.00496619933287263,EPCI
200035459,CA d'Agen,1982_1990,1986,8,76518,81675,5935,7887,5157,1952,3205,0.00818606789176468,0.00309854654347967,0.00508752134828501,EPCI
200035459,CA d'Agen,1990_1999,1994.5,9,81675,84265,6734,8345,2590,1611,979,0.00347476052541906,0.00216132787893827,0.0013134326464808,EPCI
200035459,CA d'Agen,1999_2010,2004.5,11,84265,95188,8874,11224,10923,2350,8573,0.0111422805118377,0.00239717652685331,0.00874510398498444,EPCI
200035533,CC du Grand Saint-Émilionnais,2010_2015,2012.5,5,15277,14860,608,738,-417,130,-547,-0.00551978769850381,0.0017207971242338,-0.00724058482273761,EPCI
200035533,CC du Grand Saint-Émilionnais,1968_1975,1971.5,7,17247,16762,1521,1556,-485,35,-520,-0.00406653710118643,0.000293461440291804,-0.00435999854147823,EPCI
200035533,CC du Grand Saint-Émilionnais,1975_1982,1978.5,7,16762,16896,1392,1430,134,38,96,0.00113814546039848,0.000322757667874195,0.000815387792524282,EPCI
200035533,CC du Grand Saint-Émilionnais,1982_1990,1986,8,16896,16474,1393,1526,-422,133,-555,-0.00315669799437124,0.000994883491117002,-0.00415158148548824,EPCI
200035533,CC du Grand Saint-Émilionnais,1990_1999,1994.5,9,16474,15503,1256,1623,-971,367,-1338,-0.00672725082133008,0.00254263754009077,-0.00926988836142085,EPCI
200035533,CC du Grand Saint-Émilionnais,1999_2010,2004.5,11,15503,15277,1373,1886,-226,513,-739,-0.00133412055981652,0.00302833560701715,-0.00436245616683367,EPCI
200035541,CC des Landes d'Armagnac,2010_2015,2012.5,5,10605,10890,714,482,285,-232,517,0.0053179602032285,-0.00432900620052285,0.00964696640375135,EPCI
200035541,CC des Landes d'Armagnac,1968_1975,1971.5,7,12333,11395,1274,977,-938,-297,-641,-0.0112369504739178,-0.00355796832702942,-0.0076789821468884,EPCI
200035541,CC des Landes d'Armagnac,1975_1982,1978.5,7,11395,10519,1255,629,-876,-626,-250,-0.0113623152868416,-0.00811964539904435,-0.00324266988779727,EPCI
200035541,CC des Landes d'Armagnac,1982_1990,1986,8,10519,10346,1299,722,-173,-577,404,-0.0020707498051995,-0.00690648923468273,0.00483573942948323,EPCI
200035541,CC des Landes d'Armagnac,1990_1999,1994.5,9,10346,10076,1423,751,-270,-672,402,-0.00293386700812459,-0.00730206899799898,0.00436820198987439,EPCI
200035541,CC des Landes d'Armagnac,1999_2010,2004.5,11,10076,10605,1551,932,529,-619,1148,0.00466258431499833,-0.00545584062567858,0.0101184249406769,EPCI
200035632,CC Armagnac Adour,2010_2015,2012.5,5,6898,6809,497,228,-89,-269,180,-0.00259387966816615,-0.00783992843524377,0.00524604876707762,EPCI
200035632,CC Armagnac Adour,1968_1975,1971.5,7,8042,7491,801,591,-551,-210,-341,-0.0100881283571637,-0.00384484020871936,-0.0062432881484443,EPCI
200035632,CC Armagnac Adour,1975_1982,1978.5,7,7491,7328,716,461,-163,-255,92,-0.00313787691170875,-0.00490894854285724,0.0017710716311485,EPCI
200035632,CC Armagnac Adour,1982_1990,1986,8,7328,7020,833,512,-308,-321,13,-0.00535304727232333,-0.00557898757927204,0.000225940306948712,EPCI
200035632,CC Armagnac Adour,1990_1999,1994.5,9,7020,6796,866,483,-224,-383,159,-0.00359673998211774,-0.00614978309442452,0.00255304311230679,EPCI
200035632,CC Armagnac Adour,1999_2010,2004.5,11,6796,6898,1021,597,102,-424,526,0.00135521845287601,-0.00563345709822967,0.00698867555110568,EPCI
200035665,CA Seine Eure,2010_2015,2012.5,5,69415,71123,2665,4915,1708,2250,-542,0.00487339455801994,0.00641986988029559,-0.00154647532227565,EPCI
200035665,CA Seine Eure,1968_1975,1971.5,7,39094,44452,3148,5199,5358,2051,3307,0.0185180794083901,0.00708857425655247,0.0114295051518377,EPCI
200035665,CA Seine Eure,1975_1982,1978.5,7,44452,52237,3107,5530,7785,2423,5362,0.023322250725506,0.00725880713010931,0.0160634435953967,EPCI
200035665,CA Seine Eure,1982_1990,1986,8,52237,62799,3880,7581,10562,3701,6861,0.0232854821411128,0.00815939873170408,0.0151260834094087,EPCI
200035665,CA Seine Eure,1990_1999,1994.5,9,62799,66895,4626,8794,4096,4168,-72,0.00704526594900456,0.00716910851451441,-0.000123842565509846,EPCI
200035665,CA Seine Eure,1999_2010,2004.5,11,66895,69415,6010,10992,2520,4982,-2462,0.00336736200978738,0.00665722124315902,-0.00328985923337164,EPCI
200035707,CC Piège Lauragais Malepère,2010_2015,2012.5,5,15528,15749,933,812,221,-121,342,0.00283040311375737,-0.00154967772291693,0.00438008083667431,EPCI
200035707,CC Piège Lauragais Malepère,1968_1975,1971.5,7,13421,12178,1309,912,-1243,-397,-846,-0.0137882870985449,-0.00440382138223838,-0.00938446571630647,EPCI
200035707,CC Piège Lauragais Malepère,1975_1982,1978.5,7,12178,12175,1303,708,-3,-595,592,-3.51959831395021e-05,-0.00698053665600125,0.00694534067286175,EPCI
200035707,CC Piège Lauragais Malepère,1982_1990,1986,8,12175,12453,1376,955,278,-421,699,0.00282609700048742,-0.00427980876692519,0.0071059057674126,EPCI
200035707,CC Piège Lauragais Malepère,1990_1999,1994.5,9,12453,13188,1619,1129,735,-490,1225,0.00639209473602631,-0.00426139649068421,0.0106534912267105,EPCI
200035707,CC Piège Lauragais Malepère,1999_2010,2004.5,11,13188,15528,1985,1680,2340,-305,2645,0.0149596576175999,-0.0019498699031487,0.0169095275207486,EPCI
200035715,CA Carcassonne Agglo,2010_2015,2012.5,5,108744,111159,5667,6037,2415,370,2045,0.00440268602083105,0.000674531605675978,0.00372815441515507,EPCI
200035715,CA Carcassonne Agglo,1968_1975,1971.5,7,85394,85309,7581,7774,-85,193,-278,-0.000142258711472998,0.000323010956638689,-0.000465269668111687,EPCI
200035715,CA Carcassonne Agglo,1975_1982,1978.5,7,85309,89158,7370,6943,3849,-427,4276,0.0063242164819235,-0.000701595333276522,0.00702581181520002,EPCI
200035715,CA Carcassonne Agglo,1982_1990,1986,8,89158,95065,8552,8425,5907,-127,6034,0.00805108601449223,-0.000173097667824702,0.00822418368231693,EPCI
200035715,CA Carcassonne Agglo,1990_1999,1994.5,9,95065,97721,9650,9651,2656,1,2655,0.00306642650722933,1.15452805242068e-06,0.0030652719791769,EPCI
200035715,CA Carcassonne Agglo,1999_2010,2004.5,11,97721,108744,11931,12681,11023,750,10273,0.00976372225617417,0.000664319304375454,0.00909940295179871,EPCI
200035723,CC Ventoux Sud,2010_2015,2012.5,5,9049,9416,463,411,367,-52,419,0.0079829180411084,-0.00113109465432599,0.00911401269543438,EPCI
200035723,CC Ventoux Sud,1968_1975,1971.5,7,5459,5023,450,455,-436,5,-441,-0.0118207590459335,0.000135559163370797,-0.0119563182093043,EPCI
200035723,CC Ventoux Sud,1975_1982,1978.5,7,5023,5626,468,414,603,-54,657,0.0163277710917853,-0.00146218845598077,0.0177899595477661,EPCI
200035723,CC Ventoux Sud,1982_1990,1986,8,5626,6110,572,609,484,37,447,0.0103694013433528,0.000792702168810032,0.00957669917454282,EPCI
200035723,CC Ventoux Sud,1990_1999,1994.5,9,6110,6873,727,688,763,-39,802,0.0131607298774079,-0.000672697857429762,0.0138334277348377,EPCI
200035723,CC Ventoux Sud,1999_2010,2004.5,11,6873,9049,890,952,2176,62,2114,0.0253201130969316,0.000721437045960368,0.0245986760509712,EPCI
200035731,CA Roannais Agglomération,2010_2015,2012.5,5,101405,100458,5143,5580,-947,437,-1384,-0.0018747743916514,0.000865128203961629,-0.00273990259561303,EPCI
200035731,CA Roannais Agglomération,1968_1975,1971.5,7,101271,108233,8258,12579,6962,4321,2641,0.00954328070016675,0.00592308473217761,0.00362019596798914,EPCI
200035731,CA Roannais Agglomération,1975_1982,1978.5,7,108233,107210,7886,10742,-1023,2856,-3879,-0.00135576337872012,0.00378500509249723,-0.00514076847121735,EPCI
200035731,CA Roannais Agglomération,1982_1990,1986,8,107210,103833,8434,10941,-3377,2507,-5884,-0.00399271889049135,0.00296409424295583,-0.00695681313344718,EPCI
200035731,CA Roannais Agglomération,1990_1999,1994.5,9,103833,100709,9135,10361,-3124,1226,-4350,-0.00338854246218467,0.00132981852069091,-0.00471836098287559,EPCI
200035731,CA Roannais Agglomération,1999_2010,2004.5,11,100709,101405,11028,11867,696,839,-143,0.000626307821242955,0.000754988882216723,-0.000128681060973768,EPCI
200035756,CC Astarac Arros en Gascogne,2010_2015,2012.5,5,7401,7372,360,267,-29,-93,64,-0.000784909079134755,-0.00251712221929421,0.00173221314015946,EPCI
200035756,CC Astarac Arros en Gascogne,1968_1975,1971.5,7,7716,7060,732,544,-656,-188,-468,-0.0126127897709676,-0.00361464097094803,-0.00899814880001956,EPCI
200035756,CC Astarac Arros en Gascogne,1975_1982,1978.5,7,7060,7034,649,418,-26,-231,205,-0.000526935042849952,-0.00468161518839765,0.0041546801455477,EPCI
200035756,CC Astarac Arros en Gascogne,1982_1990,1986,8,7034,7075,737,487,41,-250,291,0.000726752641510009,-0.00443141854579274,0.00515817118730275,EPCI
200035756,CC Astarac Arros en Gascogne,1990_1999,1994.5,9,7075,6971,746,508,-104,-238,134,-0.00164406449010035,-0.00376237835234503,0.00211831386224468,EPCI
200035756,CC Astarac Arros en Gascogne,1999_2010,2004.5,11,6971,7401,902,638,430,-264,694,0.0054563263407108,-0.00334993059057594,0.00880625693128674,EPCI
200035764,CC de la Beauce Loirétaine,2010_2015,2012.5,5,15848,16536,578,1038,688,460,228,0.00853552421573456,0.00570689119075276,0.0028286330249818,EPCI
200035764,CC de la Beauce Loirétaine,1968_1975,1971.5,7,11626,12391,810,1269,765,459,306,0.00914534160240144,0.00548720496144086,0.00365813664096057,EPCI
200035764,CC de la Beauce Loirétaine,1975_1982,1978.5,7,12391,13408,868,1268,1017,400,617,0.0113324657972003,0.00445721368621446,0.0068752521109858,EPCI
200035764,CC de la Beauce Loirétaine,1982_1990,1986,8,13408,13707,986,1390,299,404,-105,0.00276069215028762,0.00373016598232843,-0.000969473832040805,EPCI
200035764,CC de la Beauce Loirétaine,1990_1999,1994.5,9,13707,13956,981,1444,249,463,-214,0.00200232109240495,0.00372319142884936,-0.00172087033644441,EPCI
200035764,CC de la Beauce Loirétaine,1999_2010,2004.5,11,13956,15848,1211,2256,1892,1045,847,0.0116246642233897,0.00642059942570943,0.00520406479768027,EPCI
200035772,CC du Pays du Saintois,2010_2015,2012.5,5,14268,14488,692,850,220,158,62,0.00306497808667694,0.00220121153497707,0.000863766551699865,EPCI
200035772,CC du Pays du Saintois,1968_1975,1971.5,7,11454,11078,1209,1132,-376,-77,-299,-0.00475691478086415,-0.000974155420549308,-0.00378275936031484,EPCI
200035772,CC du Pays du Saintois,1975_1982,1978.5,7,11078,11759,1140,999,681,-141,822,0.00855895522520167,-0.00177211848275101,0.0103310737079527,EPCI
200035772,CC du Pays du Saintois,1982_1990,1986,8,11759,12105,1281,1164,346,-117,463,0.00363153880967704,-0.00122800589806998,0.00485954470774702,EPCI
200035772,CC du Pays du Saintois,1990_1999,1994.5,9,12105,12549,1410,1300,444,-110,554,0.004010508511612,-0.000993594451075045,0.00500410296268704,EPCI
200035772,CC du Pays du Saintois,1999_2010,2004.5,11,12549,14268,1632,1954,1719,322,1397,0.0117391222611185,0.00219895134850504,0.00954017091261347,EPCI
200035814,CA Flers Agglo,2010_2015,2012.5,5,55177,54445,3026,2968,-732,-58,-674,-0.00266747235395404,-0.00021135709908379,-0.00245611525487025,EPCI
200035814,CA Flers Agglo,1968_1975,1971.5,7,52721,56389,3925,7099,3668,3174,494,0.00965491742206215,0.00835460956860013,0.00130030785346202,EPCI
200035814,CA Flers Agglo,1975_1982,1978.5,7,56389,57379,3921,6388,990,2467,-1477,0.00248941899987565,0.00620343098251841,-0.00371401198264276,EPCI
200035814,CA Flers Agglo,1982_1990,1986,8,57379,57499,4362,6242,120,1880,-1760,0.000261180804458583,0.00409183260318446,-0.00383065179872588,EPCI
200035814,CA Flers Agglo,1990_1999,1994.5,9,57499,55822,4905,5942,-1677,1037,-2714,-0.00328343098184791,0.00203036250934781,-0.00531379349119573,EPCI
200035814,CA Flers Agglo,1999_2010,2004.5,11,55822,55177,6007,7090,-645,1083,-1728,-0.00105597453257533,0.00177305491283579,-0.00282902944541112,EPCI
200035848,CC du Châtillonnais en Berry,2010_2015,2012.5,5,6398,6117,554,205,-281,-349,68,-0.00894250804521257,-0.0111065313444099,0.00216402329919735,EPCI
200035848,CC du Châtillonnais en Berry,1968_1975,1971.5,7,9011,8323,811,727,-688,-84,-604,-0.0112820585954329,-0.00137746064246564,-0.00990459795296722,EPCI
200035848,CC du Châtillonnais en Berry,1975_1982,1978.5,7,8323,7916,842,537,-407,-305,-102,-0.00713680249337123,-0.00534821808471309,-0.00178858440865815,EPCI
200035848,CC du Châtillonnais en Berry,1982_1990,1986,8,7916,7242,982,490,-674,-492,-182,-0.0110619388239669,-0.00807488709405298,-0.00298705172991391,EPCI
200035848,CC du Châtillonnais en Berry,1990_1999,1994.5,9,7242,6771,1068,509,-471,-559,88,-0.00744422291608704,-0.00883507560529226,0.00139085268920522,EPCI
200035848,CC du Châtillonnais en Berry,1999_2010,2004.5,11,6771,6398,1323,516,-373,-807,434,-0.0051379684329721,-0.0111161944380924,0.00597822600512035,EPCI
200035855,CC Castelnaudary Lauragais Audois,2010_2015,2012.5,5,25825,25901,1228,1363,76,135,-59,0.000587885335497917,0.00104427000384499,-0.000456384668347068,EPCI
200035855,CC Castelnaudary Lauragais Audois,1968_1975,1971.5,7,19611,19429,1825,1623,-182,-202,20,-0.00133109017507727,-0.00147736382069015,0.000146273645612886,EPCI
200035855,CC Castelnaudary Lauragais Audois,1975_1982,1978.5,7,19429,20672,1761,1465,1243,-296,1539,0.00889840497559402,-0.00211900874720501,0.011017413722799,EPCI
200035855,CC Castelnaudary Lauragais Audois,1982_1990,1986,8,20672,21863,2065,1919,1191,-146,1337,0.0070265187882701,-0.000861353268755193,0.00788787205702529,EPCI
200035855,CC Castelnaudary Lauragais Audois,1990_1999,1994.5,9,21863,22856,2270,2216,993,-54,1047,0.00494752708540647,-0.000269049811290986,0.00521657689669745,EPCI
200035855,CC Castelnaudary Lauragais Audois,1999_2010,2004.5,11,22856,25825,2738,2995,2969,257,2712,0.0111645315467543,0.000966414485522353,0.010198117061232,EPCI
200035863,"CC Région Lézignanaise, Corbières et Minervois",2010_2015,2012.5,5,30912,32976,1823,1663,2064,-160,2224,0.013011029560539,-0.00100860694267744,0.0140196365032165,EPCI
200035863,"CC Région Lézignanaise, Corbières et Minervois",1968_1975,1971.5,7,25741,23781,2630,1819,-1960,-811,-1149,-0.011250252784802,-0.00465507908595632,-0.00659517369884564,EPCI
200035863,"CC Région Lézignanaise, Corbières et Minervois",1975_1982,1978.5,7,23781,23046,2682,1453,-735,-1229,494,-0.00447491814488599,-0.0074825502041699,0.00300763205928392,EPCI
200035863,"CC Région Lézignanaise, Corbières et Minervois",1982_1990,1986,8,23046,23905,2928,1840,859,-1088,1947,0.00458490660312716,-0.00580719253108539,0.0103920991342125,EPCI
200035863,"CC Région Lézignanaise, Corbières et Minervois",1990_1999,1994.5,9,23905,25035,2942,2080,1130,-862,1992,0.00514510233562904,-0.00392484797638251,0.00906995031201154,EPCI
200035863,"CC Région Lézignanaise, Corbières et Minervois",1999_2010,2004.5,11,25035,30912,3757,3057,5877,-700,6577,0.019354888293255,-0.00230532955679403,0.0216602178500491,EPCI
200035970,CC Vexin Centre,2010_2015,2012.5,5,23656,24811,748,1350,1155,602,553,0.00957965810674888,0.00499303392230548,0.0045866241844434,EPCI
200035970,CC Vexin Centre,1968_1975,1971.5,7,14338,15604,1210,1568,1266,358,908,0.0121610567342996,0.00343890861838803,0.00872214811591154,EPCI
200035970,CC Vexin Centre,1975_1982,1978.5,7,15604,17576,1119,1401,1972,282,1690,0.017146345782886,0.00245196222655875,0.0146943835563272,EPCI
200035970,CC Vexin Centre,1982_1990,1986,8,17576,20147,1349,1776,2571,427,2144,0.0172115735544445,0.00285855383420762,0.0143530197202369,EPCI
200035970,CC Vexin Centre,1990_1999,1994.5,9,20147,22227,1252,2367,2080,1115,965,0.0109767373625143,0.00588416449961702,0.00509257286289724,EPCI
200035970,CC Vexin Centre,1999_2010,2004.5,11,22227,23656,1553,2908,1429,1355,74,0.00568052940643105,0.00538636623213021,0.000294163174300839,EPCI
200036069,CC du Pays de Mortagne-au-Perche,2010_2015,2012.5,5,14753,14106,830,677,-647,-153,-494,-0.00892913896261616,-0.00211152745174694,-0.00681761151086921,EPCI
200036069,CC du Pays de Mortagne-au-Perche,1968_1975,1971.5,7,14589,14637,1189,1622,48,433,-385,0.000469360030972199,0.00423401861272838,-0.00376465858175618,EPCI
200036069,CC du Pays de Mortagne-au-Perche,1975_1982,1978.5,7,14637,14819,1125,1388,182,263,-81,0.00176692656498201,0.0025533059702762,-0.00078637940529419,EPCI
200036069,CC du Pays de Mortagne-au-Perche,1982_1990,1986,8,14819,14733,1240,1451,-86,211,-297,-0.000727268597254582,0.00178434504675252,-0.0025116136440071,EPCI
200036069,CC du Pays de Mortagne-au-Perche,1990_1999,1994.5,9,14733,14736,1365,1470,3,105,-102,2.26228989754773e-05,0.000791801464141706,-0.000769178565166229,EPCI
200036069,CC du Pays de Mortagne-au-Perche,1999_2010,2004.5,11,14736,14753,1734,1730,17,-4,21,0.000104821168125602,-2.46638042648475e-05,0.000129484972390449,EPCI
200036077,CC du Golfe de Saint-Tropez,2010_2015,2012.5,5,54513,57591,3004,2858,3078,-146,3224,0.0110459813189023,-0.000523948431630845,0.0115699297505332,EPCI
200036077,CC du Golfe de Saint-Tropez,1968_1975,1971.5,7,25653,29865,2127,2618,4212,491,3721,0.0219556549033817,0.00255940801461548,0.0193962468887662,EPCI
200036077,CC du Golfe de Saint-Tropez,1975_1982,1978.5,7,29865,35943,2391,2577,6078,186,5892,0.0268171526961054,0.000820663113108853,0.0259964895829966,EPCI
200036077,CC du Golfe de Saint-Tropez,1982_1990,1986,8,35943,43399,3158,3917,7456,759,6697,0.0238425511268414,0.00242710519115781,0.0214154459356836,EPCI
200036077,CC du Golfe de Saint-Tropez,1990_1999,1994.5,9,43399,48396,4294,5076,4997,782,4215,0.0121825844764503,0.00190650011218413,0.0102760843642661,EPCI
200036077,CC du Golfe de Saint-Tropez,1999_2010,2004.5,11,48396,54513,6048,6414,6117,366,5751,0.0108789353333252,0.000650922074872816,0.0102280132584524,EPCI
200036135,CC Coeur de France,2010_2015,2012.5,5,19976,18840,1314,795,-1136,-519,-617,-0.0116415632222379,-0.00531863671861043,-0.00632292650362743,EPCI
200036135,CC Coeur de France,1968_1975,1971.5,7,20674,21383,2048,2295,709,247,462,0.00482866943991311,0.00168220218851698,0.00314646725139613,EPCI
200036135,CC Coeur de France,1975_1982,1978.5,7,21383,21428,2135,1759,45,-376,421,0.000300368560349984,-0.00250974619314653,0.00281011475349652,EPCI
200036135,CC Coeur de France,1982_1990,1986,8,21428,21287,2215,1860,-141,-355,214,-0.000824899616613473,-0.00207687492126087,0.0012519753046474,EPCI
200036135,CC Coeur de France,1990_1999,1994.5,9,21287,20758,2411,1924,-529,-487,-42,-0.00279218826058503,-0.00257050223611514,-0.000221686024469889,EPCI
200036135,CC Coeur de France,1999_2010,2004.5,11,20758,19976,3089,2195,-782,-894,112,-0.00348483758848073,-0.00398394476227848,0.000499107173797752,EPCI
200036150,CC des Hauts du Val de Saône,2010_2015,2012.5,5,9092,8732,582,392,-360,-190,-170,-0.0080475372501061,-0.00424731132644488,-0.00380022592366121,EPCI
200036150,CC des Hauts du Val de Saône,1968_1975,1971.5,7,11714,10698,1202,1093,-1016,-109,-907,-0.0128774948012635,-0.00138154225722217,-0.0114959525440414,EPCI
200036150,CC des Hauts du Val de Saône,1975_1982,1978.5,7,10698,9998,1130,734,-700,-396,-304,-0.00962081172930429,-0.005442630635435,-0.00417818109386929,EPCI
200036150,CC des Hauts du Val de Saône,1982_1990,1986,8,9998,9276,1146,836,-722,-310,-412,-0.00932557627118191,-0.00400405629372077,-0.00532151997746115,EPCI
200036150,CC des Hauts du Val de Saône,1990_1999,1994.5,9,9276,9189,1152,813,-87,-339,252,-0.00104648570424826,-0.00407768567517424,0.00303119997092598,EPCI
200036150,CC des Hauts du Val de Saône,1999_2010,2004.5,11,9189,9092,1321,1019,-97,-302,205,-0.000964281193475802,-0.00300219505597621,0.00203791386250041,EPCI
200036465,CC de Thann-Cernay,2010_2015,2012.5,5,37510,37845,1704,2064,335,360,-25,0.00177984337777581,0.00191266751044565,-0.000132824132669837,EPCI
200036465,CC de Thann-Cernay,1968_1975,1971.5,7,30779,32352,2501,3687,1573,1186,387,0.00714586838969122,0.00538779396705263,0.00175807442263859,EPCI
200036465,CC de Thann-Cernay,1975_1982,1978.5,7,32352,32961,2494,3336,609,842,-233,0.0026677237088486,0.00368837990615849,-0.00102065619730989,EPCI
200036465,CC de Thann-Cernay,1982_1990,1986,8,32961,34000,2529,3818,1039,1289,-250,0.00388696977710579,0.00482223680720824,-0.000935267030102452,EPCI
200036465,CC de Thann-Cernay,1990_1999,1994.5,9,34000,35495,2811,3991,1495,1180,315,0.00479270588060854,0.00378287153118266,0.00100983434942588,EPCI
200036465,CC de Thann-Cernay,1999_2010,2004.5,11,35495,37510,3485,4825,2015,1340,675,0.00503223049961843,0.00334649571686784,0.00168573478275059,EPCI
200036473,CA de Saintes,2010_2015,2012.5,5,58898,59484,3115,2837,586,-278,864,0.0019820085079274,-0.000940270247788085,0.00292227875571549,EPCI
200036473,CA de Saintes,1968_1975,1971.5,7,45946,47640,3753,4763,1694,1010,684,0.00518567798457492,0.00309181509115742,0.0020938628934175,EPCI
200036473,CA de Saintes,1975_1982,1978.5,7,47640,49452,3722,4534,1812,812,1000,0.00534706733096146,0.0023961471703867,0.00295092016057476,EPCI
200036473,CA de Saintes,1982_1990,1986,8,49452,52210,4095,4907,2758,812,1946,0.00680700622546526,0.00200409320343647,0.00480291302202879,EPCI
200036473,CA de Saintes,1990_1999,1994.5,9,52210,53354,4644,4995,1144,351,793,0.0024112250145687,0.000739807674924486,0.00167141733964421,EPCI
200036473,CA de Saintes,1999_2010,2004.5,11,53354,58898,6250,6212,5544,-38,5582,0.00902761282138509,-6.18775770585558e-05,0.00908949039844364,EPCI
200036499,CC de Marana-Golo,2010_2015,2012.5,5,20483,23186,654,1357,2703,703,2000,0.0251005187814266,0.0065281778406744,0.0185723409407522,EPCI
200036499,CC de Marana-Golo,1968_1975,1971.5,7,5351,7913,320,526,2562,206,2356,0.0574803750562838,0.00462176317782766,0.0528586118784561,EPCI
200036499,CC de Marana-Golo,1975_1982,1978.5,7,7913,9920,364,695,2007,331,1676,0.0328193313666967,0.00541265504851849,0.0274066763181782,EPCI
200036499,CC de Marana-Golo,1982_1990,1986,8,9920,11903,554,1138,1983,584,1399,0.0230411320933968,0.00678568892715265,0.0162554431662441,EPCI
200036499,CC de Marana-Golo,1990_1999,1994.5,9,11903,14925,801,1529,3022,728,2294,0.0254572151319721,0.0061326448100846,0.0193245703218875,EPCI
200036499,CC de Marana-Golo,1999_2010,2004.5,11,14925,20483,1190,2461,5558,1271,4287,0.0291960515154459,0.00667653499030798,0.0225195165251379,EPCI
200036523,CC des Bastides en Haut-Agenais Périgord,2010_2015,2012.5,5,17286,17151,1170,699,-135,-471,336,-0.0015668600671167,-0.00546660067860717,0.00389974061149046,EPCI
200036523,CC des Bastides en Haut-Agenais Périgord,1968_1975,1971.5,7,17038,15695,1601,1256,-1343,-345,-998,-0.0116606180196069,-0.00299546777123186,-0.00866515024837507,EPCI
200036523,CC des Bastides en Haut-Agenais Périgord,1975_1982,1978.5,7,15695,15711,1510,1049,16,-461,477,0.000145569690173986,-0.00419422669813796,0.00433979638831195,EPCI
200036523,CC des Bastides en Haut-Agenais Périgord,1982_1990,1986,8,15711,16059,1785,1225,348,-560,908,0.00274229524576386,-0.0044128889012292,0.00715518414699306,EPCI
200036523,CC des Bastides en Haut-Agenais Périgord,1990_1999,1994.5,9,16059,15939,1908,1277,-120,-631,511,-0.000833042154502417,-0.00438041332909188,0.00354737117458946,EPCI
200036523,CC des Bastides en Haut-Agenais Périgord,1999_2010,2004.5,11,15939,17286,2390,1603,1347,-787,2134,0.00740253604751984,-0.00432501549324284,0.0117275515407627,EPCI
200036549,CC Val de Gray,2010_2015,2012.5,5,21483,20570,1275,1020,-913,-255,-658,-0.00864803296935268,-0.00241538708344462,-0.00623264588590807,EPCI
200036549,CC Val de Gray,1968_1975,1971.5,7,21653,22844,1802,3016,1191,1214,-23,0.00767854250865274,0.00782682670487358,-0.000148284196220835,EPCI
200036549,CC Val de Gray,1975_1982,1978.5,7,22844,22322,1763,2473,-522,710,-1232,-0.00329680521655573,0.00448416035202025,-0.00778096556857598,EPCI
200036549,CC Val de Gray,1982_1990,1986,8,22322,21721,1933,2363,-601,430,-1031,-0.0034058375217223,0.00243678890905256,-0.00584262643077486,EPCI
200036549,CC Val de Gray,1990_1999,1994.5,9,21721,21649,2118,2481,-72,363,-435,-0.000368850904024609,0.00185962330779074,-0.00222847421181535,EPCI
200036549,CC Val de Gray,1999_2010,2004.5,11,21649,21483,2669,2787,-166,118,-284,-0.000699513345692071,0.00049724442645581,-0.00119675777214788,EPCI
200036572,CC Porte d'Aquitaine en Pays de Serres,2010_2015,2012.5,5,5125,5328,248,282,203,34,169,0.00779933926473042,0.00130629327586618,0.00649304598886424,EPCI
200036572,CC Porte d'Aquitaine en Pays de Serres,1968_1975,1971.5,7,4201,3788,406,270,-413,-136,-277,-0.0146747488707722,-0.00483236282427367,-0.00984238604649858,EPCI
200036572,CC Porte d'Aquitaine en Pays de Serres,1975_1982,1978.5,7,3788,4011,406,307,223,-99,322,0.008205253138869,-0.00364269085537233,0.0118479439942413,EPCI
200036572,CC Porte d'Aquitaine en Pays de Serres,1982_1990,1986,8,4011,4431,409,452,420,43,377,0.0125258881133286,0.00128241235445983,0.0112434757588687,EPCI
200036572,CC Porte d'Aquitaine en Pays de Serres,1990_1999,1994.5,9,4431,4593,445,438,162,-7,169,0.00399776015663944,-0.000172742722817754,0.00417050287945719,EPCI
200036572,CC Porte d'Aquitaine en Pays de Serres,1999_2010,2004.5,11,4593,5125,529,561,532,32,500,0.010013174185822,0.000602296191628393,0.00941087799419365,EPCI
200037059,CC de la Haute Somme (Combles - Péronne - Roisel),2010_2015,2012.5,5,27978,27839,1660,1678,-139,18,-157,-0.000995618397460984,0.000128929001110056,-0.00112454739857104,EPCI
200037059,CC de la Haute Somme (Combles - Péronne - Roisel),1968_1975,1971.5,7,29165,29078,2512,3571,-87,1059,-1146,-0.000426692611713353,0.00519387903223495,-0.0056205716439483,EPCI
200037059,CC de la Haute Somme (Combles - Péronne - Roisel),1975_1982,1978.5,7,29078,29486,2533,3107,408,574,-166,0.00199251097687858,0.00280318946256938,-0.000810678485690795,EPCI
200037059,CC de la Haute Somme (Combles - Péronne - Roisel),1982_1990,1986,8,29486,28563,2696,3412,-923,716,-1639,-0.00396753351567747,0.0030777399753251,-0.00704527349100257,EPCI
200037059,CC de la Haute Somme (Combles - Péronne - Roisel),1990_1999,1994.5,9,28563,28263,2745,3292,-300,547,-847,-0.00117249489420879,0.00213784902377402,-0.00331034391798281,EPCI
200037059,CC de la Haute Somme (Combles - Péronne - Roisel),1999_2010,2004.5,11,28263,27978,3555,3874,-285,319,-604,-0.000920943096855531,0.00103080999262075,-0.00195175308947628,EPCI
200037133,CC du Provinois,2010_2015,2012.5,5,34141,34502,1542,2189,361,647,-286,0.00210587129493178,0.00377423470310489,-0.0016683634081731,EPCI
200037133,CC du Provinois,1968_1975,1971.5,7,26678,26928,2197,3190,250,993,-743,0.00133337125427757,0.00529615062199051,-0.00396277936771294,EPCI
200037133,CC du Provinois,1975_1982,1978.5,7,26928,27959,2072,2575,1031,503,528,0.00538193283192112,0.00262571504796928,0.00275621778395184,EPCI
200037133,CC du Provinois,1982_1990,1986,8,27959,29707,2500,3307,1748,807,941,0.00760924892329684,0.00351296560703693,0.00409628331625991,EPCI
200037133,CC du Provinois,1990_1999,1994.5,9,29707,31426,2607,3763,1719,1156,563,0.00626989261182831,0.00421640247776238,0.00205349013406593,EPCI
200037133,CC du Provinois,1999_2010,2004.5,11,31426,34141,3215,4663,2715,1448,1267,0.00756148402290213,0.00403279147888114,0.003528692544021,EPCI
200038958,CC de la Pieve de l'Ornano,2010_2015,2012.5,5,11103,12036,648,400,933,-248,1181,0.0162682738222582,-0.00432425713603432,0.0205925309582925,EPCI
200038958,CC de la Pieve de l'Ornano,1968_1975,1971.5,7,6808,6775,725,381,-33,-344,311,-0.000693905494052904,-0.00723343908952119,0.00653953359546828,EPCI
200038958,CC de la Pieve de l'Ornano,1975_1982,1978.5,7,6775,7413,800,454,638,-346,984,0.0129395506007686,-0.00701737383678045,0.019956924437549,EPCI
200038958,CC de la Pieve de l'Ornano,1982_1990,1986,8,7413,7787,961,634,374,-327,701,0.00617152347386551,-0.00539595768971664,0.0115674811635822,EPCI
200038958,CC de la Pieve de l'Ornano,1990_1999,1994.5,9,7787,8877,1017,717,1090,-300,1390,0.0146629037833665,-0.00403566159175226,0.0186985653751188,EPCI
200038958,CC de la Pieve de l'Ornano,1999_2010,2004.5,11,8877,11103,1348,884,2226,-464,2690,0.0205493510926631,-0.00428342268957578,0.0248327737822389,EPCI
200038990,CC de Saint-Méen Montauban,2010_2015,2012.5,5,24629,26214,1140,1819,1585,679,906,0.0125519241112584,0.00537713342053277,0.00717479069072561,EPCI
200038990,CC de Saint-Méen Montauban,1968_1975,1971.5,7,18089,17945,1639,1939,-144,300,-444,-0.00114113328594057,0.00237736101237618,-0.00351849429831674,EPCI
200038990,CC de Saint-Méen Montauban,1975_1982,1978.5,7,17945,18586,1653,1767,641,114,527,0.00502645969518079,0.000893941349844945,0.00413251834533584,EPCI
200038990,CC de Saint-Méen Montauban,1982_1990,1986,8,18586,18996,1798,2016,410,218,192,0.00273120064523758,0.00145219936746778,0.00127900127776979,EPCI
200038990,CC de Saint-Méen Montauban,1990_1999,1994.5,9,18996,19274,1874,1900,278,26,252,0.00161559330494643,0.00015109865441945,0.00146449465052698,EPCI
200038990,CC de Saint-Méen Montauban,1999_2010,2004.5,11,19274,24629,2225,3520,5355,1295,4060,0.0225381933845445,0.00545041277926894,0.0170877806052756,EPCI
200039022,CA Vitré Communauté,2010_2015,2012.5,5,76157,79948,2921,5455,3791,2534,1257,0.00976323731844131,0.00652599402926148,0.00323724328917983,EPCI
200039022,CA Vitré Communauté,1968_1975,1971.5,7,50813,51766,3807,6556,953,2749,-1796,0.0026580027773313,0.00766720843114769,-0.00500920565381639,EPCI
200039022,CA Vitré Communauté,1975_1982,1978.5,7,51766,55360,3866,6246,3594,2380,1214,0.00963522967957631,0.00638059171880679,0.00325463796076952,EPCI
200039022,CA Vitré Communauté,1982_1990,1986,8,55360,59690,4096,7052,4330,2956,1374,0.00945784424919149,0.00645667150129563,0.00300117274789587,EPCI
200039022,CA Vitré Communauté,1990_1999,1994.5,9,59690,64989,4555,7947,5299,3392,1907,0.00949518735346566,0.00607806671125788,0.00341712064220778,EPCI
200039022,CA Vitré Communauté,1999_2010,2004.5,11,64989,76157,5982,12055,11168,6073,5095,0.0145206859603944,0.0078961430728398,0.00662454288755455,EPCI
200039055,CC Ouche et Montagne,2010_2015,2012.5,5,10381,10672,404,604,291,200,91,0.0055445699380301,0.00381070098833684,0.00173386894969326,EPCI
200039055,CC Ouche et Montagne,1968_1975,1971.5,7,6098,6054,646,523,-44,-123,79,-0.00103398477847194,-0.0028904574489102,0.00185647267043826,EPCI
200039055,CC Ouche et Montagne,1975_1982,1978.5,7,6054,7401,635,539,1347,-96,1443,0.0291152129443859,-0.00207502631229476,0.0311902392566807,EPCI
200039055,CC Ouche et Montagne,1982_1990,1986,8,7401,8510,699,749,1109,50,1059,0.0176065517802035,0.000793803055915399,0.0168127487242881,EPCI
200039055,CC Ouche et Montagne,1990_1999,1994.5,9,8510,9432,878,879,922,1,921,0.0114951472863112,1.2467621785587e-05,0.0114826796645256,EPCI
200039055,CC Ouche et Montagne,1999_2010,2004.5,11,9432,10381,1044,1251,949,207,742,0.00875345748314316,0.00190934214858865,0.0068441153345545,EPCI
200039063,"CC Forêts, Seine et Suzon",2010_2015,2012.5,5,6664,6813,444,336,149,-108,257,0.0044323232009702,-0.00321269064231397,0.00764501384328417,EPCI
200039063,"CC Forêts, Seine et Suzon",1968_1975,1971.5,7,4463,4734,366,477,271,111,160,0.00845689137287331,0.00346389277634294,0.00499299859653037,EPCI
200039063,"CC Forêts, Seine et Suzon",1975_1982,1978.5,7,4734,5195,305,395,461,90,371,0.0133636652004316,0.00260895849899967,0.010754706701432,EPCI
200039063,"CC Forêts, Seine et Suzon",1982_1990,1986,8,5195,5558,357,534,363,177,186,0.00847845356112109,0.0041341219843483,0.00434433157677279,EPCI
200039063,"CC Forêts, Seine et Suzon",1990_1999,1994.5,9,5558,5892,400,601,334,201,133,0.00650519717689524,0.00391480428908965,0.00259039288780559,EPCI
200039063,"CC Forêts, Seine et Suzon",1999_2010,2004.5,11,5892,6664,650,769,772,119,653,0.0112560052770436,0.00173505780824895,0.00952094746879467,EPCI
200039204,CC de Lacq-Orthez,2010_2015,2012.5,5,53155,53306,2495,2638,151,143,8,0.000567505260639534,0.000537438756764592,3.00665038749421e-05,EPCI
200039204,CC de Lacq-Orthez,1968_1975,1971.5,7,51573,50674,3358,5312,-899,1954,-2853,-0.00250903583473094,0.00545345497337516,-0.0079624908081061,EPCI
200039204,CC de Lacq-Orthez,1975_1982,1978.5,7,50674,50779,3391,4076,105,685,-580,0.000295747259354773,0.00192939878721923,-0.00163365152786446,EPCI
200039204,CC de Lacq-Orthez,1982_1990,1986,8,50779,49270,3949,4560,-1509,611,-2120,-0.00376383728249063,0.00152399243181032,-0.00528782971430096,EPCI
200039204,CC de Lacq-Orthez,1990_1999,1994.5,9,49270,49656,4373,4595,386,222,164,0.000867470763698863,0.000498908055806082,0.000368562707892781,EPCI
200039204,CC de Lacq-Orthez,1999_2010,2004.5,11,49656,53155,5334,5849,3499,515,2984,0.00620946699645431,0.00091393984086138,0.00529552715559293,EPCI
200039519,CC du Quercy Blanc,2010_2015,2012.5,5,7924,7783,451,283,-141,-168,27,-0.00358441277210075,-0.00427078968590728,0.000686376913806528,EPCI
200039519,CC du Quercy Blanc,1968_1975,1971.5,7,7638,7079,666,566,-559,-100,-459,-0.0107988596873335,-0.00193181747537272,-0.0088670422119608,EPCI
200039519,CC du Quercy Blanc,1975_1982,1978.5,7,7079,6988,718,407,-91,-311,220,-0.0018466161197378,-0.00631096278284017,0.00446434666310237,EPCI
200039519,CC du Quercy Blanc,1982_1990,1986,8,6988,7158,771,555,170,-216,386,0.00300904562558113,-0.00382325797132661,0.00683230359690774,EPCI
200039519,CC du Quercy Blanc,1990_1999,1994.5,9,7158,7389,806,552,231,-254,485,0.00353532294910774,-0.00388732480118341,0.00742264775029115,EPCI
200039519,CC du Quercy Blanc,1999_2010,2004.5,11,7389,7924,947,747,535,-200,735,0.0063751188448169,-0.00238322199806239,0.00875834084287929,EPCI
200039642,CC Le Tonnerrois en Bourgogne,2010_2015,2012.5,5,17749,16650,1351,770,-1099,-581,-518,-0.0127024263965742,-0.0067152954835392,-0.00598713091303495,EPCI
200039642,CC Le Tonnerrois en Bourgogne,1968_1975,1971.5,7,20359,20209,2194,2144,-150,-50,-100,-0.00105587429010423,-0.00035195809670141,-0.00070391619340282,EPCI
200039642,CC Le Tonnerrois en Bourgogne,1975_1982,1978.5,7,20209,19394,2266,1865,-815,-401,-414,-0.00586335871671362,-0.00288491637472658,-0.00297844234198704,EPCI
200039642,CC Le Tonnerrois en Bourgogne,1982_1990,1986,8,19394,18907,2252,1847,-487,-405,-82,-0.00317389202385066,-0.00263947899314069,-0.000534413030709967,EPCI
200039642,CC Le Tonnerrois en Bourgogne,1990_1999,1994.5,9,18907,18825,2496,1953,-82,-543,461,-0.00048282231264607,-0.00319722580203434,0.00271440348938827,EPCI
200039642,CC Le Tonnerrois en Bourgogne,1999_2010,2004.5,11,18825,17749,2999,2146,-1076,-853,-223,-0.00533631079908914,-0.00423036534537457,-0.00110594545371457,EPCI
200039709,CC du Serein,2010_2015,2012.5,5,7856,7627,601,286,-229,-315,86,-0.0058991289791146,-0.00811452239485196,0.00221539341573736,EPCI
200039709,CC du Serein,1968_1975,1971.5,7,8105,7460,1090,583,-645,-507,-138,-0.0117766405081151,-0.00925698719009978,-0.00251965331801533,EPCI
200039709,CC du Serein,1975_1982,1978.5,7,7460,6965,1035,441,-495,-594,99,-0.00976031405404287,-0.0117123768648514,0.00195206281080857,EPCI
200039709,CC du Serein,1982_1990,1986,8,6965,6887,970,531,-78,-439,361,-0.00140676341303359,-0.00791755305540697,0.00651078964237339,EPCI
200039709,CC du Serein,1990_1999,1994.5,9,6887,7645,1063,591,758,-472,1230,0.0116693689700123,-0.00726641445098388,0.0189357834209961,EPCI
200039709,CC du Serein,1999_2010,2004.5,11,7645,7856,1317,813,211,-504,715,0.00247813202127478,-0.00591932956740517,0.00839746158867995,EPCI
200039758,"CC Avallon, Vézelay, Morvan",2010_2015,2012.5,5,20287,19373,1228,901,-914,-327,-587,-0.0091776147770537,-0.00328345736553234,-0.00589415741152136,EPCI
200039758,"CC Avallon, Vézelay, Morvan",1968_1975,1971.5,7,20152,21049,2174,2108,897,-66,963,0.00624075199505803,-0.000459185765522664,0.00669993776058069,EPCI
200039758,"CC Avallon, Vézelay, Morvan",1975_1982,1978.5,7,21049,21247,2178,1833,198,-345,543,0.00133841714923766,-0.00233209048730804,0.0036705076365457,EPCI
200039758,"CC Avallon, Vézelay, Morvan",1982_1990,1986,8,21247,21012,2339,2187,-235,-152,-83,-0.00138928477936673,-0.00089860121899465,-0.000490683560372079,EPCI
200039758,"CC Avallon, Vézelay, Morvan",1990_1999,1994.5,9,21012,20847,2296,2141,-165,-155,-10,-0.000875577579322773,-0.000822512271485029,-5.30653078377438e-05,EPCI
200039758,"CC Avallon, Vézelay, Morvan",1999_2010,2004.5,11,20847,20287,2695,2288,-560,-407,-153,-0.00247237193079086,-0.00179688459969979,-0.000675487331091075,EPCI
200039808,CC des Gorges de l'Ardèche,2010_2015,2012.5,5,14183,14849,886,646,666,-240,906,0.00921993586863734,-0.00332249941212156,0.0125424352807589,EPCI
200039808,CC des Gorges de l'Ardèche,1968_1975,1971.5,7,8599,8714,1030,686,115,-344,459,0.00189966068299618,-0.00568246326044076,0.00758212394343695,EPCI
200039808,CC des Gorges de l'Ardèche,1975_1982,1978.5,7,8714,9538,1007,541,824,-466,1290,0.0129912180972167,-0.00734697528313469,0.0203381933803514,EPCI
200039808,CC des Gorges de l'Ardèche,1982_1990,1986,8,9538,10063,1136,781,525,-355,880,0.00672016856186275,-0.00454411397992624,0.011264282541789,EPCI
200039808,CC des Gorges de l'Ardèche,1990_1999,1994.5,9,10063,11458,1221,928,1395,-293,1688,0.0145292994628174,-0.00305167365061327,0.0175809731134307,EPCI
200039808,CC des Gorges de l'Ardèche,1999_2010,2004.5,11,11458,14183,1655,1298,2725,-357,3082,0.019585314121797,-0.00256585583173634,0.0221511699535333,EPCI
200039824,CC Ardèche des Sources et Volcans,2010_2015,2012.5,5,9488,9731,633,378,243,-255,498,0.00507057679992218,-0.00532097565423932,0.0103915524541615,EPCI
200039824,CC Ardèche des Sources et Volcans,1968_1975,1971.5,7,9077,8652,1074,527,-425,-547,122,-0.00682705099673653,-0.00878681622403501,0.00195976522729849,EPCI
200039824,CC Ardèche des Sources et Volcans,1975_1982,1978.5,7,8652,8372,1072,450,-280,-622,342,-0.00468864575135986,-0.010415491633378,0.00572684588201811,EPCI
200039824,CC Ardèche des Sources et Volcans,1982_1990,1986,8,8372,8151,1057,514,-221,-543,322,-0.00333843816561319,-0.00820258789107675,0.00486414972546356,EPCI
200039824,CC Ardèche des Sources et Volcans,1990_1999,1994.5,9,8151,8206,1157,598,55,-559,614,0.00074749867217383,-0.00759730468627583,0.00834480335844966,EPCI
200039824,CC Ardèche des Sources et Volcans,1999_2010,2004.5,11,8206,9488,1268,833,1282,-435,1717,0.0132840270212631,-0.00450745066634122,0.0177914776876043,EPCI
200039832,CC Pays des Vans en Cévennes,2010_2015,2012.5,5,8690,9113,646,302,423,-344,767,0.00955112891284893,-0.00776734833574475,0.0173184772485937,EPCI
200039832,CC Pays des Vans en Cévennes,1968_1975,1971.5,7,7746,7341,897,435,-405,-462,57,-0.00764229204126055,-0.00871787388410462,0.00107558184284408,EPCI
200039832,CC Pays des Vans en Cévennes,1975_1982,1978.5,7,7341,7477,885,412,136,-473,609,0.00262580839601934,-0.00913240714203784,0.0117582155380572,EPCI
200039832,CC Pays des Vans en Cévennes,1982_1990,1986,8,7477,7568,876,523,91,-353,444,0.00151329258984134,-0.00587024488147246,0.0073835374713138,EPCI
200039832,CC Pays des Vans en Cévennes,1990_1999,1994.5,9,7568,7734,1049,540,166,-509,675,0.00241372629554881,-0.00740112460502618,0.00981485090057499,EPCI
200039832,CC Pays des Vans en Cévennes,1999_2010,2004.5,11,7734,8690,1207,722,956,-485,1441,0.010651486186966,-0.00540373514715325,0.0160552213341192,EPCI
200039857,CA du Pays de Grasse,2010_2015,2012.5,5,99973,101860,4434,5743,1887,1309,578,0.00374683629153538,0.00259915670674076,0.00114767958479462,EPCI
200039857,CA du Pays de Grasse,1968_1975,1971.5,7,44136,51871,3981,4171,7735,190,7545,0.0233373068942404,0.000573249943103514,0.0227640569511369,EPCI
200039857,CA du Pays de Grasse,1975_1982,1978.5,7,51871,61792,4716,4517,9921,-199,10120,0.02531717688414,-0.000507823626644881,0.0258250005107849,EPCI
200039857,CA du Pays de Grasse,1982_1990,1986,8,61792,76039,6171,6743,14247,572,13675,0.0262732712572182,0.00105484039861928,0.025218430858599,EPCI
200039857,CA du Pays de Grasse,1990_1999,1994.5,9,76039,85528,7511,9525,9489,2014,7475,0.013152120546311,0.00279148179789971,0.0103606387484113,EPCI
200039857,CA du Pays de Grasse,1999_2010,2004.5,11,85528,99973,8876,12546,14445,3670,10775,0.0142880523929876,0.00363012476858875,0.0106579276243988,EPCI
200039865,Metz Métropole,2010_2015,2012.5,5,223891,220593,8868,13217,-3298,4349,-7647,-0.0029635901920918,0.00390802114778874,-0.00687161133988054,EPCI
200039865,Metz Métropole,1968_1975,1971.5,7,182463,201632,11752,26724,19169,14972,4197,0.0143732938242169,0.0112263005444299,0.00314699327978707,EPCI
200039865,Metz Métropole,1975_1982,1978.5,7,201632,208807,12298,24943,7175,12645,-5470,0.00500765755687338,0.00882534213333295,-0.00381768457645957,EPCI
200039865,Metz Métropole,1982_1990,1986,8,208807,216909,13359,28575,8102,15216,-7114,0.00476978066020672,0.00895790946997106,-0.00418812880976433,EPCI
200039865,Metz Métropole,1990_1999,1994.5,9,216909,225297,14527,28224,8388,13697,-5309,0.0042246343832526,0.00689852374194217,-0.00267388935868956,EPCI
200039865,Metz Métropole,1999_2010,2004.5,11,225297,223891,19016,31175,-1406,12159,-13565,-0.000568947677836884,0.00492022390812139,-0.00548917158595827,EPCI
200039907,CC du Sud Messin,2010_2015,2012.5,5,15266,15954,472,877,688,405,283,0.00885526756662802,0.00521276651814586,0.00364250104848217,EPCI
200039907,CC du Sud Messin,1968_1975,1971.5,7,7617,9363,676,884,1746,208,1538,0.0299222445381349,0.00356462019698285,0.026357624341152,EPCI
200039907,CC du Sud Messin,1975_1982,1978.5,7,9363,11191,677,886,1828,209,1619,0.0258050645435983,0.00295036022407661,0.0228547043195217,EPCI
200039907,CC du Sud Messin,1982_1990,1986,8,11191,12395,779,1356,1204,577,627,0.012854832246691,0.00616049684912021,0.00669433539757083,EPCI
200039907,CC du Sud Messin,1990_1999,1994.5,9,12395,13286,750,1258,891,508,383,0.00774289836818443,0.00441458178567642,0.00332831658250801,EPCI
200039907,CC du Sud Messin,1999_2010,2004.5,11,13286,15266,1069,1735,1980,666,1314,0.0127089246160654,0.0042748200981311,0.00843410451793433,EPCI
200039915,CA Cannes Pays de Lérins,2010_2015,2012.5,5,158225,158225,9723,8903,0,-820,820,0,,,EPCI
200039915,CA Cannes Pays de Lérins,1968_1975,1971.5,7,103586,123244,10085,9105,19658,-980,20638,0.0251340870435832,-0.00125299650537753,0.0263870835489608,EPCI
200039915,CA Cannes Pays de Lérins,1975_1982,1978.5,7,123244,135160,12021,9171,11916,-2850,14766,0.0132720349481541,-0.00317432860038932,0.0164463635485434,EPCI
200039915,CA Cannes Pays de Lérins,1982_1990,1986,8,135160,141241,15399,11637,6081,-3762,9843,0.00551620721848556,-0.0034125919348697,0.00892879915335526,EPCI
200039915,CA Cannes Pays de Lérins,1990_1999,1994.5,9,141241,144679,17415,14597,3438,-2818,6256,0.0026757784187752,-0.00219323548112522,0.00486901389990042,EPCI
200039915,CA Cannes Pays de Lérins,1999_2010,2004.5,11,144679,158225,21815,18783,13546,-3032,16578,0.00816960653469945,-0.00182860231900256,0.00999820885370201,EPCI
200039931,CC Alpes d'Azur,2010_2015,2012.5,5,9477,9689,603,432,212,-171,383,0.00443448554275627,-0.00357687277269492,0.00801135831545119,EPCI
200039931,CC Alpes d'Azur,1968_1975,1971.5,7,6265,5933,780,428,-332,-352,20,-0.00774819833301266,-0.00821495726873631,0.000466758935723654,EPCI
200039931,CC Alpes d'Azur,1975_1982,1978.5,7,5933,6374,703,318,441,-385,826,0.010295094797256,-0.00898778117220761,0.0192828759694636,EPCI
200039931,CC Alpes d'Azur,1982_1990,1986,8,6374,7385,776,484,1011,-292,1303,0.0185733405617985,-0.00536440696740372,0.0239377475292022,EPCI
200039931,CC Alpes d'Azur,1990_1999,1994.5,9,7385,7796,827,594,411,-233,644,0.00603590596158443,-0.0034218153018228,0.00945772126340723,EPCI
200039931,CC Alpes d'Azur,1999_2010,2004.5,11,7796,9477,1256,851,1681,-405,2086,0.0179091178898045,-0.00431480829587795,0.0222239261856825,EPCI
200039949,CC Rives de Moselle,2010_2015,2012.5,5,50367,51163,2040,3024,796,984,-188,0.00314100581965726,0.0038828514152547,-0.000741845595597444,EPCI
200039949,CC Rives de Moselle,1968_1975,1971.5,7,46303,49079,2431,6047,2776,3616,-840,0.00835247329853561,0.0108798787635104,-0.00252740546497475,EPCI
200039949,CC Rives de Moselle,1975_1982,1978.5,7,49079,46468,2531,4652,-2611,2121,-4732,-0.00777920430188495,0.006319300009306,-0.0140985043111909,EPCI
200039949,CC Rives de Moselle,1982_1990,1986,8,46468,44783,2804,4759,-1685,1955,-3640,-0.00460627100887234,0.00534436784708928,-0.00995063885596162,EPCI
200039949,CC Rives de Moselle,1990_1999,1994.5,9,44783,47107,3174,5122,2324,1948,376,0.00563727517346435,0.00472522032612244,0.000912054847341909,EPCI
200039949,CC Rives de Moselle,1999_2010,2004.5,11,47107,50367,4239,6174,3260,1935,1325,0.00610168433269731,0.00362170527109488,0.00247997906160244,EPCI
200040038,CC Saône Doubs Bresse,2010_2015,2012.5,5,11646,12127,516,669,481,153,328,0.00812716722369467,0.00258514882583219,0.00554201839786247,EPCI
200040038,CC Saône Doubs Bresse,1968_1975,1971.5,7,9230,8572,881,761,-658,-120,-538,-0.010509806366676,-0.00191668201215975,-0.00859312435451622,EPCI
200040038,CC Saône Doubs Bresse,1975_1982,1978.5,7,8572,9083,905,590,511,-315,826,0.00830622929513236,-0.00512027833261584,0.0134265076277482,EPCI
200040038,CC Saône Doubs Bresse,1982_1990,1986,8,9083,9374,958,810,291,-148,439,0.00394970021046581,-0.00200878223762522,0.00595848244809104,EPCI
200040038,CC Saône Doubs Bresse,1990_1999,1994.5,9,9374,9847,986,868,473,-118,591,0.00548464598587573,-0.0013682626349542,0.00685290862082992,EPCI
200040038,CC Saône Doubs Bresse,1999_2010,2004.5,11,9847,11646,1199,1263,1799,64,1735,0.0153711145245803,0.000546832312158498,0.0148242822124218,EPCI
200040095,CC Isle Vern Salembre en Périgord,2010_2015,2012.5,5,18669,19011,1175,846,342,-329,671,0.0036372718276021,-0.00349901295696225,0.00713628478456435,EPCI
200040095,CC Isle Vern Salembre en Périgord,1968_1975,1971.5,7,14255,14666,1255,1198,411,-57,468,0.00406885071692975,-0.000564293165121644,0.0046331438820514,EPCI
200040095,CC Isle Vern Salembre en Périgord,1975_1982,1978.5,7,14666,15201,1455,941,535,-514,1049,0.00513159684182862,-0.0049301696760746,0.0100617665179032,EPCI
200040095,CC Isle Vern Salembre en Périgord,1982_1990,1986,8,15201,15825,1624,1201,624,-423,1047,0.00504138433754098,-0.00341747688265999,0.00845886122020097,EPCI
200040095,CC Isle Vern Salembre en Périgord,1990_1999,1994.5,9,15825,16852,1928,1323,1027,-605,1632,0.00701094866239882,-0.00413011094523007,0.0111410596076289,EPCI
200040095,CC Isle Vern Salembre en Périgord,1999_2010,2004.5,11,16852,18669,2263,1857,1817,-406,2223,0.0093521010665345,-0.0020896824617573,0.0114417835282918,EPCI
200040111,CC Coeur de Chartreuse,2010_2015,2012.5,5,16502,16943,811,941,441,130,311,0.00528857208550959,0.00155898950366496,0.00372958258184463,EPCI
200040111,CC Coeur de Chartreuse,1968_1975,1971.5,7,12015,11763,1071,1126,-252,55,-307,-0.00302354232001745,0.000659900109527617,-0.00368344242954506,EPCI
200040111,CC Coeur de Chartreuse,1975_1982,1978.5,7,11763,12749,1042,1012,986,-30,1016,0.0115654868896129,-0.000351891081834064,0.011917377971447,EPCI
200040111,CC Coeur de Chartreuse,1982_1990,1986,8,12749,13609,1150,1243,860,93,767,0.00819319468444224,0.000886008262387358,0.00730718642205488,EPCI
200040111,CC Coeur de Chartreuse,1990_1999,1994.5,9,13609,14604,1293,1480,995,187,808,0.00787127523771103,0.0014793250949266,0.00639195014278443,EPCI
200040111,CC Coeur de Chartreuse,1999_2010,2004.5,11,14604,16502,1666,2133,1898,467,1431,0.0111697502549679,0.00274829998370391,0.00842145027126401,EPCI
200040137,CC des Lacs de Champagne,2010_2015,2012.5,5,9891,9655,594,425,-236,-169,-67,-0.00481822232157836,-0.00345033717096077,-0.00136788515061758,EPCI
200040137,CC des Lacs de Champagne,1968_1975,1971.5,7,11888,11231,916,1246,-657,330,-987,-0.00808877635889782,0.00406285570538247,-0.0121516320642803,EPCI
200040137,CC des Lacs de Champagne,1975_1982,1978.5,7,11231,10874,986,966,-357,-20,-337,-0.0046041103327652,-0.000257933351975641,-0.00434617698078956,EPCI
200040137,CC des Lacs de Champagne,1982_1990,1986,8,10874,10379,1068,973,-495,-95,-400,-0.00580683537093796,-0.00111444315199819,-0.00469239221893976,EPCI
200040137,CC des Lacs de Champagne,1990_1999,1994.5,9,10379,9827,1079,1005,-552,-74,-478,-0.00605391571225045,-0.000811575657077053,-0.00524234005517339,EPCI
200040137,CC des Lacs de Champagne,1999_2010,2004.5,11,9827,9891,1345,1173,64,-172,236,0.000590315383715456,-0.00158647259373529,0.00217678797745074,EPCI
200040178,CC de l'Outre-Forêt,2010_2015,2012.5,5,15809,16081,655,813,272,158,114,0.00341763740200607,0.00198524525557705,0.00143239214642901,EPCI
200040178,CC de l'Outre-Forêt,1968_1975,1971.5,7,12301,12450,1006,1427,149,421,-272,0.00172148906737712,0.00486407313668302,-0.00314258406930589,EPCI
200040178,CC de l'Outre-Forêt,1975_1982,1978.5,7,12450,12993,997,1266,543,269,274,0.00611722397272563,0.00303044797175542,0.00308677600097021,EPCI
200040178,CC de l'Outre-Forêt,1982_1990,1986,8,12993,13394,1089,1381,401,292,109,0.00380673911895491,0.00277198958287988,0.00103474953607502,EPCI
200040178,CC de l'Outre-Forêt,1990_1999,1994.5,9,13394,14386,1109,1446,992,337,655,0.00797033601734065,0.00270766455427802,0.00526267146306263,EPCI
200040178,CC de l'Outre-Forêt,1999_2010,2004.5,11,14386,15809,1291,1825,1423,534,889,0.00861176854214829,0.00323168264336415,0.00538008589878414,EPCI
200040202,CC Provence Verdon,2010_2015,2012.5,5,20570,22057,1142,1064,1487,-78,1565,0.0140571470649116,-0.000737362119074043,0.0147945091839856,EPCI
200040202,CC Provence Verdon,1968_1975,1971.5,7,8470,8465,830,702,-5,-128,123,-8.43525962431757e-05,-0.0021594264638253,0.00207507386758212,EPCI
200040202,CC Provence Verdon,1975_1982,1978.5,7,8465,9323,899,538,858,-361,1219,0.0138876135337918,-0.00584315674323872,0.0197307702770305,EPCI
200040202,CC Provence Verdon,1982_1990,1986,8,9323,12204,1197,895,2881,-302,3183,0.0342328174577411,-0.00358844528713565,0.0378212627448767,EPCI
200040202,CC Provence Verdon,1990_1999,1994.5,9,12204,14997,1701,1192,2793,-509,3302,0.0231626735152275,-0.00422119614008263,0.0273838696553101,EPCI
200040202,CC Provence Verdon,1999_2010,2004.5,11,14997,20570,2267,2110,5573,-157,5730,0.0291423389904191,-0.000820984608199496,0.0299633235986186,EPCI
200040210,CC Lacs et Gorges du Verdon,2010_2015,2012.5,5,8103,8880,485,313,777,-172,949,0.0184821580940291,-0.00409128853561519,0.0225734466296443,EPCI
200040210,CC Lacs et Gorges du Verdon,1968_1975,1971.5,7,3666,3803,445,248,137,-197,334,0.00525505670195892,-0.00755654138894822,0.0128115980909071,EPCI
200040210,CC Lacs et Gorges du Verdon,1975_1982,1978.5,7,3803,4484,429,233,681,-196,877,0.0238112488411626,-0.00685316413049614,0.0306644129716587,EPCI
200040210,CC Lacs et Gorges du Verdon,1982_1990,1986,8,4484,5445,486,404,961,-82,1043,0.0245697633463706,-0.00209648344890988,0.0266662467952805,EPCI
200040210,CC Lacs et Gorges du Verdon,1990_1999,1994.5,9,5445,6184,622,457,739,-165,904,0.0142412940489876,-0.00317972059280507,0.0174210146417926,EPCI
200040210,CC Lacs et Gorges du Verdon,1999_2010,2004.5,11,6184,8103,899,646,1919,-253,2172,0.0248742414918972,-0.00327940755468994,0.0281536490465872,EPCI
200040244,CA du Bocage Bressuirais,2010_2015,2012.5,5,71537,73428,3253,4271,1891,1018,873,0.00523174521229541,0.00281645511693111,0.0024152900953643,EPCI
200040244,CA du Bocage Bressuirais,1968_1975,1971.5,7,63139,66435,4534,8186,3296,3652,-356,0.00729582591488542,0.00808384594695436,-0.000788020032068936,EPCI
200040244,CA du Bocage Bressuirais,1975_1982,1978.5,7,66435,68596,4391,7851,2161,3460,-1299,0.00458335701777646,0.00733846149074805,-0.0027551044729716,EPCI
200040244,CA du Bocage Bressuirais,1982_1990,1986,8,68596,69696,5040,7464,1100,2424,-1324,0.00199056646681228,0.0043864846505027,-0.00239591818369042,EPCI
200040244,CA du Bocage Bressuirais,1990_1999,1994.5,9,69696,68013,5612,7124,-1683,1512,-3195,-0.00271232209359795,0.00243673856537142,-0.00514906065896938,EPCI
200040244,CA du Bocage Bressuirais,1999_2010,2004.5,11,68013,71537,6766,9422,3524,2656,868,0.00460291876203489,0.00346916919181744,0.00113374957021745,EPCI
200040251,CC Bassée-Montois,2010_2015,2012.5,5,23172,23527,1186,1295,355,109,246,0.00304543686191705,0.00093507779703932,0.00211035906487773,EPCI
200040251,CC Bassée-Montois,1968_1975,1971.5,7,15069,15072,1514,1388,3,-126,129,2.84381754986907e-05,-0.00119440337094501,0.0012228415464437,EPCI
200040251,CC Bassée-Montois,1975_1982,1978.5,7,15072,16429,1513,1169,1357,-344,1701,0.0123917707065455,-0.00314131843997911,0.0155330891465246,EPCI
200040251,CC Bassée-Montois,1982_1990,1986,8,16429,19056,1749,1718,2627,-31,2658,0.0187147088325028,-0.00022084353780266,0.0189355523703055,EPCI
200040251,CC Bassée-Montois,1990_1999,1994.5,9,19056,21240,1793,2198,2184,405,1779,0.0121289871667269,0.00224919404877491,0.00987979311795203,EPCI
200040251,CC Bassée-Montois,1999_2010,2004.5,11,21240,23172,2374,2733,1932,359,1573,0.0079458068609779,0.00147647239290428,0.00646933446807362,EPCI
200040277,CA du Pays de Dreux,2010_2015,2012.5,5,112695,114895,4721,8308,2200,3587,-1387,0.00387420808051231,0.00631672017490802,-0.00244251209439572,EPCI
200040277,CA du Pays de Dreux,1968_1975,1971.5,7,71384,83616,5416,10893,12232,5477,6755,0.0228516357096991,0.0102320478075557,0.0126195879021433,EPCI
200040277,CA du Pays de Dreux,1975_1982,1978.5,7,83616,93453,5614,10802,9837,5188,4649,0.0160160097726674,0.00844678852298448,0.00756922124968289,EPCI
200040277,CA du Pays de Dreux,1982_1990,1986,8,93453,107223,6654,13485,13770,6831,6939,0.0173299689812745,0.00859702382796558,0.0087329451533089,EPCI
200040277,CA du Pays de Dreux,1990_1999,1994.5,9,107223,107341,7870,13733,118,5863,-5745,0.000122219138634971,0.00607263398149862,-0.00595041484286365,EPCI
200040277,CA du Pays de Dreux,1999_2010,2004.5,11,107341,112695,10116,17003,5354,6887,-1533,0.00443474738788718,0.00570453964519593,-0.00126979225730875,EPCI
200040293,CC du Clunisois,2010_2015,2012.5,5,13672,13836,1006,541,164,-465,629,0.00238763492355631,-0.00676981853325418,0.0091574534568105,EPCI
200040293,CC du Clunisois,1968_1975,1971.5,7,13256,13200,1409,1213,-56,-196,140,-0.000604595805674735,-0.00211608531986157,0.00151148951418684,EPCI
200040293,CC du Clunisois,1975_1982,1978.5,7,13200,12841,1348,955,-359,-393,34,-0.0039313451979851,-0.00430367315545444,0.000372327957469341,EPCI
200040293,CC du Clunisois,1982_1990,1986,8,12841,12546,1497,1020,-295,-477,182,-0.00290094500051219,-0.00469068056015022,0.00178973555963803,EPCI
200040293,CC du Clunisois,1990_1999,1994.5,9,12546,12745,1541,1144,199,-397,596,0.0017501016605419,-0.00349140884037757,0.00524151050091947,EPCI
200040293,CC du Clunisois,1999_2010,2004.5,11,12745,13672,2217,1298,927,-919,1846,0.00640322335621812,-0.00634796360772865,0.0127511869639468,EPCI
200040350,CC Bugey Sud,2010_2015,2012.5,5,32181,33665,1644,1854,1484,210,1274,0.00905727223460229,0.0012816894671607,0.00777558276744159,EPCI
200040350,CC Bugey Sud,1968_1975,1971.5,7,23532,23698,2320,2368,166,48,118,0.00100471287078219,0.00029051938432256,0.000714193486459627,EPCI
200040350,CC Bugey Sud,1975_1982,1978.5,7,23698,25362,2181,2134,1664,-47,1711,0.00974162000245915,-0.000275153930357921,0.0100167739328171,EPCI
200040350,CC Bugey Sud,1982_1990,1986,8,25362,25941,2509,2504,579,-5,584,0.00282557666717098,-2.44004893538081e-05,0.00284997715652479,EPCI
200040350,CC Bugey Sud,1990_1999,1994.5,9,25941,27531,2856,2697,1590,-159,1749,0.00663166093308343,-0.000663166093308343,0.00729482702639177,EPCI
200040350,CC Bugey Sud,1999_2010,2004.5,11,27531,32181,3502,3844,4650,342,4308,0.0142887192376324,0.00105091225360651,0.0132378069840259,EPCI
200040384,CC Isle Double Landais,2010_2015,2012.5,5,11714,11920,856,498,206,-358,564,0.0034926760217826,-0.00606979619319501,0.00956247221497761,EPCI
200040384,CC Isle Double Landais,1968_1975,1971.5,7,10509,10726,1233,879,217,-354,571,0.0029240764641647,-0.00477015238854519,0.00769422885270989,EPCI
200040384,CC Isle Double Landais,1975_1982,1978.5,7,10726,10845,1093,645,119,-448,567,0.00157744911142621,-0.00593863194889867,0.00751608106032488,EPCI
200040384,CC Isle Double Landais,1982_1990,1986,8,10845,10732,1291,773,-113,-518,405,-0.00130841973594131,-0.00599788870104071,0.0046894689650994,EPCI
200040384,CC Isle Double Landais,1990_1999,1994.5,9,10732,10596,1397,797,-136,-600,464,-0.00141603660087908,-0.00624722029799593,0.00483118369711686,EPCI
200040384,CC Isle Double Landais,1999_2010,2004.5,11,10596,11714,1902,1191,1118,-711,1829,0.00916062551131924,-0.00582576452464041,0.0149863900359597,EPCI
200040392,CA Le Grand Périgueux,2010_2015,2012.5,5,101804,103461,5185,5070,1657,-115,1772,0.00323428585717256,-0.000224467636436237,0.0034587534936088,EPCI
200040392,CA Le Grand Périgueux,1968_1975,1971.5,7,81110,83597,7025,8180,2487,1155,1332,0.00432380309264002,0.00200803883071943,0.00231576426192059,EPCI
200040392,CA Le Grand Périgueux,1975_1982,1978.5,7,83597,87347,6933,7539,3750,606,3144,0.00628841200759811,0.00101620738042785,0.00527220462717026,EPCI
200040392,CA Le Grand Périgueux,1982_1990,1986,8,87347,91682,7530,8340,4335,810,3525,0.00607303861813135,0.0011347546206889,0.00493828399744245,EPCI
200040392,CA Le Grand Périgueux,1990_1999,1994.5,9,91682,93905,8350,8311,2223,-39,2262,0.0026654978276579,-4.6763119783472e-05,0.00271226094744138,EPCI
200040392,CA Le Grand Périgueux,1999_2010,2004.5,11,93905,101804,10925,10879,7899,-46,7945,0.00736936318984394,-4.29156484026866e-05,0.00741227883824662,EPCI
200040400,CC du Pays Ribéracois,2010_2015,2012.5,5,19911,19802,1427,741,-109,-686,577,-0.00109727757653155,-0.00690580199541876,0.00580852441888721,EPCI
200040400,CC du Pays Ribéracois,1968_1975,1971.5,7,20269,19290,2116,1461,-979,-655,-324,-0.00704730734779524,-0.00471500134096617,-0.00233230600682907,EPCI
200040400,CC du Pays Ribéracois,1975_1982,1978.5,7,19290,18772,2088,1200,-518,-888,370,-0.0038810817708077,-0.00665328303567035,0.00277220126486265,EPCI
200040400,CC du Pays Ribéracois,1982_1990,1986,8,18772,19067,2284,1422,295,-862,1157,0.00195098747306166,-0.00570085153145475,0.00765183900451641,EPCI
200040400,CC du Pays Ribéracois,1990_1999,1994.5,9,19067,18985,2508,1423,-82,-1085,1003,-0.000478762956261036,-0.00633485131150274,0.0058560883552417,EPCI
200040400,CC du Pays Ribéracois,1999_2010,2004.5,11,18985,19911,3084,1802,926,-1282,2208,0.0043387624880038,-0.00600679644667481,0.0103455589346786,EPCI
200040418,CC du Pays de Serres en Quercy,2010_2015,2012.5,5,8821,8627,515,336,-194,-179,-15,-0.00443780813566308,-0.00409467864063758,-0.000343129495025496,EPCI
200040418,CC du Pays de Serres en Quercy,1968_1975,1971.5,7,10684,9633,971,785,-1051,-186,-865,-0.0146843451331208,-0.00259875185039055,-0.0120855932827302,EPCI
200040418,CC du Pays de Serres en Quercy,1975_1982,1978.5,7,9633,9201,944,564,-432,-380,-52,-0.00653321229793968,-0.00574680711392843,-0.000786405184011258,EPCI
200040418,CC du Pays de Serres en Quercy,1982_1990,1986,8,9201,9227,1038,718,26,-320,346,0.000352786564072449,-0.00434198848089168,0.00469477504496413,EPCI
200040418,CC du Pays de Serres en Quercy,1990_1999,1994.5,9,9227,8835,1102,675,-392,-427,35,-0.00481203630171179,-0.00524168240007891,0.000429646098367124,EPCI
200040418,CC du Pays de Serres en Quercy,1999_2010,2004.5,11,8835,8821,1251,797,-14,-454,440,-0.000144159016729262,-0.00467487097107749,0.00453071195434823,EPCI
200040426,CC du Val de l'Oise,2010_2015,2012.5,5,16528,16240,793,906,-288,113,-401,-0.00350954263707326,0.00137700804857388,-0.00488655068564714,EPCI
200040426,CC du Val de l'Oise,1968_1975,1971.5,7,17584,16685,1457,1911,-899,454,-1353,-0.00746900806735162,0.00377189061465811,-0.0112408986820097,EPCI
200040426,CC du Val de l'Oise,1975_1982,1978.5,7,16685,16786,1388,1519,101,131,-30,0.00086252797168096,0.00111872439891293,-0.000256196427231968,EPCI
200040426,CC du Val de l'Oise,1982_1990,1986,8,16786,17044,1613,1809,258,196,62,0.00190844751944264,0.00144982834810371,0.000458619171338928,EPCI
200040426,CC du Val de l'Oise,1990_1999,1994.5,9,17044,16506,1506,1688,-538,182,-720,-0.00355746655369238,0.00120345522820077,-0.00476092178189315,EPCI
200040426,CC du Val de l'Oise,1999_2010,2004.5,11,16506,16528,1793,2165,22,372,-350,0.00012109471380839,0.0020476015243964,-0.00192650681058802,EPCI
200040442,CA Luberon Monts de Vaucluse,2010_2015,2012.5,5,52827,55164,2666,3361,2337,695,1642,0.00869521424874375,0.00258586816554425,0.00610934608319951,EPCI
200040442,CA Luberon Monts de Vaucluse,1968_1975,1971.5,7,31581,35990,2536,3213,4409,677,3732,0.0188447116436872,0.00289359713830261,0.0159511145053846,EPCI
200040442,CA Luberon Monts de Vaucluse,1975_1982,1978.5,7,35990,38370,2856,3093,2380,237,2143,0.00918979526261809,0.000915118267748104,0.00827467699486999,EPCI
200040442,CA Luberon Monts de Vaucluse,1982_1990,1986,8,38370,44742,3494,4155,6372,661,5711,0.0193901885949588,0.00201144297885558,0.0173787456161032,EPCI
200040442,CA Luberon Monts de Vaucluse,1990_1999,1994.5,9,44742,49326,4338,5123,4584,785,3799,0.01089656957367,0.00186601376861496,0.00903055580505507,EPCI
200040442,CA Luberon Monts de Vaucluse,1999_2010,2004.5,11,49326,52827,5590,6711,3501,1121,2380,0.00625320637423577,0.00200224060140483,0.00425096577283094,EPCI
200040459,CA Montélimar Agglomération,2010_2015,2012.5,5,59367,64249,2478,3803,4882,1325,3557,0.0159310966548205,0.00432378186555452,0.011607314789266,EPCI
200040459,CA Montélimar Agglomération,1968_1975,1971.5,7,39384,41439,2767,4648,2055,1881,174,0.00729257999140676,0.00667510606512706,0.000617473926279696,EPCI
200040459,CA Montélimar Agglomération,1975_1982,1978.5,7,41439,45064,2918,3874,3625,956,2669,0.0120522262074789,0.0031784629667172,0.00887376324076172,EPCI
200040459,CA Montélimar Agglomération,1982_1990,1986,8,45064,48340,3367,5253,3276,1886,1390,0.00881054558807981,0.00507224938312531,0.0037382962049545,EPCI
200040459,CA Montélimar Agglomération,1990_1999,1994.5,9,48340,51690,3957,5794,3350,1837,1513,0.00747277888020825,0.00409775964266942,0.00337501923753883,EPCI
200040459,CA Montélimar Agglomération,1999_2010,2004.5,11,51690,59367,5226,7838,7677,2612,5065,0.0126681310451062,0.0043101678116214,0.00835796323348483,EPCI
200040475,CC Loué - Brûlon - Noyen,2010_2015,2012.5,5,18194,18637,871,1273,443,402,41,0.00482298989401375,0.00437661836883415,0.000446371525179602,EPCI
200040475,CC Loué - Brûlon - Noyen,1968_1975,1971.5,7,15916,14747,1292,1577,-1169,285,-1454,-0.0108387217519179,0.00264245996518101,-0.0134811817170989,EPCI
200040475,CC Loué - Brûlon - Noyen,1975_1982,1978.5,7,14747,13939,1159,1240,-808,81,-889,-0.00801754458929116,0.000803738999669039,-0.0088212835889602,EPCI
200040475,CC Loué - Brûlon - Noyen,1982_1990,1986,8,13939,14208,1360,1455,269,95,174,0.0023921716254165,0.000844818975518836,0.00154735264989766,EPCI
200040475,CC Loué - Brûlon - Noyen,1990_1999,1994.5,9,14208,15305,1545,1778,1097,233,864,0.00829806030090352,0.00176248682781269,0.00653557347309083,EPCI
200040475,CC Loué - Brûlon - Noyen,1999_2010,2004.5,11,15305,18194,1775,2703,2889,928,1961,0.0158434978351927,0.00508922325754891,0.0107542745776438,EPCI
200040491,CC Porte de Drômardèche,2010_2015,2012.5,5,44242,46366,1894,2938,2124,1044,1080,0.00942248831855119,0.00463139256335567,0.00479109575519552,EPCI
200040491,CC Porte de Drômardèche,1968_1975,1971.5,7,33267,33887,2626,3632,620,1006,-386,0.0026414174655085,0.00428591285532508,-0.00164449538981658,EPCI
200040491,CC Porte de Drômardèche,1975_1982,1978.5,7,33887,33606,2624,2865,-281,241,-522,-0.00118884099041572,0.00101961095619284,-0.00220845194660856,EPCI
200040491,CC Porte de Drômardèche,1982_1990,1986,8,33606,35213,2770,3448,1607,678,929,0.00585591801250462,0.00247063622431745,0.00338528178818718,EPCI
200040491,CC Porte de Drômardèche,1990_1999,1994.5,9,35213,36768,3140,3890,1555,750,805,0.00481294173713875,0.00232135453559747,0.00249158720154128,EPCI
200040491,CC Porte de Drômardèche,1999_2010,2004.5,11,36768,44242,3968,5754,7474,1786,5688,0.0169647176231797,0.00405391834024606,0.0129107992829337,EPCI
200040509,CC du Crestois et de Pays de Saillans Coeur de Drôme,2010_2015,2012.5,5,14244,14952,849,809,708,-40,748,0.00974907657007318,-0.000550795286444812,0.010299871856518,EPCI
200040509,CC du Crestois et de Pays de Saillans Coeur de Drôme,1968_1975,1971.5,7,11414,11965,1145,1251,551,106,445,0.00675773819785808,0.0013000367494972,0.00545770144836088,EPCI
200040509,CC du Crestois et de Pays de Saillans Coeur de Drôme,1975_1982,1978.5,7,11965,12242,1135,1098,277,-37,314,0.00327491386098822,-0.000437443367713227,0.00371235722870144,EPCI
200040509,CC du Crestois et de Pays de Saillans Coeur de Drôme,1982_1990,1986,8,12242,12594,1194,1288,352,94,258,0.00354976650539762,0.000947949009964138,0.00260181749543348,EPCI
200040509,CC du Crestois et de Pays de Saillans Coeur de Drôme,1990_1999,1994.5,9,12594,13146,1414,1316,552,-98,650,0.00477771257615567,-0.000848217087795753,0.00562592966395142,EPCI
200040509,CC du Crestois et de Pays de Saillans Coeur de Drôme,1999_2010,2004.5,11,13146,14244,1830,1631,1098,-199,1297,0.00731922239248584,-0.00132652573415727,0.0086457481266431,EPCI
200040558,CC Écueillé-Valençay,2010_2015,2012.5,5,11962,11469,967,412,-493,-555,62,-0.00838211556610913,-0.00943625586042711,0.00105414029431798,EPCI
200040558,CC Écueillé-Valençay,1968_1975,1971.5,7,15254,14843,1502,1278,-411,-224,-187,-0.00389431030072152,-0.00212244648993095,-0.00177186381079057,EPCI
200040558,CC Écueillé-Valençay,1975_1982,1978.5,7,14843,14589,1650,998,-254,-652,398,-0.00246275579342425,-0.00632171959571895,0.0038589638022947,EPCI
200040558,CC Écueillé-Valençay,1982_1990,1986,8,14589,13525,1796,889,-1064,-907,-157,-0.00942133788027433,-0.00803115926448197,-0.00139017861579236,EPCI
200040558,CC Écueillé-Valençay,1990_1999,1994.5,9,13525,12524,1826,935,-1001,-891,-110,-0.00850727560777598,-0.00757241015637202,-0.000934865451403954,EPCI
200040558,CC Écueillé-Valençay,1999_2010,2004.5,11,12524,11962,2251,1012,-562,-1239,677,-0.00416510586204777,-0.00918250206953236,0.00501739620748459,EPCI
200040566,CA de l'Ouest Rhodanien,2010_2015,2012.5,5,49855,50692,2533,2998,837,465,372,0.00333541314027697,0.00185300730015387,0.0014824058401231,EPCI
200040566,CA de l'Ouest Rhodanien,1968_1975,1971.5,7,49940,48170,4644,5393,-1770,749,-2519,-0.00514185861332384,0.0021758486448472,-0.00731770725817104,EPCI
200040566,CA de l'Ouest Rhodanien,1975_1982,1978.5,7,48170,46735,4426,4562,-1435,136,-1571,-0.00431111918878047,0.000408579937055152,-0.00471969912583562,EPCI
200040566,CA de l'Ouest Rhodanien,1982_1990,1986,8,46735,46456,4701,4892,-279,191,-470,-0.000748185040487459,0.000512198361050554,-0.00126038340153801,EPCI
200040566,CA de l'Ouest Rhodanien,1990_1999,1994.5,9,46456,46634,4953,5134,178,181,-3,0.000425008152277639,0.000432171211023892,-7.16305874625236e-06,EPCI
200040566,CA de l'Ouest Rhodanien,1999_2010,2004.5,11,46634,49855,5764,6630,3221,866,2355,0.00609018874168266,0.00163741181319378,0.00445277692848887,EPCI
200040574,CC Beaujolais Pierres Dorées,2010_2015,2012.5,5,47601,50674,1860,2948,3073,1088,1985,0.0125904383384645,0.00445766251618919,0.00813277582227532,EPCI
200040574,CC Beaujolais Pierres Dorées,1968_1975,1971.5,7,22021,26038,2302,2544,4017,242,3775,0.0242260041282747,0.00145947050013505,0.0227665336281396,EPCI
200040574,CC Beaujolais Pierres Dorées,1975_1982,1978.5,7,26038,30909,2352,2534,4871,182,4689,0.0248011848090222,0.000926671245173893,0.0238745135638483,EPCI
200040574,CC Beaujolais Pierres Dorées,1982_1990,1986,8,30909,35327,2614,3165,4418,551,3867,0.0168402423491285,0.00210026562570616,0.0147399767234224,EPCI
200040574,CC Beaujolais Pierres Dorées,1990_1999,1994.5,9,35327,40949,2764,4005,5622,1241,4381,0.0165442366826167,0.00365197398134603,0.0128922627012707,EPCI
200040574,CC Beaujolais Pierres Dorées,1999_2010,2004.5,11,40949,47601,3844,5964,6652,2120,4532,0.0137782737454921,0.00439115158455251,0.00938712216093961,EPCI
200040590,CA Villefranche Beaujolais Saône,2010_2015,2012.5,5,69761,72896,2495,5499,3135,3004,131,0.00883049146531145,0.00846149804204007,0.000368993423271388,EPCI
200040590,CA Villefranche Beaujolais Saône,1968_1975,1971.5,7,42901,50187,3373,5856,7286,2483,4803,0.0226616599181715,0.00772287971133953,0.014938780206832,EPCI
200040590,CA Villefranche Beaujolais Saône,1975_1982,1978.5,7,50187,53713,3377,6104,3526,2727,799,0.00974705739530135,0.00753835096908304,0.00220870642621832,EPCI
200040590,CA Villefranche Beaujolais Saône,1982_1990,1986,8,53713,58683,4002,7861,4970,3859,1111,0.011123286142884,0.00863677288237214,0.00248651326051191,EPCI
200040590,CA Villefranche Beaujolais Saône,1990_1999,1994.5,9,58683,62387,4423,8419,3704,3996,-292,0.0068239380860069,0.00736189432820831,-0.000537956242201407,EPCI
200040590,CA Villefranche Beaujolais Saône,1999_2010,2004.5,11,62387,69761,5311,11250,7374,5939,1435,0.0102079486937965,0.00822145474538342,0.00198649394841307,EPCI
200040624,CC Pays d'Apt-Luberon,2010_2015,2012.5,5,30008,30023,1556,1508,15,-48,63,9.99533570980038e-05,-0.000319850742713612,0.000419804099811616,EPCI
200040624,CC Pays d'Apt-Luberon,1968_1975,1971.5,7,19737,22931,1714,2335,3194,621,2573,0.0216590326699755,0.00421110184347363,0.0174479308265019,EPCI
200040624,CC Pays d'Apt-Luberon,1975_1982,1978.5,7,22931,25448,1844,2023,2517,179,2338,0.0149894382668032,0.00106599501380921,0.013923443252994,EPCI
200040624,CC Pays d'Apt-Luberon,1982_1990,1986,8,25448,27913,2094,2816,2465,722,1743,0.0116239611894424,0.00340466530579206,0.00821929588365036,EPCI
200040624,CC Pays d'Apt-Luberon,1990_1999,1994.5,9,27913,27984,2661,2767,71,106,-35,0.000282305190506316,0.000421469721037598,-0.000139164530531282,EPCI
200040624,CC Pays d'Apt-Luberon,1999_2010,2004.5,11,27984,30008,3230,3380,2024,150,1874,0.00636847436409793,0.000471971914335321,0.00589650244976261,EPCI
200040657,CC de la Matheysine,2010_2015,2012.5,5,19136,19154,975,951,18,-24,42,0.000188056346619447,-0.000250741795492597,0.000438798142112044,EPCI
200040657,CC de la Matheysine,1968_1975,1971.5,7,18996,15698,1652,1299,-3298,-353,-2945,-0.0268744383989926,-0.00287649386138399,-0.0239979445376086,EPCI
200040657,CC de la Matheysine,1975_1982,1978.5,7,15698,16673,1691,1240,975,-451,1426,0.00864534684691898,-0.00399902710560047,0.0126443739525195,EPCI
200040657,CC de la Matheysine,1982_1990,1986,8,16673,17202,1763,1631,529,-132,661,0.00391200845108886,-0.000976153337511775,0.00488816178860063,EPCI
200040657,CC de la Matheysine,1990_1999,1994.5,9,17202,17476,1838,1647,274,-191,465,0.0017574152205686,-0.0012250595150679,0.0029824747356365,EPCI
200040657,CC de la Matheysine,1999_2010,2004.5,11,17476,19136,2174,2281,1660,107,1553,0.00828347117364481,0.000533934587698792,0.00774953658594602,EPCI
200040681,CC Enclave des Papes-Pays de Grignan,2010_2015,2012.5,5,22870,22972,1172,1157,102,-15,117,0.000890411174343297,-0.000130942819756367,0.00102135399409966,EPCI
200040681,CC Enclave des Papes-Pays de Grignan,1968_1975,1971.5,7,15943,16709,1348,1640,766,292,474,0.00672646961377943,0.00256413724180626,0.00416233237197317,EPCI
200040681,CC Enclave des Papes-Pays de Grignan,1975_1982,1978.5,7,16709,18376,1528,1498,1667,-30,1697,0.013678125333102,-0.000246157024590917,0.0139242823576929,EPCI
200040681,CC Enclave des Papes-Pays de Grignan,1982_1990,1986,8,18376,20181,1718,2008,1805,290,1515,0.0117808669567991,0.0018927708684054,0.00988809608839374,EPCI
200040681,CC Enclave des Papes-Pays de Grignan,1990_1999,1994.5,9,20181,21239,1940,2180,1058,240,818,0.00569365275230793,0.00129156584173337,0.00440208691057456,EPCI
200040681,CC Enclave des Papes-Pays de Grignan,1999_2010,2004.5,11,21239,22870,2392,2691,1631,299,1332,0.00674875213459569,0.00123720226133912,0.00551154987325657,EPCI
200040715,Métropole Grenoble-Alpes-Métropole,2010_2015,2012.5,5,432916,445516,14453,29737,12600,15284,-2684,0.00575438265123296,0.00698015749535274,-0.00122577484411978,EPCI
200040715,Métropole Grenoble-Alpes-Métropole,1968_1975,1971.5,7,338231,393673,18456,49309,55442,30853,24589,0.0219213205609725,0.0121990278717883,0.00972229268918425,EPCI
200040715,Métropole Grenoble-Alpes-Métropole,1975_1982,1978.5,7,393673,398638,18545,42982,4965,24437,-19472,0.00179204972558078,0.00882020526566315,-0.00702815554008237,EPCI
200040715,Métropole Grenoble-Alpes-Métropole,1982_1990,1986,8,398638,409547,21645,47934,10909,26289,-15380,0.00338044259198034,0.00814634295541031,-0.00476590036342997,EPCI
200040715,Métropole Grenoble-Alpes-Métropole,1990_1999,1994.5,9,409547,422357,24925,50853,12810,25928,-13118,0.00342800188806769,0.00693842567945504,-0.00351042379138735,EPCI
200040715,Métropole Grenoble-Alpes-Métropole,1999_2010,2004.5,11,422357,432916,30183,62756,10559,32573,-22014,0.00224732015918594,0.00693266024672446,-0.00468534008753852,EPCI
200040764,CC du Sud Corse,2010_2015,2012.5,5,18999,20680,900,1416,1681,516,1165,0.0171007120090532,0.00524923699980454,0.0118514750092486,EPCI
200040764,CC du Sud Corse,1968_1975,1971.5,7,9977,13445,873,1027,3468,154,3314,0.043539014666617,0.00193339338484978,0.0416056212817673,EPCI
200040764,CC du Sud Corse,1975_1982,1978.5,7,13445,14567,968,1085,1122,117,1005,0.0115160054330656,0.00120086687671005,0.0103151385563556,EPCI
200040764,CC du Sud Corse,1982_1990,1986,8,14567,15440,1245,1605,873,360,513,0.00730188571745716,0.00301108689379677,0.00429079882366039,EPCI
200040764,CC du Sud Corse,1990_1999,1994.5,9,15440,16628,1473,2084,1188,611,577,0.00827028662558416,0.00425348916517838,0.00401679746040577,EPCI
200040764,CC du Sud Corse,1999_2010,2004.5,11,16628,18999,1828,2769,2371,941,1430,0.0121917503308551,0.00483864911907829,0.00735310121177678,EPCI
200040772,CC du Perche et Haut Vendômois,2010_2015,2012.5,5,9337,9219,622,469,-118,-153,35,-0.0025404535093343,-0.00329397785532328,0.000753524345988986,EPCI
200040772,CC du Perche et Haut Vendômois,1968_1975,1971.5,7,9363,8888,908,777,-475,-131,-344,-0.00741008034318491,-0.00204362215780468,-0.00536645818538023,EPCI
200040772,CC du Perche et Haut Vendômois,1975_1982,1978.5,7,8888,8796,887,619,-92,-268,176,-0.00148532148008151,-0.00432680605067224,0.00284148457059072,EPCI
200040772,CC du Perche et Haut Vendômois,1982_1990,1986,8,8796,8512,994,671,-284,-323,39,-0.00409411368289936,-0.00465633351963554,0.00056221983673618,EPCI
200040772,CC du Perche et Haut Vendômois,1990_1999,1994.5,9,8512,8535,1113,674,23,-439,462,0.000299869801642094,-0.00572360186612519,0.00602347166776728,EPCI
200040772,CC du Perche et Haut Vendômois,1999_2010,2004.5,11,8535,9337,1342,1054,802,-288,1090,0.00819793373517586,-0.00294389640365417,0.01114183013883,EPCI
200040798,CC Val Vanoise,2010_2015,2012.5,5,9549,9307,295,546,-242,251,-493,-0.00512077027673752,0.00531121214653354,-0.0104319824232711,EPCI
200040798,CC Val Vanoise,1968_1975,1971.5,7,6627,6758,457,809,131,352,-221,0.00280031001881942,0.00752449714980485,-0.00472418713098543,EPCI
200040798,CC Val Vanoise,1975_1982,1978.5,7,6758,7306,444,651,548,207,341,0.0112006831680778,0.00423091499232134,0.00696976817575642,EPCI
200040798,CC Val Vanoise,1982_1990,1986,8,7306,8055,446,833,749,387,362,0.0122743551310873,0.0063420232786793,0.00593233185240803,EPCI
200040798,CC Val Vanoise,1990_1999,1994.5,9,8055,9010,552,1040,955,488,467,0.0125269300461137,0.00640119566754292,0.00612573437857079,EPCI
200040798,CC Val Vanoise,1999_2010,2004.5,11,9010,9549,681,1291,539,610,-71,0.00529591635414195,0.00599352314661705,-0.000697606792475099,EPCI
200040814,CC Briance Sud Haute Vienne,2010_2015,2012.5,5,9067,9158,645,460,91,-185,276,0.00199926899269354,-0.00406444795217917,0.00606371694487271,EPCI
200040814,CC Briance Sud Haute Vienne,1968_1975,1971.5,7,10139,9300,1049,554,-839,-495,-344,-0.0122634651951561,-0.00723529829749972,-0.00502816689765637,EPCI
200040814,CC Briance Sud Haute Vienne,1975_1982,1978.5,7,9300,8404,1068,412,-896,-656,-240,-0.0143681524623537,-0.0105195401956518,-0.00384861226670188,EPCI
200040814,CC Briance Sud Haute Vienne,1982_1990,1986,8,8404,7998,1213,467,-406,-746,340,-0.00617041836320531,-0.0113377637905201,0.00516734542731479,EPCI
200040814,CC Briance Sud Haute Vienne,1990_1999,1994.5,9,7998,7915,1213,630,-83,-583,500,-0.0011584193016968,-0.00813684882999078,0.00697842952829398,EPCI
200040814,CC Briance Sud Haute Vienne,1999_2010,2004.5,11,7915,9067,1314,970,1152,-344,1496,0.0124294988899676,-0.00371158647408754,0.0161410853640551,EPCI
200040830,CC du Pays de Fénelon,2010_2015,2012.5,5,9423,9679,613,386,256,-227,483,0.00537541214991677,-0.00476647874230901,0.0101418908922258,EPCI
200040830,CC du Pays de Fénelon,1968_1975,1971.5,7,7512,7247,845,552,-265,-293,28,-0.00511745409833664,-0.00565816622948164,0.000540712131145003,EPCI
200040830,CC du Pays de Fénelon,1975_1982,1978.5,7,7247,7628,856,478,381,-378,759,0.00734658292386126,-0.00728873581422455,0.0146353187380858,EPCI
200040830,CC du Pays de Fénelon,1982_1990,1986,8,7628,7965,976,633,337,-343,680,0.00541853439473328,-0.00551500681719144,0.0109335412119247,EPCI
200040830,CC du Pays de Fénelon,1990_1999,1994.5,9,7965,8284,1020,671,319,-349,668,0.00437275495482847,-0.00478398582832331,0.00915674078315179,EPCI
200040830,CC du Pays de Fénelon,1999_2010,2004.5,11,8284,9423,1310,954,1139,-356,1495,0.0117804461475393,-0.00368203584593852,0.0154624819934778,EPCI
200040889,CC de Portes Sud Périgord,2010_2015,2012.5,5,8341,8654,633,339,313,-294,607,0.00739491403227555,-0.00694602148718534,0.0143409355194609,EPCI
200040889,CC de Portes Sud Périgord,1968_1975,1971.5,7,8688,8050,841,698,-638,-143,-495,-0.01083666591446,-0.00242890787737896,-0.00840775803708102,EPCI
200040889,CC de Portes Sud Périgord,1975_1982,1978.5,7,8050,7895,795,560,-155,-235,80,-0.00277363829827859,-0.00420519354900303,0.00143155525072443,EPCI
200040889,CC de Portes Sud Périgord,1982_1990,1986,8,7895,7845,880,599,-50,-281,231,-0.000793842430568459,-0.00446139445979474,0.00366755202922628,EPCI
200040889,CC de Portes Sud Périgord,1990_1999,1994.5,9,7845,7796,957,565,-49,-392,343,-0.000695936006312237,-0.00556748805049789,0.00487155204418566,EPCI
200040889,CC de Portes Sud Périgord,1999_2010,2004.5,11,7796,8341,1191,716,545,-475,1020,0.00616184578298329,-0.00537041604938911,0.0115322618323724,EPCI
200040905,CC Carmausin-Ségala,2010_2015,2012.5,5,29560,29509,1825,1432,-51,-393,342,-0.000345299273948996,-0.00266083558160697,0.00231553630765797,EPCI
200040905,CC Carmausin-Ségala,1968_1975,1971.5,7,39609,35614,3128,2516,-3995,-612,-3383,-0.0150734615880388,-0.00230912603050807,-0.0127643355575307,EPCI
200040905,CC Carmausin-Ségala,1975_1982,1978.5,7,35614,32917,3113,1924,-2697,-1189,-1508,-0.0111868956835267,-0.0049318572368236,-0.00625503844670311,EPCI
200040905,CC Carmausin-Ségala,1982_1990,1986,8,32917,30374,3418,2160,-2543,-1258,-1285,-0.00999994746911814,-0.00494688710819922,-0.00505306036091892,EPCI
200040905,CC Carmausin-Ségala,1990_1999,1994.5,9,30374,28532,3637,1971,-1842,-1666,-176,-0.00692708690060928,-0.0062652154052199,-0.000661871495389378,EPCI
200040905,CC Carmausin-Ségala,1999_2010,2004.5,11,28532,29560,4088,2632,1028,-1456,2484,0.00322298556370915,-0.00456485114859973,0.00778783671230887,EPCI
200040947,CC de Flandre Intérieure,2010_2015,2012.5,5,100395,101858,4598,6287,1463,1689,-226,0.00289764633486156,0.00334526634284427,-0.000447620007982715,EPCI
200040947,CC de Flandre Intérieure,1968_1975,1971.5,7,83013,85035,6861,10157,2022,3296,-1274,0.00344387576100313,0.0056137559388063,-0.00216988017780316,EPCI
200040947,CC de Flandre Intérieure,1975_1982,1978.5,7,85035,87730,7024,9443,2695,2419,276,0.00446723127428506,0.00400973374860688,0.000457497525678172,EPCI
200040947,CC de Flandre Intérieure,1982_1990,1986,8,87730,91563,7480,10980,3833,3500,333,0.00535973021281389,0.00489409228929001,0.000465637923523878,EPCI
200040947,CC de Flandre Intérieure,1990_1999,1994.5,9,91563,95443,7870,11033,3880,3163,717,0.00462197639059014,0.00376786374315377,0.000854112647436375,EPCI
200040947,CC de Flandre Intérieure,1999_2010,2004.5,11,95443,100395,9917,13516,4952,3599,1353,0.0046090614316685,0.00334976011562499,0.00125930131604352,EPCI
200040954,CC des Hauts de Flandre,2010_2015,2012.5,5,52150,53386,2317,3237,1236,920,316,0.00469586274050449,0.0034953023634823,0.00120056037702218,EPCI
200040954,CC des Hauts de Flandre,1968_1975,1971.5,7,37809,41355,3340,4675,3546,1335,2211,0.0128889504276608,0.00485243903579447,0.00803651139186634,EPCI
200040954,CC des Hauts de Flandre,1975_1982,1978.5,7,41355,47335,3554,5114,5980,1560,4420,0.0194811349402548,0.00508203520180561,0.0143990997384492,EPCI
200040954,CC des Hauts de Flandre,1982_1990,1986,8,47335,49076,3732,5604,1741,1872,-131,0.00452522521591381,0.00486572177150526,-0.000340496555591447,EPCI
200040954,CC des Hauts de Flandre,1990_1999,1994.5,9,49076,49320,3934,5338,244,1404,-1160,0.00055121423689819,0.00317174093690598,-0.00262052670000779,EPCI
200040954,CC des Hauts de Flandre,1999_2010,2004.5,11,49320,52150,5089,7068,2830,1979,851,0.00508511308224491,0.00355598543807868,0.00152912764416622,EPCI
200041010,CC Coeur de Savoie,2010_2015,2012.5,5,34422,36216,1350,2061,1794,711,1083,0.0102128215451787,0.00404755636489522,0.00616526518028344,EPCI
200041010,CC Coeur de Savoie,1968_1975,1971.5,7,20513,21897,2009,2143,1384,134,1250,0.00937089295310511,0.000907297439101218,0.0084635955140039,EPCI
200041010,CC Coeur de Savoie,1975_1982,1978.5,7,21897,24134,1976,2067,2237,91,2146,0.0139929972432518,0.00056922787176393,0.0134237693714878,EPCI
200041010,CC Coeur de Savoie,1982_1990,1986,8,24134,26219,2187,2490,2085,303,1782,0.0104116661076512,0.00151306226888169,0.00889860383876952,EPCI
200041010,CC Coeur de Savoie,1990_1999,1994.5,9,26219,28866,2324,2964,2647,640,2007,0.0107439835076155,0.00259771418393424,0.00814626932368128,EPCI
200041010,CC Coeur de Savoie,1999_2010,2004.5,11,28866,34422,2867,4336,5556,1469,4087,0.0161315918064033,0.00426517429150585,0.0118664175148975,EPCI
200041051,CC Vallée de la Dordogne et Forêt Bessède,2010_2015,2012.5,5,9062,9079,624,317,17,-307,324,0.000374911890836938,-0.00677046767570234,0.00714537956653928,EPCI
200041051,CC Vallée de la Dordogne et Forêt Bessède,1968_1975,1971.5,7,8607,8134,943,577,-473,-366,-107,-0.00804220392664146,-0.00622293157959994,-0.00181927234704151,EPCI
200041051,CC Vallée de la Dordogne et Forêt Bessède,1975_1982,1978.5,7,8134,8257,917,511,123,-406,529,0.00214637416315555,-0.00708477975805816,0.00923115392121371,EPCI
200041051,CC Vallée de la Dordogne et Forêt Bessède,1982_1990,1986,8,8257,8128,1008,544,-129,-464,335,-0.00196636848425413,-0.00707282927669704,0.0051064607924429,EPCI
200041051,CC Vallée de la Dordogne et Forêt Bessède,1990_1999,1994.5,9,8128,8234,1101,593,106,-508,614,0.00144070710182276,-0.00690452082760341,0.00834522792942616,EPCI
200041051,CC Vallée de la Dordogne et Forêt Bessède,1999_2010,2004.5,11,8234,9062,1232,778,828,-454,1282,0.00874876898415145,-0.00479703033672072,0.0135457993208722,EPCI
200041150,CC du Terrassonnais en Périgord Noir Thenon Hautefort,2010_2015,2012.5,5,23104,22837,1406,1037,-267,-369,102,-0.00232204688063642,-0.00320912096986831,0.000887074089231891,EPCI
200041150,CC du Terrassonnais en Périgord Noir Thenon Hautefort,1968_1975,1971.5,7,21082,21963,2070,2085,881,15,866,0.00586565361249747,9.98692442536459e-05,0.00576578436824382,EPCI
200041150,CC du Terrassonnais en Périgord Noir Thenon Hautefort,1975_1982,1978.5,7,21963,22163,1951,1802,200,-149,349,0.00129584065472477,-0.000965401287769951,0.00226124194249472,EPCI
200041150,CC du Terrassonnais en Périgord Noir Thenon Hautefort,1982_1990,1986,8,22163,21807,2297,1661,-356,-636,280,-0.00202210436258798,-0.00361252352417404,0.00159041916158606,EPCI
200041150,CC du Terrassonnais en Périgord Noir Thenon Hautefort,1990_1999,1994.5,9,21807,21614,2418,1931,-193,-487,294,-0.00098726414371797,-0.00249117947145415,0.00150391532773618,EPCI
200041150,CC du Terrassonnais en Périgord Noir Thenon Hautefort,1999_2010,2004.5,11,21614,23104,3090,2481,1490,-609,2099,0.00607881142372535,-0.00248456117922734,0.00856337260295269,EPCI
200041168,CC de la Vallée de l'Homme,2010_2015,2012.5,5,15533,15610,1081,567,77,-514,591,0.000989477514508286,-0.00660508366827609,0.00759456118278438,EPCI
200041168,CC de la Vallée de l'Homme,1968_1975,1971.5,7,14067,13615,1651,1111,-452,-540,88,-0.00465477602969389,-0.00556101561069624,0.000906239581002349,EPCI
200041168,CC de la Vallée de l'Homme,1975_1982,1978.5,7,13615,13981,1551,849,366,-702,1068,0.00379678084854551,-0.00728235015212828,0.0110791310006738,EPCI
200041168,CC de la Vallée de l'Homme,1982_1990,1986,8,13981,14274,1635,1083,293,-552,845,0.00259591801829084,-0.00489060322899845,0.00748652124728929,EPCI
200041168,CC de la Vallée de l'Homme,1990_1999,1994.5,9,14274,14823,1890,1209,549,-681,1230,0.00420217425341862,-0.00521253309030616,0.00941470734372478,EPCI
200041168,CC de la Vallée de l'Homme,1999_2010,2004.5,11,14823,15533,2307,1358,710,-949,1659,0.0042624005230818,-0.00569720858648539,0.00995960910956719,EPCI
200041283,CC de la Plaine du Rhin,2010_2015,2012.5,5,18351,18439,706,754,88,48,40,0.000957241422301136,0.000522131684891529,0.000435109737409607,EPCI
200041283,CC de la Plaine du Rhin,1968_1975,1971.5,7,13343,14298,1059,1693,955,634,321,0.00992431756403334,0.0065884998278504,0.00333581773618293,EPCI
200041283,CC de la Plaine du Rhin,1975_1982,1978.5,7,14298,14631,1029,1335,333,306,27,0.00329440008311277,0.00302728656286038,0.000267113520252387,EPCI
200041283,CC de la Plaine du Rhin,1982_1990,1986,8,14631,15164,1133,1666,533,533,0,0.00448272150242945,0.00448272150242945,0,EPCI
200041283,CC de la Plaine du Rhin,1990_1999,1994.5,9,15164,17002,1119,1638,1838,519,1319,0.0127930043749889,0.00361238806888968,0.00918061630609919,EPCI
200041283,CC de la Plaine du Rhin,1999_2010,2004.5,11,17002,18351,1481,1793,1349,312,1037,0.00696533541193789,0.00161095970980328,0.00535437570213461,EPCI
200041317,CA du Niortais,2010_2015,2012.5,5,116797,120545,5256,6319,3748,1063,2685,0.00633714367791805,0.00179732756927078,0.00453981610864727,EPCI
200041317,CA du Niortais,1968_1975,1971.5,7,87429,96980,6057,12151,9551,6094,3457,0.0149213331268678,0.00952053230814915,0.00540080081871868,EPCI
200041317,CA du Niortais,1975_1982,1978.5,7,96980,101229,5935,10029,4249,4094,155,0.00614458748503166,0.00592043802393966,0.000224149461092,EPCI
200041317,CA du Niortais,1982_1990,1986,8,101229,105229,6872,10374,4000,3502,498,0.00485595846726294,0.00425139163808871,0.000604566829174237,EPCI
200041317,CA du Niortais,1990_1999,1994.5,9,105229,107126,8061,10998,1897,2937,-1040,0.00198717003830828,0.00307660432393855,-0.00108943428563027,EPCI
200041317,CA du Niortais,1999_2010,2004.5,11,107126,116797,10419,14002,9671,3583,6088,0.0078883754252268,0.00292255704152493,0.00496581838370187,EPCI
200041325,CC du Pays Rhénan,2010_2015,2012.5,5,35137,36331,1298,1809,1194,511,683,0.00670571630631445,0.00286986686141263,0.00383584944490181,EPCI
200041325,CC du Pays Rhénan,1968_1975,1971.5,7,24052,27006,1828,2840,2954,1012,1942,0.0166863897124663,0.00571652890623422,0.0109698608062321,EPCI
200041325,CC du Pays Rhénan,1975_1982,1978.5,7,27006,28271,1942,2355,1265,413,852,0.00656107024002361,0.00214207273448992,0.00441899750553369,EPCI
200041325,CC du Pays Rhénan,1982_1990,1986,8,28271,28012,1995,2552,-259,557,-816,-0.00114978280186273,0.00247269892138047,-0.0036224817232432,EPCI
200041325,CC du Pays Rhénan,1990_1999,1994.5,9,28012,30898,2198,2901,2886,703,2183,0.0109549560952291,0.00266851494627376,0.00828644114895536,EPCI
200041325,CC du Pays Rhénan,1999_2010,2004.5,11,30898,35137,2509,3843,4239,1334,2905,0.0117561346192037,0.00369961867940969,0.00805651593979397,EPCI
200041333,CC de Parthenay-Gâtine,2010_2015,2012.5,5,37973,37785,2153,1684,-188,-469,281,-0.000992143978273408,-0.00247508258409696,0.00148293860582355,EPCI
200041333,CC de Parthenay-Gâtine,1968_1975,1971.5,7,37161,38673,2983,4503,1512,1520,-8,0.00571366936771023,0.00574390042256584,-3.023105485561e-05,EPCI
200041333,CC de Parthenay-Gâtine,1975_1982,1978.5,7,38673,38980,2854,3684,307,830,-523,0.00113021134377522,0.00305562024538578,-0.00192540890161056,EPCI
200041333,CC de Parthenay-Gâtine,1982_1990,1986,8,38980,37507,3220,3365,-1473,145,-1618,-0.00480356478492094,0.000472856003946732,-0.00527642078886768,EPCI
200041333,CC de Parthenay-Gâtine,1990_1999,1994.5,9,37507,36479,3634,3262,-1028,-372,-656,-0.00308310739656437,-0.00111567699564391,-0.00196743040092045,EPCI
200041333,CC de Parthenay-Gâtine,1999_2010,2004.5,11,36479,37973,4551,4306,1494,-245,1739,0.00365563179290818,-0.000599484464031127,0.0042551162569393,EPCI
200041366,CC Rhône Crussol,2010_2015,2012.5,5,32243,33454,1310,1747,1211,437,774,0.00740133456898828,0.0026708366694037,0.00473049789958458,EPCI
200041366,CC Rhône Crussol,1968_1975,1971.5,7,17846,20493,1150,2202,2647,1052,1595,0.0199541855237839,0.00793041298489637,0.0120237725388876,EPCI
200041366,CC Rhône Crussol,1975_1982,1978.5,7,20493,23725,1265,1986,3232,721,2511,0.0211412294986162,0.00471622106079897,0.0164250084378172,EPCI
200041366,CC Rhône Crussol,1982_1990,1986,8,23725,27334,1539,2574,3609,1035,2574,0.0178578282889146,0.00512132232724483,0.0127365059616697,EPCI
200041366,CC Rhône Crussol,1990_1999,1994.5,9,27334,29100,1998,2928,1766,930,836,0.00698056531210534,0.00367606214057642,0.00330450317152891,EPCI
200041366,CC Rhône Crussol,1999_2010,2004.5,11,29100,32243,2751,3868,3143,1117,2026,0.00936749298701933,0.0033291408420301,0.00603835214498924,EPCI
200041416,CC Airvaudais-Val du Thouet,2010_2015,2012.5,5,7049,6951,517,314,-98,-203,105,-0.00279612926290596,-0.00579198204459091,0.00299585278168495,EPCI
200041416,CC Airvaudais-Val du Thouet,1968_1975,1971.5,7,8410,8205,716,905,-205,189,-394,-0.00351918587648892,0.00324451771051905,-0.00676370358700797,EPCI
200041416,CC Airvaudais-Val du Thouet,1975_1982,1978.5,7,8205,8012,755,740,-193,-15,-178,-0.00339469733280018,-0.000263836580269444,-0.00313086075253073,EPCI
200041416,CC Airvaudais-Val du Thouet,1982_1990,1986,8,8012,7591,809,673,-421,-136,-285,-0.00672442453477351,-0.00217226065731401,-0.0045521638774595,EPCI
200041416,CC Airvaudais-Val du Thouet,1990_1999,1994.5,9,7591,7138,873,618,-453,-255,-198,-0.00681342817556452,-0.00383537347631115,-0.00297805469925337,EPCI
200041416,CC Airvaudais-Val du Thouet,1999_2010,2004.5,11,7138,7049,1068,821,-89,-247,158,-0.00113997357917672,-0.00316374689951293,0.0020237733203362,EPCI
200041440,CC de Domme - Villefranche du Périgord,2010_2015,2012.5,5,8997,8788,578,279,-209,-299,90,-0.00468977528273917,-0.00670929573942111,0.00201952045668194,EPCI
200041440,CC de Domme - Villefranche du Périgord,1968_1975,1971.5,7,8793,8439,911,646,-354,-265,-89,-0.00585310803109884,-0.00438156392158529,-0.00147154410951355,EPCI
200041440,CC de Domme - Villefranche du Périgord,1975_1982,1978.5,7,8439,8307,977,521,-132,-456,324,-0.00224964935436134,-0.00777151595143008,0.00552186659706874,EPCI
200041440,CC de Domme - Villefranche du Périgord,1982_1990,1986,8,8307,8412,978,535,105,-443,548,0.00157132386056924,-0.00662949019268737,0.00820081405325661,EPCI
200041440,CC de Domme - Villefranche du Périgord,1990_1999,1994.5,9,8412,8431,1046,639,19,-407,426,0.000250712656508778,-0.00537052901047751,0.00562124166698629,EPCI
200041440,CC de Domme - Villefranche du Périgord,1999_2010,2004.5,11,8431,8997,1297,795,566,-502,1068,0.00592437094365983,-0.00525447740939441,0.0111788483530542,EPCI
200041465,CC Val Eyrieux,2010_2015,2012.5,5,13611,12909,937,509,-702,-428,-274,-0.0105348252607393,-0.00642294189686102,-0.00411188336387832,EPCI
200041465,CC Val Eyrieux,1968_1975,1971.5,7,17236,16242,1765,1646,-994,-119,-875,-0.00844977539141756,-0.00101159282854999,-0.00743818256286757,EPCI
200041465,CC Val Eyrieux,1975_1982,1978.5,7,16242,15479,1752,1313,-763,-439,-324,-0.00685017460515736,-0.00394131933376681,-0.00290885527139054,EPCI
200041465,CC Val Eyrieux,1982_1990,1986,8,15479,14547,1806,1307,-932,-499,-433,-0.00773238508040242,-0.00413997870721116,-0.00359240637319125,EPCI
200041465,CC Val Eyrieux,1990_1999,1994.5,9,14547,13984,1786,1314,-563,-472,-91,-0.00437606012077185,-0.00366873956839132,-0.00070732055238053,EPCI
200041465,CC Val Eyrieux,1999_2010,2004.5,11,13984,13611,2047,1457,-373,-590,217,-0.0024547575577567,-0.00388286048009774,0.00142810292234103,EPCI
200041499,CC Aunis Atlantique,2010_2015,2012.5,5,26323,29292,1335,2044,2969,709,2260,0.0216043378848874,0.00515913626149718,0.0164452016233902,EPCI
200041499,CC Aunis Atlantique,1968_1975,1971.5,7,15152,15755,1392,1521,603,129,474,0.00559060353192664,0.00119599976056142,0.00439460377136522,EPCI
200041499,CC Aunis Atlantique,1975_1982,1978.5,7,15755,16882,1425,1422,1127,-3,1130,0.00991889655991152,-2.6403451357351e-05,0.00994530001126887,EPCI
200041499,CC Aunis Atlantique,1982_1990,1986,8,16882,17427,1728,1616,545,-112,657,0.00397949250050877,-0.000817803963407308,0.00479729646391608,EPCI
200041499,CC Aunis Atlantique,1990_1999,1994.5,9,17427,18765,2103,1722,1338,-381,1719,0.00825305970354684,-0.00235008650751222,0.0106031462110591,EPCI
200041499,CC Aunis Atlantique,1999_2010,2004.5,11,18765,26323,2803,3412,7558,609,6949,0.0312463816129105,0.00251773569757376,0.0287286459153367,EPCI
200041507,CA La Riviera du Levant,2010_2015,2012.5,5,66879,66758,2289,4668,-121,2379,-2500,-0.000362109667540356,0.00711949503370666,-0.00748160470124702,EPCI
200041507,CA La Riviera du Levant,1968_1975,1971.5,7,33808,34966,1763,5208,1158,3445,-2287,0.00482283545612483,0.0143477272420985,-0.00952489178597365,EPCI
200041507,CA La Riviera du Levant,1975_1982,1978.5,7,34966,37781,1707,4943,2815,3236,-421,0.0111228569209534,0.0127863463574441,-0.00166348943649072,EPCI
200041507,CA La Riviera du Levant,1982_1990,1986,8,37781,47219,2139,6389,9438,4250,5188,0.0282658606452215,0.0127283224986429,0.0155375381465786,EPCI
200041507,CA La Riviera du Levant,1990_1999,1994.5,9,47219,58049,2635,8447,10830,5812,5018,0.0232086842715742,0.0124551129257977,0.0107535713457765,EPCI
200041507,CA La Riviera du Levant,1999_2010,2004.5,11,58049,66879,4081,11462,8830,7381,1449,0.0129557105005254,0.0108296828091028,0.00212602769142256,EPCI
200041515,CC du Bassin de Pont-à-Mousson,2010_2015,2012.5,5,39914,40753,1614,2484,839,870,-31,0.0041691301555955,0.0043231742972206,-0.000154044141625102,EPCI
200041515,CC du Bassin de Pont-à-Mousson,1968_1975,1971.5,7,35856,37685,2494,4847,1829,2353,-524,0.00713263409834308,0.00917610061968358,-0.0020434665213405,EPCI
200041515,CC du Bassin de Pont-à-Mousson,1975_1982,1978.5,7,37685,38890,2549,4356,1205,1807,-602,0.00450655423496671,0.00675796141293348,-0.00225140717796677,EPCI
200041515,CC du Bassin de Pont-à-Mousson,1982_1990,1986,8,38890,39699,2657,4762,809,2105,-1296,0.00257692085393346,0.0067050907262422,-0.00412816987230874,EPCI
200041515,CC du Bassin de Pont-à-Mousson,1990_1999,1994.5,9,39699,39715,2934,4656,16,1722,-1706,4.47734051960413e-05,0.00481873773422395,-0.00477396432902791,EPCI
200041515,CC du Bassin de Pont-à-Mousson,1999_2010,2004.5,11,39715,39914,3565,5512,199,1947,-1748,0.000454484106683584,0.00444663595835647,-0.00399215185167289,EPCI
200041523,CC de la Haute-Saintonge,2010_2015,2012.5,5,66807,67892,4050,3077,1085,-973,2058,0.00322726480740543,-0.00289412779502809,0.00612139260243352,EPCI
200041523,CC de la Haute-Saintonge,1968_1975,1971.5,7,68190,65525,6095,6448,-2665,353,-3018,-0.00567898146195178,0.000752225311845771,-0.00643120677379755,EPCI
200041523,CC de la Haute-Saintonge,1975_1982,1978.5,7,65525,64116,6058,5337,-1409,-721,-688,-0.00310058415068493,-0.00158660125808647,-0.00151398289259846,EPCI
200041523,CC de la Haute-Saintonge,1982_1990,1986,8,64116,62487,6548,5248,-1629,-1300,-329,-0.00321175719472244,-0.0025630965949289,-0.000648660599793544,EPCI
200041523,CC de la Haute-Saintonge,1990_1999,1994.5,9,62487,61974,6871,5053,-513,-1818,1305,-0.00091553540312983,-0.00324452897249519,0.00232899356936536,EPCI
200041523,CC de la Haute-Saintonge,1999_2010,2004.5,11,61974,66807,8587,6776,4833,-1811,6644,0.00684998393195802,-0.00256679513775625,0.00941677906971427,EPCI
200041556,CC Portes de la Creuse en Marche,2010_2015,2012.5,5,6825,6670,608,221,-155,-387,232,-0.00458395767685693,-0.0114451072318944,0.00686114955503747,EPCI
200041556,CC Portes de la Creuse en Marche,1968_1975,1971.5,7,10335,8906,1268,666,-1429,-602,-827,-0.0210343386720964,-0.00886121195283556,-0.0121731267192608,EPCI
200041556,CC Portes de la Creuse en Marche,1975_1982,1978.5,7,8906,8062,1192,441,-844,-751,-93,-0.0141226890156841,-0.0125665159369417,-0.00155617307874245,EPCI
200041556,CC Portes de la Creuse en Marche,1982_1990,1986,8,8062,7526,1222,427,-536,-795,259,-0.00856287451743076,-0.0127005321667117,0.00413765764928091,EPCI
200041556,CC Portes de la Creuse en Marche,1990_1999,1994.5,9,7526,7068,1204,445,-458,-759,301,-0.00695196006666854,-0.0115208246519682,0.00456886458529963,EPCI
200041556,CC Portes de la Creuse en Marche,1999_2010,2004.5,11,7068,6825,1371,499,-243,-872,629,-0.00317542159467366,-0.0113949285208042,0.00821950692613057,EPCI
200041572,CC Dronne et Belle,2010_2015,2012.5,5,11488,11415,864,467,-73,-397,324,-0.00127413406586951,-0.00692919485137257,0.00565506078550305,EPCI
200041572,CC Dronne et Belle,1968_1975,1971.5,7,11560,11156,1224,850,-404,-374,-30,-0.00506902227882577,-0.00469260973336842,-0.000376412545457359,EPCI
200041572,CC Dronne et Belle,1975_1982,1978.5,7,11156,11077,1322,725,-79,-597,518,-0.00101471100803607,-0.00766813255439919,0.00665342154636311,EPCI
200041572,CC Dronne et Belle,1982_1990,1986,8,11077,11045,1509,859,-32,-650,618,-0.00036156582715563,-0.00734430586409873,0.0069827400369431,EPCI
200041572,CC Dronne et Belle,1990_1999,1994.5,9,11045,10885,1644,807,-160,-837,677,-0.00162003545529843,-0.00847481047552991,0.00685477502023148,EPCI
200041572,CC Dronne et Belle,1999_2010,2004.5,11,10885,11488,1828,1029,603,-799,1402,0.00491360669563101,-0.00651073258674822,0.0114243392823792,EPCI
200041614,CC Aunis Sud,2010_2015,2012.5,5,29677,31255,1355,1857,1578,502,1076,0.0104152709149723,0.00331334980945253,0.00710192110551977,EPCI
200041614,CC Aunis Sud,1968_1975,1971.5,7,20568,21235,1550,2284,667,734,-67,0.00456959372463972,0.00502860838663501,-0.000459014661995294,EPCI
200041614,CC Aunis Sud,1975_1982,1978.5,7,21235,22578,1542,1947,1343,405,938,0.00879923293674589,0.00265352891986753,0.00614570401687837,EPCI
200041614,CC Aunis Sud,1982_1990,1986,8,22578,22954,1768,2225,376,457,-81,0.0020666616598517,0.00251187334721337,-0.000445211687361669,EPCI
200041614,CC Aunis Sud,1990_1999,1994.5,9,22954,24051,2068,2265,1097,197,900,0.00520062794693255,0.000933932274882144,0.0042666956720504,EPCI
200041614,CC Aunis Sud,1999_2010,2004.5,11,24051,29677,2627,3679,5626,1052,4574,0.0192924451783918,0.00360747464053824,0.0156849705378535,EPCI
200041622,CC Ardennes Thiérache,2010_2015,2012.5,5,10031,9999,484,541,-32,57,-89,-0.000638837837687922,0.00113792989838161,-0.00177676773606953,EPCI
200041622,CC Ardennes Thiérache,1968_1975,1971.5,7,11379,10420,976,1178,-959,202,-1161,-0.0124987359429923,0.00263268473460318,-0.0151314206775955,EPCI
200041622,CC Ardennes Thiérache,1975_1982,1978.5,7,10420,10093,899,855,-327,-44,-283,-0.00454463063831267,-0.000611509932983968,-0.00393312070532871,EPCI
200041622,CC Ardennes Thiérache,1982_1990,1986,8,10093,9377,983,917,-716,-66,-650,-0.00915560879804689,-0.000843952766300412,-0.00831165603174648,EPCI
200041622,CC Ardennes Thiérache,1990_1999,1994.5,9,9377,9271,944,872,-106,-72,-34,-0.00126238405676504,-0.000857468415915878,-0.000404915640849165,EPCI
200041622,CC Ardennes Thiérache,1999_2010,2004.5,11,9271,10031,1127,1295,760,168,592,0.00718835390973571,0.00158900454846789,0.00559934936126782,EPCI
200041630,CA Ardenne Métropole,2010_2015,2012.5,5,129249,125076,6408,7412,-4173,1004,-5177,-0.00654234980039847,0.00157405204878986,-0.00811640184918833,EPCI
200041630,CA Ardenne Métropole,1968_1975,1971.5,7,134121,141026,9608,19200,6905,9592,-2687,0.00719747721557007,0.0099982913036565,-0.00280081408808643,EPCI
200041630,CA Ardenne Métropole,1975_1982,1978.5,7,141026,140364,9335,16881,-662,7546,-8208,-0.000671948724937366,0.00765940344165765,-0.00833135216659501,EPCI
200041630,CA Ardenne Métropole,1982_1990,1986,8,140364,138770,10154,18333,-1594,8179,-9773,-0.00142662665850446,0.00732018785439647,-0.00874681451290093,EPCI
200041630,CA Ardenne Métropole,1990_1999,1994.5,9,138770,136423,10978,17406,-2347,6428,-8775,-0.00189348658678934,0.00518591043028627,-0.00707939701707561,EPCI
200041630,CA Ardenne Métropole,1999_2010,2004.5,11,136423,129249,13676,18874,-7174,5198,-12372,-0.00489883197891239,0.00354950217819718,-0.00844833415710957,EPCI
200041689,CC Vals de Saintonge,2010_2015,2012.5,5,52746,52723,3473,2310,-23,-1163,1140,-8.72256198707344e-05,-0.00441058243085496,0.00432335681098423,EPCI
200041689,CC Vals de Saintonge,1968_1975,1971.5,7,56368,53667,4840,5577,-2701,737,-3438,-0.00699021600265704,0.00190736364085829,-0.00889757964351532,EPCI
200041689,CC Vals de Saintonge,1975_1982,1978.5,7,53667,52343,4810,4253,-1324,-557,-767,-0.00356222224681424,-0.00149860860383348,-0.00206361364298076,EPCI
200041689,CC Vals de Saintonge,1982_1990,1986,8,52343,50722,5169,4290,-1621,-879,-742,-0.00392458753131786,-0.00212813845775965,-0.00179644907355821,EPCI
200041689,CC Vals de Saintonge,1990_1999,1994.5,9,50722,49878,5929,4285,-844,-1644,800,-0.00186267614501756,-0.00362824595072141,0.00176556980570385,EPCI
200041689,CC Vals de Saintonge,1999_2010,2004.5,11,49878,52746,7216,5436,2868,-1780,4648,0.00509547585277947,-0.00316246409272924,0.00825793994550872,EPCI
200041721,CC de la Haute Comté,2010_2015,2012.5,5,18800,18028,947,899,-772,-48,-724,-0.00835108731096401,-0.000519238589282736,-0.00783184872168128,EPCI
200041721,CC de la Haute Comté,1968_1975,1971.5,7,20940,21710,1856,2521,770,665,105,0.00517215514470104,0.00446686126133272,0.000705293883368324,EPCI
200041721,CC de la Haute Comté,1975_1982,1978.5,7,21710,22000,1791,2277,290,486,-196,0.00189743635394812,0.00317984161385789,-0.00128240525990977,EPCI
200041721,CC de la Haute Comté,1982_1990,1986,8,22000,21214,1892,2604,-786,712,-1498,-0.00453731418115089,0.0041101370190578,-0.00864745120020869,EPCI
200041721,CC de la Haute Comté,1990_1999,1994.5,9,21214,20331,1798,2147,-883,349,-1232,-0.00471269648449357,0.00186266259692894,-0.00657535908142252,EPCI
200041721,CC de la Haute Comté,1999_2010,2004.5,11,20331,18800,2113,2372,-1531,259,-1790,-0.00709199995743659,0.00119975701435407,-0.00829175697179066,EPCI
200041762,CA Rochefort Océan,2010_2015,2012.5,5,62914,63159,3426,3171,245,-255,500,0.000777630597956991,-0.000809370622363399,0.00158700122032039,EPCI
200041762,CA Rochefort Océan,1968_1975,1971.5,7,52555,52445,4077,6337,-110,2260,-2370,-0.000299275045679503,0.00614874184759707,-0.00644801689327658,EPCI
200041762,CA Rochefort Océan,1975_1982,1978.5,7,52445,53197,4108,5249,752,1141,-389,0.00203592717197743,0.00308908630748171,-0.00105315913550428,EPCI
200041762,CA Rochefort Océan,1982_1990,1986,8,53197,54301,4788,5837,1104,1049,55,0.00257087895575259,0.00244280074690622,0.00012807820884637,EPCI
200041762,CA Rochefort Océan,1990_1999,1994.5,9,54301,55993,5178,5636,1692,458,1234,0.00341515617415511,0.000924433527046714,0.0024907226471084,EPCI
200041762,CA Rochefort Océan,1999_2010,2004.5,11,55993,62914,6801,7275,6921,474,6447,0.0106510530257493,0.000729460935443603,0.00992159209030571,EPCI
200041788,CA du Pays Nord Martinique,2010_2015,2012.5,5,108555,103121,4419,5838,-5434,1419,-6853,-0.0102182158424841,0.00266831952162033,-0.0128865353641044,EPCI
200041788,CA du Pays Nord Martinique,1968_1975,1971.5,7,100743,100439,5177,18521,-304,13344,-13648,-0.000431641310040254,0.0189467817143985,-0.0193784230244388,EPCI
200041788,CA du Pays Nord Martinique,1975_1982,1978.5,7,100439,94666,5375,13140,-5773,7765,-13538,-0.00842086858101332,0.0113265277206943,-0.0197473963017077,EPCI
200041788,CA du Pays Nord Martinique,1982_1990,1986,8,94666,102258,5139,13577,7592,8438,-846,0.00968965921434917,0.010769407857044,-0.00107974864269486,EPCI
200041788,CA du Pays Nord Martinique,1990_1999,1994.5,9,102258,108470,6309,14925,6212,8616,-2404,0.00657425008539558,0.00911843830260276,-0.00254418821720718,EPCI
200041788,CA du Pays Nord Martinique,1999_2010,2004.5,11,108470,108555,8786,16020,85,7234,-7149,7.12134386542385e-05,0.00606068253205601,-0.00598946909340177,EPCI
200041853,CC du Pays de Montbozon et du Chanois,2010_2015,2012.5,5,6367,6545,406,385,178,-21,199,0.00552983305927968,-0.000652396035083557,0.00618222909436323,EPCI
200041853,CC du Pays de Montbozon et du Chanois,1968_1975,1971.5,7,5031,4796,450,499,-235,49,-284,-0.00681049337314832,0.00142006032035859,-0.0082305536935069,EPCI
200041853,CC du Pays de Montbozon et du Chanois,1975_1982,1978.5,7,4796,5364,433,474,568,41,527,0.0161181944039539,0.00116346121577836,0.0149547331881755,EPCI
200041853,CC du Pays de Montbozon et du Chanois,1982_1990,1986,8,5364,5398,674,522,34,-152,186,0.000790130635927921,-0.00353234872532483,0.00432247936125275,EPCI
200041853,CC du Pays de Montbozon et du Chanois,1990_1999,1994.5,9,5398,5488,814,516,90,-298,388,0.00183895278443202,-0.00608897699734159,0.00792792978177362,EPCI
200041853,CC du Pays de Montbozon et du Chanois,1999_2010,2004.5,11,5488,6367,929,880,879,-49,928,0.0135974807776029,-0.000757993808990379,0.0143554745865933,EPCI
200041861,CC du Triangle Vert,2010_2015,2012.5,5,11001,11064,439,662,63,223,-160,0.001142735746539,0.0040449217694952,-0.0029021860229562,EPCI
200041861,CC du Triangle Vert,1968_1975,1971.5,7,7894,7532,846,803,-362,-43,-319,-0.00668361695931685,-0.000793910301797306,-0.00588970665751955,EPCI
200041861,CC du Triangle Vert,1975_1982,1978.5,7,7532,8310,753,685,778,-68,846,0.0141417760756812,-0.00123604212486674,0.015377818200548,EPCI
200041861,CC du Triangle Vert,1982_1990,1986,8,8310,9070,823,975,760,152,608,0.0109991324300593,0.00219982648601187,0.00879930594404748,EPCI
200041861,CC du Triangle Vert,1990_1999,1994.5,9,9070,9537,737,908,467,171,296,0.00559411187444336,0.00204837929449639,0.00354573257994697,EPCI
200041861,CC du Triangle Vert,1999_2010,2004.5,11,9537,11001,958,1508,1464,550,914,0.0130671115601175,0.00490909245769443,0.0081580191024231,EPCI
200041879,CC Terres de Saône,2010_2015,2012.5,5,13390,13390,601,787,0,186,-186,0,,,EPCI
200041879,CC Terres de Saône,1968_1975,1971.5,7,13098,13291,1150,1219,193,69,124,0.00209183736589535,0.000747858954646526,0.00134397841124883,EPCI
200041879,CC Terres de Saône,1975_1982,1978.5,7,13291,13965,1172,1207,674,35,639,0.00709175465488432,0.000368266191277376,0.00672348846360694,EPCI
200041879,CC Terres de Saône,1982_1990,1986,8,13965,13688,1223,1335,-277,112,-389,-0.00250119962548412,0.0010113153720369,-0.00351251499752102,EPCI
200041879,CC Terres de Saône,1990_1999,1994.5,9,13688,13012,1471,1260,-676,-211,-465,-0.00561169837409714,-0.00175158040966641,-0.00386011796443073,EPCI
200041879,CC Terres de Saône,1999_2010,2004.5,11,13012,13390,1328,1694,378,366,12,0.0026066779554812,0.00252392627435481,8.27516811263873e-05,EPCI
200041887,CC du Val Marnaysien,2010_2015,2012.5,5,13402,14078,485,920,676,435,241,0.0098904595971403,0.00636442296561543,0.00352603663152487,EPCI
200041887,CC du Val Marnaysien,1968_1975,1971.5,7,7465,7648,788,758,183,-30,213,0.00346581276779845,-0.000568166027507942,0.00403397879530639,EPCI
200041887,CC du Val Marnaysien,1975_1982,1978.5,7,7648,9058,681,689,1410,8,1402,0.024466535767353,0.000138817224211932,0.0243277185431411,EPCI
200041887,CC du Val Marnaysien,1982_1990,1986,8,9058,10033,776,956,975,180,795,0.0128609135919953,0.00237432250929143,0.0104865910827038,EPCI
200041887,CC du Val Marnaysien,1990_1999,1994.5,9,10033,11121,901,1052,1088,151,937,0.0115051872395537,0.00159676771431306,0.00990841952524067,EPCI
200041887,CC du Val Marnaysien,1999_2010,2004.5,11,11121,13402,1059,1915,2281,856,1425,0.0171054451584287,0.00641922887137877,0.0106862162870499,EPCI
200041960,CC Pévèle-Carembault,2010_2015,2012.5,5,90138,93890,3338,5157,3752,1819,1933,0.00818976513425351,0.00397046449339209,0.00421930064086142,EPCI
200041960,CC Pévèle-Carembault,1968_1975,1971.5,7,63993,68489,5320,7573,4496,2253,2243,0.00974711757524127,0.00488439855360734,0.00486271902163394,EPCI
200041960,CC Pévèle-Carembault,1975_1982,1978.5,7,68489,73043,5376,7118,4554,1742,2812,0.00923886877491742,0.00353406003643086,0.00570480873848656,EPCI
200041960,CC Pévèle-Carembault,1982_1990,1986,8,73043,79003,5604,8382,5960,2778,3182,0.00985291314674619,0.00459251555732566,0.00526039758942053,EPCI
200041960,CC Pévèle-Carembault,1990_1999,1994.5,9,79003,84135,5903,8841,5132,2938,2194,0.00701748856097506,0.0040174164832706,0.00300007207770446,EPCI
200041960,CC Pévèle-Carembault,1999_2010,2004.5,11,84135,90138,7084,11358,6003,4274,1729,0.00628504833655286,0.00447481202572496,0.0018102363108279,EPCI
200041994,CC Haut Val de Sèvre,2010_2015,2012.5,5,30334,29810,1255,1650,-524,395,-919,-0.00347899182320877,0.00262252246215165,-0.00610151428536041,EPCI
200041994,CC Haut Val de Sèvre,1968_1975,1971.5,7,22974,22707,1944,2459,-267,515,-782,-0.0016685913121669,0.00321844391672642,-0.00488703522889332,EPCI
200041994,CC Haut Val de Sèvre,1975_1982,1978.5,7,22707,24166,1715,2085,1459,370,1089,0.00893589450219579,0.00226612814654725,0.00666976635564853,EPCI
200041994,CC Haut Val de Sèvre,1982_1990,1986,8,24166,24879,1913,2546,713,633,80,0.00364128687715293,0.00323272733974446,0.000408559537408463,EPCI
200041994,CC Haut Val de Sèvre,1990_1999,1994.5,9,24879,25490,2147,2547,611,400,211,0.0026994307251651,0.00176722142400334,0.00093220930116176,EPCI
200041994,CC Haut Val de Sèvre,1999_2010,2004.5,11,25490,30334,2739,3839,4844,1100,3744,0.0159423793345659,0.00362027606689151,0.0123221032676744,EPCI
200042000,CC Bruyères-Vallons des Vosges,2010_2015,2012.5,5,15449,15446,857,839,-3,-18,15,-3.88404822569965e-05,-0.000233042893541979,0.000194202411284983,EPCI
200042000,CC Bruyères-Vallons des Vosges,1968_1975,1971.5,7,15130,14990,1394,1567,-140,173,-313,-0.00132714936956957,0.00163997743525382,-0.00296712680482339,EPCI
200042000,CC Bruyères-Vallons des Vosges,1975_1982,1978.5,7,14990,15121,1388,1462,131,74,57,0.0012438005957307,0.000702604916672306,0.000541195679058398,EPCI
200042000,CC Bruyères-Vallons des Vosges,1982_1990,1986,8,15121,14933,1532,1571,-188,39,-227,-0.00156264992111277,0.000324166738954245,-0.00188681666006701,EPCI
200042000,CC Bruyères-Vallons des Vosges,1990_1999,1994.5,9,14933,14929,1632,1595,-4,-37,33,-2.97661129446958e-05,-0.000275336544738436,0.00024557043179374,EPCI
200042000,CC Bruyères-Vallons des Vosges,1999_2010,2004.5,11,14929,15449,1994,2125,520,131,389,0.00311745338767389,0.000785358449587075,0.00233209493808681,EPCI
200042174,CA Lorient Agglomération,2010_2015,2012.5,5,198351,201792,10429,10295,3441,-134,3575,0.00344577816741531,-0.000134186072198097,0.00357996423961341,EPCI
200042174,CA Lorient Agglomération,1968_1975,1971.5,7,163359,174516,13116,22004,11157,8888,2269,0.00948270649595706,0.00755420770243492,0.00192849879352214,EPCI
200042174,CA Lorient Agglomération,1975_1982,1978.5,7,174516,182060,13168,19612,7544,6444,1100,0.00606400854922029,0.0051798079389151,0.000884200610305186,EPCI
200042174,CA Lorient Agglomération,1982_1990,1986,8,182060,191544,14941,21792,9484,6851,2633,0.00636784458101602,0.00459996870777528,0.00176787587324074,EPCI
200042174,CA Lorient Agglomération,1990_1999,1994.5,9,191544,192683,16552,20777,1139,4225,-3086,0.000658973055822631,0.00244439083481178,-0.00178541777898915,EPCI
200042174,CA Lorient Agglomération,1999_2010,2004.5,11,192683,198351,21624,23815,5668,2191,3477,0.00263909785326111,0.00102015938540845,0.00161893846785266,EPCI
200042182,CC du Mont des Avaloirs,2010_2015,2012.5,5,17014,16519,1013,781,-495,-232,-263,-0.00588765959555671,-0.00275946873973567,-0.00312819085582104,EPCI
200042182,CC du Mont des Avaloirs,1968_1975,1971.5,7,17962,17321,1665,1811,-641,146,-787,-0.00517780259384104,0.00117934349251294,-0.00635714608635398,EPCI
200042182,CC du Mont des Avaloirs,1975_1982,1978.5,7,17321,17251,1537,1495,-70,-42,-28,-0.000578336324260187,-0.000347001794556112,-0.000231334529704075,EPCI
200042182,CC du Mont des Avaloirs,1982_1990,1986,8,17251,16845,1627,1588,-406,-39,-367,-0.00297260253598319,-0.000285545563801341,-0.00268705697218185,EPCI
200042182,CC du Mont des Avaloirs,1990_1999,1994.5,9,16845,16758,1689,1627,-87,-62,-25,-0.000575181260626168,-0.000409899289181867,-0.000165281971444301,EPCI
200042182,CC du Mont des Avaloirs,1999_2010,2004.5,11,16758,17014,2203,2051,256,-152,408,0.00137920280500348,-0.000818901665470814,0.00219810447047429,EPCI
200042190,CA de la Porte du Hainaut,2010_2015,2012.5,5,157029,158425,7804,11441,1396,3637,-2241,0.0017717263643684,0.00461588022006294,-0.00284415385569454,EPCI
200042190,CA de la Porte du Hainaut,1968_1975,1971.5,7,176243,172656,14539,22076,-3587,7537,-11124,-0.00293319674357029,0.00616322939957883,-0.00909642614314912,EPCI
200042190,CA de la Porte du Hainaut,1975_1982,1978.5,7,172656,161574,13765,18085,-11082,4320,-15402,-0.00943208385001781,0.00367682748890786,-0.0131089113389257,EPCI
200042190,CA de la Porte du Hainaut,1982_1990,1986,8,161574,156472,14348,19660,-5102,5312,-10414,-0.00400273783066796,0.00416749183781031,-0.00817022966847827,EPCI
200042190,CA de la Porte du Hainaut,1990_1999,1994.5,9,156472,156254,14656,18664,-218,4008,-4226,-0.000154898218296506,0.00284785348134127,-0.00300275169963778,EPCI
200042190,CA de la Porte du Hainaut,1999_2010,2004.5,11,156254,157029,17549,23996,775,6447,-5672,0.000449884201906503,0.00374245606411771,-0.00329257186221121,EPCI
200042372,CC des Coteaux Arrats Gimone,2010_2015,2012.5,5,10281,10510,604,530,229,-74,303,0.00441565104870589,-0.00142689160525867,0.00584254265396457,EPCI
200042372,CC des Coteaux Arrats Gimone,1968_1975,1971.5,7,10178,9399,1039,713,-779,-326,-453,-0.011310581430992,-0.00473331135623026,-0.00657727007476169,EPCI
200042372,CC des Coteaux Arrats Gimone,1975_1982,1978.5,7,9399,9241,969,549,-158,-420,262,-0.00241895470705156,-0.00643013276558009,0.00401117805852853,EPCI
200042372,CC des Coteaux Arrats Gimone,1982_1990,1986,8,9241,9151,1055,674,-90,-381,291,-0.00122261973732229,-0.00517575688799771,0.00395313715067542,EPCI
200042372,CC des Coteaux Arrats Gimone,1990_1999,1994.5,9,9151,9097,1169,727,-54,-442,388,-0.000657392055686046,-0.00538087571505986,0.00472348365937381,EPCI
200042372,CC des Coteaux Arrats Gimone,1999_2010,2004.5,11,9097,10281,1419,1054,1184,-365,1549,0.0111850761040149,-0.00344810200841675,0.0146331781124316,EPCI
200042414,CC Bresse Revermont 71,2010_2015,2012.5,5,9550,9868,580,444,318,-136,454,0.00657271494150846,-0.00281097242781494,0.0093836873693234,EPCI
200042414,CC Bresse Revermont 71,1968_1975,1971.5,7,10462,9429,1003,735,-1033,-268,-765,-0.0147416335192636,-0.00382454770877313,-0.0109170858104905,EPCI
200042414,CC Bresse Revermont 71,1975_1982,1978.5,7,9429,8829,1048,502,-600,-546,-54,-0.00934863984666578,-0.00850726226046587,-0.000841377586199921,EPCI
200042414,CC Bresse Revermont 71,1982_1990,1986,8,8829,8357,1117,565,-472,-552,80,-0.00684425155106228,-0.00800429418683554,0.00116004263577327,EPCI
200042414,CC Bresse Revermont 71,1990_1999,1994.5,9,8357,8011,1108,559,-346,-549,203,-0.00468719330572276,-0.00743719400243293,0.00275000069671017,EPCI
200042414,CC Bresse Revermont 71,1999_2010,2004.5,11,8011,9550,1208,997,1539,-211,1750,0.0161033339822594,-0.00220779952583283,0.0183111335080922,EPCI
200042463,CC de la Montagne Noire,2010_2015,2012.5,5,5838,5866,426,256,28,-170,198,0.000957397637475044,-0.00581277137038419,0.00677016900785924,EPCI
200042463,CC de la Montagne Noire,1968_1975,1971.5,7,5636,5053,538,365,-583,-173,-410,-0.0154778908923454,-0.00459292474163938,-0.010884966150706,EPCI
200042463,CC de la Montagne Noire,1975_1982,1978.5,7,5053,4822,474,285,-231,-189,-42,-0.00666247046236279,-0.00545111219647865,-0.00121135826588414,EPCI
200042463,CC de la Montagne Noire,1982_1990,1986,8,4822,4905,547,378,83,-169,252,0.0021355662375433,-0.00434832161620261,0.00648388785374591,EPCI
200042463,CC de la Montagne Noire,1990_1999,1994.5,9,4905,5208,638,417,303,-221,524,0.00668231792949059,-0.0048739018561631,0.0115562197856537,EPCI
200042463,CC de la Montagne Noire,1999_2010,2004.5,11,5208,5838,834,525,630,-309,939,0.0104351951348995,-0.00511821475664121,0.0155534098915407,EPCI
200042497,CC Dombes Saône Vallée,2010_2015,2012.5,5,34800,36925,1133,2037,2125,904,1221,0.0119248288636606,0.00507296249070552,0.00685186637295513,EPCI
200042497,CC Dombes Saône Vallée,1968_1975,1971.5,7,13529,15489,1171,1592,1960,421,1539,0.0195157860191126,0.00419191118063593,0.0153238748384767,EPCI
200042497,CC Dombes Saône Vallée,1975_1982,1978.5,7,15489,20588,1108,1735,5099,627,4472,0.0414917298075719,0.00510204247682831,0.0363896873307436,EPCI
200042497,CC Dombes Saône Vallée,1982_1990,1986,8,20588,25867,1364,2485,5279,1121,4158,0.0289434050682453,0.00614615591617788,0.0227972491520675,EPCI
200042497,CC Dombes Saône Vallée,1990_1999,1994.5,9,25867,30009,1580,3097,4142,1517,2625,0.0166401878235858,0.0060944386596764,0.0105457491639094,EPCI
200042497,CC Dombes Saône Vallée,1999_2010,2004.5,11,30009,34800,2077,4210,4791,2133,2658,0.0135565266917972,0.00603549810761916,0.00752102858417803,EPCI
200042604,"CC de Granville, Terre et Mer",2010_2015,2012.5,5,43605,44589,2722,1761,984,-961,1945,0.00447304817842387,-0.00436849522303388,0.00884154340145775,EPCI
200042604,"CC de Granville, Terre et Mer",1968_1975,1971.5,7,33842,35108,3088,3799,1266,711,555,0.00526041480536832,0.0029543087887969,0.00230610601657142,EPCI
200042604,"CC de Granville, Terre et Mer",1975_1982,1978.5,7,35108,36646,3103,3397,1538,294,1244,0.00614383312668076,0.00117443884216134,0.00496939428451942,EPCI
200042604,"CC de Granville, Terre et Mer",1982_1990,1986,8,36646,36812,3509,3531,166,22,144,0.000565109253932716,7.48939975091552e-05,0.000490215256423561,EPCI
200042604,"CC de Granville, Terre et Mer",1990_1999,1994.5,9,36812,39515,4028,3930,2703,-98,2801,0.00790401394421725,-0.000286568023134773,0.00819058196735202,EPCI
200042604,"CC de Granville, Terre et Mer",1999_2010,2004.5,11,39515,43605,5464,4860,4090,-604,4694,0.00899397545655312,-0.00132820566644452,0.0103221811229976,EPCI
200042620,CC de la Région de Suippes,2010_2015,2012.5,5,7641,7712,358,580,71,222,-151,0.00185152649089959,0.00578928001379872,-0.00393775352289913,EPCI
200042620,CC de la Région de Suippes,1968_1975,1971.5,7,6800,6520,481,814,-280,333,-613,-0.00598888559282984,0.00712249608004406,-0.0131113816728739,EPCI
200042620,CC de la Région de Suippes,1975_1982,1978.5,7,6520,6370,452,621,-150,169,-319,-0.00331946497554703,0.00373993053911632,-0.00705939551466334,EPCI
200042620,CC de la Région de Suippes,1982_1990,1986,8,6370,6532,472,742,162,270,-108,0.00314414568027455,0.00524024280045758,-0.00209609712018303,EPCI
200042620,CC de la Région de Suippes,1990_1999,1994.5,9,6532,6840,628,807,308,179,129,0.00513252166337708,0.00298286161605356,0.00214966004732352,EPCI
200042620,CC de la Région de Suippes,1999_2010,2004.5,11,6840,7641,728,1202,801,474,327,0.0101181873492158,0.00598754157743854,0.00413064577177722,EPCI
200042646,CC Grand Orb CC en Languedoc,2010_2015,2012.5,5,20669,20504,1507,815,-165,-692,527,-0.00160171671398945,-0.00671750282473153,0.00511578611074207,EPCI
200042646,CC Grand Orb CC en Languedoc,1968_1975,1971.5,7,20839,19193,2108,1483,-1646,-625,-1021,-0.0116855589488142,-0.00443710470413661,-0.00724845424467757,EPCI
200042646,CC Grand Orb CC en Languedoc,1975_1982,1978.5,7,19193,19016,2127,1275,-177,-852,675,-0.00132268150840253,-0.00636680590485288,0.00504412439645034,EPCI
200042646,CC Grand Orb CC en Languedoc,1982_1990,1986,8,19016,18728,2432,1472,-288,-960,672,-0.00190580662355477,-0.00635268874518258,0.0044468821216278,EPCI
200042646,CC Grand Orb CC en Languedoc,1990_1999,1994.5,9,18728,18586,2512,1515,-142,-997,855,-0.000845322630401379,-0.00593511734162095,0.00508979471121957,EPCI
200042646,CC Grand Orb CC en Languedoc,1999_2010,2004.5,11,18586,20669,3233,1845,2083,-1388,3471,0.0097037227510306,-0.00646604281249662,0.0161697655635272,EPCI
200042653,CC Sud-Hérault,2010_2015,2012.5,5,16962,17550,1165,757,588,-408,996,0.00683896000283024,-0.00474540081829037,0.0115843608211206,EPCI
200042653,CC Sud-Hérault,1968_1975,1971.5,7,15378,13496,1613,947,-1882,-666,-1216,-0.0184764036861633,-0.00653840853081019,-0.0119379951553531,EPCI
200042653,CC Sud-Hérault,1975_1982,1978.5,7,13496,13666,1540,685,170,-855,1025,0.00178983572082236,-0.00900182083119483,0.0107916565520172,EPCI
200042653,CC Sud-Hérault,1982_1990,1986,8,13666,14344,1746,897,678,-849,1527,0.00607094644194706,-0.00760211434987176,0.0136730607918188,EPCI
200042653,CC Sud-Hérault,1990_1999,1994.5,9,14344,14863,1805,1117,519,-688,1207,0.00395704928982665,-0.00524556823005923,0.00920261751988588,EPCI
200042653,CC Sud-Hérault,1999_2010,2004.5,11,14863,16962,2487,1592,2099,-895,2994,0.0120815488889419,-0.00515149416655692,0.0172330430554988,EPCI
200042703,CC de l'Argonne Champenoise,2010_2015,2012.5,5,12475,12166,866,606,-309,-260,-49,-0.00500373256064712,-0.004210260407017,-0.000793472153630126,EPCI
200042703,CC de l'Argonne Champenoise,1968_1975,1971.5,7,14848,14236,1279,1588,-612,309,-921,-0.00599498768797058,0.00302688103853416,-0.00902186872650474,EPCI
200042703,CC de l'Argonne Champenoise,1975_1982,1978.5,7,14236,13839,1244,1285,-397,41,-438,-0.00403231606471266,0.000416435664113902,-0.00444875172882656,EPCI
200042703,CC de l'Argonne Champenoise,1982_1990,1986,8,13839,13283,1339,1305,-556,-34,-522,-0.00511259485668358,-0.000312640692674895,-0.00479995416400869,EPCI
200042703,CC de l'Argonne Champenoise,1990_1999,1994.5,9,13283,12849,1340,1285,-434,-55,-379,-0.0036842004903318,-0.000466891767207947,-0.00321730872312385,EPCI
200042703,CC de l'Argonne Champenoise,1999_2010,2004.5,11,12849,12475,1820,1570,-374,-250,-124,-0.00268179261241364,-0.00179264212059735,-0.000889150491816286,EPCI
200042729,CC de la Baie du Cotentin,2010_2015,2012.5,5,23421,23326,1483,1164,-95,-319,224,-0.000812557203937137,-0.00272848155848365,0.00191592435454651,EPCI
200042729,CC de la Baie du Cotentin,1968_1975,1971.5,7,23649,23402,1584,2599,-247,1015,-1262,-0.00149878169592055,0.00615896122007836,-0.00765774291599891,EPCI
200042729,CC de la Baie du Cotentin,1975_1982,1978.5,7,23402,23339,1811,2158,-63,347,-410,-0.000385026966326141,0.00212070408436779,-0.00250573105069393,EPCI
200042729,CC de la Baie du Cotentin,1982_1990,1986,8,23339,22765,2190,2440,-574,250,-824,-0.0031078496375172,0.00135359304769913,-0.00446144268521633,EPCI
200042729,CC de la Baie du Cotentin,1990_1999,1994.5,9,22765,22927,2398,2556,162,158,4,0.000788197859669548,0.000768736184122152,1.94616755473963e-05,EPCI
200042729,CC de la Baie du Cotentin,1999_2010,2004.5,11,22927,23421,3065,2842,494,-223,717,0.00193986096105903,-0.00087568622331207,0.0028155471843711,EPCI
200042901,CC Drôme Sud Provence,2010_2015,2012.5,5,40150,41386,1499,2554,1236,1055,181,0.00608246733452189,0.00519175003068009,0.000890717303841798,EPCI
200042901,CC Drôme Sud Provence,1968_1975,1971.5,7,23676,24421,1482,2716,745,1234,-489,0.00443574335033992,0.00734725811318048,-0.00291151476284056,EPCI
200042901,CC Drôme Sud Provence,1975_1982,1978.5,7,24421,30363,1536,2684,5942,1148,4794,0.0316006453123394,0.00610527445617059,0.0254953708561688,EPCI
200042901,CC Drôme Sud Provence,1982_1990,1986,8,30363,32594,1868,3820,2231,1952,279,0.00890232463708318,0.0077890352718899,0.00111328936519328,EPCI
200042901,CC Drôme Sud Provence,1990_1999,1994.5,9,32594,34497,2320,3830,1903,1510,393,0.00632482234669785,0.00501864516211968,0.00130617718457817,EPCI
200042901,CC Drôme Sud Provence,1999_2010,2004.5,11,34497,40150,2887,4908,5653,2021,3632,0.0138910579868885,0.00496618223801551,0.00892487574887299,EPCI
200042935,CA Haut - Bugey Agglomération,2010_2015,2012.5,5,57750,57187,1936,3654,-563,1718,-2281,-0.00195743164177298,0.00597312177720422,-0.0079305534189772,EPCI
200042935,CA Haut - Bugey Agglomération,1968_1975,1971.5,7,37674,42195,2732,5126,4521,2394,2127,0.0163219902286256,0.00864296496512489,0.00767902526350068,EPCI
200042935,CA Haut - Bugey Agglomération,1975_1982,1978.5,7,42195,47276,2798,5401,5081,2603,2478,0.0163756399852601,0.00838925228924073,0.00798638769601942,EPCI
200042935,CA Haut - Bugey Agglomération,1982_1990,1986,8,47276,53022,2997,6769,5746,3772,1974,0.0144413017573168,0.00948008879718049,0.00496121296013635,EPCI
200042935,CA Haut - Bugey Agglomération,1990_1999,1994.5,9,53022,56829,3108,7733,3807,4625,-818,0.00773418179869356,0.00939600494325131,-0.00166182314455775,EPCI
200042935,CA Haut - Bugey Agglomération,1999_2010,2004.5,11,56829,57750,4302,9577,921,5275,-4354,0.0014625767588905,0.00837686471568663,-0.00691428795679613,EPCI
200042943,CC du Cap Corse,2010_2015,2012.5,5,6486,6808,402,232,322,-170,492,0.00973758137902547,-0.00514095911315009,0.0148785404921756,EPCI
200042943,CC du Cap Corse,1968_1975,1971.5,7,5869,5172,601,322,-697,-279,-418,-0.0178985690705207,-0.00716456351603338,-0.0107340055544873,EPCI
200042943,CC du Cap Corse,1975_1982,1978.5,7,5172,5022,587,274,-150,-313,163,-0.0041956308120521,-0.00875488296114871,0.00455925214909661,EPCI
200042943,CC du Cap Corse,1982_1990,1986,8,5022,5230,620,387,208,-233,441,0.00508576599432065,-0.00569703594556111,0.0107828019398818,EPCI
200042943,CC du Cap Corse,1990_1999,1994.5,9,5230,5779,687,404,549,-283,832,0.0111527757667294,-0.00574906291800438,0.0169018386847337,EPCI
200042943,CC du Cap Corse,1999_2010,2004.5,11,5779,6486,839,510,707,-329,1036,0.0105475418429102,-0.00490826204571068,0.0154558038886209,EPCI
200042992,CC Perthois-Bocage et Der,2010_2015,2012.5,5,5686,5704,346,328,18,-18,36,0.000632333815425712,-0.000632333815425712,0.00126466763085142,EPCI
200042992,CC Perthois-Bocage et Der,1968_1975,1971.5,7,5083,4783,505,477,-300,-28,-272,-0.00865287136798998,-0.000807601327679065,-0.00784527004031091,EPCI
200042992,CC Perthois-Bocage et Der,1975_1982,1978.5,7,4783,5215,471,391,432,-80,512,0.0124296313470968,-0.00230178358279571,0.0147314149298926,EPCI
200042992,CC Perthois-Bocage et Der,1982_1990,1986,8,5215,5382,533,520,167,-13,180,0.0039478929610175,-0.000307321008941482,0.00425521396995898,EPCI
200042992,CC Perthois-Bocage et Der,1990_1999,1994.5,9,5382,5298,592,445,-84,-147,63,-0.00174632467027791,-0.00305606817298634,0.00130974350270843,EPCI
200042992,CC Perthois-Bocage et Der,1999_2010,2004.5,11,5298,5686,642,635,388,-7,395,0.0064459245230164,-0.000116292452734832,0.00656221697575123,EPCI
200043016,CC Val de Charente,2010_2015,2012.5,5,14423,14167,938,551,-256,-387,131,-0.00357536076271425,-0.00540493990300944,0.00182957914029518,EPCI
200043016,CC Val de Charente,1968_1975,1971.5,7,15980,15194,1527,1462,-786,-65,-721,-0.00717943629150708,-0.000593719286193334,-0.00658571700531375,EPCI
200043016,CC Val de Charente,1975_1982,1978.5,7,15194,15009,1482,1177,-185,-305,120,-0.00174855405310936,-0.00288275127674787,0.00113419722363851,EPCI
200043016,CC Val de Charente,1982_1990,1986,8,15009,14580,1805,1274,-429,-531,102,-0.00361834976270092,-0.00447865669928716,0.000860306936586234,EPCI
200043016,CC Val de Charente,1990_1999,1994.5,9,14580,14113,1856,1216,-467,-640,173,-0.00361061800270834,-0.00494817028208424,0.0013375522793759,EPCI
200043016,CC Val de Charente,1999_2010,2004.5,11,14113,14423,2172,1422,310,-750,1060,0.00197720629688547,-0.0047835636214971,0.00676076991838257,EPCI
200043065,CC du Val d'Amboise,2010_2015,2012.5,5,27443,28315,1363,1475,872,112,760,0.00627572500640672,0.00080605642284123,0.00546966858356549,EPCI
200043065,CC du Val d'Amboise,1968_1975,1971.5,7,17520,20514,1749,2220,2994,471,2523,0.0227936796024855,0.00358577925610242,0.019207900346383,EPCI
200043065,CC du Val d'Amboise,1975_1982,1978.5,7,20514,22055,1783,2181,1541,398,1143,0.0104011127819439,0.00268633542324054,0.00771477735870335,EPCI
200043065,CC du Val d'Amboise,1982_1990,1986,8,22055,23490,1923,2192,1435,269,1166,0.00791055756644687,0.00148288500722941,0.00642767255921746,EPCI
200043065,CC du Val d'Amboise,1990_1999,1994.5,9,23490,24797,2278,2592,1307,314,993,0.00603456612151199,0.00144977334518345,0.00458479277632854,EPCI
200043065,CC du Val d'Amboise,1999_2010,2004.5,11,24797,27443,2779,3532,2646,753,1893,0.00925974022295128,0.00263514149201902,0.00662459873093227,EPCI
200043081,"CC Chinon, Vienne et Loire",2010_2015,2012.5,5,23384,23512,1266,1168,128,-98,226,0.0010923764705606,-0.000836350735272957,0.00192872720583355,EPCI
200043081,"CC Chinon, Vienne et Loire",1968_1975,1971.5,7,20171,20939,1645,2646,768,1001,-233,0.00535249073822808,0.00697635837104988,-0.0016238676328218,EPCI
200043081,"CC Chinon, Vienne et Loire",1975_1982,1978.5,7,20939,22923,1747,1918,1984,171,1813,0.0130164610447547,0.00112188247915981,0.0118945785655949,EPCI
200043081,"CC Chinon, Vienne et Loire",1982_1990,1986,8,22923,23313,2022,2545,390,523,-133,0.0021110215202349,0.00283093398739193,-0.000719912467157031,EPCI
200043081,"CC Chinon, Vienne et Loire",1990_1999,1994.5,9,23313,23473,2234,2568,160,334,-174,0.00076025324072182,0.0015870286400068,-0.000826775399284979,EPCI
200043081,"CC Chinon, Vienne et Loire",1999_2010,2004.5,11,23473,23384,2588,2781,-89,193,-282,-0.000345285524119388,0.000748765237697099,-0.00109405076181649,EPCI
200043123,CC Auray Quiberon Terre Atlantique,2010_2015,2012.5,5,81827,86050,4484,4310,4223,-174,4397,0.0101150669450674,-0.000416770459020062,0.0105318374040874,EPCI
200043123,CC Auray Quiberon Terre Atlantique,1968_1975,1971.5,7,55127,57412,5425,6425,2285,1000,1285,0.00581882489147856,0.00254653168117224,0.00327229321030632,EPCI
200043123,CC Auray Quiberon Terre Atlantique,1975_1982,1978.5,7,57412,60225,5304,5579,2813,275,2538,0.00685685960552007,0.000670329325104166,0.00618653028041591,EPCI
200043123,CC Auray Quiberon Terre Atlantique,1982_1990,1986,8,60225,64182,6154,6263,3957,109,3848,0.00798612646954466,0.000219986804442853,0.00776613966510181,EPCI
200043123,CC Auray Quiberon Terre Atlantique,1990_1999,1994.5,9,64182,68038,6596,6652,3856,56,3800,0.00650367710800603,9.44517422324528e-05,0.00640922536577358,EPCI
200043123,CC Auray Quiberon Terre Atlantique,1999_2010,2004.5,11,68038,81827,8638,9378,13789,740,13049,0.0169179593438131,0.000907918624586389,0.0160100407192267,EPCI
200043156,CC du Pays Rethélois,2010_2015,2012.5,5,29086,29832,1561,1984,746,423,323,0.00507778529979697,0.00287922678527362,0.00219855851452335,EPCI
200043156,CC du Pays Rethélois,1968_1975,1971.5,7,27246,27020,2223,3312,-226,1089,-1315,-0.00118920502201503,0.00573028437599277,-0.00691948939800779,EPCI
200043156,CC du Pays Rethélois,1975_1982,1978.5,7,27020,27246,2184,2774,226,590,-364,0.00119062091438571,0.00310825813932552,-0.00191763722493982,EPCI
200043156,CC du Pays Rethélois,1982_1990,1986,8,27246,27513,2438,2935,267,497,-230,0.00121973062970637,0.00227043491746842,-0.00105070428776204,EPCI
200043156,CC du Pays Rethélois,1990_1999,1994.5,9,27513,27238,2505,2983,-275,478,-753,-0.00111555098743144,0.00193903044360809,-0.00305458143103953,EPCI
200043156,CC du Pays Rethélois,1999_2010,2004.5,11,27238,29086,3069,4029,1848,960,888,0.00598546918082232,0.00310933463938822,0.0028761345414341,EPCI
200043172,CA du Bassin de Brive,2010_2015,2012.5,5,107794,107955,5608,5444,161,-164,325,0.000298539619898452,-0.000304102469958672,0.000602642089857125,EPCI
200043172,CA du Bassin de Brive,1968_1975,1971.5,7,83575,91424,7062,9087,7849,2025,5824,0.0129059425234468,0.00332966411134918,0.0095762784120976,EPCI
200043172,CA du Bassin de Brive,1975_1982,1978.5,7,91424,96076,7072,8168,4652,1096,3556,0.00711541208281585,0.00167637395588267,0.00543903812693319,EPCI
200043172,CA du Bassin de Brive,1982_1990,1986,8,96076,98048,8243,8534,1972,291,1681,0.00254292899137876,0.000375249663535101,0.00216767932784366,EPCI
200043172,CA du Bassin de Brive,1990_1999,1994.5,9,98048,99572,9243,8761,1524,-482,2006,0.00171522998165008,-0.000542480873461508,0.00225771085511159,EPCI
200043172,CA du Bassin de Brive,1999_2010,2004.5,11,99572,107794,11632,12033,8222,401,7821,0.00723889300072078,0.000353052310057046,0.00688584069066373,EPCI
200043263,CC Coeur de l'Avesnois,2010_2015,2012.5,5,30988,30538,1551,1936,-450,385,-835,-0.00292136907407403,0.00249939354115223,-0.00542076261522626,EPCI
200043263,CC Coeur de l'Avesnois,1968_1975,1971.5,7,35529,34767,2953,4690,-762,1737,-2499,-0.00309243758942235,0.00704929670974622,-0.0101417342991686,EPCI
200043263,CC Coeur de l'Avesnois,1975_1982,1978.5,7,34767,33859,2871,3699,-908,828,-1736,-0.00377340818146332,0.00344094931084981,-0.00721435749231314,EPCI
200043263,CC Coeur de l'Avesnois,1982_1990,1986,8,33859,31665,2891,3845,-2194,954,-3148,-0.00833914393305191,0.00362604526532886,-0.0119651891983808,EPCI
200043263,CC Coeur de l'Avesnois,1990_1999,1994.5,9,31665,30925,2690,3573,-740,883,-1623,-0.00262400146162889,0.00313107201434907,-0.00575507347597795,EPCI
200043263,CC Coeur de l'Avesnois,1999_2010,2004.5,11,30925,30988,3437,4337,63,900,-837,0.00018502752376337,0.00264325033947672,-0.00245822281571335,EPCI
200043321,CC du Pays de Mormal,2010_2015,2012.5,5,48160,48465,2375,2818,305,443,-138,0.00126341482572023,0.0018350582550625,-0.000571643429342269,EPCI
200043321,CC du Pays de Mormal,1968_1975,1971.5,7,45595,44748,4446,5598,-847,1152,-1999,-0.00267517395634942,0.00363848925350004,-0.00631366320984946,EPCI
200043321,CC du Pays de Mormal,1975_1982,1978.5,7,44748,45113,4153,4436,365,283,82,0.00116120257787866,0.000900329669971675,0.000260872907906987,EPCI
200043321,CC du Pays de Mormal,1982_1990,1986,8,45113,46255,4419,5337,1142,918,224,0.00312977666983394,0.00251588002005916,0.000613896649774783,EPCI
200043321,CC du Pays de Mormal,1990_1999,1994.5,9,46255,46361,4529,4905,106,376,-270,0.000254368161081597,0.000902287061949817,-0.00064791890086822,EPCI
200043321,CC du Pays de Mormal,1999_2010,2004.5,11,46361,48160,5208,6485,1799,1277,522,0.00346692433172735,0.00246095740501158,0.00100596692671577,EPCI
200043354,CC de Villedieu Intercom,2010_2015,2012.5,5,15629,15739,942,880,110,-62,172,0.00140369339850466,-0.000791172642793534,0.00219486604129819,EPCI
200043354,CC de Villedieu Intercom,1968_1975,1971.5,7,17122,16089,1317,1662,-1033,345,-1378,-0.00885037107657571,0.00295583545151851,-0.0118062065280942,EPCI
200043354,CC de Villedieu Intercom,1975_1982,1978.5,7,16089,15968,1334,1493,-121,159,-280,-0.00107785999113919,0.00141636147595976,-0.00249422146709894,EPCI
200043354,CC de Villedieu Intercom,1982_1990,1986,8,15968,15353,1541,1520,-615,-21,-594,-0.00489744632186839,-0.000167229874405262,-0.00473021644746313,EPCI
200043354,CC de Villedieu Intercom,1990_1999,1994.5,9,15353,15052,1597,1422,-301,-175,-126,-0.00219758420672922,-0.00127766523647048,-0.000919918970258743,EPCI
200043354,CC de Villedieu Intercom,1999_2010,2004.5,11,15052,15629,1910,1832,577,-78,655,0.00342560767679534,-0.00046308041384755,0.00388868809064289,EPCI
200043396,CA Maubeuge Val de Sambre,2010_2015,2012.5,5,126764,126380,6070,8624,-384,2554,-2938,-0.000606585687539685,0.00403442668223009,-0.00464101236976978,EPCI
200043396,CA Maubeuge Val de Sambre,1968_1975,1971.5,7,134794,141529,10464,19134,6735,8670,-1935,0.00698959340276573,0.00899773939153361,-0.00200814598876788,EPCI
200043396,CA Maubeuge Val de Sambre,1975_1982,1978.5,7,141529,142145,10413,17468,616,7055,-6439,0.000620623976777424,0.00710795804572195,-0.00648733406894453,EPCI
200043396,CA Maubeuge Val de Sambre,1982_1990,1986,8,142145,139024,10708,19785,-3121,9077,-12198,-0.00277128828003237,0.00805991147640302,-0.0108311997564354,EPCI
200043396,CA Maubeuge Val de Sambre,1990_1999,1994.5,9,139024,133743,10838,17305,-5281,6467,-11748,-0.00429370359879311,0.00525797787793884,-0.00955168147673195,EPCI
200043396,CA Maubeuge Val de Sambre,1999_2010,2004.5,11,133743,126764,13101,19630,-6979,6529,-13508,-0.00486023772044597,0.00454685371497231,-0.00940709143541828,EPCI
200043404,CC du Sud Avesnois,2010_2015,2012.5,5,26780,26182,1493,1790,-598,297,-895,-0.00450645303221864,0.00223815476683768,-0.00674460779905632,EPCI
200043404,CC du Sud Avesnois,1968_1975,1971.5,7,30744,30702,2596,4100,-42,1504,-1546,-0.000195274390264233,0.00699268292755729,-0.00718795731782153,EPCI
200043404,CC du Sud Avesnois,1975_1982,1978.5,7,30702,29515,2488,3431,-1187,943,-2130,-0.00561690733530695,0.00446229453849575,-0.0100792018738027,EPCI
200043404,CC du Sud Avesnois,1982_1990,1986,8,29515,28516,2539,3677,-999,1138,-2137,-0.00429490981083081,0.00489249986459005,-0.00918740967542085,EPCI
200043404,CC du Sud Avesnois,1990_1999,1994.5,9,28516,27437,2697,3626,-1079,929,-2008,-0.00427670272914038,0.00368216574177147,-0.00795886847091185,EPCI
200043404,CC du Sud Avesnois,1999_2010,2004.5,11,27437,26780,3136,4213,-657,1077,-1734,-0.00220094954816197,0.00360794925931574,-0.00580889880747771,EPCI
200043438,CC de la Moivre à la Coole,2010_2015,2012.5,5,9545,9584,396,508,39,112,-73,0.000815849463347895,0.00234295230499908,-0.00152710284165119,EPCI
200043438,CC de la Moivre à la Coole,1968_1975,1971.5,7,6485,6992,495,792,507,297,210,0.0108115729842533,0.00633340665941464,0.00447816632483864,EPCI
200043438,CC de la Moivre à la Coole,1975_1982,1978.5,7,6992,8191,505,750,1199,245,954,0.0228674487441296,0.00467266467248687,0.0181947840716427,EPCI
200043438,CC de la Moivre à la Coole,1982_1990,1986,8,8191,8625,602,872,434,270,164,0.00647449103397046,0.00402790916859914,0.00244658186537133,EPCI
200043438,CC de la Moivre à la Coole,1990_1999,1994.5,9,8625,8589,695,787,-36,92,-128,-0.000464630707187941,0.00118738958503585,-0.00165202029222379,EPCI
200043438,CC de la Moivre à la Coole,1999_2010,2004.5,11,8589,9545,821,1105,956,284,672,0.00964027480652274,0.00286384732746073,0.00677642747906201,EPCI
200043495,CA du Pays de Laon,2010_2015,2012.5,5,43200,43137,1909,2919,-63,1010,-1073,-0.000291836954579239,0.00467865593849256,-0.0049704928930718,EPCI
200043495,CA du Pays de Laon,1968_1975,1971.5,7,38491,40618,2608,5575,2127,2967,-840,0.00771343506971878,0.0107596435598757,-0.00304620849015692,EPCI
200043495,CA du Pays de Laon,1975_1982,1978.5,7,40618,40839,2563,4896,221,2333,-2112,0.000775470391457089,0.00818630055778004,-0.00741083016632295,EPCI
200043495,CA du Pays de Laon,1982_1990,1986,8,40839,41803,3058,5522,964,2464,-1500,0.00292058162414732,0.00746505510570436,-0.00454447348155704,EPCI
200043495,CA du Pays de Laon,1990_1999,1994.5,9,41803,42079,3322,5445,276,2123,-1847,0.0007314558944016,0.00562637994135724,-0.00489492404695564,EPCI
200043495,CA du Pays de Laon,1999_2010,2004.5,11,42079,43200,4038,6500,1121,2462,-1341,0.00239301245475798,0.00525566160893323,-0.00286264915417525,EPCI
200043602,"CC des Albères, de la Côte Vermeille et de l'Illibéris",2010_2015,2012.5,5,52937,55144,3678,2360,2207,-1318,3525,0.00820254167219159,-0.00489848206794224,0.0131010237401338,EPCI
200043602,"CC des Albères, de la Côte Vermeille et de l'Illibéris",1968_1975,1971.5,7,34038,34794,3201,2531,756,-670,1426,0.00314313081651441,-0.00278557889823367,0.00592870971474807,EPCI
200043602,"CC des Albères, de la Côte Vermeille et de l'Illibéris",1975_1982,1978.5,7,34794,37789,3534,2374,2995,-1160,4155,0.0118660057308038,-0.00459584863029461,0.0164618543610984,EPCI
200043602,"CC des Albères, de la Côte Vermeille et de l'Illibéris",1982_1990,1986,8,37789,42912,4293,3048,5123,-1245,6368,0.01601862584654,-0.00389287315614724,0.0199114990026873,EPCI
200043602,"CC des Albères, de la Côte Vermeille et de l'Illibéris",1990_1999,1994.5,9,42912,48119,5531,3633,5207,-1898,7105,0.0128063751168317,-0.00466804301358682,0.0174744181304185,EPCI
200043602,"CC des Albères, de la Côte Vermeille et de l'Illibéris",1999_2010,2004.5,11,48119,52937,7404,4912,4818,-2492,7310,0.00871277516474622,-0.00450648312796754,0.0132192582927138,EPCI
200043628,CC des Vallées du Clain,2010_2015,2012.5,5,24285,26003,951,1518,1718,567,1151,0.0137644780643222,0.00454275847640903,0.00922171958791321,EPCI
200043628,CC des Vallées du Clain,1968_1975,1971.5,7,11415,13585,986,1342,2170,356,1814,0.0251742171801437,0.0041299637401526,0.0210442534399911,EPCI
200043628,CC des Vallées du Clain,1975_1982,1978.5,7,13585,16674,957,1466,3089,509,2580,0.0297017495127025,0.00489420216962305,0.0248075473430795,EPCI
200043628,CC des Vallées du Clain,1982_1990,1986,8,16674,19195,1110,1841,2521,731,1790,0.0177556919426711,0.00514851678305934,0.0126071751596118,EPCI
200043628,CC des Vallées du Clain,1990_1999,1994.5,9,19195,20671,1354,1988,1476,634,842,0.00826529531582132,0.00355026912617257,0.00471502618964875,EPCI
200043628,CC des Vallées du Clain,1999_2010,2004.5,11,20671,24285,1713,2941,3614,1228,2386,0.0147557268846326,0.00501384411021826,0.0097418827744143,EPCI
200043693,CC Terre Lorraine du Longuyonnais,2010_2015,2012.5,5,15810,15586,775,768,-224,-7,-217,-0.00284984661547927,-8.90577067337271e-05,-0.00276078890874554,EPCI
200043693,CC Terre Lorraine du Longuyonnais,1968_1975,1971.5,7,17076,17632,1190,2227,556,1037,-481,0.00458784408893576,0.00855682431695392,-0.00396898022801816,EPCI
200043693,CC Terre Lorraine du Longuyonnais,1975_1982,1978.5,7,17632,16707,1144,1646,-925,502,-1427,-0.00766867872728771,0.00416181267145777,-0.0118304913987455,EPCI
200043693,CC Terre Lorraine du Longuyonnais,1982_1990,1986,8,16707,15051,1348,1516,-1656,168,-1824,-0.0129631648077735,0.00131510367615093,-0.0142782684839244,EPCI
200043693,CC Terre Lorraine du Longuyonnais,1990_1999,1994.5,9,15051,15165,1375,1435,114,60,54,0.000838763451081359,0.000441454447937557,0.000397309003143802,EPCI
200043693,CC Terre Lorraine du Longuyonnais,1999_2010,2004.5,11,15165,15810,1678,1839,645,161,484,0.00379377002179715,0.000946972051952467,0.00284679796984468,EPCI
200043776,CC Pyrénées Audoises,2010_2015,2012.5,5,15155,14243,1184,460,-912,-724,-188,-0.0123362671283956,-0.00979326469403338,-0.00254300243436226,EPCI
200043776,CC Pyrénées Audoises,1968_1975,1971.5,7,19644,18063,1883,1328,-1581,-555,-1026,-0.0119150611488135,-0.00418270647538993,-0.00773235467342354,EPCI
200043776,CC Pyrénées Audoises,1975_1982,1978.5,7,18063,17344,1896,976,-719,-920,201,-0.00578591416583196,-0.00740339503833853,0.00161748087250657,EPCI
200043776,CC Pyrénées Audoises,1982_1990,1986,8,17344,15860,2154,1140,-1484,-1014,-470,-0.0111185282772285,-0.00759716150479089,-0.00352136677243759,EPCI
200043776,CC Pyrénées Audoises,1990_1999,1994.5,9,15860,15174,2272,1115,-686,-1157,471,-0.00490092655283858,-0.00826584842803825,0.00336492187519967,EPCI
200043776,CC Pyrénées Audoises,1999_2010,2004.5,11,15174,15155,2534,1244,-19,-1290,1271,-0.000113895913923967,-0.00773293310325881,0.00761903718933485,EPCI
200043974,CC du Sud Gironde,2010_2015,2012.5,5,36118,37942,1746,2203,1824,457,1367,0.00990216960046042,0.00248097122116799,0.00742119837929243,EPCI
200043974,CC du Sud Gironde,1968_1975,1971.5,7,24310,24084,2628,2011,-226,-617,391,-0.00133340575576335,-0.00364031571374331,0.00230690995797996,EPCI
200043974,CC du Sud Gironde,1975_1982,1978.5,7,24084,25467,2576,1735,1383,-841,2224,0.00800843689126807,-0.00486991715513843,0.0128783540464065,EPCI
200043974,CC du Sud Gironde,1982_1990,1986,8,25467,26900,2821,2327,1433,-494,1927,0.00686631455638009,-0.00236703376891261,0.0092333483252927,EPCI
200043974,CC du Sud Gironde,1990_1999,1994.5,9,26900,28752,2922,2726,1852,-196,2048,0.00742532573519772,-0.000785833609124597,0.00821115934432232,EPCI
200043974,CC du Sud Gironde,1999_2010,2004.5,11,28752,36118,3729,4273,7366,544,6822,0.0209513732467037,0.00154731836087521,0.0194040548858285,EPCI
200043982,CC du Bazadais,2010_2015,2012.5,5,15270,15589,953,663,319,-290,609,0.00414364487470675,-0.00376694988609705,0.0079105947608038,EPCI
200043982,CC du Bazadais,1968_1975,1971.5,7,14857,14296,1401,1172,-561,-229,-332,-0.00548367471963862,-0.00223843406559224,-0.00324524065404638,EPCI
200043982,CC du Bazadais,1975_1982,1978.5,7,14296,13895,1388,921,-401,-467,66,-0.00405613936356486,-0.00472373337352815,0.000667594009963293,EPCI
200043982,CC du Bazadais,1982_1990,1986,8,13895,13472,1507,967,-423,-540,117,-0.00385699333147904,-0.00492382127422856,0.00106682794274952,EPCI
200043982,CC du Bazadais,1990_1999,1994.5,9,13472,13494,1591,1110,22,-481,503,0.000181314736114935,-0.00396419945778562,0.00414551419390055,EPCI
200043982,CC du Bazadais,1999_2010,2004.5,11,13494,15270,1941,1428,1776,-513,2289,0.0113038637102378,-0.0032651363081937,0.0145690000184315,EPCI
200043990,CC Vallons de Haute-Bretagne Communauté,2010_2015,2012.5,5,39410,42946,1339,3003,3536,1664,1872,0.0173332921450731,0.00815684336238733,0.00917644878268574,EPCI
200043990,CC Vallons de Haute-Bretagne Communauté,1968_1975,1971.5,7,21925,23427,2269,2453,1502,184,1318,0.00951089598097621,0.00116511641844183,0.00834577956253438,EPCI
200043990,CC Vallons de Haute-Bretagne Communauté,1975_1982,1978.5,7,23427,25293,2431,2374,1866,-57,1923,0.0110085060108636,-0.000336272691650173,0.0113447787025137,EPCI
200043990,CC Vallons de Haute-Bretagne Communauté,1982_1990,1986,8,25293,27553,2596,2790,2260,194,2066,0.0107553959884197,0.000923250806085583,0.0098321451823341,EPCI
200043990,CC Vallons de Haute-Bretagne Communauté,1990_1999,1994.5,9,27553,30120,2669,3343,2567,674,1893,0.00994669614966792,0.00261163739964012,0.00733505875002781,EPCI
200043990,CC Vallons de Haute-Bretagne Communauté,1999_2010,2004.5,11,30120,39410,2819,5885,9290,3066,6224,0.0247401907533211,0.00816506187832966,0.0165751288749915,EPCI
200044014,CC Creuse Grand Sud,2010_2015,2012.5,5,12657,12288,951,458,-369,-493,124,-0.00589997546259102,-0.00788262304351592,0.0019826475809249,EPCI
200044014,CC Creuse Grand Sud,1968_1975,1971.5,7,16601,16094,1869,1535,-507,-334,-173,-0.00442111266417988,-0.00291252786949917,-0.00150858479468071,EPCI
200044014,CC Creuse Grand Sud,1975_1982,1978.5,7,16094,15208,1782,1142,-886,-640,-246,-0.00805664507691184,-0.00581969847542165,-0.00223694660149019,EPCI
200044014,CC Creuse Grand Sud,1982_1990,1986,8,15208,14432,1793,1211,-776,-582,-194,-0.00652532224667657,-0.00489399168500743,-0.00163133056166914,EPCI
200044014,CC Creuse Grand Sud,1990_1999,1994.5,9,14432,13554,1887,1142,-878,-745,-133,-0.0069497664092697,-0.00589701136094069,-0.00105275504832901,EPCI
200044014,CC Creuse Grand Sud,1999_2010,2004.5,11,13554,12657,2119,1174,-897,-945,48,-0.00620532918856864,-0.00653738693778971,0.000332057749221064,EPCI
200044030,CC des Sept Vallées,2010_2015,2012.5,5,29452,29769,1914,1766,317,-148,465,0.0021434467233532,-0.00100072591500402,0.00314417263835722,EPCI
200044030,CC des Sept Vallées,1968_1975,1971.5,7,28718,29242,2406,3449,524,1043,-519,0.0025864717505415,0.00514826342712745,-0.00256179167658595,EPCI
200044030,CC des Sept Vallées,1975_1982,1978.5,7,29242,29476,2551,2950,234,399,-165,0.00113926860392821,0.00194259902977503,-0.000803330425846816,EPCI
200044030,CC des Sept Vallées,1982_1990,1986,8,29476,29264,2685,3124,-212,439,-651,-0.000901878220178287,0.00186756857857674,-0.00276944679875502,EPCI
200044030,CC des Sept Vallées,1990_1999,1994.5,9,29264,29150,3185,2964,-114,-221,107,-0.000433592510698411,-0.000840560919862708,0.000406968409164298,EPCI
200044030,CC des Sept Vallées,1999_2010,2004.5,11,29150,29452,3964,3792,302,-172,474,0.000937430632779401,-0.000533900890192242,0.00147133152297164,EPCI
200044048,CC Osartis Marquion,2010_2015,2012.5,5,40974,41764,1733,2454,790,721,69,0.00382670425133824,0.00349247312052516,0.000334231130813087,EPCI
200044048,CC Osartis Marquion,1968_1975,1971.5,7,35284,37326,3022,4292,2042,1270,772,0.0080696039131225,0.00501880360904289,0.00305080030407962,EPCI
200044048,CC Osartis Marquion,1975_1982,1978.5,7,37326,37848,3015,3663,522,648,-126,0.00198596994094813,0.00246534199565975,-0.000479372054711617,EPCI
200044048,CC Osartis Marquion,1982_1990,1986,8,37848,39414,3083,4315,1566,1232,334,0.00508073146550303,0.00399710163825015,0.00108362982725288,EPCI
200044048,CC Osartis Marquion,1990_1999,1994.5,9,39414,39321,3232,4351,-93,1119,-1212,-0.000262449535523901,0.00315786054033597,-0.00342031007585987,EPCI
200044048,CC Osartis Marquion,1999_2010,2004.5,11,39321,40974,3856,5613,1653,1757,-104,0.00375056053378731,0.00398653046452771,-0.0002359699307404,EPCI
200044253,CC du Bassin de Joinville en Champagne,2010_2015,2012.5,5,13589,13072,799,748,-517,-51,-466,-0.00772760808332695,-0.000762297896034187,-0.00696531018729277,EPCI
200044253,CC du Bassin de Joinville en Champagne,1968_1975,1971.5,7,16903,16108,1467,2127,-795,660,-1455,-0.00685852620958627,0.00569387081550558,-0.0125523970250919,EPCI
200044253,CC du Bassin de Joinville en Champagne,1975_1982,1978.5,7,16108,15892,1453,1737,-216,284,-500,-0.00192674216417876,0.0025333091417906,-0.00446005130596936,EPCI
200044253,CC du Bassin de Joinville en Champagne,1982_1990,1986,8,15892,15290,1551,1818,-602,267,-869,-0.00481547051673359,0.00213576516273732,-0.00695123567947091,EPCI
200044253,CC du Bassin de Joinville en Champagne,1990_1999,1994.5,9,15290,14547,1606,1578,-743,-28,-715,-0.00551962537506512,-0.000208007416556963,-0.00531161795850816,EPCI
200044253,CC du Bassin de Joinville en Champagne,1999_2010,2004.5,11,14547,13589,1856,1787,-958,-69,-889,-0.00617396633620693,-0.000444680247597367,-0.00572928608860956,EPCI
200044394,CC du Réolais en Sud Gironde,2010_2015,2012.5,5,22688,23487,1319,1232,799,-87,886,0.00694619895026283,-0.000756344566549269,0.0077025435168121,EPCI
200044394,CC du Réolais en Sud Gironde,1968_1975,1971.5,7,21600,20693,1972,1887,-907,-85,-822,-0.00610952276630672,-0.00057255726034848,-0.00553696550595824,EPCI
200044394,CC du Réolais en Sud Gironde,1975_1982,1978.5,7,20693,19935,1958,1517,-758,-441,-317,-0.00531702829832625,-0.00309341619994971,-0.00222361209837655,EPCI
200044394,CC du Réolais en Sud Gironde,1982_1990,1986,8,19935,20302,2153,1700,367,-453,820,0.00228290468388792,-0.00281786327466275,0.00510076795855067,EPCI
200044394,CC du Réolais en Sud Gironde,1990_1999,1994.5,9,20302,20265,2234,1802,-37,-432,395,-0.000202662048157443,-0.00236621634605447,0.00216355429789702,EPCI
200044394,CC du Réolais en Sud Gironde,1999_2010,2004.5,11,20265,22688,2745,2539,2423,-206,2629,0.0103202437953789,-0.000877412390362381,0.0111976561857413,EPCI
200044469,CC du Pays de Mirepoix,2010_2015,2012.5,5,10217,10447,557,422,230,-135,365,0.00446229778082086,-0.00261917478439485,0.00708147256521571,EPCI
200044469,CC du Pays de Mirepoix,1968_1975,1971.5,7,8840,8495,891,677,-345,-214,-131,-0.0056708768891196,-0.00351758740368578,-0.00215328948543382,EPCI
200044469,CC du Pays de Mirepoix,1975_1982,1978.5,7,8495,8790,867,571,295,-296,591,0.00488861857620604,-0.00490519016459996,0.009793808740806,EPCI
200044469,CC du Pays de Mirepoix,1982_1990,1986,8,8790,8982,1064,726,192,-338,530,0.00270463381159503,-0.00476128243916208,0.0074659162507571,EPCI
200044469,CC du Pays de Mirepoix,1990_1999,1994.5,9,8982,9361,1016,759,379,-257,636,0.00460273214957163,-0.00312111388506572,0.00772384603463736,EPCI
200044469,CC du Pays de Mirepoix,1999_2010,2004.5,11,9361,10217,1321,991,856,-330,1186,0.00798634728949255,-0.00307884883823895,0.0110651961277315,EPCI
200044618,CA du Douaisis (C.A.D.),2010_2015,2012.5,5,152206,149248,7526,10418,-2958,2892,-5850,-0.00391740977548849,0.00383000306650193,-0.00774741284199042,EPCI
200044618,CA du Douaisis (C.A.D.),1968_1975,1971.5,7,159057,159872,11668,21342,815,9674,-8859,0.000730390393708369,0.00866968916409173,-0.00793929877038336,EPCI
200044618,CA du Douaisis (C.A.D.),1975_1982,1978.5,7,159872,156535,11778,18742,-3337,6964,-10301,-0.00300887394023652,0.00627923228043367,-0.00928810622067019,EPCI
200044618,CA du Douaisis (C.A.D.),1982_1990,1986,8,156535,155687,12520,19871,-848,7351,-8199,-0.00067877523940485,0.00588405281234086,-0.00656282805174571,EPCI
200044618,CA du Douaisis (C.A.D.),1990_1999,1994.5,9,155687,153972,13695,18783,-1715,5088,-6803,-0.00123000001298212,0.00364911957204259,-0.00487911958502472,EPCI
200044618,CA du Douaisis (C.A.D.),1999_2010,2004.5,11,153972,152206,16576,23053,-1766,6477,-8243,-0.00104816858141576,0.00384427401009621,-0.00489244259151198,EPCI
200044691,CA du Nord Grande Terre,2010_2015,2012.5,5,57359,58624,2396,3346,1265,950,315,0.00437241255572185,0.00328362998255791,0.00108878257316394,EPCI
200044691,CA du Nord Grande Terre,1968_1975,1971.5,7,48838,49186,2604,7707,348,5103,-4755,0.0010148477236438,0.0148815170510181,-0.0138666693273743,EPCI
200044691,CA du Nord Grande Terre,1975_1982,1978.5,7,49186,46014,2287,6095,-3172,3808,-6980,-0.0094781298361396,0.0113785367011411,-0.0208566665372807,EPCI
200044691,CA du Nord Grande Terre,1982_1990,1986,8,46014,51127,2657,7002,5113,4345,768,0.0132579975101035,0.0112665752359475,0.00199142227415597,EPCI
200044691,CA du Nord Grande Terre,1990_1999,1994.5,9,51127,56336,3111,8162,5209,5051,158,0.0108384291253556,0.0105096766197295,0.000328752505626067,EPCI
200044691,CA du Nord Grande Terre,1999_2010,2004.5,11,56336,57359,4613,8944,1023,4331,-3308,0.00163733897580931,0.00693188182231684,-0.00529454284650753,EPCI
200046977,Métropole de LYON,2010_2015,2012.5,5,1296166,1370678,43857,103558,74512,59701,14811,0.0112416844916168,0.00900713718372897,0.00223454730788781,EPCI
200046977,Métropole de LYON,1968_1975,1971.5,7,1077794,1153402,69956,140130,75608,70174,5434,0.00973269712498226,0.00903320135499557,0.000699495769986689,EPCI
200046977,Métropole de LYON,1975_1982,1978.5,7,1153402,1138718,67515,127282,-14684,59767,-74451,-0.00182872127535894,0.00744328415039346,-0.00927200542575239,EPCI
200046977,Métropole de LYON,1982_1990,1986,8,1138718,1166797,73226,141863,28079,68637,-40558,0.00304955542030938,0.00745440846838473,-0.00440485304807535,EPCI
200046977,Métropole de LYON,1990_1999,1994.5,9,1166797,1199589,79974,158511,32792,78537,-45745,0.00308437027323349,0.00738708185377345,-0.00430271158053995,EPCI
200046977,Métropole de LYON,1999_2010,2004.5,11,1199589,1296166,95613,206152,96577,110539,-13962,0.00706407716656576,0.00808532078978445,-0.00102124362321869,EPCI
200048551,CC du Pays de Craon,2010_2015,2012.5,5,28435,28629,1540,1831,194,291,-97,0.00136080692751728,0.00204121039127592,-0.000680403463758639,EPCI
200048551,CC du Pays de Craon,1968_1975,1971.5,7,29025,27615,2305,3264,-1410,959,-2369,-0.00708881557562069,0.00482140009717748,-0.0119102156727982,EPCI
200048551,CC du Pays de Craon,1975_1982,1978.5,7,27615,27548,2302,2974,-67,672,-739,-0.000346963461494432,0.00347999173319788,-0.00382695519469231,EPCI
200048551,CC du Pays de Craon,1982_1990,1986,8,27548,27112,2382,2938,-436,556,-992,-0.0019922008505624,0.00254051301126765,-0.00453271386183004,EPCI
200048551,CC du Pays de Craon,1990_1999,1994.5,9,27112,26729,2569,2902,-383,333,-716,-0.00157956406258508,0.0013733546549369,-0.00295291871752198,EPCI
200048551,CC du Pays de Craon,1999_2010,2004.5,11,26729,28435,3202,3991,1706,789,917,0.00564054489281918,0.00260866935547147,0.00303187553734771,EPCI
200049187,CA du Grand Verdun,2010_2015,2012.5,5,29063,28636,1395,1690,-427,295,-722,-0.0029558667913544,0.00204210937576007,-0.00499797616711447,EPCI
200049187,CA du Grand Verdun,1968_1975,1971.5,7,30921,32286,2135,4670,1365,2535,-1170,0.00619024299590998,0.0114961655638328,-0.00530592256792284,EPCI
200049187,CA du Grand Verdun,1975_1982,1978.5,7,32286,30733,2207,3875,-1553,1668,-3221,-0.00701764677643268,0.00753730510179634,-0.014554951878229,EPCI
200049187,CA du Grand Verdun,1982_1990,1986,8,30733,30544,2274,4108,-189,1834,-2023,-0.000770793893804966,0.00747955556210745,-0.00825034945591242,EPCI
200049187,CA du Grand Verdun,1990_1999,1994.5,9,30544,29380,2531,3950,-1164,1419,-2583,-0.00430781642947653,0.00525153910088247,-0.009559355530359,EPCI
200049187,CA du Grand Verdun,1999_2010,2004.5,11,29380,29063,3071,4296,-317,1225,-1542,-0.000985721424876296,0.00380917585322859,-0.00479489727810488,EPCI
200049211,CC Conflent-Canigó,2010_2015,2012.5,5,19984,20657,1373,938,673,-435,1108,0.00664644858166419,-0.00429599574000583,0.01094244432167,EPCI
200049211,CC Conflent-Canigó,1968_1975,1971.5,7,17766,17518,2016,1176,-248,-840,592,-0.00200621266067358,-0.00679523643131373,0.00478902377064016,EPCI
200049211,CC Conflent-Canigó,1975_1982,1978.5,7,17518,17280,2036,991,-238,-1045,807,-0.00195225762764772,-0.00857188748273896,0.00661962985509123,EPCI
200049211,CC Conflent-Canigó,1982_1990,1986,8,17280,17800,2391,1248,520,-1143,1663,0.00371296277149469,-0.00816137778426621,0.0118743405557609,EPCI
200049211,CC Conflent-Canigó,1990_1999,1994.5,9,17800,17818,2478,1378,18,-1100,1118,0.000112309084016715,-0.00686333291213259,0.00697564199614931,EPCI
200049211,CC Conflent-Canigó,1999_2010,2004.5,11,17818,19984,3052,1835,2166,-1217,3383,0.0104839179844485,-0.00589054856282262,0.0163744665472711,EPCI
200049484,CC Berry Grand Sud,2010_2015,2012.5,5,12584,12208,1004,484,-376,-520,144,-0.00604857153495286,-0.00836504573982843,0.00231647420487557,EPCI
200049484,CC Berry Grand Sud,1968_1975,1971.5,7,17849,15666,1947,1271,-2183,-676,-1507,-0.0184638056007643,-0.00571760539904566,-0.0127462002017187,EPCI
200049484,CC Berry Grand Sud,1975_1982,1978.5,7,15666,14138,1989,881,-1528,-1108,-420,-0.0145539876563021,-0.0105535460230254,-0.00400044163327676,EPCI
200049484,CC Berry Grand Sud,1982_1990,1986,8,14138,13069,2098,916,-1069,-1182,113,-0.00977976328565577,-0.0108135455600048,0.00103378227434902,EPCI
200049484,CC Berry Grand Sud,1990_1999,1994.5,9,13069,12577,1986,911,-492,-1075,583,-0.00425461941365124,-0.00929617046681927,0.00504155105316803,EPCI
200049484,CC Berry Grand Sud,1999_2010,2004.5,11,12577,12584,2249,1163,7,-1086,1093,5.0584614900151e-05,-0.00784784168308057,0.00789842629798072,EPCI
200054781,Métropole du Grand Paris,2010_2015,2012.5,5,6902389,7020210,208255,544387,117821,336132,-218311,0.00339084566580339,0.00967375710049842,-0.00628291143469503,EPCI
200054781,Métropole du Grand Paris,1968_1975,1971.5,7,6627331,6506587,437585,751384,-120744,313799,-434543,-0.00262328325672467,0.00681759476807912,-0.0094408780248038,EPCI
200054781,Métropole du Grand Paris,1975_1982,1978.5,7,6506587,6296648,415278,672902,-209939,257624,-467563,-0.00467441505372468,0.00573614956630625,-0.0104105646200309,EPCI
200054781,Métropole du Grand Paris,1982_1990,1986,8,6296648,6355983,439095,787567,59335,348472,-289137,0.00117308073699873,0.00688945463189386,-0.00571637389489513,EPCI
200054781,Métropole du Grand Paris,1990_1999,1994.5,9,6355983,6383877,443461,885024,27894,441563,-413669,0.000486676056365543,0.00770409907065814,-0.0072174230142926,EPCI
200054781,Métropole du Grand Paris,1999_2010,2004.5,11,6383877,6902389,475560,1170736,518512,695176,-176664,0.00712453143527481,0.00955195495002738,-0.00242742351475258,EPCI
200054807,Métropole d'Aix-Marseille-Provence,2010_2015,2012.5,5,1831514,1869055,77027,123206,37541,46179,-8638,0.00406624650283138,0.00500186988237528,-0.000935623379543899,EPCI
200054807,Métropole d'Aix-Marseille-Provence,1968_1975,1971.5,7,1365063,1520528,102012,150039,155465,48027,107438,0.0155274692511453,0.00479682092898567,0.0107306483221597,EPCI
200054807,Métropole d'Aix-Marseille-Provence,1975_1982,1978.5,7,1520528,1603840,107025,143368,83312,36343,46969,0.00764955389402977,0.00333694710450744,0.00431260678952233,EPCI
200054807,Métropole d'Aix-Marseille-Provence,1982_1990,1986,8,1603840,1633096,123532,173491,29256,49959,-20703,0.00226216057331952,0.00386297785351619,-0.00160081728019668,EPCI
200054807,Métropole d'Aix-Marseille-Provence,1990_1999,1994.5,9,1633096,1705626,141779,190891,72530,49112,23418,0.00483996374736173,0.00327726871033268,0.00156269503702905,EPCI
200054807,Métropole d'Aix-Marseille-Provence,1999_2010,2004.5,11,1705626,1831514,167306,251811,125888,84505,41383,0.0064947041188046,0.00435970840397482,0.00213499571482977,EPCI
200055481,CC Beauce Val de Loire,2010_2015,2012.5,5,19551,19911,968,1182,360,214,146,0.00365584773148098,0.00217319837371369,0.00148264935776729,EPCI
200055481,CC Beauce Val de Loire,1968_1975,1971.5,7,16784,16494,1471,1707,-290,236,-526,-0.00248681320735966,0.00202375143771338,-0.00451056464507304,EPCI
200055481,CC Beauce Val de Loire,1975_1982,1978.5,7,16494,17007,1433,1375,513,-58,571,0.00438506432290953,-0.000495777252882559,0.00488084157579209,EPCI
200055481,CC Beauce Val de Loire,1982_1990,1986,8,17007,17418,1658,1691,411,33,378,0.00298935050618021,0.000240020843561915,0.0027493296626183,EPCI
200055481,CC Beauce Val de Loire,1990_1999,1994.5,9,17418,17706,1754,1834,288,80,208,0.00182381790514308,0.000506616084761966,0.00131720182038111,EPCI
200055481,CC Beauce Val de Loire,1999_2010,2004.5,11,17706,19551,2161,2593,1845,432,1413,0.00905189289665298,0.00211946760506997,0.00693242529158301,EPCI
200055655,CA Roissy Pays de France,2010_2015,2012.5,5,337395,348720,9145,30821,11325,21676,-10351,0.00662483923513624,0.0126799130473124,-0.00605507381217618,EPCI
200055655,CA Roissy Pays de France,1968_1975,1971.5,7,206698,257737,10578,29282,51039,18704,32335,0.0320280449748502,0.0117371530243461,0.0202908919505042,EPCI
200055655,CA Roissy Pays de France,1975_1982,1978.5,7,257737,275132,11466,30662,17395,19196,-1801,0.00937384720004197,0.0103443731446971,-0.000970525944655108,EPCI
200055655,CA Roissy Pays de France,1982_1990,1986,8,275132,301221,13826,39139,26089,25313,776,0.0113885149604822,0.0110497711370572,0.000338743823424977,EPCI
200055655,CA Roissy Pays de France,1990_1999,1994.5,9,301221,318403,16284,45625,17182,29341,-12159,0.00618277509346288,0.0105580726351586,-0.00437529754169568,EPCI
200055655,CA Roissy Pays de France,1999_2010,2004.5,11,318403,337395,19348,62985,18992,43637,-24645,0.00528084702757825,0.0121335468482746,-0.0068526998206964,EPCI
200055887,CC Mayenne Communauté,2010_2015,2012.5,5,36935,36963,1732,2170,28,438,-410,0.00015157175182523,0.00237101526069467,-0.00221944350886944,EPCI
200055887,CC Mayenne Communauté,1968_1975,1971.5,7,30141,30426,2552,3631,285,1079,-794,0.00134535201696684,0.00509345553090252,-0.00374810351393568,EPCI
200055887,CC Mayenne Communauté,1975_1982,1978.5,7,30426,32316,2546,3529,1890,983,907,0.00864644608403342,0.00449706693153696,0.00414937915249646,EPCI
200055887,CC Mayenne Communauté,1982_1990,1986,8,32316,33038,2698,3692,722,994,-272,0.002765811633473,0.00380777945106948,-0.00104196781759648,EPCI
200055887,CC Mayenne Communauté,1990_1999,1994.5,9,33038,34549,2920,3768,1511,848,663,0.00498127574053564,0.00279558029647533,0.00218569544406031,EPCI
200055887,CC Mayenne Communauté,1999_2010,2004.5,11,34549,36935,3690,5277,2386,1587,799,0.00608946630443064,0.0040502862636762,0.00203918004075443,EPCI
200056232,CA Communauté Paris-Saclay,2010_2015,2012.5,5,291043,309985,8229,21588,18942,13359,5583,0.0126904259496965,0.00895002641019932,0.00374039953949718,EPCI
200056232,CA Communauté Paris-Saclay,1968_1975,1971.5,7,165965,228258,8070,25118,62293,17048,45245,0.0465808534810659,0.012747987577179,0.0338328659038869,EPCI
200056232,CA Communauté Paris-Saclay,1975_1982,1978.5,7,228258,249704,9383,26805,21446,17422,4024,0.012911159652101,0.0104885863778282,0.0024225732742728,EPCI
200056232,CA Communauté Paris-Saclay,1982_1990,1986,8,249704,265903,11203,30790,16199,19587,-3388,0.00788786712555956,0.0095376043822665,-0.00164973725670694,EPCI
200056232,CA Communauté Paris-Saclay,1990_1999,1994.5,9,265903,275108,13312,35617,9205,22305,-13100,0.00378851024433557,0.00918008919064693,-0.00539157894631136,EPCI
200056232,CA Communauté Paris-Saclay,1999_2010,2004.5,11,275108,291043,16938,45050,15935,28112,-12177,0.00513196681855566,0.00905364613763643,-0.00392167931908078,EPCI
200056380,CA Plaine Vallée,2010_2015,2012.5,5,177917,181406,6068,13097,3489,7029,-3540,0.00389164562374011,0.00784017686708778,-0.00394853124334766,EPCI
200056380,CA Plaine Vallée,1968_1975,1971.5,7,117507,137515,7484,14939,20008,7455,12553,0.0227163303087272,0.00846412647198928,0.0142522038367379,EPCI
200056380,CA Plaine Vallée,1975_1982,1978.5,7,137515,143789,7899,13791,6274,5892,382,0.0063937742009661,0.00600448160537014,0.00038929259559596,EPCI
200056380,CA Plaine Vallée,1982_1990,1986,8,143789,158994,9858,17374,15205,7516,7689,0.0126442103217477,0.0062501732836735,0.00639403703807418,EPCI
200056380,CA Plaine Vallée,1990_1999,1994.5,9,158994,166699,11017,20822,7705,9805,-2100,0.00527199557105562,0.00670887950346533,-0.00143688393240971,EPCI
200056380,CA Plaine Vallée,1999_2010,2004.5,11,166699,177917,13210,27167,11218,13957,-2739,0.00593823075440469,0.00738811612045162,-0.00144988536604693,EPCI
200057859,CA Coeur d'Essonne Agglomération,2010_2015,2012.5,5,186716,195819,5587,13726,9103,8139,964,0.0095658666673728,0.00855284947882536,0.00101301718854744,EPCI
200057859,CA Coeur d'Essonne Agglomération,1968_1975,1971.5,7,99375,147012,5336,17509,47637,12173,35464,0.0575393124709893,0.014703403881633,0.0428359085893563,EPCI
200057859,CA Coeur d'Essonne Agglomération,1975_1982,1978.5,7,147012,151630,5964,15718,4618,9754,-5136,0.00442822240130281,0.00935315749292065,-0.00492493509161785,EPCI
200057859,CA Coeur d'Essonne Agglomération,1982_1990,1986,8,151630,165570,7280,18340,13940,11060,2880,0.0110544947477551,0.00877063930489035,0.00228385544286476,EPCI
200057859,CA Coeur d'Essonne Agglomération,1990_1999,1994.5,9,165570,173942,8624,22470,8372,13846,-5474,0.00549591903220348,0.0090894045532596,-0.00359348552105612,EPCI
200057859,CA Coeur d'Essonne Agglomération,1999_2010,2004.5,11,173942,186716,11336,28971,12774,17635,-4861,0.00646323674642213,0.0089227477707182,-0.00245951102429607,EPCI
200057958,CA Paris - Vallée de la Marne,2010_2015,2012.5,5,219786,227844,5572,18152,8058,12580,-4522,0.00722735991933132,0.0112832201272261,-0.00405586020789479,EPCI
200057958,CA Paris - Vallée de la Marne,1968_1975,1971.5,7,69607,97504,4548,9940,27897,5392,22505,0.0493247846890736,0.00953361433284887,0.0397911703562248,EPCI
200057958,CA Paris - Vallée de la Marne,1975_1982,1978.5,7,97504,142784,5584,14843,45280,9259,36021,0.0560033639715445,0.0114517479463898,0.0445516160251547,EPCI
200057958,CA Paris - Vallée de la Marne,1982_1990,1986,8,142784,190975,7147,23947,48191,16800,31391,0.0370199749691103,0.012905637556412,0.0241143374126982,EPCI
200057958,CA Paris - Vallée de la Marne,1990_1999,1994.5,9,190975,205194,8729,28121,14219,19392,-5173,0.00801117954729369,0.0109257186708713,-0.00291453912357763,EPCI
200057958,CA Paris - Vallée de la Marne,1999_2010,2004.5,11,205194,219786,11630,35817,14592,24187,-9595,0.00626485833439006,0.0103843289839564,-0.00411947064956638,EPCI
200058360,CC Entre Beauce et Perche,2010_2015,2012.5,5,20450,21245,1081,1293,795,212,583,0.00765690351867443,0.00204184093831318,0.00561506258036125,EPCI
200058360,CC Entre Beauce et Perche,1968_1975,1971.5,7,14156,15107,1422,1427,951,5,946,0.00933179362948722,4.90630579888918e-05,0.00928273057149833,EPCI
200058360,CC Entre Beauce et Perche,1975_1982,1978.5,7,15107,15569,1422,1177,462,-245,707,0.00431263635797152,-0.00228700412922732,0.00659964048719884,EPCI
200058360,CC Entre Beauce et Perche,1982_1990,1986,8,15569,16845,1548,1470,1276,-78,1354,0.00989515132368846,-0.000604876021353997,0.0105000273450425,EPCI
200058360,CC Entre Beauce et Perche,1990_1999,1994.5,9,16845,17873,1791,1714,1028,-77,1105,0.00660363261441455,-0.000494630069367627,0.00709826268378217,EPCI
200058360,CC Entre Beauce et Perche,1999_2010,2004.5,11,17873,20450,2215,2739,2577,524,2053,0.0123199721795841,0.00250510881726895,0.00981486336231519,EPCI
200058477,CA Val d'Yerres Val de Seine,2010_2015,2012.5,5,168783,176252,6080,12498,7469,6418,1051,0.00869779247512748,0.00747388299710378,0.00122390947802369,EPCI
200058477,CA Val d'Yerres Val de Seine,1968_1975,1971.5,7,118233,158447,6897,18943,40214,12046,28168,0.0427101855936081,0.0127937259576417,0.0299164596359664,EPCI
200058477,CA Val d'Yerres Val de Seine,1975_1982,1978.5,7,158447,157844,7546,17237,-603,9691,-10294,-0.000544558678122975,0.00875177139252032,-0.00929633007064329,EPCI
200058477,CA Val d'Yerres Val de Seine,1982_1990,1986,8,157844,160694,8987,18483,2850,9496,-6646,0.00223934508158763,0.00746134066482671,-0.00522199558323908,EPCI
200058477,CA Val d'Yerres Val de Seine,1990_1999,1994.5,9,160694,161451,10698,20576,757,9878,-9121,0.000522331440792279,0.00681583880072144,-0.00629350735992916,EPCI
200058477,CA Val d'Yerres Val de Seine,1999_2010,2004.5,11,161451,168783,12873,25729,7332,12856,-5524,0.00404563203117103,0.00709365049000747,-0.00304801845883644,EPCI
200058485,CA Val Parisis,2010_2015,2012.5,5,258483,269448,8430,19476,10965,11046,-81,0.00834371518443722,0.0084053513841581,-6.16361997208773e-05,EPCI
200058485,CA Val Parisis,1968_1975,1971.5,7,160739,187864,9704,19790,27125,10086,17039,0.0225266003489042,0.00837615819793724,0.0141504421509669,EPCI
200058485,CA Val Parisis,1975_1982,1978.5,7,187864,212822,10293,21964,24958,11671,13287,0.017979409252054,0.0084076322373877,0.00957177701466629,EPCI
200058485,CA Val Parisis,1982_1990,1986,8,212822,239424,12052,28524,26602,16472,10130,0.0148313975350389,0.00918362454691982,0.0056477729881191,EPCI
200058485,CA Val Parisis,1990_1999,1994.5,9,239424,246721,13809,31117,7297,17308,-10011,0.00334135936150548,0.00792548277770822,-0.00458412341620274,EPCI
200058485,CA Val Parisis,1999_2010,2004.5,11,246721,258483,17473,39142,11762,21669,-9907,0.00424277375235205,0.00781641425265401,-0.00357364050030197,EPCI
200058519,CA Saint-Germain Boucles de Seine,2010_2015,2012.5,5,332043,334326,10816,22782,2283,11966,-9683,0.00137135670158295,0.00718775921644396,-0.00581640251486101,EPCI
200058519,CA Saint-Germain Boucles de Seine,1968_1975,1971.5,7,272744,296249,15255,33727,23505,18472,5033,0.0118795350118033,0.00933583368381324,0.00254370132799004,EPCI
200058519,CA Saint-Germain Boucles de Seine,1975_1982,1978.5,7,296249,302741,15356,30770,6492,15414,-8922,0.00310156243351134,0.00736406089805049,-0.00426249846453915,EPCI
200058519,CA Saint-Germain Boucles de Seine,1982_1990,1986,8,302741,313963,17407,35956,11222,18549,-7327,0.00456005179616525,0.00753737308564153,-0.00297732128947628,EPCI
200058519,CA Saint-Germain Boucles de Seine,1990_1999,1994.5,9,313963,315133,19887,41066,1170,21179,-20009,0.00041337734652136,0.00748283659997938,-0.00706945925345802,EPCI
200058519,CA Saint-Germain Boucles de Seine,1999_2010,2004.5,11,315133,332043,23404,52134,16910,28730,-11820,0.00476309917975271,0.00809248015578328,-0.00332938097603057,EPCI
200058782,CA de Saint-Quentin-en-Yvelines,2010_2015,2012.5,5,225850,228052,4825,18121,2202,13296,-11094,0.00194240623672903,0.0117285346610124,-0.00978612842428333,EPCI
200058782,CA de Saint-Quentin-en-Yvelines,1968_1975,1971.5,7,51393,109484,2740,12339,58091,9599,48492,0.11409174214002,0.0188526042382134,0.0952391379018069,EPCI
200058782,CA de Saint-Quentin-en-Yvelines,1975_1982,1978.5,7,109484,163605,3482,20541,54121,17059,37062,0.0590606824166302,0.0186159934470038,0.0404446889696264,EPCI
200058782,CA de Saint-Quentin-en-Yvelines,1982_1990,1986,8,163605,204010,5234,28803,40405,23569,16836,0.0279733610021973,0.0163173900621405,0.0116559709400568,EPCI
200058782,CA de Saint-Quentin-en-Yvelines,1990_1999,1994.5,9,204010,224259,6946,34022,20249,27076,-6827,0.0105702098354183,0.0141339819992981,-0.00356377216387975,EPCI
200058782,CA de Saint-Quentin-en-Yvelines,1999_2010,2004.5,11,224259,225850,9613,40846,1591,31233,-29642,0.000642881849810317,0.0126204455154781,-0.0119775636656678,EPCI
200059228,CA Grand Paris Sud Seine Essonne Sénart,2010_2015,2012.5,5,323637,346826,7497,30334,23189,22837,352,0.0139363572891911,0.013724808806471,0.00021154848272005,EPCI
200059228,CA Grand Paris Sud Seine Essonne Sénart,1968_1975,1971.5,7,93150,159073,5558,16883,65923,11325,54598,0.0794485433886953,0.0136485711189869,0.0657999722697084,EPCI
200059228,CA Grand Paris Sud Seine Essonne Sénart,1975_1982,1978.5,7,159073,204544,6793,22617,45471,15824,29647,0.036569940145821,0.0127264131615199,0.0238435269843011,EPCI
200059228,CA Grand Paris Sud Seine Essonne Sénart,1982_1990,1986,8,204544,271251,8925,34787,66707,25862,40845,0.035912504368012,0.01392311433531,0.0219893900327019,EPCI
200059228,CA Grand Paris Sud Seine Essonne Sénart,1990_1999,1994.5,9,271251,290802,11188,45106,19551,33918,-14367,0.00776309239175155,0.0134677800492777,-0.00570468765752619,EPCI
200059228,CA Grand Paris Sud Seine Essonne Sénart,1999_2010,2004.5,11,290802,323637,15291,60815,32835,45524,-12689,0.00977289074558052,0.01354959885189,-0.00377670810630946,EPCI
200059392,CC Bièvre Isère,2010_2015,2012.5,5,50794,53896,2196,3241,3102,1045,2057,0.0119261614984383,0.00401767851897744,0.00790848297946085,EPCI
200059392,CC Bièvre Isère,1968_1975,1971.5,7,30374,31844,2824,3044,1470,220,1250,0.00677455876808342,0.00101387954352269,0.00576067922456073,EPCI
200059392,CC Bièvre Isère,1975_1982,1978.5,7,31844,35949,2874,3087,4105,213,3892,0.0174726467407249,0.000906619672539441,0.0165660270681855,EPCI
200059392,CC Bièvre Isère,1982_1990,1986,8,35949,38495,3279,3597,2546,318,2228,0.00859007165240211,0.0010729154695459,0.00751715618285621,EPCI
200059392,CC Bièvre Isère,1990_1999,1994.5,9,38495,41195,3688,3828,2700,140,2560,0.00756049586511365,0.000392025711524411,0.00716847015358924,EPCI
200059392,CC Bièvre Isère,1999_2010,2004.5,11,41195,50794,4556,6479,9599,1923,7676,0.0192243946967792,0.00385128773850467,0.0153731069582745,EPCI
200059400,CC Porte Océane du Limousin,2010_2015,2012.5,5,25400,25699,1551,1157,299,-394,693,0.0023433226215539,-0.00308785656485698,0.00543117918641088,EPCI
200059400,CC Porte Océane du Limousin,1968_1975,1971.5,7,24948,24413,2311,2010,-535,-301,-234,-0.00309204993086254,-0.00173963930689649,-0.00135241062396605,EPCI
200059400,CC Porte Océane du Limousin,1975_1982,1978.5,7,24413,23994,2372,1740,-419,-632,213,-0.00247008405391769,-0.00372575924123145,0.00125567518731376,EPCI
200059400,CC Porte Océane du Limousin,1982_1990,1986,8,23994,24009,2588,1737,15,-851,866,7.81231714912511e-05,-0.00443218792927032,0.00451031110076157,EPCI
200059400,CC Porte Océane du Limousin,1990_1999,1994.5,9,24009,23655,2851,1785,-354,-1066,712,-0.00164911104955523,-0.00496596717182451,0.00331685612226928,EPCI
200059400,CC Porte Océane du Limousin,1999_2010,2004.5,11,23655,25400,3422,2634,1745,-788,2533,0.00649140250151192,-0.00293136112962258,0.0094227636311345,EPCI
200059889,CU Grand Paris Seine et Oise,2010_2015,2012.5,5,398509,408672,12024,33127,10163,21103,-10940,0.0050492639136448,0.0104845632558935,-0.00543529934224875,EPCI
200059889,CU Grand Paris Seine et Oise,1968_1975,1971.5,7,234847,310745,13220,37888,75898,24668,51230,0.040816484077596,0.013265975773092,0.027550508304504,EPCI
200059889,CU Grand Paris Seine et Oise,1975_1982,1978.5,7,310745,333553,14875,41035,22808,26160,-3352,0.0101698121753502,0.0116644285560839,-0.00149461638073368,EPCI
200059889,CU Grand Paris Seine et Oise,1982_1990,1986,8,333553,366365,17279,47987,32812,30708,2104,0.0117975903942551,0.0110410948990243,0.000756495495230792,EPCI
200059889,CU Grand Paris Seine et Oise,1990_1999,1994.5,9,366365,383452,20838,53634,17087,32796,-15709,0.00507777573632007,0.00974604863629384,-0.00466827289997378,EPCI
200059889,CU Grand Paris Seine et Oise,1999_2010,2004.5,11,383452,398509,26418,66425,15057,40007,-24950,0.0035075582873656,0.00931971072608325,-0.00581215243871765,EPCI
200060010,CA Mauges Communauté,2010_2015,2012.5,5,115702,120630,5033,8551,4928,3518,1410,0.00837690947429182,0.00598010704759712,0.0023968024266947,EPCI
200060010,CA Mauges Communauté,1968_1975,1971.5,7,88085,91344,6496,12157,3259,5661,-2402,0.00520354046878713,0.00903873660441974,-0.00383519613563261,EPCI
200060010,CA Mauges Communauté,1975_1982,1978.5,7,91344,97146,6396,11836,5802,5440,362,0.00883629765612759,0.00828498091163979,0.000551316744487796,EPCI
200060010,CA Mauges Communauté,1982_1990,1986,8,97146,100096,7218,12110,2950,4892,-1942,0.00374634054990741,0.0062125755831007,-0.00246623503319329,EPCI
200060010,CA Mauges Communauté,1990_1999,1994.5,9,100096,101125,8177,11196,1029,3019,-1990,0.00113705149743026,0.00333601406291736,-0.0021989625654871,EPCI
200060010,CA Mauges Communauté,1999_2010,2004.5,11,101125,115702,10612,17563,14577,6951,7626,0.0123171060734917,0.00587337616223096,0.00644372991126072,EPCI
200065563,CC Normandie-Cabourg-Pays d'Auge,2010_2015,2012.5,5,30761,31181,1543,1482,420,-61,481,0.00271593771339651,-0.000394457620279017,0.00311039533367553,EPCI
200065563,CC Normandie-Cabourg-Pays d'Auge,1968_1975,1971.5,7,22574,23367,1600,2562,793,962,-169,0.00494446501840717,0.00599820346495296,-0.00105373844654579,EPCI
200065563,CC Normandie-Cabourg-Pays d'Auge,1975_1982,1978.5,7,23367,24017,1686,2077,650,391,259,0.00392728340668791,0.00236241201848457,0.00156487138820334,EPCI
200065563,CC Normandie-Cabourg-Pays d'Auge,1982_1990,1986,8,24017,26063,1843,2637,2046,794,1252,0.0102717422389289,0.00398619908978961,0.00628554314913929,EPCI
200065563,CC Normandie-Cabourg-Pays d'Auge,1990_1999,1994.5,9,26063,28169,2142,2915,2106,773,1333,0.00867131306572366,0.00318277540351586,0.00548853766220781,EPCI
200065563,CC Normandie-Cabourg-Pays d'Auge,1999_2010,2004.5,11,28169,30761,2885,3751,2592,866,1726,0.00803442884814776,0.00268434235435801,0.00535008649378975,EPCI
200065589,CC Val Ès Dunes,2010_2015,2012.5,5,16351,17599,570,1159,1248,589,659,0.0148193384120956,0.00699406276019576,0.00782527565189984,EPCI
200065589,CC Val Ès Dunes,1968_1975,1971.5,7,8248,9046,558,1062,798,504,294,0.0132805454110059,0.0083877128911616,0.00489283251984427,EPCI
200065589,CC Val Ès Dunes,1975_1982,1978.5,7,9046,11276,566,1065,2230,499,1731,0.031979836801205,0.0071560262617943,0.0248238105394107,EPCI
200065589,CC Val Ès Dunes,1982_1990,1986,8,11276,13536,708,1481,2260,773,1487,0.0230972323123375,0.00790007105196323,0.0151971612603743,EPCI
200065589,CC Val Ès Dunes,1990_1999,1994.5,9,13536,14031,881,1497,495,616,-121,0.00399868064693831,0.0049761359161899,-0.000977455269251588,EPCI
200065589,CC Val Ès Dunes,1999_2010,2004.5,11,14031,16351,1061,2095,2320,1034,1286,0.0140081058821833,0.00624326788024892,0.00776483800193434,EPCI
200065597,CU Caen la Mer,2010_2015,2012.5,5,260602,264376,9923,14966,3774,5043,-1269,0.00287973710779887,0.00384804298744826,-0.000968305879649383,EPCI
200065597,CU Caen la Mer,1968_1975,1971.5,7,182789,216842,9911,30286,34053,20375,13678,0.0247054584187938,0.0147820666397358,0.00992339177905798,EPCI
200065597,CU Caen la Mer,1975_1982,1978.5,7,216842,227044,10231,27867,10202,17636,-7434,0.00658945175530734,0.0113910577491276,-0.00480160599382031,EPCI
200065597,CU Caen la Mer,1982_1990,1986,8,227044,240779,12318,30020,13735,17702,-3967,0.00736897688909277,0.00949731553627377,-0.002128338647181,EPCI
200065597,CU Caen la Mer,1990_1999,1994.5,9,240779,256981,14698,30420,16202,15722,480,0.00726209222835128,0.00704694568659047,0.000215146541760808,EPCI
200065597,CU Caen la Mer,1999_2010,2004.5,11,256981,260602,19859,36011,3621,16152,-12531,0.00127282636196657,0.00567762811336208,-0.0044048017513955,EPCI
200065647,CA Pays de Montbéliard Agglomération,2010_2015,2012.5,5,142575,140469,6094,9007,-2106,2913,-5019,-0.00297184593392341,0.00411063020205076,-0.00708247613597417,EPCI
200065647,CA Pays de Montbéliard Agglomération,1968_1975,1971.5,7,140400,160628,7573,20817,20228,13244,6984,0.0194139962337461,0.0127110424223716,0.00670295381137446,EPCI
200065647,CA Pays de Montbéliard Agglomération,1975_1982,1978.5,7,160628,158245,7628,19882,-2383,12254,-14637,-0.00213296022470244,0.0109682310505681,-0.0131011912752705,EPCI
200065647,CA Pays de Montbéliard Agglomération,1982_1990,1986,8,158245,148914,8632,18062,-9331,9430,-18761,-0.00756815455505655,0.00764845112572964,-0.0152166056807862,EPCI
200065647,CA Pays de Montbéliard Agglomération,1990_1999,1994.5,9,148914,144504,9885,16577,-4410,6692,-11102,-0.00333462433524256,0.00506016010236808,-0.00839478443761065,EPCI
200065647,CA Pays de Montbéliard Agglomération,1999_2010,2004.5,11,144504,142575,12695,20349,-1929,7654,-9583,-0.00122098233809509,0.00484468575208907,-0.00606566809018416,EPCI
200065787,CC de Pont-Audemer / Val de Risle,2010_2015,2012.5,5,26590,27878,1466,1684,1288,218,1070,0.00950542066592974,0.00160883672761854,0.0078965839383112,EPCI
200065787,CC de Pont-Audemer / Val de Risle,1968_1975,1971.5,7,21710,22741,1488,2892,1031,1404,-373,0.00665008266143419,0.00905598065630805,-0.00240589799487386,EPCI
200065787,CC de Pont-Audemer / Val de Risle,1975_1982,1978.5,7,22741,23693,1499,2549,952,1050,-98,0.00587579273699967,0.00648065375404376,-0.000604861017044084,EPCI
200065787,CC de Pont-Audemer / Val de Risle,1982_1990,1986,8,23693,24164,1853,2742,471,889,-418,0.00246356415096072,0.00464991195372416,-0.00218634780276344,EPCI
200065787,CC de Pont-Audemer / Val de Risle,1990_1999,1994.5,9,24164,24456,2232,2698,292,466,-174,0.00133552015960747,0.00213134381635987,-0.000795823656752398,EPCI
200065787,CC de Pont-Audemer / Val de Risle,1999_2010,2004.5,11,24456,26590,3101,3332,2134,231,1903,0.00763441472665827,0.000826405717834143,0.00680800900882413,EPCI
200065886,CA Loire Forez Agglomération Lfa,2010_2015,2012.5,5,102972,108187,4813,5954,5215,1141,4074,0.00992979742898048,0.00217255970593801,0.00775723772304247,EPCI
200065886,CA Loire Forez Agglomération Lfa,1968_1975,1971.5,7,71158,73504,7179,7478,2346,299,2047,0.00464462007668343,0.000591961382322397,0.00405265869436103,EPCI
200065886,CA Loire Forez Agglomération Lfa,1975_1982,1978.5,7,73504,79185,7117,6930,5681,-187,5868,0.0106920501174006,-0.000351947433894369,0.011043997551295,EPCI
200065886,CA Loire Forez Agglomération Lfa,1982_1990,1986,8,79185,86083,7651,8177,6898,526,6372,0.01049532610364,0.000800310456728711,0.0096950156469113,EPCI
200065886,CA Loire Forez Agglomération Lfa,1990_1999,1994.5,9,86083,90159,8373,8596,4076,223,3853,0.00515354865743234,0.00028195322635118,0.00487159543108116,EPCI
200065886,CA Loire Forez Agglomération Lfa,1999_2010,2004.5,11,90159,102972,10235,12633,12813,2398,10415,0.0121534721272838,0.00227456693680064,0.00987890519048316,EPCI
200065894,CC de Forez-Est,2010_2015,2012.5,5,60518,63070,2611,3432,2552,821,1731,0.00829509103139503,0.00266860099403422,0.00562649003736081,EPCI
200065894,CC de Forez-Est,1968_1975,1971.5,7,43408,44760,3830,4910,1352,1080,272,0.00439120284588834,0.00350776558695223,0.000883437258936116,EPCI
200065894,CC de Forez-Est,1975_1982,1978.5,7,44760,47856,3484,4345,3096,861,2235,0.00960030703529857,0.00266985282861501,0.00693045420668356,EPCI
200065894,CC de Forez-Est,1982_1990,1986,8,47856,51488,4076,4935,3632,859,2773,0.0091859680097246,0.00217256236793872,0.00701340564178588,EPCI
200065894,CC de Forez-Est,1990_1999,1994.5,9,51488,54444,4804,5318,2956,514,2442,0.00622192958359324,0.00108189167996175,0.0051400379036315,EPCI
200065894,CC de Forez-Est,1999_2010,2004.5,11,54444,60518,5764,7563,6074,1799,4275,0.00966166550915259,0.00286159635346815,0.00680006915568445,EPCI
200065928,CA Lannion-Trégor Communauté,2010_2015,2012.5,5,100953,100135,6475,4342,-818,-2133,1315,-0.00162583418569251,-0.00423949183139624,0.00261365764570373,EPCI
200065928,CA Lannion-Trégor Communauté,1968_1975,1971.5,7,82255,88338,8120,9131,6083,1011,5072,0.0102444311139447,0.00170263354532272,0.00854179756862197,EPCI
200065928,CA Lannion-Trégor Communauté,1975_1982,1978.5,7,88338,91295,8498,8102,2957,-396,3353,0.00471474466549293,-0.000631396309616233,0.00534614097510916,EPCI
200065928,CA Lannion-Trégor Communauté,1982_1990,1986,8,91295,91357,9680,8170,62,-1510,1572,8.48644322832826e-05,-0.00206685956044769,0.00215172399273097,EPCI
200065928,CA Lannion-Trégor Communauté,1990_1999,1994.5,9,91357,93105,10638,8218,1748,-2420,4168,0.00210810563595598,-0.0029185444159116,0.00502665005186758,EPCI
200065928,CA Lannion-Trégor Communauté,1999_2010,2004.5,11,93105,100953,13500,11157,7848,-2343,10191,0.0073841450996095,-0.00220451732522745,0.00958866242483695,EPCI
200066009,CA Mulhouse Alsace Agglomération,2010_2015,2012.5,5,268619,272985,11162,18425,4366,7263,-2897,0.00322977048094719,0.00537284081610615,-0.00214307033515896,EPCI
200066009,CA Mulhouse Alsace Agglomération,1968_1975,1971.5,7,220406,243743,17203,28462,23337,11259,12078,0.0144814390795402,0.00698661021538945,0.0074948288641508,EPCI
200066009,CA Mulhouse Alsace Agglomération,1975_1982,1978.5,7,243743,248488,16810,27612,4745,10802,-6057,0.00275810561042822,0.00627883178163237,-0.00352072617120416,EPCI
200066009,CA Mulhouse Alsace Agglomération,1982_1990,1986,8,248488,253338,18269,32023,4850,13754,-8904,0.00241917284572568,0.0068604749113631,-0.00444130206563742,EPCI
200066009,CA Mulhouse Alsace Agglomération,1990_1999,1994.5,9,253338,261570,19508,32615,8232,13107,-4875,0.00355936048927896,0.00566721792188768,-0.00210785743260871,EPCI
200066009,CA Mulhouse Alsace Agglomération,1999_2010,2004.5,11,261570,268619,23201,39933,7049,16732,-9683,0.00242038665748257,0.00574519925563885,-0.00332481259815629,EPCI
200066017,CC Lieuvin Pays d'Auge,2010_2015,2012.5,5,17402,18509,707,1090,1107,383,724,0.0124107739546679,0.00429388114240092,0.00811689281226702,EPCI
200066017,CC Lieuvin Pays d'Auge,1968_1975,1971.5,7,14574,14142,1080,1656,-432,576,-1008,-0.00428934950190607,0.00571913266920809,-0.0100084821711142,EPCI
200066017,CC Lieuvin Pays d'Auge,1975_1982,1978.5,7,14142,14454,1011,1249,312,238,74,0.00312230708947903,0.00238175989517951,0.000740547194299513,EPCI
200066017,CC Lieuvin Pays d'Auge,1982_1990,1986,8,14454,14720,1156,1372,266,216,50,0.00228209006764035,0.00185312576921171,0.000428964298428638,EPCI
200066017,CC Lieuvin Pays d'Auge,1990_1999,1994.5,9,14720,15143,1172,1491,423,319,104,0.00315287830643718,0.00237770255260865,0.000775175753828526,EPCI
200066017,CC Lieuvin Pays d'Auge,1999_2010,2004.5,11,15143,17402,1473,2155,2259,682,1577,0.0127208451021672,0.00384046762269944,0.00888037747946776,EPCI
200066025,CC Pays Rhin - Brisach,2010_2015,2012.5,5,32353,32935,1012,1702,582,690,-108,0.00357219909775175,0.00423508140455104,-0.000662882306799294,EPCI
200066025,CC Pays Rhin - Brisach,1968_1975,1971.5,7,16471,20416,1275,2403,3945,1128,2817,0.0311492426186009,0.00890655150159234,0.0222426911170085,EPCI
200066025,CC Pays Rhin - Brisach,1975_1982,1978.5,7,20416,23147,1223,2311,2731,1088,1643,0.0180969834356159,0.00720963675501653,0.0108873466805994,EPCI
200066025,CC Pays Rhin - Brisach,1982_1990,1986,8,23147,25131,1377,2785,1984,1408,576,0.0103326369710957,0.00733283914077756,0.00299979783031809,EPCI
200066025,CC Pays Rhin - Brisach,1990_1999,1994.5,9,25131,28136,1478,2818,3005,1340,1665,0.0126288287215746,0.00563149101061894,0.00699733771095562,EPCI
200066025,CC Pays Rhin - Brisach,1999_2010,2004.5,11,28136,32353,1923,3898,4217,1975,2242,0.0127770152890083,0.00598401830585521,0.00679299698315311,EPCI
200066033,CC Sud Alsace Largue,2010_2015,2012.5,5,21670,22166,868,1168,496,300,196,0.004536412065417,0.00274379762021189,0.0017926144452051,EPCI
200066033,CC Sud Alsace Largue,1968_1975,1971.5,7,14508,15354,1211,1556,846,345,501,0.00812940921768357,0.00331518461004826,0.00481422460763531,EPCI
200066033,CC Sud Alsace Largue,1975_1982,1978.5,7,15354,16234,1215,1374,880,159,721,0.00799346161322734,0.00144427317784448,0.00654918843538285,EPCI
200066033,CC Sud Alsace Largue,1982_1990,1986,8,16234,17217,1322,1699,983,377,606,0.00737575026233417,0.00282874654008136,0.0045470037222528,EPCI
200066033,CC Sud Alsace Largue,1990_1999,1994.5,9,17217,18697,1308,1916,1480,608,872,0.00920497596547931,0.00378150363987258,0.00542347232560673,EPCI
200066033,CC Sud Alsace Largue,1999_2010,2004.5,11,18697,21670,1567,2577,2973,1010,1963,0.0135054523089242,0.00458812876959752,0.00891732353932667,EPCI
200066041,CC Sundgau,2010_2015,2012.5,5,47563,47482,1888,2352,-81,464,-545,-0.000340833142532637,0.00195242689055733,-0.00229326003308997,EPCI
200066041,CC Sundgau,1968_1975,1971.5,7,34841,36252,2980,3803,1411,823,588,0.0056874981781081,0.00331737136823739,0.0023701268098707,EPCI
200066041,CC Sundgau,1975_1982,1978.5,7,36252,38076,3023,3241,1824,218,1606,0.00703744873057466,0.000841098587316489,0.00619635014325817,EPCI
200066041,CC Sundgau,1982_1990,1986,8,38076,39895,3151,4004,1819,853,966,0.00585040219318045,0.00274348162220062,0.00310692057097983,EPCI
200066041,CC Sundgau,1990_1999,1994.5,9,39895,43144,3281,4452,3249,1171,2078,0.00873709815392232,0.00314901260025948,0.00558808555366284,EPCI
200066041,CC Sundgau,1999_2010,2004.5,11,43144,47563,3731,5596,4419,1865,2554,0.0089041160691925,0.00375790370424169,0.00514621236495082,EPCI
200066058,CA Saint-Louis Agglomération,2010_2015,2012.5,5,73554,77647,2565,4040,4093,1475,2618,0.010889480167936,0.0039242568403874,0.00696522332754861,EPCI
200066058,CA Saint-Louis Agglomération,1968_1975,1971.5,7,46558,54601,3515,4840,8043,1325,6718,0.0230258590837744,0.00379326908939464,0.0192325899943798,EPCI
200066058,CA Saint-Louis Agglomération,1975_1982,1978.5,7,54601,57851,3710,5248,3250,1538,1712,0.00829399790387164,0.00392497500804756,0.00436902289582408,EPCI
200066058,CA Saint-Louis Agglomération,1982_1990,1986,8,57851,61123,4099,6102,3272,2003,1269,0.00690088812808987,0.00422447399772739,0.00267641413036248,EPCI
200066058,CA Saint-Louis Agglomération,1990_1999,1994.5,9,61123,65923,4424,6969,4800,2545,2255,0.00843528563881768,0.00447245873974812,0.00396282689906956,EPCI
200066058,CA Saint-Louis Agglomération,1999_2010,2004.5,11,65923,73554,5251,8524,7631,3273,4358,0.0100072349939553,0.00429218714915681,0.00571504784479847,EPCI
200066108,CC Haute Saulx et Perthois-Val d'Ornois,2010_2015,2012.5,5,17536,17060,824,834,-476,10,-486,-0.00548875517694436,0.000115309982708915,-0.00560406515965328,EPCI
200066108,CC Haute Saulx et Perthois-Val d'Ornois,1968_1975,1971.5,7,18937,18418,1588,2052,-519,464,-983,-0.00396202082820263,0.00354215349573414,-0.00750417432393677,EPCI
200066108,CC Haute Saulx et Perthois-Val d'Ornois,1975_1982,1978.5,7,18418,18690,1595,1785,272,190,82,0.00209650519569671,0.00146447054111167,0.000632034654585037,EPCI
200066108,CC Haute Saulx et Perthois-Val d'Ornois,1982_1990,1986,8,18690,18667,1559,2025,-23,466,-489,-0.00015390845700447,0.00311831917235144,-0.00327222762935591,EPCI
200066108,CC Haute Saulx et Perthois-Val d'Ornois,1990_1999,1994.5,9,18667,17570,1609,1671,-1097,62,-1159,-0.006706781457127,0.000379052370411918,-0.00708583382753892,EPCI
200066108,CC Haute Saulx et Perthois-Val d'Ornois,1999_2010,2004.5,11,17570,17536,1848,2117,-34,269,-303,-0.000176074627352141,0.00139306102228605,-0.0015691356496382,EPCI
200066116,CC Argonne-Meuse,2010_2015,2012.5,5,7526,7322,516,348,-204,-168,-36,-0.00548095992283171,-0.00451373170115552,-0.000967228221676184,EPCI
200066116,CC Argonne-Meuse,1968_1975,1971.5,7,8856,8119,949,794,-737,-155,-582,-0.0123358816496251,-0.0025943848788221,-0.00974149677080297,EPCI
200066116,CC Argonne-Meuse,1975_1982,1978.5,7,8119,7766,906,647,-353,-259,-94,-0.0063301315589499,-0.00464448746109922,-0.00168564409785068,EPCI
200066116,CC Argonne-Meuse,1982_1990,1986,8,7766,7652,913,785,-114,-128,14,-0.00184681500103723,-0.00207361684326987,0.000226801842232642,EPCI
200066116,CC Argonne-Meuse,1990_1999,1994.5,9,7652,7507,987,766,-145,-221,76,-0.00212342378218966,-0.00323639073009596,0.0011129669479063,EPCI
200066116,CC Argonne-Meuse,1999_2010,2004.5,11,7507,7526,1091,966,19,-125,144,0.00022982400370708,-0.00151200002438868,0.00174182402809576,EPCI
200066124,CA Gaillac-Graulhet,2010_2015,2012.5,5,67149,72973,3628,4070,5824,442,5382,0.0167742294141295,0.00127304419660805,0.0155011852175215,EPCI
200066124,CA Gaillac-Graulhet,1968_1975,1971.5,7,54355,55826,4991,5246,1471,255,1216,0.00382201463086918,0.00066255182248242,0.00315946280838676,EPCI
200066124,CA Gaillac-Graulhet,1975_1982,1978.5,7,55826,55536,4728,4161,-290,-567,277,-0.00074375921214187,-0.00145417749408428,0.000710418281942407,EPCI
200066124,CA Gaillac-Graulhet,1982_1990,1986,8,55536,56808,5399,4709,1272,-690,1962,0.0028347229703598,-0.00153770349807254,0.00437242646843234,EPCI
200066124,CA Gaillac-Graulhet,1990_1999,1994.5,9,56808,58329,6050,5257,1521,-793,2314,0.00294011768199565,-0.00153288186839089,0.00447299955038654,EPCI
200066124,CA Gaillac-Graulhet,1999_2010,2004.5,11,58329,67149,7532,7823,8820,291,8529,0.0128836181533538,0.000425071755399769,0.012458546397954,EPCI
200066132,CC du Pays de Stenay et du Val Dunois,2010_2015,2012.5,5,10284,10132,677,573,-152,-104,-48,-0.0029736812778729,-0.00203462403222882,-0.000939057245644073,EPCI
200066132,CC du Pays de Stenay et du Val Dunois,1968_1975,1971.5,7,13367,12361,1180,1459,-1006,279,-1285,-0.0111152819385263,0.00308266765491932,-0.0141979495934456,EPCI
200066132,CC du Pays de Stenay et du Val Dunois,1975_1982,1978.5,7,12361,11685,1178,1074,-676,-104,-572,-0.00800215193391485,-0.00123110029752536,-0.00677105163638949,EPCI
200066132,CC du Pays de Stenay et du Val Dunois,1982_1990,1986,8,11685,10928,1178,1040,-757,-138,-619,-0.0083372588130558,-0.00151987016671295,-0.00681738864634286,EPCI
200066132,CC du Pays de Stenay et du Val Dunois,1990_1999,1994.5,9,10928,10368,1397,1078,-560,-319,-241,-0.00582785878651182,-0.0033197981301737,-0.00250806065633812,EPCI
200066132,CC du Pays de Stenay et du Val Dunois,1999_2010,2004.5,11,10368,10284,1655,1165,-84,-490,406,-0.000739258450662028,-0.00431234096219516,0.00357308251153314,EPCI
200066140,CC de l'Aire à l'Argonne,2010_2015,2012.5,5,6566,6596,300,381,30,81,-51,0.000912132863983395,0.00246275873275517,-0.00155062586877177,EPCI
200066140,CC de l'Aire à l'Argonne,1968_1975,1971.5,7,7682,6710,748,585,-972,-163,-809,-0.0191403070232693,-0.00320974284443714,-0.0159305641788322,EPCI
200066140,CC de l'Aire à l'Argonne,1975_1982,1978.5,7,6710,6448,663,511,-262,-152,-110,-0.00567369286123287,-0.00329160807216564,-0.00238208478906724,EPCI
200066140,CC de l'Aire à l'Argonne,1982_1990,1986,8,6448,6556,708,662,108,-46,154,0.00207848902953311,-0.000885282364430771,0.00296377139396389,EPCI
200066140,CC de l'Aire à l'Argonne,1990_1999,1994.5,9,6556,6428,698,646,-128,-52,-76,-0.00218840339119997,-0.000889038877674986,-0.00129936451352498,EPCI
200066140,CC de l'Aire à l'Argonne,1999_2010,2004.5,11,6428,6566,706,789,138,83,55,0.00193289939217634,0.00116254093877272,0.000770358453403612,EPCI
200066157,CC de Commercy - Void - Vaucouleurs,2010_2015,2012.5,5,23515,23037,1256,1397,-478,141,-619,-0.00409895553095874,0.00120910612942507,-0.0053080616603838,EPCI
200066157,CC de Commercy - Void - Vaucouleurs,1968_1975,1971.5,7,25246,23294,2190,2678,-1952,488,-2440,-0.0114301608623313,0.00285754021558282,-0.0142877010779141,EPCI
200066157,CC de Commercy - Void - Vaucouleurs,1975_1982,1978.5,7,23294,22845,2051,2310,-449,259,-708,-0.00277664392579169,0.00160167210864153,-0.00437831603443322,EPCI
200066157,CC de Commercy - Void - Vaucouleurs,1982_1990,1986,8,22845,22544,2035,2635,-301,600,-901,-0.0016565414005183,0.00330207588143182,-0.00495861728195012,EPCI
200066157,CC de Commercy - Void - Vaucouleurs,1990_1999,1994.5,9,22544,22414,2266,2388,-130,122,-252,-0.000642370427994643,0.00060283994011805,-0.00124521036811269,EPCI
200066157,CC de Commercy - Void - Vaucouleurs,1999_2010,2004.5,11,22414,23515,2725,3301,1101,576,525,0.00436885681946597,0.00228561446685958,0.00208324235260639,EPCI
200066165,CC Val de Meuse - Voie Sacrée,2010_2015,2012.5,5,8729,9055,345,550,326,205,121,0.00736020927869996,0.00462835246053218,0.00273185681816778,EPCI
200066165,CC Val de Meuse - Voie Sacrée,1968_1975,1971.5,7,8007,7671,645,817,-336,172,-508,-0.00610545323833334,0.00312541058628968,-0.00923086382462302,EPCI
200066165,CC Val de Meuse - Voie Sacrée,1975_1982,1978.5,7,7671,8225,623,781,554,158,396,0.0100113980156167,0.00285523625716144,0.00715616175845524,EPCI
200066165,CC Val de Meuse - Voie Sacrée,1982_1990,1986,8,8225,8445,636,893,220,257,-37,0.00330498114765643,0.00386081888612592,-0.00055583773846949,EPCI
200066165,CC Val de Meuse - Voie Sacrée,1990_1999,1994.5,9,8445,8387,729,904,-58,175,-233,-0.000765447146584886,0.00230953880435095,-0.00307498595093583,EPCI
200066165,CC Val de Meuse - Voie Sacrée,1999_2010,2004.5,11,8387,8729,878,1143,342,265,77,0.0036400569514905,0.00282051196533621,0.000819544986154294,EPCI
200066173,CC de Damvillers Spincourt,2010_2015,2012.5,5,8342,8385,338,468,43,130,-87,0.00102880876111699,0.00311035206849324,-0.00208154330737625,EPCI
200066173,CC de Damvillers Spincourt,1968_1975,1971.5,7,9396,8514,833,874,-882,41,-923,-0.0139830587875925,0.000650006134117114,-0.0146330649217097,EPCI
200066173,CC de Damvillers Spincourt,1975_1982,1978.5,7,8514,7897,816,666,-617,-150,-467,-0.0106894469844827,-0.00259873103350471,-0.008090715950978,EPCI
200066173,CC de Damvillers Spincourt,1982_1990,1986,8,7897,7190,733,690,-707,-43,-664,-0.011655513142863,-0.000708892595676247,-0.0109466205471867,EPCI
200066173,CC de Damvillers Spincourt,1990_1999,1994.5,9,7190,7138,682,669,-52,-13,-39,-0.000806180047106198,-0.000201545011776549,-0.000604635035329648,EPCI
200066173,CC de Damvillers Spincourt,1999_2010,2004.5,11,7138,8342,787,1089,1204,302,902,0.0142709045126195,0.00357957903887964,0.0106913254737398,EPCI
200066223,CC Arize Lèze,2010_2015,2012.5,5,10734,10683,737,498,-51,-239,188,-0.000952062658661545,-0.00446162696902175,0.00350956431036021,EPCI
200066223,CC Arize Lèze,1968_1975,1971.5,7,9863,9265,1002,681,-598,-321,-277,-0.00889541703656171,-0.00477496466343865,-0.00412045237312307,EPCI
200066223,CC Arize Lèze,1975_1982,1978.5,7,9265,8611,1024,525,-654,-499,-155,-0.0104031382564298,-0.00793756267577748,-0.00246557558065232,EPCI
200066223,CC Arize Lèze,1982_1990,1986,8,8611,8923,1067,575,312,-492,804,0.00445888100896719,-0.00703131236029441,0.0114901933692616,EPCI
200066223,CC Arize Lèze,1990_1999,1994.5,9,8923,9325,1317,699,402,-618,1020,0.0049083123390532,-0.00754561449138029,0.0124539268304335,EPCI
200066223,CC Arize Lèze,1999_2010,2004.5,11,9325,10734,1631,1060,1409,-571,1980,0.0128746563995699,-0.0052174796338924,0.0180921360334623,EPCI
200066231,CC des Portes d'Ariège Pyrénées,2010_2015,2012.5,5,37479,38899,1961,2334,1420,373,1047,0.00746528074616104,0.00196095050585779,0.00550433024030325,EPCI
200066231,CC des Portes d'Ariège Pyrénées,1968_1975,1971.5,7,28715,29335,2681,2640,620,-41,661,0.00305633367316238,-0.000202112388063964,0.00325844606122635,EPCI
200066231,CC des Portes d'Ariège Pyrénées,1975_1982,1978.5,7,29335,28949,2540,2065,-386,-475,89,-0.00189045102362462,-0.00232633221819092,0.000435881194566298,EPCI
200066231,CC des Portes d'Ariège Pyrénées,1982_1990,1986,8,28949,29602,3004,2496,653,-508,1161,0.00279217406538379,-0.00217216604167682,0.00496434010706061,EPCI
200066231,CC des Portes d'Ariège Pyrénées,1990_1999,1994.5,9,29602,30740,3386,2968,1138,-418,1556,0.00420021980035101,-0.00154278723773877,0.00574300703808979,EPCI
200066231,CC des Portes d'Ariège Pyrénées,1999_2010,2004.5,11,30740,37479,4117,4386,6739,269,6470,0.0181829731225756,0.000725807949246598,0.017457165173329,EPCI
200066280,CC du Pithiverais,2010_2015,2012.5,5,28116,29371,1179,1859,1255,680,575,0.00877204761324157,0.00475298197370858,0.00401906563953299,EPCI
200066280,CC du Pithiverais,1968_1975,1971.5,7,21508,23266,1775,2557,1758,782,976,0.0112872410812486,0.00502083192578861,0.00626640915545996,EPCI
200066280,CC du Pithiverais,1975_1982,1978.5,7,23266,24006,1820,2257,740,437,303,0.00448298029778904,0.00264738160828893,0.00183559868950011,EPCI
200066280,CC du Pithiverais,1982_1990,1986,8,24006,25443,1966,2543,1437,577,860,0.00729357662105357,0.00292859687567704,0.00436497974537653,EPCI
200066280,CC du Pithiverais,1990_1999,1994.5,9,25443,26636,2131,3014,1193,883,310,0.00510443102256541,0.00377804911393568,0.00132638190862974,EPCI
200066280,CC du Pithiverais,1999_2010,2004.5,11,26636,28116,2473,3936,1480,1463,17,0.00492802342173815,0.00487141774729926,5.66056744388836e-05,EPCI
200066322,CC Terres des Confluences,2010_2015,2012.5,5,38332,40683,1996,2406,2351,410,1941,0.0119761988426184,0.00208857572329797,0.00988762311932039,EPCI
200066322,CC Terres des Confluences,1968_1975,1971.5,7,33053,31977,2807,3344,-1076,537,-1613,-0.00471676088867579,0.00235399683756403,-0.00707075772623982,EPCI
200066322,CC Terres des Confluences,1975_1982,1978.5,7,31977,31743,2709,2613,-234,-96,-138,-0.00104868771159128,-0.000430230856037448,-0.000618456855553831,EPCI
200066322,CC Terres des Confluences,1982_1990,1986,8,31743,33615,2933,3017,1872,84,1788,0.00718823312070538,0.000322548922082934,0.00686568419862245,EPCI
200066322,CC Terres des Confluences,1990_1999,1994.5,9,33615,34285,3302,3501,670,199,471,0.00219524434110285,0.00065202033414846,0.00154322400695439,EPCI
200066322,CC Terres des Confluences,1999_2010,2004.5,11,34285,38332,4081,4786,4047,705,3342,0.0101949925589386,0.00177599944503379,0.00841899311390485,EPCI
200066330,CC Terres du Haut-Berry,2010_2015,2012.5,5,24187,24783,1089,1317,596,228,368,0.00488039763560977,0.00186699775321984,0.00301339988238992,EPCI
200066330,CC Terres du Haut-Berry,1968_1975,1971.5,7,17162,18048,1738,1631,886,-107,993,0.00721695156249447,-0.000871573157095833,0.0080885247195903,EPCI
200066330,CC Terres du Haut-Berry,1975_1982,1978.5,7,18048,20289,1704,1450,2241,-254,2495,0.0168611413966309,-0.00191107983701216,0.018772221233643,EPCI
200066330,CC Terres du Haut-Berry,1982_1990,1986,8,20289,22662,1963,2035,2373,72,2301,0.0139223564735893,0.000422422952422431,0.0134999335211669,EPCI
200066330,CC Terres du Haut-Berry,1990_1999,1994.5,9,22662,23098,1930,2084,436,154,282,0.00211963444845997,0.000748678222621183,0.00137095622583879,EPCI
200066330,CC Terres du Haut-Berry,1999_2010,2004.5,11,23098,24187,2301,2853,1089,552,537,0.00419689741438356,0.00212735295935696,0.0020695444550266,EPCI
200066348,CC Minervois Saint-Ponais Orb-Jaur,2010_2015,2012.5,5,14498,14695,977,590,197,-387,584,0.00270296463803588,-0.00530988484730906,0.00801284948534493,EPCI
200066348,CC Minervois Saint-Ponais Orb-Jaur,1968_1975,1971.5,7,15948,14248,1804,943,-1700,-861,-839,-0.0159734611652971,-0.00809008827254164,-0.00788337289275544,EPCI
200066348,CC Minervois Saint-Ponais Orb-Jaur,1975_1982,1978.5,7,14248,13803,1663,796,-445,-867,422,-0.00452268260738475,-0.00881160858562378,0.00428892597823903,EPCI
200066348,CC Minervois Saint-Ponais Orb-Jaur,1982_1990,1986,8,13803,13477,1725,1025,-326,-700,374,-0.00298322021071651,-0.00640568756902318,0.00342246735830667,EPCI
200066348,CC Minervois Saint-Ponais Orb-Jaur,1990_1999,1994.5,9,13477,13582,1695,1025,105,-670,775,0.000862689447618914,-0.0055047802848064,0.00636746973242532,EPCI
200066348,CC Minervois Saint-Ponais Orb-Jaur,1999_2010,2004.5,11,13582,14498,2146,1212,916,-934,1850,0.00595084746777186,-0.0060677855184486,0.0120186329862205,EPCI
200066355,CA du Bassin de Thau,2010_2015,2012.5,5,119534,124878,6508,6674,5344,166,5178,0.0087856514612894,0.000272907586559514,0.00851274387472989,EPCI
200066355,CA du Bassin de Thau,1968_1975,1971.5,7,71995,74209,6086,7342,2214,1256,958,0.00433634118672077,0.00246000204630591,0.00187633914041486,EPCI
200066355,CA du Bassin de Thau,1975_1982,1978.5,7,74209,81149,6361,6366,6940,5,6935,0.0128535535851988,9.26048529192997e-06,0.0128442930999069,EPCI
200066355,CA du Bassin de Thau,1982_1990,1986,8,81149,91381,7616,8022,10232,406,9826,0.0149545427728546,0.000593387838719601,0.014361154934135,EPCI
200066355,CA du Bassin de Thau,1990_1999,1994.5,9,91381,100231,9136,10128,8850,992,7858,0.0103240335926578,0.00115722500835215,0.00916680858430562,EPCI
200066355,CA du Bassin de Thau,1999_2010,2004.5,11,100231,119534,12640,14468,19303,1828,17475,0.0161400779068661,0.00152847031102685,0.0146116075958393,EPCI
200066363,CC de la Haute Ariège,2010_2015,2012.5,5,7575,7226,469,250,-349,-219,-130,-0.00938918744887085,-0.00589178238195621,-0.00349740506691464,EPCI
200066363,CC de la Haute Ariège,1968_1975,1971.5,7,9160,8290,1039,602,-870,-437,-433,-0.0141554572490874,-0.00711026990557608,-0.00704518734351132,EPCI
200066363,CC de la Haute Ariège,1975_1982,1978.5,7,8290,8129,948,476,-161,-472,311,-0.00279780089430071,-0.00820224858453375,0.00540444769023304,EPCI
200066363,CC de la Haute Ariège,1982_1990,1986,8,8129,7481,1064,671,-648,-393,-255,-0.0103302033569074,-0.00626507703590216,-0.00406512632100522,EPCI
200066363,CC de la Haute Ariège,1990_1999,1994.5,9,7481,7536,876,634,55,-242,297,0.000814227345903973,-0.00358260032197748,0.00439682766788145,EPCI
200066363,CC de la Haute Ariège,1999_2010,2004.5,11,7536,7575,1036,692,39,-344,383,0.000469365946955902,-0.00414004835263667,0.00460941429959258,EPCI
200066371,CC Causses et Vallée de la Dordogne,2010_2015,2012.5,5,46261,45518,2871,1886,-743,-985,242,-0.00323304669171121,-0.00428607132077461,0.00105302462906341,EPCI
200066371,CC Causses et Vallée de la Dordogne,1968_1975,1971.5,7,41097,40546,4226,3407,-551,-819,268,-0.00192642692333278,-0.00286341860292114,0.000936991679588358,EPCI
200066371,CC Causses et Vallée de la Dordogne,1975_1982,1978.5,7,40546,41353,4237,3040,807,-1197,2004,0.00281937243059405,-0.00418189442307444,0.00700126685366849,EPCI
200066371,CC Causses et Vallée de la Dordogne,1982_1990,1986,8,41353,41500,4741,3334,147,-1407,1554,0.000443655512021746,-0.00424641704363671,0.00469007255565845,EPCI
200066371,CC Causses et Vallée de la Dordogne,1990_1999,1994.5,9,41500,42737,5040,3485,1237,-1555,2792,0.00326884531963989,-0.00410917903964432,0.00737802435928422,EPCI
200066371,CC Causses et Vallée de la Dordogne,1999_2010,2004.5,11,42737,46261,6289,4300,3524,-1989,5513,0.00722911552554817,-0.00408022439850037,0.0113093399240485,EPCI
200066389,CA Saint-Lô Agglo,2010_2015,2012.5,5,74363,76336,3596,4377,1973,781,1192,0.00525096674677039,0.00207856311668914,0.00317240363008125,EPCI
200066389,CA Saint-Lô Agglo,1968_1975,1971.5,7,64476,68491,4047,8486,4015,4439,-424,0.0086672432428585,0.00958253866875439,-0.000915295425895891,EPCI
200066389,CA Saint-Lô Agglo,1975_1982,1978.5,7,68491,71129,4067,8222,2638,4155,-1517,0.00541356928189085,0.00852667944134059,-0.00311311015944974,EPCI
200066389,CA Saint-Lô Agglo,1982_1990,1986,8,71129,71267,4788,7907,138,3119,-2981,0.000242311515120441,0.00547659141783085,-0.0052342799027104,EPCI
200066389,CA Saint-Lô Agglo,1990_1999,1994.5,9,71267,70937,5369,7403,-330,2034,-2364,-0.000515559052362113,0.00317771852274103,-0.00369327757510314,EPCI
200066389,CA Saint-Lô Agglo,1999_2010,2004.5,11,70937,74363,6999,9208,3426,2209,1217,0.00429705571892258,0.00277063516727962,0.00152642055164296,EPCI
200066405,CC Roumois Seine,2010_2015,2012.5,5,48212,51272,1754,2985,3060,1231,1829,0.0123834156128904,0.00498169432008759,0.00740172129280277,EPCI
200066405,CC Roumois Seine,1968_1975,1971.5,7,25574,29930,1850,3081,4356,1231,3125,0.0227236377434887,0.00642167081318518,0.0163019669303036,EPCI
200066405,CC Roumois Seine,1975_1982,1978.5,7,29930,36693,1840,2820,6763,980,5783,0.029531171806565,0.00427924713447193,0.025251924672093,EPCI
200066405,CC Roumois Seine,1982_1990,1986,8,36693,40382,2233,3696,3689,1463,2226,0.0120467520685168,0.00477755442565467,0.00726919764286213,EPCI
200066405,CC Roumois Seine,1990_1999,1994.5,9,40382,42056,2592,3888,1674,1296,378,0.00452330187254546,0.00350191112713197,0.00102139074541349,EPCI
200066405,CC Roumois Seine,1999_2010,2004.5,11,42056,48212,3615,5908,6156,2293,3863,0.0124961496746057,0.00465459246326686,0.0078415572113388,EPCI
200066413,CC Intercom Bernay Terres de Normandie,2010_2015,2012.5,5,55031,55876,3056,3202,845,146,699,0.00305230623982822,0.00052738072309458,0.00252492551673364,EPCI
200066413,CC Intercom Bernay Terres de Normandie,1968_1975,1971.5,7,47229,48584,3754,5942,1355,2188,-833,0.00404905362743135,0.00653825043307734,-0.00248919680564599,EPCI
200066413,CC Intercom Bernay Terres de Normandie,1975_1982,1978.5,7,48584,50057,3783,4910,1473,1127,346,0.0042759871306377,0.00327158010606157,0.00100440702457613,EPCI
200066413,CC Intercom Bernay Terres de Normandie,1982_1990,1986,8,50057,50097,4332,5391,40,1059,-1019,9.98512269061447e-05,0.00264356123234018,-0.00254371000543404,EPCI
200066413,CC Intercom Bernay Terres de Normandie,1990_1999,1994.5,9,50097,51347,4558,5379,1250,821,429,0.00274212900127724,0.00180103032803889,0.000941098673238348,EPCI
200066413,CC Intercom Bernay Terres de Normandie,1999_2010,2004.5,11,51347,55031,6269,6874,3684,605,3079,0.00631898569414369,0.0010377270208895,0.00528125867325418,EPCI
200066462,CC Interco Normandie Sud Eure,2010_2015,2012.5,5,37836,39235,2230,2271,1399,41,1358,0.00728806465279286,0.000213588742505009,0.00707447591028785,EPCI
200066462,CC Interco Normandie Sud Eure,1968_1975,1971.5,7,30402,31711,2636,3504,1309,868,441,0.00604034520038721,0.00400536259277013,0.00203498260761708,EPCI
200066462,CC Interco Normandie Sud Eure,1975_1982,1978.5,7,31711,32405,2738,3035,694,297,397,0.00309751714176421,0.00132559451167719,0.00177192263008702,EPCI
200066462,CC Interco Normandie Sud Eure,1982_1990,1986,8,32405,33858,3048,3453,1453,405,1048,0.00549788021854947,0.00153244424536307,0.0039654359731864,EPCI
200066462,CC Interco Normandie Sud Eure,1990_1999,1994.5,9,33858,35156,3477,3711,1298,234,1064,0.0041887475469331,0.000755136306611977,0.00343361124032113,EPCI
200066462,CC Interco Normandie Sud Eure,1999_2010,2004.5,11,35156,37836,4561,4925,2680,364,2316,0.00670105496384466,0.000910143286134125,0.00579091167771053,EPCI
200066512,CC Élan Limousin Avenir Nature,2010_2015,2012.5,5,27392,27882,1587,1448,490,-139,629,0.00355235859711045,-0.00100770988775174,0.00456006848486219,EPCI
200066512,CC Élan Limousin Avenir Nature,1968_1975,1971.5,7,24408,22971,2341,1705,-1437,-636,-801,-0.00863088061578421,-0.00381993046043059,-0.00481095015535362,EPCI
200066512,CC Élan Limousin Avenir Nature,1975_1982,1978.5,7,22971,24161,2451,1462,1190,-989,2179,0.00724140913148075,-0.00601828036221383,0.0132596894936946,EPCI
200066512,CC Élan Limousin Avenir Nature,1982_1990,1986,8,24161,24889,2938,1828,728,-1110,1838,0.00371766542037966,-0.00566841842942503,0.00938608384980468,EPCI
200066512,CC Élan Limousin Avenir Nature,1990_1999,1994.5,9,24889,24905,3087,2039,16,-1048,1064,7.14078528278872e-05,-0.00467721436022661,0.0047486222130545,EPCI
200066512,CC Élan Limousin Avenir Nature,1999_2010,2004.5,11,24905,27392,3539,3007,2487,-532,3019,0.00869049163228364,-0.00185900343722352,0.0105494950695072,EPCI
200066520,CC Ouest Limousin,2010_2015,2012.5,5,11322,11533,776,467,211,-309,520,0.00369977847164016,-0.00541815899401331,0.00911793746565347,EPCI
200066520,CC Ouest Limousin,1968_1975,1971.5,7,13358,12254,1482,901,-1104,-581,-523,-0.0122476709061105,-0.00644555869243675,-0.0058021122136737,EPCI
200066520,CC Ouest Limousin,1975_1982,1978.5,7,12254,11904,1388,635,-350,-753,403,-0.00413114840535689,-0.00888787071209639,0.0047567223067395,EPCI
200066520,CC Ouest Limousin,1982_1990,1986,8,11904,11444,1606,743,-460,-863,403,-0.00491399946770343,-0.00921909030571318,0.00430509083800975,EPCI
200066520,CC Ouest Limousin,1990_1999,1994.5,9,11444,10951,1674,820,-493,-854,361,-0.00488080540230074,-0.0084547825832958,0.00357397718099506,EPCI
200066520,CC Ouest Limousin,1999_2010,2004.5,11,10951,11322,1810,983,371,-827,1198,0.00303340597672497,-0.00676179715027372,0.00979520312699868,EPCI
200066553,CC des Monts de Lacaune et de la Montagne du Haut Languedoc,2010_2015,2012.5,5,8199,7897,597,260,-302,-337,35,-0.00747775246509308,-0.00834437940641181,0.000866626941318734,EPCI
200066553,CC des Monts de Lacaune et de la Montagne du Haut Languedoc,1968_1975,1971.5,7,11004,9721,976,809,-1283,-167,-1116,-0.0175541486517493,-0.00228491256807649,-0.0152692360836728,EPCI
200066553,CC des Monts de Lacaune et de la Montagne du Haut Languedoc,1975_1982,1978.5,7,9721,9238,887,660,-483,-227,-256,-0.00725400205580196,-0.00340923077984895,-0.003844771275953,EPCI
200066553,CC des Monts de Lacaune et de la Montagne du Haut Languedoc,1982_1990,1986,8,9238,8647,1052,714,-591,-338,-253,-0.00823006752495836,-0.0047068744897393,-0.00352319303521906,EPCI
200066553,CC des Monts de Lacaune et de la Montagne du Haut Languedoc,1990_1999,1994.5,9,8647,8366,1038,670,-281,-368,87,-0.00366400076973872,-0.00479840670200658,0.00113440593226786,EPCI
200066553,CC des Monts de Lacaune et de la Montagne du Haut Languedoc,1999_2010,2004.5,11,8366,8199,1304,711,-167,-593,426,-0.00183138255105753,-0.00650305301064139,0.00467167045958387,EPCI
200066561,CC Sidobre Vals et Plateaux,2010_2015,2012.5,5,12772,12903,739,527,131,-212,343,0.0020429976050087,-0.00330622513176981,0.00534922273677851,EPCI
200066561,CC Sidobre Vals et Plateaux,1968_1975,1971.5,7,13020,13003,1227,1255,-17,28,-45,-0.000186630683932543,0.000307391714712423,-0.000494022398644966,EPCI
200066561,CC Sidobre Vals et Plateaux,1975_1982,1978.5,7,13003,13131,1125,1095,128,-30,158,0.00140037200754195,-0.000328212189267645,0.00172858419680959,EPCI
200066561,CC Sidobre Vals et Plateaux,1982_1990,1986,8,13131,12920,1200,1168,-211,-32,-179,-0.00202286980079724,-0.000306785941353137,-0.00171608385944411,EPCI
200066561,CC Sidobre Vals et Plateaux,1990_1999,1994.5,9,12920,12570,1304,1135,-350,-169,-181,-0.00304684622003537,-0.00147119146053136,-0.00157565475950401,EPCI
200066561,CC Sidobre Vals et Plateaux,1999_2010,2004.5,11,12570,12772,1567,1192,202,-375,577,0.00145034639562724,-0.00269247474435751,0.00414282113998475,EPCI
200066587,CC des Monts du Lyonnais,2010_2015,2012.5,5,33243,34971,1190,2101,1728,911,817,0.0101865185112027,0.00537032312714446,0.00481619538405821,EPCI
200066587,CC des Monts du Lyonnais,1968_1975,1971.5,7,24557,23826,2010,2567,-731,557,-1288,-0.00430776977055003,0.00328239091955727,-0.0075901606901073,EPCI
200066587,CC des Monts du Lyonnais,1975_1982,1978.5,7,23826,24869,1917,2365,1043,448,595,0.00613943045419396,0.00263707079911687,0.00350235965507709,EPCI
200066587,CC des Monts du Lyonnais,1982_1990,1986,8,24869,26520,1947,2742,1651,795,856,0.00806700401263338,0.0038844749788271,0.00418252903380628,EPCI
200066587,CC des Monts du Lyonnais,1990_1999,1994.5,9,26520,28491,2265,3068,1971,803,1168,0.00799726224980901,0.00325814387955182,0.00473911837025719,EPCI
200066587,CC des Monts du Lyonnais,1999_2010,2004.5,11,28491,33243,2738,4568,4752,1830,2922,0.0141220573481216,0.005438418549466,0.00868363879865555,EPCI
200066603,CC du Pays de Lubersac-Pompadour,2010_2015,2012.5,5,7892,7639,625,255,-253,-370,117,-0.00649538988102283,-0.0094991867825235,0.00300379690150067,EPCI
200066603,CC du Pays de Lubersac-Pompadour,1968_1975,1971.5,7,9388,8962,950,623,-426,-327,-99,-0.00661216587712687,-0.00507553577892133,-0.00153663009820554,EPCI
200066603,CC du Pays de Lubersac-Pompadour,1975_1982,1978.5,7,8962,8650,967,510,-312,-457,145,-0.00504922323127688,-0.00739581736119722,0.00234659412992034,EPCI
200066603,CC du Pays de Lubersac-Pompadour,1982_1990,1986,8,8650,8194,1063,524,-456,-539,83,-0.00674678031527176,-0.00797481269721816,0.0012280323819464,EPCI
200066603,CC du Pays de Lubersac-Pompadour,1990_1999,1994.5,9,8194,7830,1158,532,-364,-626,262,-0.00503612809369824,-0.00866103347982171,0.00362490538612346,EPCI
200066603,CC du Pays de Lubersac-Pompadour,1999_2010,2004.5,11,7830,7892,1237,671,62,-566,628,0.000717264216282487,-0.00654792816799819,0.00726519238428068,EPCI
200066637,CC Hautes Terres,2010_2015,2012.5,5,13679,13137,1241,469,-542,-772,230,-0.00805322435861921,-0.0114706442893986,0.00341741993077937,EPCI
200066637,CC Hautes Terres,1968_1975,1971.5,7,21577,19823,2166,1898,-1754,-268,-1486,-0.0120390935692274,-0.00183949662289221,-0.0101995969463352,EPCI
200066637,CC Hautes Terres,1975_1982,1978.5,7,19823,18128,2133,1367,-1695,-766,-929,-0.0126881290381274,-0.00573398633817441,-0.00695414269995303,EPCI
200066637,CC Hautes Terres,1982_1990,1986,8,18128,16908,2136,1383,-1220,-753,-467,-0.00867104048659162,-0.00535187990688811,-0.00331916057970351,EPCI
200066637,CC Hautes Terres,1990_1999,1994.5,9,16908,15008,2227,1127,-1900,-1100,-800,-0.0131575054484417,-0.00761750315436101,-0.00554000229408073,EPCI
200066637,CC Hautes Terres,1999_2010,2004.5,11,15008,13679,2578,1211,-1329,-1367,38,-0.00839380835134207,-0.00863381190089135,0.000240003549549284,EPCI
200066645,CC Vézère-Monédières-Millesources,2010_2015,2012.5,5,5072,5023,593,131,-49,-462,413,-0.00193968684471502,-0.0182884759644559,0.0163487891197409,EPCI
200066645,CC Vézère-Monédières-Millesources,1968_1975,1971.5,7,7272,6586,1058,286,-686,-772,86,-0.0140553133674067,-0.0158173497370816,0.0017620363696749,EPCI
200066645,CC Vézère-Monédières-Millesources,1975_1982,1978.5,7,6586,6081,1057,238,-505,-819,314,-0.011332021675404,-0.0183780707963483,0.00704604912094429,EPCI
200066645,CC Vézère-Monédières-Millesources,1982_1990,1986,8,6081,5549,1084,275,-532,-809,277,-0.0113786954305559,-0.0173033169235333,0.00592462149297742,EPCI
200066645,CC Vézère-Monédières-Millesources,1990_1999,1994.5,9,5549,5129,1155,275,-420,-880,460,-0.00870709652025148,-0.018243440328146,0.00953634380789448,EPCI
200066645,CC Vézère-Monédières-Millesources,1999_2010,2004.5,11,5129,5072,1252,344,-57,-908,851,-0.00101543784573277,-0.0161757467355325,0.0151603088897998,EPCI
200066652,CC Grand Sud Tarn et Garonne,2010_2015,2012.5,5,38249,41737,1474,2795,3488,1321,2167,0.0176073351731525,0.00666837435886882,0.0109389608142837,EPCI
200066652,CC Grand Sud Tarn et Garonne,1968_1975,1971.5,7,19586,20246,2017,1702,660,-315,975,0.00474582849446237,-0.00226505450872068,0.00701088300318304,EPCI
200066652,CC Grand Sud Tarn et Garonne,1975_1982,1978.5,7,20246,22027,1931,1663,1781,-268,2049,0.0121173604018259,-0.00182338719129104,0.0139407475931169,EPCI
200066652,CC Grand Sud Tarn et Garonne,1982_1990,1986,8,22027,24397,2150,2085,2370,-65,2435,0.0128558348047203,-0.00035258618662735,0.0132084209913477,EPCI
200066652,CC Grand Sud Tarn et Garonne,1990_1999,1994.5,9,24397,26829,2453,2598,2432,145,2287,0.010614069135592,0.000632828957508572,0.00998124017808347,EPCI
200066652,CC Grand Sud Tarn et Garonne,1999_2010,2004.5,11,26829,38249,3431,4877,11420,1446,9974,0.0327647781823046,0.00414867506581545,0.0286161031164892,EPCI
200066660,CC de Saint-Flour,2010_2015,2012.5,5,23893,23820,1496,1115,-73,-381,308,-0.000611805786718267,-0.00319312335259808,0.00258131756587981,EPCI
200066660,CC de Saint-Flour,1968_1975,1971.5,7,27743,27265,2558,2775,-478,217,-695,-0.00247973860477624,0.00112573907371641,-0.00360547767849265,EPCI
200066660,CC de Saint-Flour,1975_1982,1978.5,7,27265,26699,2578,2382,-566,-196,-370,-0.00299233072100202,-0.00103621346522332,-0.00195611725577871,EPCI
200066660,CC de Saint-Flour,1982_1990,1986,8,26699,25577,2673,2318,-1122,-355,-767,-0.00535220083219801,-0.00169343252712147,-0.00365876830507653,EPCI
200066660,CC de Saint-Flour,1990_1999,1994.5,9,25577,23762,2887,2017,-1815,-870,-945,-0.00814507477369664,-0.00390425071797029,-0.00424082405572635,EPCI
200066660,CC de Saint-Flour,1999_2010,2004.5,11,23762,23893,3319,2537,131,-782,913,0.000499930648447222,-0.00298431883271548,0.0034842494811627,EPCI
200066678,CC de la Châtaigneraie Cantalienne,2010_2015,2012.5,5,21097,21438,1385,847,341,-538,879,0.00321198700906877,-0.00506759240726979,0.00827957941633857,EPCI
200066678,CC de la Châtaigneraie Cantalienne,1968_1975,1971.5,7,25284,23860,2258,2009,-1424,-249,-1175,-0.00824700077719087,-0.00144206684938239,-0.00680493392780848,EPCI
200066678,CC de la Châtaigneraie Cantalienne,1975_1982,1978.5,7,23860,22598,2256,1592,-1262,-664,-598,-0.00773308888952651,-0.00406875675328495,-0.00366433213624156,EPCI
200066678,CC de la Châtaigneraie Cantalienne,1982_1990,1986,8,22598,21585,2550,1551,-1013,-999,-14,-0.00571644581104336,-0.0056374426112856,-7.90031997577566e-05,EPCI
200066678,CC de la Châtaigneraie Cantalienne,1990_1999,1994.5,9,21585,20524,2645,1404,-1061,-1241,180,-0.00558475759369281,-0.00653221882542204,0.000947461231729224,EPCI
200066678,CC de la Châtaigneraie Cantalienne,1999_2010,2004.5,11,20524,21097,3073,2120,573,-953,1526,0.00250640098425747,-0.00416858662826767,0.00667498761252514,EPCI
200066710,CC Cingal-Suisse Normande,2010_2015,2012.5,5,22503,23894,1025,1652,1391,627,764,0.0120679871104188,0.00543970375142529,0.0066282833589935,EPCI
200066710,CC Cingal-Suisse Normande,1968_1975,1971.5,7,16795,16859,1383,1926,64,543,-479,0.000543492748608099,0.00461119628897184,-0.00406770354036374,EPCI
200066710,CC Cingal-Suisse Normande,1975_1982,1978.5,7,16859,18180,1362,1715,1321,353,968,0.0108350572012998,0.00289536350647907,0.00793969369482078,EPCI
200066710,CC Cingal-Suisse Normande,1982_1990,1986,8,18180,18958,1715,1957,778,242,536,0.00525173191147621,0.00163357213698874,0.00361815977448747,EPCI
200066710,CC Cingal-Suisse Normande,1990_1999,1994.5,9,18958,19881,1804,2082,923,278,645,0.00529602972965981,0.00159512054696146,0.00370090918269835,EPCI
200066710,CC Cingal-Suisse Normande,1999_2010,2004.5,11,19881,22503,2188,3209,2622,1021,1601,0.0113258510610725,0.00441025703026509,0.00691559403080745,EPCI
200066728,CC Vallées de l'Orne et de l'Odon,2010_2015,2012.5,5,22595,24733,663,1528,2138,865,1273,0.0182464165259795,0.00738220313141826,0.0108642133945612,EPCI
200066728,CC Vallées de l'Orne et de l'Odon,1968_1975,1971.5,7,9110,11263,542,1157,2153,615,1538,0.0307711243421087,0.00878970806799668,0.021981416274112,EPCI
200066728,CC Vallées de l'Orne et de l'Odon,1975_1982,1978.5,7,11263,14235,534,1303,2972,769,2203,0.03402027709551,0.00880268946381131,0.0252175876316987,EPCI
200066728,CC Vallées de l'Orne et de l'Odon,1982_1990,1986,8,14235,17079,663,1570,2844,907,1937,0.023029414505449,0.00734447220690657,0.0156849422985425,EPCI
200066728,CC Vallées de l'Orne et de l'Odon,1990_1999,1994.5,9,17079,18071,893,1600,992,707,285,0.00629291826298029,0.00448497299589421,0.00180794526708607,EPCI
200066728,CC Vallées de l'Orne et de l'Odon,1999_2010,2004.5,11,18071,22595,1259,3013,4524,1754,2770,0.0205185977152449,0.00795526533875763,0.0125633323764873,EPCI
200066744,CC Haute-Corrèze Communauté,2010_2015,2012.5,5,34814,33706,2682,1416,-1108,-1266,158,-0.00644787102377264,-0.00736733277626008,0.000919461752487435,EPCI
200066744,CC Haute-Corrèze Communauté,1968_1975,1971.5,7,40547,40228,4310,3258,-319,-1052,733,-0.00112772428406616,-0.00371901550732789,0.00259129122326173,EPCI
200066744,CC Haute-Corrèze Communauté,1975_1982,1978.5,7,40228,39306,4418,2934,-922,-1484,562,-0.00330681919066667,-0.0053224725368214,0.00201565334615474,EPCI
200066744,CC Haute-Corrèze Communauté,1982_1990,1986,8,39306,38049,4697,3125,-1257,-1572,315,-0.00405455503383134,-0.00507061297787022,0.00101605794403888,EPCI
200066744,CC Haute-Corrèze Communauté,1990_1999,1994.5,9,38049,35655,5034,3030,-2394,-2004,-390,-0.00719459556238544,-0.00602254365372616,-0.00117205190865928,EPCI
200066744,CC Haute-Corrèze Communauté,1999_2010,2004.5,11,35655,34814,5748,3586,-841,-2162,1321,-0.00216762772634083,-0.00557242704441007,0.00340479931806924,EPCI
200066751,CC Xaintrie Val'dordogne,2010_2015,2012.5,5,12021,11664,996,356,-357,-640,283,-0.0060114475195675,-0.0107768246849389,0.00476537716537144,EPCI
200066751,CC Xaintrie Val'dordogne,1968_1975,1971.5,7,15972,14822,1683,1238,-1150,-445,-705,-0.0106181714859811,-0.00410877070544486,-0.00650940078053624,EPCI
200066751,CC Xaintrie Val'dordogne,1975_1982,1978.5,7,14822,13920,1662,892,-902,-770,-132,-0.0089293103065311,-0.00762258196898996,-0.00130672833754114,EPCI
200066751,CC Xaintrie Val'dordogne,1982_1990,1986,8,13920,13069,1786,972,-851,-814,-37,-0.00785444651915412,-0.00751294884440829,-0.000341497674745832,EPCI
200066751,CC Xaintrie Val'dordogne,1990_1999,1994.5,9,13069,12007,1752,789,-1062,-963,-99,-0.00937282098780212,-0.00849908343809175,-0.000873737549710369,EPCI
200066751,CC Xaintrie Val'dordogne,1999_2010,2004.5,11,12007,12021,2077,1021,14,-1056,1070,0.000105942636391632,-0.00799110171639736,0.00809704435278899,EPCI
200066769,CC Midi Corrézien,2010_2015,2012.5,5,12899,13190,950,517,291,-433,724,0.00447180435836025,-0.00665392194903777,0.011125726307398,EPCI
200066769,CC Midi Corrézien,1968_1975,1971.5,7,13828,12621,1562,843,-1207,-719,-488,-0.0129628813259096,-0.00772188208229413,-0.00524099924361549,EPCI
200066769,CC Midi Corrézien,1975_1982,1978.5,7,12621,12331,1575,655,-290,-920,630,-0.00331530311849493,-0.0105175133414322,0.00720221022293726,EPCI
200066769,CC Midi Corrézien,1982_1990,1986,8,12331,12002,1717,741,-329,-976,647,-0.00337468220678983,-0.0100112153003856,0.0066365330935958,EPCI
200066769,CC Midi Corrézien,1990_1999,1994.5,9,12002,11888,1711,847,-114,-864,750,-0.00105986179287065,-0.00803263674596706,0.0069727749530964,EPCI
200066769,CC Midi Corrézien,1999_2010,2004.5,11,11888,12899,1996,1127,1011,-869,1880,0.00744762398102838,-0.006401567991606,0.0138491919726344,EPCI
200066777,CC Ploërmel Communauté,2010_2015,2012.5,5,41312,42258,2557,2251,946,-306,1252,0.00453840155615159,-0.00146802418201098,0.00600642573816258,EPCI
200066777,CC Ploërmel Communauté,1968_1975,1971.5,7,37729,36962,3660,4484,-767,824,-1591,-0.00292979569775786,0.00314752497386243,-0.00607732067162029,EPCI
200066777,CC Ploërmel Communauté,1975_1982,1978.5,7,36962,37156,3588,3659,194,71,123,0.000748123656681754,0.000273797833115487,0.000474325823566267,EPCI
200066777,CC Ploërmel Communauté,1982_1990,1986,8,37156,37213,3869,3673,57,-196,253,0.000191630492736072,-0.000658939939934565,0.000850570432670637,EPCI
200066777,CC Ploërmel Communauté,1990_1999,1994.5,9,37213,37384,4216,3612,171,-604,775,0.000509534524323563,-0.00179975937246451,0.00230929389678808,EPCI
200066777,CC Ploërmel Communauté,1999_2010,2004.5,11,37384,41312,5208,5038,3928,-170,4098,0.00912411960328074,-0.000394882976720399,0.00951900258000114,EPCI
200066785,CC de l'Oust à Brocéliande Communauté,2010_2015,2012.5,5,38071,39149,2000,2269,1078,269,809,0.0056000302495236,0.00139741014575311,0.0042026201037705,EPCI
200066785,CC de l'Oust à Brocéliande Communauté,1968_1975,1971.5,7,31932,32001,2924,3677,69,753,-684,0.000308406194257982,0.00336565020690232,-0.00305724401264434,EPCI
200066785,CC de l'Oust à Brocéliande Communauté,1975_1982,1978.5,7,32001,32817,2846,3360,816,514,302,0.00360355173570204,0.00226988430410643,0.00133366743159561,EPCI
200066785,CC de l'Oust à Brocéliande Communauté,1982_1990,1986,8,32817,33475,3239,3763,658,524,134,0.00248460875855505,0.00197862460407727,0.000505984154477777,EPCI
200066785,CC de l'Oust à Brocéliande Communauté,1990_1999,1994.5,9,33475,33472,3318,3839,-3,521,-524,-9.95807650450153e-06,0.00172938595294843,-0.00173934402945293,EPCI
200066785,CC de l'Oust à Brocéliande Communauté,1999_2010,2004.5,11,33472,38071,4092,5267,4599,1175,3424,0.0117727201588054,0.00300781608753997,0.0087649040712654,EPCI
200066793,CA du Grand Annecy,2010_2015,2012.5,5,185712,198626,6891,11883,12914,4992,7922,0.0135361092728632,0.00523248083398893,0.00830362843887426,EPCI
200066793,CA du Grand Annecy,1968_1975,1971.5,7,100790,124040,6020,14930,23250,8910,14340,0.0300961379435005,0.011533616734477,0.0185625212090235,EPCI
200066793,CA du Grand Annecy,1975_1982,1978.5,7,124040,135136,6590,13923,11096,7333,3763,0.0123148660472112,0.00813851051948448,0.00417635552772673,EPCI
200066793,CA du Grand Annecy,1982_1990,1986,8,135136,151545,8050,16138,16409,8088,8321,0.0144282126555713,0.00711166944714854,0.00731654320842272,EPCI
200066793,CA du Grand Annecy,1990_1999,1994.5,9,151545,166833,9780,19106,15288,9326,5962,0.0107361905188164,0.00654930094050768,0.00418688957830868,EPCI
200066793,CA du Grand Annecy,1999_2010,2004.5,11,166833,185712,13197,25091,18879,11894,6985,0.00979344262553061,0.00616998816611373,0.00362345445941688,EPCI
200066801,CC Isigny-Omaha Intercom,2010_2015,2012.5,5,27018,26975,1410,1495,-43,85,-128,-0.000318509145846968,0.000629611102255634,-0.000948120248102602,EPCI
200066801,CC Isigny-Omaha Intercom,1968_1975,1971.5,7,26454,24617,2017,2674,-1837,657,-2494,-0.0102287715370842,0.00365830315724787,-0.0138870746943321,EPCI
200066801,CC Isigny-Omaha Intercom,1975_1982,1978.5,7,24617,24261,1854,2222,-356,368,-724,-0.00207885595063151,0.00214892974672021,-0.00422778569735172,EPCI
200066801,CC Isigny-Omaha Intercom,1982_1990,1986,8,24261,24063,2060,2428,-198,368,-566,-0.00102381700748277,0.00190285181188718,-0.00292666881936995,EPCI
200066801,CC Isigny-Omaha Intercom,1990_1999,1994.5,9,24063,24192,2382,2326,129,-56,185,0.00059424415360998,-0.000257966454280301,0.000852210607890281,EPCI
200066801,CC Isigny-Omaha Intercom,1999_2010,2004.5,11,24192,27018,2838,3342,2826,504,2322,0.0100943633057857,0.00180026861504459,0.00829409469074114,EPCI
200066819,CC du Volvestre,2010_2015,2012.5,5,27351,29571,1208,1670,2220,462,1758,0.0157306563736515,0.00327367713721936,0.0124569792364321,EPCI
200066819,CC du Volvestre,1968_1975,1971.5,7,14995,15304,1590,1112,309,-478,787,0.00291816671702749,-0.00451418670142117,0.00743235341844866,EPCI
200066819,CC du Volvestre,1975_1982,1978.5,7,15304,16759,1656,984,1455,-672,2127,0.0130589899229598,-0.00603136854173815,0.019090358464698,EPCI
200066819,CC du Volvestre,1982_1990,1986,8,16759,18765,1918,1289,2006,-629,2635,0.0142325829856547,-0.00446275907177307,0.0186953420574277,EPCI
200066819,CC du Volvestre,1990_1999,1994.5,9,18765,20509,1993,1923,1744,-70,1814,0.0099234004565516,-0.000398301623829479,0.0103217020803811,EPCI
200066819,CC du Volvestre,1999_2010,2004.5,11,20509,27351,2462,3224,6842,762,6080,0.0265172401967755,0.00295325007745439,0.0235639901193211,EPCI
200066827,CC du Pays de Honfleur-Beuzeville,2010_2015,2012.5,5,27650,29017,1319,1712,1367,393,974,0.00969795071937107,0.00278807215267947,0.00690987856669161,EPCI
200066827,CC du Pays de Honfleur-Beuzeville,1968_1975,1971.5,7,20868,20754,1744,2520,-114,776,-890,-0.000782249023162929,0.00532478282433713,-0.00610703184750006,EPCI
200066827,CC du Pays de Honfleur-Beuzeville,1975_1982,1978.5,7,20754,21386,1788,2233,632,445,187,0.00429455286822633,0.00302385447208974,0.00127069839613659,EPCI
200066827,CC du Pays de Honfleur-Beuzeville,1982_1990,1986,8,21386,22447,1951,2502,1061,551,510,0.00607091282543237,0.00315275491688335,0.00291815790854902,EPCI
200066827,CC du Pays de Honfleur-Beuzeville,1990_1999,1994.5,9,22447,23863,2169,2803,1416,634,782,0.0068200588697982,0.00305361392899157,0.00376644494080663,EPCI
200066827,CC du Pays de Honfleur-Beuzeville,1999_2010,2004.5,11,23863,27650,2542,3788,3787,1246,2541,0.0134806542891626,0.00443540935946569,0.00904524492969688,EPCI
200066835,CC de Sézanne-Sud Ouest Marnais,2010_2015,2012.5,5,21794,21852,1173,1137,58,-36,94,0.000531690893276204,-0.00033001503720592,0.000861705930482124,EPCI
200066835,CC de Sézanne-Sud Ouest Marnais,1968_1975,1971.5,7,21078,20730,1780,2144,-348,364,-712,-0.00237544787114552,0.00248466386522118,-0.0048601117363667,EPCI
200066835,CC de Sézanne-Sud Ouest Marnais,1975_1982,1978.5,7,20730,20682,1678,1750,-48,72,-120,-0.000331112268073031,0.000496668402109546,-0.000827780670182576,EPCI
200066835,CC de Sézanne-Sud Ouest Marnais,1982_1990,1986,8,20682,20841,1997,1882,159,-115,274,0.000957763815125912,-0.000692722256223144,0.00165048607134906,EPCI
200066835,CC de Sézanne-Sud Ouest Marnais,1990_1999,1994.5,9,20841,20762,2197,2070,-79,-127,48,-0.000421889602631675,-0.000678227589040795,0.000256337986409119,EPCI
200066835,CC de Sézanne-Sud Ouest Marnais,1999_2010,2004.5,11,20762,21794,2546,2441,1032,-105,1137,0.00441976664674582,-0.000449685559988673,0.00486945220673449,EPCI
200066850,CC des Paysages de la Champagne,2010_2015,2012.5,5,21601,21622,988,1171,21,183,-162,0.000194359876594774,0.00169370749604017,-0.0014993476194454,EPCI
200066850,CC des Paysages de la Champagne,1968_1975,1971.5,7,20628,20364,1780,2000,-264,220,-484,-0.00183841377891081,0.00153201148242567,-0.00337042526133648,EPCI
200066850,CC des Paysages de la Champagne,1975_1982,1978.5,7,20364,20224,1663,1626,-140,-37,-103,-0.000985031405690617,-0.000260329728646806,-0.000724701677043811,EPCI
200066850,CC des Paysages de la Champagne,1982_1990,1986,8,20224,21126,1879,1835,902,-44,946,0.00546921326691896,-0.000266790891069218,0.00573600415798818,EPCI
200066850,CC des Paysages de la Champagne,1990_1999,1994.5,9,21126,20990,1962,2105,-136,143,-279,-0.000717339874025225,0.000754261779305935,-0.00147160165333116,EPCI
200066850,CC des Paysages de la Champagne,1999_2010,2004.5,11,20990,21601,2246,2675,611,429,182,0.00261190291619084,0.00183388928158081,0.000778013634610039,EPCI
200066868,CC Presqu'île de Crozon-Aulne Maritime,2010_2015,2012.5,5,23480,23229,1528,1194,-251,-334,83,-0.00214719085800308,-0.00285721811383677,0.000710027255833687,EPCI
200066868,CC Presqu'île de Crozon-Aulne Maritime,1968_1975,1971.5,7,22755,22313,2462,2189,-442,-273,-169,-0.00279828223420842,-0.00172835079171696,-0.00106993144249145,EPCI
200066868,CC Presqu'île de Crozon-Aulne Maritime,1975_1982,1978.5,7,22313,22085,2503,1913,-228,-590,362,-0.00146618455734426,-0.00379407407382945,0.00232788951648519,EPCI
200066868,CC Presqu'île de Crozon-Aulne Maritime,1982_1990,1986,8,22085,21815,2635,2193,-270,-442,172,-0.00153642330048209,-0.00251518184745587,0.000978758546973778,EPCI
200066868,CC Presqu'île de Crozon-Aulne Maritime,1990_1999,1994.5,9,21815,21596,2829,2059,-219,-770,551,-0.00112044896329677,-0.0039394780901302,0.00281902912683343,EPCI
200066868,CC Presqu'île de Crozon-Aulne Maritime,1999_2010,2004.5,11,21596,23480,3397,2793,1884,-604,2488,0.00763269826296753,-0.00244700092931655,0.0100796991922841,EPCI
200066876,CA de Châlons-en-Champagne,2010_2015,2012.5,5,79239,80835,3100,5351,1596,2251,-655,0.00399625144129478,0.00563631703906927,-0.00164006559777449,EPCI
200066876,CA de Châlons-en-Champagne,1968_1975,1971.5,7,70384,78522,4131,11481,8138,7350,788,0.0157532046230466,0.0142278267362242,0.00152537788682241,EPCI
200066876,CA de Châlons-en-Champagne,1975_1982,1978.5,7,78522,80206,4252,10043,1684,5791,-4107,0.00303595416545321,0.0104401487958073,-0.00740419463035413,EPCI
200066876,CA de Châlons-en-Champagne,1982_1990,1986,8,80206,80937,4732,10735,731,6003,-5272,0.0011347369807444,0.0093185035504906,-0.0081837665697462,EPCI
200066876,CA de Châlons-en-Champagne,1990_1999,1994.5,9,80937,79896,5263,10108,-1041,4845,-5886,-0.0014373310852217,0.00668959568482148,-0.00812692677004319,EPCI
200066876,CA de Châlons-en-Champagne,1999_2010,2004.5,11,79896,79239,6522,12251,-657,5729,-6386,-0.000750371701065289,0.00654319554855866,-0.00729356724962395,EPCI
200066884,CC Quercy Vert-Aveyron,2010_2015,2012.5,5,20134,21810,1009,1188,1676,179,1497,0.0161202824440216,0.00172167694360374,0.0143986055004179,EPCI
200066884,CC Quercy Vert-Aveyron,1968_1975,1971.5,7,10637,11012,922,979,375,57,318,0.00496185486259981,0.000754201939115172,0.00420765292348464,EPCI
200066884,CC Quercy Vert-Aveyron,1975_1982,1978.5,7,11012,12352,990,925,1340,-65,1405,0.0165399241697668,-0.000802309754503613,0.0173422339242704,EPCI
200066884,CC Quercy Vert-Aveyron,1982_1990,1986,8,12352,13990,1142,1149,1638,7,1631,0.0156873743800632,6.70400614532615e-05,0.0156203343186099,EPCI
200066884,CC Quercy Vert-Aveyron,1990_1999,1994.5,9,13990,14994,1246,1380,1004,134,870,0.00773054224485525,0.00103176559841694,0.00669877664643832,EPCI
200066884,CC Quercy Vert-Aveyron,1999_2010,2004.5,11,14994,20134,1802,2171,5140,369,4771,0.0271585966190695,0.0019497124810188,0.0252088841380507,EPCI
200066892,CC de Vendeuvre-Soulaines,2010_2015,2012.5,5,7877,7853,406,452,-24,46,-70,-0.00061011307097314,0.00116938338603185,-0.00177949645700499,EPCI
200066892,CC de Vendeuvre-Soulaines,1968_1975,1971.5,7,7595,7725,635,843,130,208,-78,0.00242746821818618,0.00388394914909789,-0.00145648093091171,EPCI
200066892,CC de Vendeuvre-Soulaines,1975_1982,1978.5,7,7725,7983,640,804,258,164,94,0.0047042386196372,0.00299029121558334,0.00171394740405386,EPCI
200066892,CC de Vendeuvre-Soulaines,1982_1990,1986,8,7983,7845,631,799,-138,168,-306,-0.00217736290869297,0.00265070267145231,-0.00482806558014528,EPCI
200066892,CC de Vendeuvre-Soulaines,1990_1999,1994.5,9,7845,7777,717,831,-68,114,-182,-0.000966835254674558,0.00162087086813088,-0.00258770612280544,EPCI
200066892,CC de Vendeuvre-Soulaines,1999_2010,2004.5,11,7777,7877,803,1048,100,245,-145,0.00116217125354856,0.00284731957119397,-0.00168514831764541,EPCI
200066918,CA Alès Agglomération,2010_2015,2012.5,5,125964,128188,7312,6534,2224,-778,3002,0.00350649030743755,-0.00122664094387878,0.00473313125131633,EPCI
200066918,CA Alès Agglomération,1968_1975,1971.5,7,114564,111480,9453,9991,-3084,538,-3622,-0.00389075648679382,0.000678737675063255,-0.00456949416185708,EPCI
200066918,CA Alès Agglomération,1975_1982,1978.5,7,111480,113096,9598,8236,1616,-1362,2978,0.00205808824096043,-0.0017346015991263,0.00379268984008674,EPCI
200066918,CA Alès Agglomération,1982_1990,1986,8,113096,115173,11109,10141,2077,-968,3045,0.00227738057904903,-0.0010613887340007,0.00333876931304973,EPCI
200066918,CA Alès Agglomération,1990_1999,1994.5,9,115173,113864,12203,10309,-1309,-1894,585,-0.00126925958817126,-0.00183649935828599,0.000567239770114733,EPCI
200066918,CA Alès Agglomération,1999_2010,2004.5,11,113864,125964,14955,13585,12100,-1370,13470,0.00922331117825825,-0.00104429225737304,0.0102676034356313,EPCI
200066926,CA Grand Auch Coeur de Gascogne,2010_2015,2012.5,5,37904,38732,2084,1804,828,-280,1108,0.00433124973201937,-0.00146467382242201,0.00579592355444138,EPCI
200066926,CA Grand Auch Coeur de Gascogne,1968_1975,1971.5,7,32173,34023,2614,3493,1850,879,971,0.00801900637472874,0.00381011167750625,0.00420889469722249,EPCI
200066926,CA Grand Auch Coeur de Gascogne,1975_1982,1978.5,7,34023,35095,2492,2877,1072,385,687,0.00444153503314104,0.00159514084679039,0.00284639418635065,EPCI
200066926,CA Grand Auch Coeur de Gascogne,1982_1990,1986,8,35095,36576,2747,3156,1481,409,1072,0.00518007260153341,0.00143055347334718,0.00374951912818624,EPCI
200066926,CA Grand Auch Coeur de Gascogne,1990_1999,1994.5,9,36576,35789,3147,3127,-787,-20,-767,-0.00241393775393883,-6.13453050556247e-05,-0.00235259244888321,EPCI
200066926,CA Grand Auch Coeur de Gascogne,1999_2010,2004.5,11,35789,37904,4008,3944,2115,-64,2179,0.00523328822747837,-0.000158359549200291,0.00539164777667866,EPCI
200066975,CC Senlis Sud Oise,2010_2015,2012.5,5,25804,24260,883,1436,-1544,553,-2097,-0.0122642959383088,0.00439258785873366,-0.0166568837970425,EPCI
200066975,CC Senlis Sud Oise,1968_1975,1971.5,7,17629,20959,1220,2599,3330,1379,1951,0.0250255648371887,0.0103634396127577,0.014662125224431,EPCI
200066975,CC Senlis Sud Oise,1975_1982,1978.5,7,20959,22216,1128,2663,1257,1535,-278,0.00835537025411681,0.0102032564360138,-0.00184788618189696,EPCI
200066975,CC Senlis Sud Oise,1982_1990,1986,8,22216,23138,1249,2666,922,1417,-495,0.00509588226622637,0.00783174096664075,-0.00273585870041438,EPCI
200066975,CC Senlis Sud Oise,1990_1999,1994.5,9,23138,25491,1397,3115,2353,1718,635,0.0108191258978869,0.00789938728965989,0.00291973860822703,EPCI
200066975,CC Senlis Sud Oise,1999_2010,2004.5,11,25491,25804,1795,3771,313,1976,-1663,0.00111007658673867,0.00700802343576875,-0.00589794684903007,EPCI
200067023,CC Coutances Mer et Bocage,2010_2015,2012.5,5,48018,48036,2697,2377,18,-320,338,7.49606465033637e-05,-0.00133263371561535,0.00140759436211872,EPCI
200067023,CC Coutances Mer et Bocage,1968_1975,1971.5,7,43169,42043,3608,4279,-1126,671,-1797,-0.00376855837762191,0.0022457394950127,-0.00601429787263461,EPCI
200067023,CC Coutances Mer et Bocage,1975_1982,1978.5,7,42043,41944,3569,3717,-99,148,-247,-0.000336730265264817,0.000503394739991848,-0.000840125005256666,EPCI
200067023,CC Coutances Mer et Bocage,1982_1990,1986,8,41944,42646,4079,4122,702,43,659,0.00207691476002148,0.000127218425471401,0.00194969633455007,EPCI
200067023,CC Coutances Mer et Bocage,1990_1999,1994.5,9,42646,44020,4500,4322,1374,-178,1552,0.00352961371146376,-0.000457257089258042,0.00398687080072181,EPCI
200067023,CC Coutances Mer et Bocage,1999_2010,2004.5,11,44020,48018,5700,5612,3998,-88,4086,0.00793420708915082,-0.000174639875899268,0.00810884696505009,EPCI
200067031,CC Côte Ouest Centre Manche,2010_2015,2012.5,5,22598,22410,1392,1112,-188,-280,92,-0.00166942874583564,-0.00248638323847862,0.000816954492642975,EPCI
200067031,CC Côte Ouest Centre Manche,1968_1975,1971.5,7,21526,20562,1691,2184,-964,493,-1457,-0.0065238828553752,0.00333638407437756,-0.00986026692975276,EPCI
200067031,CC Côte Ouest Centre Manche,1975_1982,1978.5,7,20562,20301,1703,1698,-261,-5,-256,-0.00182327384199932,-3.49286176628222e-05,-0.0017883452243365,EPCI
200067031,CC Côte Ouest Centre Manche,1982_1990,1986,8,20301,20678,2123,1995,377,-128,505,0.00230267048868327,-0.000781808547881852,0.00308447903656512,EPCI
200067031,CC Côte Ouest Centre Manche,1990_1999,1994.5,9,20678,21236,2408,2195,558,-213,771,0.00296299452277737,-0.00113103554364083,0.0040940300664182,EPCI
200067031,CC Côte Ouest Centre Manche,1999_2010,2004.5,11,21236,22598,2980,2720,1362,-260,1622,0.00566723034012706,-0.00108185013835025,0.00674908047847731,EPCI
200067049,CC Spelunca-Liamone,2010_2015,2012.5,5,7369,7586,487,242,217,-245,462,0.00582136496848906,-0.00657250883539088,0.0123938738038799,EPCI
200067049,CC Spelunca-Liamone,1968_1975,1971.5,7,8210,7955,959,439,-255,-520,265,-0.00449732257488544,-0.00917101074094287,0.00467368816605742,EPCI
200067049,CC Spelunca-Liamone,1975_1982,1978.5,7,7955,7175,1020,376,-780,-644,-136,-0.0146344177370327,-0.0120827756700629,-0.0025516420669698,EPCI
200067049,CC Spelunca-Liamone,1982_1990,1986,8,7175,6511,1066,483,-664,-583,-81,-0.0120653364428807,-0.0105935107623485,-0.00147182568053213,EPCI
200067049,CC Spelunca-Liamone,1990_1999,1994.5,9,6511,6541,1045,442,30,-603,633,0.000510908772155538,-0.0102692663203263,0.0107801750924819,EPCI
200067049,CC Spelunca-Liamone,1999_2010,2004.5,11,6541,7369,1251,520,828,-731,1559,0.0108945501470286,-0.00961825622883801,0.0205128063758666,EPCI
200067064,CC Decazeville Communauté,2010_2015,2012.5,5,20100,19232,1478,868,-868,-610,-258,-0.00878999148117055,-0.00617729816073045,-0.00261269332044009,EPCI
200067064,CC Decazeville Communauté,1968_1975,1971.5,7,31018,29581,2907,2618,-1437,-289,-1148,-0.00675357963645962,-0.0013582355705893,-0.00539534406587031,EPCI
200067064,CC Decazeville Communauté,1975_1982,1978.5,7,29581,27061,2801,1834,-2520,-967,-1553,-0.0126392574340278,-0.00485006426139084,-0.00778919317263699,EPCI
200067064,CC Decazeville Communauté,1982_1990,1986,8,27061,23766,2733,1574,-3295,-1159,-2136,-0.016098706690107,-0.00566264068401641,-0.0104360660060906,EPCI
200067064,CC Decazeville Communauté,1990_1999,1994.5,9,23766,21397,2917,1565,-2369,-1352,-1017,-0.011599452950527,-0.00661986508615977,-0.00497958786436723,EPCI
200067064,CC Decazeville Communauté,1999_2010,2004.5,11,21397,20100,3369,1975,-1297,-1394,97,-0.0056685012758988,-0.00609243699198375,0.000423935716084953,EPCI
200067072,CC Haut-Léon Communauté,2010_2015,2012.5,5,32117,31505,2136,1605,-612,-531,-81,-0.00384045084739215,-0.00333215588229613,-0.00050829496509602,EPCI
200067072,CC Haut-Léon Communauté,1968_1975,1971.5,7,35227,33801,3307,3239,-1426,-68,-1358,-0.00588581690813439,-0.000280670090990981,-0.00560514681714341,EPCI
200067072,CC Haut-Léon Communauté,1975_1982,1978.5,7,33801,33064,3411,2677,-737,-734,-3,-0.00314437615341023,-0.00313157679321996,-1.27993601902721e-05,EPCI
200067072,CC Haut-Léon Communauté,1982_1990,1986,8,33064,31972,3947,2763,-1092,-1184,92,-0.00418927010423698,-0.00454221227419101,0.000352942169954031,EPCI
200067072,CC Haut-Léon Communauté,1990_1999,1994.5,9,31972,30940,4030,2776,-1032,-1254,222,-0.0036389932703812,-0.00442179996226552,0.000782806691884327,EPCI
200067072,CC Haut-Léon Communauté,1999_2010,2004.5,11,30940,32117,4799,3544,1177,-1255,2432,0.00339991572101761,-0.00362522874246143,0.00702514446347904,EPCI
200067080,"CC Chablis, Villages et Terroirs",2010_2015,2012.5,5,15366,15320,1049,802,-46,-247,201,-0.00059944268899903,-0.00321874661266871,0.00261930392366968,EPCI
200067080,"CC Chablis, Villages et Terroirs",1968_1975,1971.5,7,14086,13854,1666,1302,-232,-364,132,-0.0023696731273366,-0.00371793542392467,0.00134826229658807,EPCI
200067080,"CC Chablis, Villages et Terroirs",1975_1982,1978.5,7,13854,13689,1626,1138,-165,-488,323,-0.00171016585230654,-0.00505794506621572,0.00334777921390917,EPCI
200067080,"CC Chablis, Villages et Terroirs",1982_1990,1986,8,13689,14014,1728,1274,325,-454,779,0.00293733545751484,-0.00410323168526689,0.00704056714278174,EPCI
200067080,"CC Chablis, Villages et Terroirs",1990_1999,1994.5,9,14014,14891,2049,1479,877,-570,1447,0.00676725885366292,-0.00439833243624614,0.0111655912899091,EPCI
200067080,"CC Chablis, Villages et Terroirs",1999_2010,2004.5,11,14891,15366,2454,2041,475,-413,888,0.00285864842316852,-0.00248551957635494,0.00534416799952346,EPCI
200067106,CA du Pays Basque,2010_2015,2012.5,5,289080,302980,15728,14097,13900,-1631,15531,0.00943691558278004,-0.00110731002269887,0.0105442256054789,EPCI
200067106,CA du Pays Basque,1968_1975,1971.5,7,218085,227855,19144,22001,9770,2857,6913,0.00628029122947749,0.00183651914458722,0.00444377208489026,EPCI
200067106,CA du Pays Basque,1975_1982,1978.5,7,227855,236541,20246,18822,8686,-1424,10110,0.0053588924421546,-0.000878547413956729,0.00623743985611132,EPCI
200067106,CA du Pays Basque,1982_1990,1986,8,236541,249725,24359,21113,13184,-3246,16430,0.00680287992496376,-0.00167492022424396,0.00847780014920772,EPCI
200067106,CA du Pays Basque,1990_1999,1994.5,9,249725,262370,27703,23399,12645,-4304,16949,0.0055034675031409,-0.00187322452617781,0.00737669202931872,EPCI
200067106,CA du Pays Basque,1999_2010,2004.5,11,262370,289080,33512,30492,26710,-3020,29730,0.00885238401489241,-0.00100090601740828,0.00985329003230069,EPCI
200067114,CA de l'Auxerrois,2010_2015,2012.5,5,69388,67979,3372,3878,-1409,506,-1915,-0.00409461569702163,0.00147045815663091,-0.00556507385365254,EPCI
200067114,CA de l'Auxerrois,1968_1975,1971.5,7,53624,60755,4413,7012,7131,2599,4532,0.0179961065074343,0.00655895117274181,0.0114371553346925,EPCI
200067114,CA de l'Auxerrois,1975_1982,1978.5,7,60755,66770,4370,7139,6015,2769,3246,0.0135777074649512,0.00625048578062344,0.0073272216843278,EPCI
200067114,CA de l'Auxerrois,1982_1990,1986,8,66770,68983,5386,7523,2213,2137,76,0.00408409472185833,0.00394383661121159,0.000140258110646739,EPCI
200067114,CA de l'Auxerrois,1990_1999,1994.5,9,68983,69026,6113,7569,43,1456,-1413,6.92410399267818e-05,0.00234453381705568,-0.0022752927771289,EPCI
200067114,CA de l'Auxerrois,1999_2010,2004.5,11,69026,69388,7191,9013,362,1822,-1460,0.000475630956855211,0.0023939215563265,-0.00191829059947129,EPCI
200067122,CC Coteaux et Plaines du Pays Lafrançaisain,2010_2015,2012.5,5,10461,10995,435,536,534,101,433,0.0100070525272333,0.00189271967275387,0.00811433285447946,EPCI
200067122,CC Coteaux et Plaines du Pays Lafrançaisain,1968_1975,1971.5,7,8462,8228,715,658,-234,-57,-177,-0.00399806928405666,-0.000973888671757392,-0.00302418061229927,EPCI
200067122,CC Coteaux et Plaines du Pays Lafrançaisain,1975_1982,1978.5,7,8228,8409,666,552,181,-114,295,0.00311334915861394,-0.00196089394520436,0.0050742431038183,EPCI
200067122,CC Coteaux et Plaines du Pays Lafrançaisain,1982_1990,1986,8,8409,8706,647,693,297,46,251,0.0043481612241425,0.000673452580170219,0.00367470864397228,EPCI
200067122,CC Coteaux et Plaines du Pays Lafrançaisain,1990_1999,1994.5,9,8706,8763,766,810,57,44,13,0.00072535949534247,0.000559926627983661,0.000165432867358809,EPCI
200067122,CC Coteaux et Plaines du Pays Lafrançaisain,1999_2010,2004.5,11,8763,10461,963,1140,1698,177,1521,0.0162317578858053,0.00169200303049914,0.0145397548553062,EPCI
200067130,CC de Puisaye-Forterre,2010_2015,2012.5,5,36171,35461,2803,1550,-710,-1253,543,-0.00395698875901451,-0.00698324917611998,0.00302626041710547,EPCI
200067130,CC de Puisaye-Forterre,1968_1975,1971.5,7,38642,35444,4202,2984,-3198,-1218,-1980,-0.0122649902370213,-0.00467128145987866,-0.00759370877714266,EPCI
200067130,CC de Puisaye-Forterre,1975_1982,1978.5,7,35444,34693,4148,2237,-751,-1911,1160,-0.00305476022326268,-0.00777316482910116,0.00471840460583849,EPCI
200067130,CC de Puisaye-Forterre,1982_1990,1986,8,34693,33773,4718,2512,-920,-2206,1286,-0.00335389693029331,-0.0080420615524207,0.00468816462212739,EPCI
200067130,CC de Puisaye-Forterre,1990_1999,1994.5,9,33773,34594,4944,2727,821,-2217,3038,0.00267229644963662,-0.00721617689262411,0.00988847334226073,EPCI
200067130,CC de Puisaye-Forterre,1999_2010,2004.5,11,34594,36171,6052,3402,1577,-2650,4227,0.00406071665633911,-0.00682365195897188,0.010884368615311,EPCI
200067155,"CC Saint Affricain, Roquefort, Sept Vallons",2010_2015,2012.5,5,13791,13887,757,633,96,-124,220,0.00138835191442954,-0.00179328788947149,0.00318163980390103,EPCI
200067155,"CC Saint Affricain, Roquefort, Sept Vallons",1968_1975,1971.5,7,14366,14099,1270,1221,-267,-49,-218,-0.00267647337976984,-0.00049118799853454,-0.0021852853812353,EPCI
200067155,"CC Saint Affricain, Roquefort, Sept Vallons",1975_1982,1978.5,7,14099,14330,1173,1022,231,-151,382,0.00232432119278947,-0.0015193614723429,0.00384368266513237,EPCI
200067155,"CC Saint Affricain, Roquefort, Sept Vallons",1982_1990,1986,8,14330,13608,1277,1055,-722,-222,-500,-0.00644133840497441,-0.00198057773670958,-0.00446076066826482,EPCI
200067155,"CC Saint Affricain, Roquefort, Sept Vallons",1990_1999,1994.5,9,13608,12975,1396,1100,-633,-296,-337,-0.00527862174724447,-0.00246836024831653,-0.00281026149892794,EPCI
200067155,"CC Saint Affricain, Roquefort, Sept Vallons",1999_2010,2004.5,11,12975,13791,1601,1400,816,-201,1017,0.00556010728698597,-0.00136958525083846,0.00692969253782443,EPCI
200067163,"CC Monts, Rance et Rougier",2010_2015,2012.5,5,6569,6360,439,243,-209,-196,-13,-0.00644578354503267,-0.00604484964031772,-0.000400933904714951,EPCI
200067163,"CC Monts, Rance et Rougier",1968_1975,1971.5,7,9212,8023,841,625,-1189,-216,-973,-0.0195484819723816,-0.00355128015646293,-0.0159972018159186,EPCI
200067163,"CC Monts, Rance et Rougier",1975_1982,1978.5,7,8023,7565,831,496,-458,-335,-123,-0.00836199517944725,-0.00611630651771796,-0.00224568866172928,EPCI
200067163,"CC Monts, Rance et Rougier",1982_1990,1986,8,7565,6962,897,554,-603,-343,-260,-0.0103294754516472,-0.00587563860682419,-0.004453836844823,EPCI
200067163,"CC Monts, Rance et Rougier",1990_1999,1994.5,9,6962,6558,901,486,-404,-415,11,-0.0066203340482397,-0.00680059066836503,0.000180256620125338,EPCI
200067163,"CC Monts, Rance et Rougier",1999_2010,2004.5,11,6558,6569,879,631,11,-248,259,0.000152369378660255,-0.00343523690070394,0.00358760627936419,EPCI
200067171,"CC Aubrac, Carladez et Viadène",2010_2015,2012.5,5,10623,10295,927,338,-328,-589,261,-0.00625299242521116,-0.0112286967635652,0.004975704338354,EPCI
200067171,"CC Aubrac, Carladez et Viadène",1968_1975,1971.5,7,14580,13312,1526,1195,-1268,-331,-937,-0.01291372758795,-0.00337101248549798,-0.00954271510245198,EPCI
200067171,"CC Aubrac, Carladez et Viadène",1975_1982,1978.5,7,13312,13039,1528,1002,-273,-526,253,-0.00295576846629131,-0.0056949971182023,0.00273922865191099,EPCI
200067171,"CC Aubrac, Carladez et Viadène",1982_1990,1986,8,13039,12001,1630,948,-1038,-682,-356,-0.0103157843713153,-0.00677780822855206,-0.00353797614276325,EPCI
200067171,"CC Aubrac, Carladez et Viadène",1990_1999,1994.5,9,12001,11049,1654,779,-952,-875,-77,-0.00914130120137391,-0.00840193125126278,-0.000739369950111125,EPCI
200067171,"CC Aubrac, Carladez et Viadène",1999_2010,2004.5,11,11049,10623,2041,976,-426,-1065,639,-0.00356802526441402,-0.00892006316103505,0.00535203789662103,EPCI
200067189,CC Creuse Sud Ouest,2010_2015,2012.5,5,14444,13938,1201,503,-506,-698,192,-0.00710666346575439,-0.00980326304169282,0.00269659957593843,EPCI
200067189,CC Creuse Sud Ouest,1968_1975,1971.5,7,20380,18262,2476,1326,-2118,-1150,-968,-0.0155537189413532,-0.00844512595965823,-0.00710859298169493,EPCI
200067189,CC Creuse Sud Ouest,1975_1982,1978.5,7,18262,17174,2446,984,-1088,-1462,374,-0.00873672335106202,-0.0117399720029896,0.00300324865192757,EPCI
200067189,CC Creuse Sud Ouest,1982_1990,1986,8,17174,15688,2595,1099,-1486,-1496,10,-0.0112488189564606,-0.0113245176035431,7.56986470825064e-05,EPCI
200067189,CC Creuse Sud Ouest,1990_1999,1994.5,9,15688,14993,2524,1223,-695,-1301,606,-0.00502208731423848,-0.00940105841125793,0.00437897109701945,EPCI
200067189,CC Creuse Sud Ouest,1999_2010,2004.5,11,14993,14444,2582,1395,-549,-1187,638,-0.00338555803922413,-0.00731995882069043,0.0039344007814663,EPCI
200067197,CC Monts d'Arrée Communauté,2010_2015,2012.5,5,8326,8181,718,346,-145,-372,227,-0.00350758524837136,-0.00899877043030445,0.00549118518193309,EPCI
200067197,CC Monts d'Arrée Communauté,1968_1975,1971.5,7,12482,10656,1496,684,-1826,-812,-1014,-0.0223415739118639,-0.00993502629596575,-0.0124065476158981,EPCI
200067197,CC Monts d'Arrée Communauté,1975_1982,1978.5,7,10656,9561,1549,538,-1095,-1011,-84,-0.0153707580834772,-0.0141916314359776,-0.00117912664749962,EPCI
200067197,CC Monts d'Arrée Communauté,1982_1990,1986,8,9561,8504,1565,663,-1057,-902,-155,-0.0145377518045859,-0.0124059149742067,-0.0021318368303792,EPCI
200067197,CC Monts d'Arrée Communauté,1990_1999,1994.5,9,8504,8279,1510,602,-225,-908,683,-0.00297494969476764,-0.0120055747682178,0.0090306250734502,EPCI
200067197,CC Monts d'Arrée Communauté,1999_2010,2004.5,11,8279,8326,1619,793,47,-826,873,0.000514765229453484,-0.00904672509635273,0.00956149032580621,EPCI
200067205,CA du Cotentin,2010_2015,2012.5,5,183091,181321,8788,9727,-1770,939,-2709,-0.00194098501462847,0.00102970899928595,-0.00297069401391442,EPCI
200067205,CA du Cotentin,1968_1975,1971.5,7,153879,154034,11001,19745,155,8744,-8589,0.000143835768172007,0.00811419327029697,-0.00797035750212496,EPCI
200067205,CA du Cotentin,1975_1982,1978.5,7,154034,165887,10881,17550,11853,6669,5184,0.010646774432741,0.00599032638926429,0.00465644804347669,EPCI
200067205,CA du Cotentin,1982_1990,1986,8,165887,183218,12770,24098,17331,11328,6003,0.0124986972971002,0.00816947914035837,0.00432921815674182,EPCI
200067205,CA du Cotentin,1990_1999,1994.5,9,183218,182904,14114,23569,-314,9455,-9769,-0.000190568023682114,0.0057382823691541,-0.00592885039283621,EPCI
200067205,CA du Cotentin,1999_2010,2004.5,11,182904,183091,17721,23751,187,6030,-5843,9.29017671398302e-05,0.00299570938958918,-0.00290280762244935,EPCI
200067213,CU du Grand Reims,2010_2015,2012.5,5,288057,294724,11211,18600,6667,7389,-722,0.00458667633778886,0.00508338854956081,-0.000496712211771945,EPCI
200067213,CU du Grand Reims,1968_1975,1971.5,7,220280,252806,15034,32835,32526,17801,14725,0.0198695271332228,0.010874299099136,0.00899522803408674,EPCI
200067213,CU du Grand Reims,1975_1982,1978.5,7,252806,264704,15394,31238,11898,15844,-3946,0.00659160454187702,0.00877772586665822,-0.0021861213247812,EPCI
200067213,CU du Grand Reims,1982_1990,1986,8,264704,278439,17297,34321,13735,17024,-3289,0.0063433826077306,0.00786237681208633,-0.00151899420435573,EPCI
200067213,CU du Grand Reims,1990_1999,1994.5,9,278439,288789,18973,34581,10350,15608,-5258,0.0040634906578898,0.00612782243365643,-0.00206433177576663,EPCI
200067213,CU du Grand Reims,1999_2010,2004.5,11,288789,288057,24084,40834,-732,16750,-17482,-0.000230695243116252,0.005278887052182,-0.00550958229529826,EPCI
200067221,CC Centre Morbihan Communauté,2010_2015,2012.5,5,41436,42478,2214,2581,1042,367,675,0.00497960254509167,0.0017538523359392,0.00322575020915247,EPCI
200067221,CC Centre Morbihan Communauté,1968_1975,1971.5,7,36619,36482,3366,3845,-137,479,-616,-0.000535319968900661,0.00187166616863808,-0.00240698613753874,EPCI
200067221,CC Centre Morbihan Communauté,1975_1982,1978.5,7,36482,35966,3408,3263,-516,-145,-371,-0.00203292231172725,-0.000571266928683044,-0.0014616553830442,EPCI
200067221,CC Centre Morbihan Communauté,1982_1990,1986,8,35966,35190,3839,3548,-776,-291,-485,-0.00272279849299339,-0.00102104943487252,-0.00170174905812087,EPCI
200067221,CC Centre Morbihan Communauté,1990_1999,1994.5,9,35190,35031,3936,3420,-159,-516,357,-0.000503047603750084,-0.00163253184613235,0.00112948424238226,EPCI
200067221,CC Centre Morbihan Communauté,1999_2010,2004.5,11,35031,41436,4524,5400,6405,876,5529,0.0153822607100067,0.0021038033383241,0.0132784573716826,EPCI
200067239,CC des Luys en Béarn,2010_2015,2012.5,5,26582,27904,1155,1370,1322,215,1107,0.00975441775083441,0.00158638412740499,0.00816803362342942,EPCI
200067239,CC des Luys en Béarn,1968_1975,1971.5,7,15045,15824,1418,1254,779,-164,943,0.00723779064608632,-0.00152374539917607,0.00876153604526238,EPCI
200067239,CC des Luys en Béarn,1975_1982,1978.5,7,15824,18571,1438,1132,2747,-306,3053,0.0231311044683435,-0.00257667199392542,0.025707776462269,EPCI
200067239,CC des Luys en Béarn,1982_1990,1986,8,18571,20166,1656,1584,1595,-72,1667,0.0103528226618246,-0.000467337449311204,0.0108201601111358,EPCI
200067239,CC des Luys en Béarn,1990_1999,1994.5,9,20166,22298,1777,1883,2132,106,2026,0.0112291309209167,0.000558296377869217,0.0106708345430475,EPCI
200067239,CC des Luys en Béarn,1999_2010,2004.5,11,22298,26582,2246,2861,4284,615,3669,0.0161044193099771,0.00231190893455553,0.0137925103754215,EPCI
200067247,CC Pleyben-Châteaulin-Porzay,2010_2015,2012.5,5,22633,23166,1416,1124,533,-292,825,0.00466618655297668,-0.00255633484703413,0.00722252140001081,EPCI
200067247,CC Pleyben-Châteaulin-Porzay,1968_1975,1971.5,7,21807,21120,2192,1813,-687,-379,-308,-0.00456249723290947,-0.00251701084610289,-0.00204548638680657,EPCI
200067247,CC Pleyben-Châteaulin-Porzay,1975_1982,1978.5,7,21120,21752,2206,1526,632,-680,1312,0.00422106204811934,-0.00454164903911575,0.00876271108723508,EPCI
200067247,CC Pleyben-Châteaulin-Porzay,1982_1990,1986,8,21752,21014,2379,1872,-738,-507,-231,-0.0043053086050554,-0.00295771200916408,-0.00134759659589133,EPCI
200067247,CC Pleyben-Châteaulin-Porzay,1990_1999,1994.5,9,21014,20823,2587,2079,-191,-508,317,-0.00101401190223815,-0.00269695312218315,0.001682941219945,EPCI
200067247,CC Pleyben-Châteaulin-Porzay,1999_2010,2004.5,11,20823,22633,3006,2688,1810,-318,2128,0.0076061328917123,-0.00133632611025664,0.00894245900196894,EPCI
200067254,CA Pau Béarn Pyrénées,2010_2015,2012.5,5,163531,161891,7301,8466,-1640,1165,-2805,-0.00201383062529403,0.0014305565112607,-0.00344438713655473,EPCI
200067254,CA Pau Béarn Pyrénées,1968_1975,1971.5,7,120839,137003,8401,15487,16164,7086,9078,0.0180966150271493,0.00793322284597749,0.0101633921811718,EPCI
200067254,CA Pau Béarn Pyrénées,1975_1982,1978.5,7,137003,143165,8840,13554,6162,4714,1448,0.00630479030794118,0.00482323620766548,0.00148155410027569,EPCI
200067254,CA Pau Béarn Pyrénées,1982_1990,1986,8,143165,149217,10780,15009,6052,4229,1823,0.00518889229407504,0.00362587995896288,0.00156301233511216,EPCI
200067254,CA Pau Béarn Pyrénées,1990_1999,1994.5,9,149217,154488,12040,15876,5271,3836,1435,0.0038646486947278,0.00281251990001439,0.00105212879471341,EPCI
200067254,CA Pau Béarn Pyrénées,1999_2010,2004.5,11,154488,163531,15245,19290,9043,4045,4998,0.00518486343155944,0.00231922731180559,0.00286563611975385,EPCI
200067262,CC du Haut-Béarn,2010_2015,2012.5,5,32009,32418,1896,1389,409,-507,916,0.00254256902683392,-0.003151790945244,0.00569435997207792,EPCI
200067262,CC du Haut-Béarn,1968_1975,1971.5,7,30899,30742,2794,2682,-157,-112,-45,-0.000727452866022271,-0.000518947267480856,-0.000208505598541415,EPCI
200067262,CC du Haut-Béarn,1975_1982,1978.5,7,30742,30706,2796,2372,-36,-424,388,-0.000167374929258113,-0.00197130472237333,0.00180392979311522,EPCI
200067262,CC du Haut-Béarn,1982_1990,1986,8,30706,31073,3265,2715,367,-550,917,0.00148625334017449,-0.00222735514195087,0.00371360848212537,EPCI
200067262,CC du Haut-Béarn,1990_1999,1994.5,9,31073,31080,3469,2690,7,-779,786,2.50281567808486e-05,-0.00278527630461158,0.00281030446139243,EPCI
200067262,CC du Haut-Béarn,1999_2010,2004.5,11,31080,32009,4352,3250,929,-1102,2031,0.00268109570372732,-0.00318037402099839,0.00586146972472572,EPCI
200067288,CC du Béarn des Gaves,2010_2015,2012.5,5,17762,17657,1294,749,-105,-545,440,-0.00118510491099544,-0.00615125882373823,0.00496615391274279,EPCI
200067288,CC du Béarn des Gaves,1968_1975,1971.5,7,18937,18673,1931,1595,-264,-336,72,-0.00200356874882146,-0.00254999658940913,0.000546427840587671,EPCI
200067288,CC du Béarn des Gaves,1975_1982,1978.5,7,18673,17896,1880,1243,-777,-637,-140,-0.00605323434181315,-0.0049625614874324,-0.00109067285438075,EPCI
200067288,CC du Béarn des Gaves,1982_1990,1986,8,17896,17284,2167,1293,-612,-874,262,-0.00434005538550664,-0.00619805295250458,0.00185799756699794,EPCI
200067288,CC du Béarn des Gaves,1990_1999,1994.5,9,17284,16778,2425,1390,-506,-1035,529,-0.00329596895686779,-0.0067417546845023,0.00344578572763451,EPCI
200067288,CC du Béarn des Gaves,1999_2010,2004.5,11,16778,17762,2878,1682,984,-1196,2180,0.00519461267719468,-0.00631377719707808,0.0115083898742728,EPCI
200067296,CC du Nord Est Béarn,2010_2015,2012.5,5,32334,33775,1216,1708,1441,492,949,0.0087584478438707,0.00299039301817098,0.00576805482569972,EPCI
200067296,CC du Nord Est Béarn,1968_1975,1971.5,7,19588,20219,1815,1677,631,-138,769,0.00453964777107219,-0.00099282312584463,0.00553247089691682,EPCI
200067296,CC du Nord Est Béarn,1975_1982,1978.5,7,20219,23167,1846,1635,2948,-211,3159,0.0196339883883732,-0.00140528207257352,0.0210392704609467,EPCI
200067296,CC du Nord Est Béarn,1982_1990,1986,8,23167,26102,1993,2063,2935,70,2865,0.0150221002805491,0.000358278371256707,0.0146638219092924,EPCI
200067296,CC du Nord Est Béarn,1990_1999,1994.5,9,26102,27383,2174,2287,1281,113,1168,0.00533757694843451,0.000470840121134348,0.00486673682730016,EPCI
200067296,CC du Nord Est Béarn,1999_2010,2004.5,11,27383,32334,2660,3461,4951,801,4150,0.015223526489198,0.00246294581253234,0.0127605806766657,EPCI
200067304,CC Serein et Armance,2010_2015,2012.5,5,24867,24518,1284,1386,-349,102,-451,-0.00282282463782069,0.000825008919936132,-0.00364783355775682,EPCI
200067304,CC Serein et Armance,1968_1975,1971.5,7,20950,23305,2269,2382,2355,113,2242,0.0153348596448348,0.000735812798244729,0.0145990468465901,EPCI
200067304,CC Serein et Armance,1975_1982,1978.5,7,23305,24099,2187,2318,794,131,663,0.00479753090978807,0.000791532177811382,0.00400599873197669,EPCI
200067304,CC Serein et Armance,1982_1990,1986,8,24099,24937,2445,2818,838,373,465,0.00428192867876076,0.001905918135057,0.00237601054370376,EPCI
200067304,CC Serein et Armance,1990_1999,1994.5,9,24937,25083,2590,2698,146,108,38,0.000648841685898738,0.000479965082719614,0.000168876603179124,EPCI
200067304,CC Serein et Armance,1999_2010,2004.5,11,25083,24867,2970,3416,-216,446,-662,-0.000785936676990229,0.00162281369415575,-0.00240875037114598,EPCI
200067320,CC Serre-Ponçon Val d'Avance,2010_2015,2012.5,5,6969,7425,247,415,456,168,288,0.0127568718822866,0.00469990016715821,0.00805697171512837,EPCI
200067320,CC Serre-Ponçon Val d'Avance,1968_1975,1971.5,7,3500,3502,314,294,2,-20,22,8.16126684601848e-05,-0.000816126684601848,0.000897739353062033,EPCI
200067320,CC Serre-Ponçon Val d'Avance,1975_1982,1978.5,7,3502,4005,321,246,503,-75,578,0.0193577415309665,-0.00288634317062124,0.0222440847015877,EPCI
200067320,CC Serre-Ponçon Val d'Avance,1982_1990,1986,8,4005,4754,330,383,749,53,696,0.0216616276476014,0.00153279875209996,0.0201288288955014,EPCI
200067320,CC Serre-Ponçon Val d'Avance,1990_1999,1994.5,9,4754,5593,381,523,839,142,697,0.0182228740663697,0.00308420514591716,0.0151386689204525,EPCI
200067320,CC Serre-Ponçon Val d'Avance,1999_2010,2004.5,11,5593,6969,484,779,1376,295,1081,0.0201972524236296,0.00433007955303105,0.0158671728705985,EPCI
200067346,CA Pornic Agglo Pays de Retz,2010_2015,2012.5,5,51092,55815,2497,3025,4723,528,4195,0.0178402131407314,0.00199441722174596,0.0158457959189854,EPCI
200067346,CA Pornic Agglo Pays de Retz,1968_1975,1971.5,7,26560,27591,2502,3145,1031,643,388,0.00545529881458595,0.00340228626360695,0.002053012550979,EPCI
200067346,CA Pornic Agglo Pays de Retz,1975_1982,1978.5,7,27591,30249,2524,2799,2658,275,2383,0.0132257673747735,0.0013683544123637,0.0118574129624098,EPCI
200067346,CA Pornic Agglo Pays de Retz,1982_1990,1986,8,30249,32770,3036,3255,2521,219,2302,0.0100565224195488,0.000873613014629586,0.00918290940491921,EPCI
200067346,CA Pornic Agglo Pays de Retz,1990_1999,1994.5,9,32770,38418,3565,3725,5648,160,5488,0.0178250744339219,0.000504959615691838,0.0173201148182301,EPCI
200067346,CA Pornic Agglo Pays de Retz,1999_2010,2004.5,11,38418,51092,4724,6560,12674,1836,10838,0.0262571492356465,0.00380370254036981,0.0224534466952767,EPCI
200067361,CC Grand-Figeac,2010_2015,2012.5,5,42949,43360,2704,1771,411,-933,1344,0.00190661365266798,-0.00432815216043606,0.00623476581310404,EPCI
200067361,CC Grand-Figeac,1968_1975,1971.5,7,42604,42113,3867,3755,-491,-112,-379,-0.00165458166220156,-0.000377419849626425,-0.00127716181257513,EPCI
200067361,CC Grand-Figeac,1975_1982,1978.5,7,42113,42073,3946,2936,-40,-1010,970,-0.000135744620096467,-0.0034275516574358,0.00329180703733933,EPCI
200067361,CC Grand-Figeac,1982_1990,1986,8,42073,40427,4374,2857,-1646,-1517,-129,-0.00497611867102643,-0.00458613124176616,-0.000389987429260274,EPCI
200067361,CC Grand-Figeac,1990_1999,1994.5,9,40427,39931,4684,3114,-496,-1570,1074,-0.00137071681794521,-0.00433876089551204,0.00296804407756684,EPCI
200067361,CC Grand-Figeac,1999_2010,2004.5,11,39931,42949,5743,4196,3018,-1547,4565,0.00664565782380944,-0.00340650518669092,0.0100521630105004,EPCI
200067379,CC Côtes de Champagne et Val de Saulx,2010_2015,2012.5,5,12244,12083,607,664,-161,57,-218,-0.0026438019910906,0.000936004431628349,-0.00357980642271895,EPCI
200067379,CC Côtes de Champagne et Val de Saulx,1968_1975,1971.5,7,13322,12995,977,1487,-327,510,-837,-0.00354401024675421,0.00552735543071758,-0.0090713656774718,EPCI
200067379,CC Côtes de Champagne et Val de Saulx,1975_1982,1978.5,7,12995,12797,908,1131,-198,223,-421,-0.00219101045881109,0.00246765319350946,-0.00465866365232056,EPCI
200067379,CC Côtes de Champagne et Val de Saulx,1982_1990,1986,8,12797,12230,984,1269,-567,285,-852,-0.00564883732368438,0.00283936267592601,-0.00848819999961038,EPCI
200067379,CC Côtes de Champagne et Val de Saulx,1990_1999,1994.5,9,12230,11792,1050,1100,-438,50,-488,-0.00404409102267556,0.000461654226332826,-0.00450574524900838,EPCI
200067379,CC Côtes de Champagne et Val de Saulx,1999_2010,2004.5,11,11792,12244,1328,1470,452,142,310,0.0034253700936735,0.00107611184358769,0.00234925825008581,EPCI
200067429,CC Haut Nivernais-Val d'Yonne,2010_2015,2012.5,5,13626,12808,1184,546,-818,-638,-180,-0.0123056103801836,-0.00959777435520435,-0.00270783602497928,EPCI
200067429,CC Haut Nivernais-Val d'Yonne,1968_1975,1971.5,7,16895,16365,1911,1468,-530,-443,-87,-0.00454290851959893,-0.00379718580034401,-0.000745722719254919,EPCI
200067429,CC Haut Nivernais-Val d'Yonne,1975_1982,1978.5,7,16365,15425,1994,1229,-940,-765,-175,-0.0084151552739139,-0.00684850402611078,-0.00156665124780312,EPCI
200067429,CC Haut Nivernais-Val d'Yonne,1982_1990,1986,8,15425,14781,2063,1297,-644,-766,122,-0.00531669079806707,-0.00632388998652077,0.0010071991884537,EPCI
200067429,CC Haut Nivernais-Val d'Yonne,1990_1999,1994.5,9,14781,14067,2218,1264,-714,-954,240,-0.00548611196041182,-0.00733018320760907,0.00184407124719725,EPCI
200067429,CC Haut Nivernais-Val d'Yonne,1999_2010,2004.5,11,14067,13626,2439,1368,-441,-1071,630,-0.00289143866347874,-0.00702206532559123,0.00413062666211249,EPCI
200067437,CA Provence-Alpes-Agglomération,2010_2015,2012.5,5,47694,47302,2434,2325,-392,-109,-283,-0.00164924368385866,-0.000458590718215801,-0.00119065296564286,EPCI
200067437,CA Provence-Alpes-Agglomération,1968_1975,1971.5,7,34650,36310,2497,3372,1660,875,785,0.00670746061197591,0.00353555905751742,0.00317190155445849,EPCI
200067437,CA Provence-Alpes-Agglomération,1975_1982,1978.5,7,36310,37478,2719,2717,1168,-2,1170,0.00453323110544512,-7.76238202987179e-06,0.004540993487475,EPCI
200067437,CA Provence-Alpes-Agglomération,1982_1990,1986,8,37478,40786,3173,3723,3308,550,2758,0.0106291916166597,0.00176724769926324,0.00886194391739641,EPCI
200067437,CA Provence-Alpes-Agglomération,1990_1999,1994.5,9,40786,42929,3835,4329,2143,494,1649,0.00570607385927469,0.00131535253685567,0.00439072132241902,EPCI
200067437,CA Provence-Alpes-Agglomération,1999_2010,2004.5,11,42929,47694,4754,5121,4765,367,4398,0.00961483891017378,0.000740534287520205,0.00887430462265358,EPCI
200067445,CC Buëch-Dévoluy,2010_2015,2012.5,5,9181,9267,464,437,86,-27,113,0.00186645394944285,-0.000585979728313452,0.0024524336777563,EPCI
200067445,CC Buëch-Dévoluy,1968_1975,1971.5,7,7758,7305,734,624,-453,-110,-343,-0.00855824277535422,-0.00207816049732663,-0.00648008227802759,EPCI
200067445,CC Buëch-Dévoluy,1975_1982,1978.5,7,7305,7468,730,443,163,-287,450,0.0031575718718877,-0.00555965108731147,0.00871722295919917,EPCI
200067445,CC Buëch-Dévoluy,1982_1990,1986,8,7468,7611,811,630,143,-181,324,0.00237373079925862,-0.00300451241025042,0.00537824320950905,EPCI
200067445,CC Buëch-Dévoluy,1990_1999,1994.5,9,7611,7994,862,663,383,-199,582,0.00547009452060476,-0.00284216399373459,0.00831225851433935,EPCI
200067445,CC Buëch-Dévoluy,1999_2010,2004.5,11,7994,9181,1092,863,1187,-229,1416,0.0126654330840423,-0.0024434576042508,0.0151088906882931,EPCI
200067452,CC du Guillestrois et du Queyras,2010_2015,2012.5,5,8124,7946,368,435,-178,67,-245,-0.00442099576444144,0.00166408267537964,-0.00608507843982108,EPCI
200067452,CC du Guillestrois et du Queyras,1968_1975,1971.5,7,5346,5672,457,561,326,104,222,0.00849202173449148,0.00270911122818133,0.00578291050631015,EPCI
200067452,CC du Guillestrois et du Queyras,1975_1982,1978.5,7,5672,6900,523,614,1228,91,1137,0.0283926906738872,0.00210401860856981,0.0262886720653174,EPCI
200067452,CC du Guillestrois et du Queyras,1982_1990,1986,8,6900,7233,522,743,333,221,112,0.00590894890325355,0.00392155467753464,0.00198739422571891,EPCI
200067452,CC du Guillestrois et du Queyras,1990_1999,1994.5,9,7233,7599,616,829,366,213,153,0.00549982121601333,0.00320071562571268,0.00229910559030066,EPCI
200067452,CC du Guillestrois et du Queyras,1999_2010,2004.5,11,7599,8124,835,1026,525,191,334,0.00609175097930192,0.00221623702294603,0.00387551395635589,EPCI
200067460,CC Loudéac Communauté - Bretagne Centre,2010_2015,2012.5,5,51691,51474,3153,2731,-217,-422,205,-0.000841018006682237,-0.00163552810516085,0.000794510098478611,EPCI
200067460,CC Loudéac Communauté - Bretagne Centre,1968_1975,1971.5,7,52140,52001,4943,5623,-139,680,-819,-0.000381278629051796,0.00186524796946202,-0.00224652659851382,EPCI
200067460,CC Loudéac Communauté - Bretagne Centre,1975_1982,1978.5,7,52001,52010,4780,4734,9,-46,55,2.47229654977144e-05,-0.000126361823654985,0.000151084789152699,EPCI
200067460,CC Loudéac Communauté - Bretagne Centre,1982_1990,1986,8,52010,51204,5183,4990,-806,-193,-613,-0.00195038973709583,-0.000467028808014261,-0.00148336092908156,EPCI
200067460,CC Loudéac Communauté - Bretagne Centre,1990_1999,1994.5,9,51204,49483,5461,4850,-1721,-611,-1110,-0.0037915137415242,-0.00134608651718262,-0.00244542722434158,EPCI
200067460,CC Loudéac Communauté - Bretagne Centre,1999_2010,2004.5,11,49483,51691,6451,6145,2208,-306,2514,0.00397647700403914,-0.000551087845668467,0.0045275648497076,EPCI
200067478,CC Comtal Lot et Truyère,2010_2015,2012.5,5,19118,19232,1295,833,114,-462,576,0.00118975894454043,-0.00482165466997964,0.00601141361452007,EPCI
200067478,CC Comtal Lot et Truyère,1968_1975,1971.5,7,17560,17685,1871,1462,125,-409,534,0.00101383278857758,-0.00331726088422586,0.00433109367280344,EPCI
200067478,CC Comtal Lot et Truyère,1975_1982,1978.5,7,17685,18468,1821,1449,783,-372,1155,0.00620814571957085,-0.00294946386676929,0.00915760958634014,EPCI
200067478,CC Comtal Lot et Truyère,1982_1990,1986,8,18468,18256,2111,1526,-212,-585,373,-0.00144217300821159,-0.00397958117831972,0.00253740817010813,EPCI
200067478,CC Comtal Lot et Truyère,1990_1999,1994.5,9,18256,18138,2205,1395,-118,-810,692,-0.000720252504033625,-0.00494410617175624,0.00422385366772261,EPCI
200067478,CC Comtal Lot et Truyère,1999_2010,2004.5,11,18138,19118,2718,1967,980,-751,1731,0.00479519803266948,-0.00367468747197426,0.00846988550464374,EPCI
200067486,CC Bouzonvillois-Trois Frontières,2010_2015,2012.5,5,24584,25096,991,1316,512,325,187,0.0041310385248694,0.0026222412511378,0.0015087972737316,EPCI
200067486,CC Bouzonvillois-Trois Frontières,1968_1975,1971.5,7,20485,20588,1663,2337,103,674,-571,0.000716752571832346,0.00469020614966021,-0.00397345357782786,EPCI
200067486,CC Bouzonvillois-Trois Frontières,1975_1982,1978.5,7,20588,21065,1597,2010,477,413,64,0.00327743245280532,0.00283769308806834,0.000439739364736982,EPCI
200067486,CC Bouzonvillois-Trois Frontières,1982_1990,1986,8,21065,21699,1775,2274,634,499,135,0.00371353829843235,0.00292280064813524,0.000790737650297109,EPCI
200067486,CC Bouzonvillois-Trois Frontières,1990_1999,1994.5,9,21699,22090,1815,2123,391,308,83,0.00198628571236292,0.00156464449976414,0.000421641212598779,EPCI
200067486,CC Bouzonvillois-Trois Frontières,1999_2010,2004.5,11,22090,24584,2085,2958,2494,873,1621,0.0097720566067856,0.00342061163501356,0.00635144497177203,EPCI
200067502,CA Saint-Avold Synergie,2010_2015,2012.5,5,55452,53807,2492,3035,-1645,543,-2188,-0.00600474133294426,0.001982112184674,-0.00798685351761827,EPCI
200067502,CA Saint-Avold Synergie,1968_1975,1971.5,7,51752,53445,2872,6856,1693,3984,-2291,0.00460916237374676,0.0108463691063243,-0.00623720673257757,EPCI
200067502,CA Saint-Avold Synergie,1975_1982,1978.5,7,53445,54924,2954,6202,1479,3248,-1769,0.00390723107847424,0.00858058589782578,-0.00467335481935154,EPCI
200067502,CA Saint-Avold Synergie,1982_1990,1986,8,54924,56093,3522,7060,1169,3538,-2369,0.00263604528622285,0.00797803954033914,-0.00534199425411629,EPCI
200067502,CA Saint-Avold Synergie,1990_1999,1994.5,9,56093,56064,3905,6335,-29,2430,-2459,-5.74574876779366e-05,0.00481454120887538,-0.00487199869655331,EPCI
200067502,CA Saint-Avold Synergie,1999_2010,2004.5,11,56064,55452,5140,6971,-612,1831,-2443,-0.000997330847198774,0.00298384441375973,-0.00398117526095851,EPCI
200067510,CC Monts et Vallées Ouest Creuse,2010_2015,2012.5,5,26160,25286,2186,888,-874,-1298,424,-0.00677308728404913,-0.0100588870648693,0.00328579978082017,EPCI
200067510,CC Monts et Vallées Ouest Creuse,1968_1975,1971.5,7,33874,30862,3874,2235,-3012,-1639,-1373,-0.013215061911273,-0.00719106456592842,-0.00602399734534455,EPCI
200067510,CC Monts et Vallées Ouest Creuse,1975_1982,1978.5,7,30862,29003,3854,1625,-1859,-2229,370,-0.00883592894224716,-0.0105945592319897,0.00175863028974258,EPCI
200067510,CC Monts et Vallées Ouest Creuse,1982_1990,1986,8,29003,27059,4172,1679,-1944,-2493,549,-0.00863495349604548,-0.0110735283259472,0.00243857482990173,EPCI
200067510,CC Monts et Vallées Ouest Creuse,1990_1999,1994.5,9,27059,25613,4160,1781,-1446,-2379,933,-0.0060836008436701,-0.0100089117614738,0.00392531091780374,EPCI
200067510,CC Monts et Vallées Ouest Creuse,1999_2010,2004.5,11,25613,26160,4896,2212,547,-2684,3231,0.00192289106998689,-0.00943517300154443,0.0113580640715313,EPCI
200067544,CC Creuse Confluence,2010_2015,2012.5,5,17478,17025,1456,628,-453,-828,375,-0.0052382512953425,-0.00957455203652006,0.00433630074117757,EPCI
200067544,CC Creuse Confluence,1968_1975,1971.5,7,23628,21500,2881,1587,-2128,-1294,-834,-0.0133923020987151,-0.00814362731002695,-0.00524867478868816,EPCI
200067544,CC Creuse Confluence,1975_1982,1978.5,7,21500,20169,2649,1152,-1331,-1497,166,-0.00908790493816214,-0.0102213326013739,0.00113342766321181,EPCI
200067544,CC Creuse Confluence,1982_1990,1986,8,20169,18472,2823,1263,-1697,-1560,-137,-0.0109262081089726,-0.0100441276664686,-0.000882080442503977,EPCI
200067544,CC Creuse Confluence,1990_1999,1994.5,9,18472,17337,2900,1280,-1135,-1620,485,-0.00702113871660504,-0.0100213609875772,0.0030002222709722,EPCI
200067544,CC Creuse Confluence,1999_2010,2004.5,11,17337,17478,3335,1552,141,-1783,1924,0.000736634927941848,-0.00931503600369018,0.010051670931632,EPCI
200067551,CA Thonon Agglomération,2010_2015,2012.5,5,80117,85817,2950,5226,5700,2276,3424,0.0138407191869578,0.00552657488938878,0.00831414429756906,EPCI
200067551,CA Thonon Agglomération,1968_1975,1971.5,7,35546,44322,2701,4418,8776,1717,7059,0.0320240113841788,0.00626540879063753,0.0257586025935412,EPCI
200067551,CA Thonon Agglomération,1975_1982,1978.5,7,44322,48943,2963,4311,4621,1348,3273,0.0142687241233652,0.00416235449432943,0.0101063696290358,EPCI
200067551,CA Thonon Agglomération,1982_1990,1986,8,48943,58778,3714,5667,9835,1953,7882,0.0231528711232314,0.00459761640098331,0.0185552547222481,EPCI
200067551,CA Thonon Agglomération,1990_1999,1994.5,9,58778,64612,4348,6998,5834,2650,3184,0.0105701980629547,0.00480134125245627,0.0057688568104984,EPCI
200067551,CA Thonon Agglomération,1999_2010,2004.5,11,64612,80117,5797,9465,15505,3668,11837,0.0197458675030162,0.00467125714292573,0.0150746103600905,EPCI
200067593,"CC Chénérailles, Auzances/Bellegarde et Haut Pays Marchois",2010_2015,2012.5,5,14277,13816,1114,515,-461,-599,138,-0.00654300271906771,-0.00850164561544807,0.00195864289638036,EPCI
200067593,"CC Chénérailles, Auzances/Bellegarde et Haut Pays Marchois",1968_1975,1971.5,7,21610,19587,2743,1615,-2023,-1128,-895,-0.013943320131497,-0.00777462437386487,-0.00616869575763214,EPCI
200067593,"CC Chénérailles, Auzances/Bellegarde et Haut Pays Marchois",1975_1982,1978.5,7,19587,17951,2490,1055,-1636,-1435,-201,-0.0123827318896034,-0.0108613815779834,-0.00152135031161997,EPCI
200067593,"CC Chénérailles, Auzances/Bellegarde et Haut Pays Marchois",1982_1990,1986,8,17951,16280,2615,1084,-1671,-1531,-140,-0.0121392751176868,-0.0111222203501965,-0.00101705476749021,EPCI
200067593,"CC Chénérailles, Auzances/Bellegarde et Haut Pays Marchois",1990_1999,1994.5,9,16280,14789,2500,1047,-1491,-1453,-38,-0.0106158827869,-0.0103453237353224,-0.000270559051577598,EPCI
200067593,"CC Chénérailles, Auzances/Bellegarde et Haut Pays Marchois",1999_2010,2004.5,11,14789,14277,2926,1243,-512,-1683,1171,-0.00319794930291895,-0.0105120091343996,0.00731405983148064,EPCI
200067627,CC Billom Communauté,2010_2015,2012.5,5,24272,25524,1245,1415,1252,170,1082,0.0101099160256077,0.00137275217600105,0.00873716384960668,EPCI
200067627,CC Billom Communauté,1968_1975,1971.5,7,14893,15140,1675,1423,247,-252,499,0.00235261221730521,-0.00240023594640045,0.00475284816370566,EPCI
200067627,CC Billom Communauté,1975_1982,1978.5,7,15140,16463,1542,1195,1323,-347,1670,0.0120397860584685,-0.00315782748472302,0.0151976135431915,EPCI
200067627,CC Billom Communauté,1982_1990,1986,8,16463,17928,1742,1639,1465,-103,1568,0.0107130149997081,-0.000753201737180844,0.011466216736889,EPCI
200067627,CC Billom Communauté,1990_1999,1994.5,9,17928,19585,1920,1775,1657,-145,1802,0.00987064444764107,-0.000863755850879877,0.010734400298521,EPCI
200067627,CC Billom Communauté,1999_2010,2004.5,11,19585,24272,2556,3008,4687,452,4235,0.0196968783526639,0.00189950693735952,0.0177973714153044,EPCI
200067635,CA Clisson Sèvre et Maine Agglo,2010_2015,2012.5,5,50794,53404,1802,3442,2610,1640,970,0.0100718656502967,0.00632868186455426,0.00374318378574246,EPCI
200067635,CA Clisson Sèvre et Maine Agglo,1968_1975,1971.5,7,26647,29016,2194,3437,2369,1243,1126,0.0122415834004985,0.00642308491634431,0.00581849848415422,EPCI
200067635,CA Clisson Sèvre et Maine Agglo,1975_1982,1978.5,7,29016,34256,2223,3761,5240,1538,3702,0.0239998015701057,0.00704421656771424,0.0169555850023915,EPCI
200067635,CA Clisson Sèvre et Maine Agglo,1982_1990,1986,8,34256,37702,2455,4263,3446,1808,1638,0.0120534912650567,0.00632406041997172,0.005729430845085,EPCI
200067635,CA Clisson Sèvre et Maine Agglo,1990_1999,1994.5,9,37702,41113,2792,4514,3411,1722,1689,0.00966992445732706,0.00488173846834277,0.00478818598898429,EPCI
200067635,CA Clisson Sèvre et Maine Agglo,1999_2010,2004.5,11,41113,50794,3807,7400,9681,3593,6088,0.0194090315550124,0.00720345526052676,0.0122055762944856,EPCI
200067643,"CC Meurthe, Mortagne, Moselle",2010_2015,2012.5,5,16674,16776,920,933,102,13,89,0.00122047890117205,0.00015555123250232,0.00106492766866973,EPCI
200067643,"CC Meurthe, Mortagne, Moselle",1968_1975,1971.5,7,15232,14781,1266,1549,-451,283,-734,-0.00428449607674852,0.00268849753818145,-0.00697299361492997,EPCI
200067643,"CC Meurthe, Mortagne, Moselle",1975_1982,1978.5,7,14781,15322,1352,1278,541,-74,615,0.00514851282834861,-0.000704232808313858,0.00585274563666246,EPCI
200067643,"CC Meurthe, Mortagne, Moselle",1982_1990,1986,8,15322,15059,1468,1618,-263,150,-413,-0.00216189535442834,0.00123302016412263,-0.00339491551855097,EPCI
200067643,"CC Meurthe, Mortagne, Moselle",1990_1999,1994.5,9,15059,15270,1629,1564,211,-65,276,0.00154722907300431,-0.00047663454855583,0.00202386362156014,EPCI
200067643,"CC Meurthe, Mortagne, Moselle",1999_2010,2004.5,11,15270,16674,1893,2055,1404,162,1242,0.00802846582864403,0.000926361441766618,0.00710210438687741,EPCI
200067650,CC Houve-Pays Boulageois,2010_2015,2012.5,5,22687,23237,874,1264,550,390,160,0.0048022465339026,0.00340522936040366,0.00139701717349894,EPCI
200067650,CC Houve-Pays Boulageois,1968_1975,1971.5,7,17139,17846,1280,1895,707,615,92,0.00579139495477321,0.00503777637508561,0.000753618579687603,EPCI
200067650,CC Houve-Pays Boulageois,1975_1982,1978.5,7,17846,19451,1359,1830,1605,471,1134,0.0123787168747433,0.00363263280249478,0.00874608407224857,EPCI
200067650,CC Houve-Pays Boulageois,1982_1990,1986,8,19451,20162,1436,2149,711,713,-2,0.00449772981051377,0.00451038165245615,-1.26518419423741e-05,EPCI
200067650,CC Houve-Pays Boulageois,1990_1999,1994.5,9,20162,20180,1581,1831,18,250,-232,9.91571706043803e-05,0.00137718292506084,-0.00127802575445646,EPCI
200067650,CC Houve-Pays Boulageois,1999_2010,2004.5,11,20180,22687,1946,2565,2507,619,1888,0.0107023243559534,0.00264249652027729,0.00805982783567613,EPCI
200067668,"CC de la Cléry, du Betz et de l'Ouanne",2010_2015,2012.5,5,20561,20672,1123,1106,111,-17,128,0.00107738998080031,-0.000165005672735183,0.0012423956535355,EPCI
200067668,"CC de la Cléry, du Betz et de l'Ouanne",1968_1975,1971.5,7,13619,13310,1259,1188,-309,-71,-238,-0.0032732375506811,-0.000752103126531902,-0.00252113442414919,EPCI
200067668,"CC de la Cléry, du Betz et de l'Ouanne",1975_1982,1978.5,7,13310,14562,1294,1069,1252,-225,1477,0.0129256466041265,-0.00232289974914415,0.0152485463532707,EPCI
200067668,"CC de la Cléry, du Betz et de l'Ouanne",1982_1990,1986,8,14562,16101,1564,1320,1539,-244,1783,0.0126374341673374,-0.00200359580040957,0.014641029967747,EPCI
200067668,"CC de la Cléry, du Betz et de l'Ouanne",1990_1999,1994.5,9,16101,17743,1710,1550,1642,-160,1802,0.0108483871760556,-0.00105709010241711,0.0119054772784727,EPCI
200067668,"CC de la Cléry, du Betz et de l'Ouanne",1999_2010,2004.5,11,17743,20561,2206,2246,2818,40,2778,0.0134906435573103,0.000191492456455789,0.0132991511008545,EPCI
200067676,CC Canaux et Forêts en Gâtinais,2010_2015,2012.5,5,27943,28030,1630,1514,87,-116,203,0.000621922147417076,-0.000829229529889434,0.00145115167730651,EPCI
200067676,CC Canaux et Forêts en Gâtinais,1968_1975,1971.5,7,19859,20120,1958,1846,261,-112,373,0.00186703221681128,-0.000801178575796412,0.00266821079260769,EPCI
200067676,CC Canaux et Forêts en Gâtinais,1975_1982,1978.5,7,20120,21679,2064,1532,1559,-532,2091,0.0107184214929665,-0.00365760117656074,0.0143760226695273,EPCI
200067676,CC Canaux et Forêts en Gâtinais,1982_1990,1986,8,21679,23020,2343,1987,1341,-356,1697,0.00753063281528044,-0.00199918365565983,0.00952981647094027,EPCI
200067676,CC Canaux et Forêts en Gâtinais,1990_1999,1994.5,9,23020,24524,2607,2308,1504,-299,1803,0.00705687506160846,-0.00140292928418945,0.00845980434579791,EPCI
200067676,CC Canaux et Forêts en Gâtinais,1999_2010,2004.5,11,24524,27943,3225,3379,3419,154,3265,0.0119356215139343,0.000537609158568555,0.0113980123553658,EPCI
200067684,"CA Épernay, Coteaux et Plaine de Champagne",2010_2015,2012.5,5,49533,48623,2443,2785,-910,342,-1252,-0.00370162087394443,0.00139115861416373,-0.00509277948810817,EPCI
200067684,"CA Épernay, Coteaux et Plaine de Champagne",1968_1975,1971.5,7,49897,53517,4113,6559,3620,2446,1174,0.0100557194501767,0.00679455518650061,0.00326116426367609,EPCI
200067684,"CA Épernay, Coteaux et Plaine de Champagne",1975_1982,1978.5,7,53517,51773,3970,5313,-1744,1343,-3087,-0.00472175765612948,0.00363607828680154,-0.00835783594293102,EPCI
200067684,"CA Épernay, Coteaux et Plaine de Champagne",1982_1990,1986,8,51773,51182,4522,5897,-591,1375,-1966,-0.00143407948895768,0.00333647935248192,-0.00477055884143961,EPCI
200067684,"CA Épernay, Coteaux et Plaine de Champagne",1990_1999,1994.5,9,51182,50164,4830,5892,-1018,1062,-2080,-0.00222976257468377,0.0023261373814481,-0.00455589995613187,EPCI
200067684,"CA Épernay, Coteaux et Plaine de Champagne",1999_2010,2004.5,11,50164,49533,5568,6621,-631,1053,-1684,-0.00115011300739842,0.00191928525640339,-0.00306939826380181,EPCI
200067692,CC Tannay-Brinon-Corbigny,2010_2015,2012.5,5,10440,9980,847,321,-460,-526,66,-0.00897180938915199,-0.0102590689971608,0.00128725960800876,EPCI
200067692,CC Tannay-Brinon-Corbigny,1968_1975,1971.5,7,13847,12977,1810,912,-870,-898,28,-0.00922717208371071,-0.00952413854157726,0.000296966457866553,EPCI
200067692,CC Tannay-Brinon-Corbigny,1975_1982,1978.5,7,12977,11725,1738,693,-1252,-1045,-207,-0.0143890797734667,-0.012010054603253,-0.00237902517021374,EPCI
200067692,CC Tannay-Brinon-Corbigny,1982_1990,1986,8,11725,10875,1756,771,-850,-985,135,-0.00936298389670798,-0.0108500460450087,0.00148706214830068,EPCI
200067692,CC Tannay-Brinon-Corbigny,1990_1999,1994.5,9,10875,10507,1763,753,-368,-1010,642,-0.00381768019942208,-0.0104778722864573,0.00666019208703526,EPCI
200067692,CC Tannay-Brinon-Corbigny,1999_2010,2004.5,11,10507,10440,1993,864,-67,-1129,1062,-0.000581387224563468,-0.00979680860495754,0.00921542138039407,EPCI
200067700,CC Sud Nivernais,2010_2015,2012.5,5,22366,21663,1456,1012,-703,-444,-259,-0.00636688742108393,-0.00402119205542143,-0.0023456953656625,EPCI
200067700,CC Sud Nivernais,1968_1975,1971.5,7,28371,26914,2229,2904,-1457,675,-2132,-0.00750326594867212,0.00347611840449807,-0.0109793843531702,EPCI
200067700,CC Sud Nivernais,1975_1982,1978.5,7,26914,26560,2258,2289,-354,31,-385,-0.00188967983275223,0.00016548043733141,-0.00205516027008364,EPCI
200067700,CC Sud Nivernais,1982_1990,1986,8,26560,25176,2545,2257,-1384,-288,-1096,-0.00666707140518708,-0.00138736746003893,-0.00527970394514815,EPCI
200067700,CC Sud Nivernais,1990_1999,1994.5,9,25176,23253,2842,2061,-1923,-781,-1142,-0.0087896987121191,-0.00356981523357515,-0.00521988347854395,EPCI
200067700,CC Sud Nivernais,1999_2010,2004.5,11,23253,22366,3385,2390,-887,-995,108,-0.00352941214572922,-0.00395914891206378,0.00042973676633456,EPCI
200067742,CC Serre-Ponçon,2010_2015,2012.5,5,15307,15904,838,763,597,-75,672,0.00768143396030063,-0.000965004266369426,0.00864643822667006,EPCI
200067742,CC Serre-Ponçon,1968_1975,1971.5,7,9186,9422,807,835,236,28,208,0.00363040177021379,0.000430725633754178,0.00319967613645961,EPCI
200067742,CC Serre-Ponçon,1975_1982,1978.5,7,9422,10728,819,908,1306,89,1217,0.0187172646961551,0.00127552569522037,0.0174417390009347,EPCI
200067742,CC Serre-Ponçon,1982_1990,1986,8,10728,11966,950,1282,1238,332,906,0.0137451260802097,0.00368609196981392,0.0100590341103958,EPCI
200067742,CC Serre-Ponçon,1990_1999,1994.5,9,11966,13351,1096,1232,1385,136,1249,0.0122434552702977,0.00120224542726389,0.0110412098430338,EPCI
200067742,CC Serre-Ponçon,1999_2010,2004.5,11,13351,15307,1649,1683,1956,34,1922,0.0125065565770428,0.000217394132729783,0.012289162444313,EPCI
200067759,CC Vallées et Plateau d'Ardenne,2010_2015,2012.5,5,26036,25532,1171,1404,-504,233,-737,-0.00390189341720359,0.00180385152025484,-0.00570574493745843,EPCI
200067759,CC Vallées et Plateau d'Ardenne,1968_1975,1971.5,7,28254,27688,2298,3647,-566,1349,-1915,-0.00288667325987568,0.00688007460701819,-0.00976674786689387,EPCI
200067759,CC Vallées et Plateau d'Ardenne,1975_1982,1978.5,7,27688,27094,2232,2842,-594,610,-1204,-0.00309332081885305,0.00317664259175145,-0.0062699634106045,EPCI
200067759,CC Vallées et Plateau d'Ardenne,1982_1990,1986,8,27094,26185,2282,2873,-909,591,-1500,-0.00425661151708223,0.00276749989724488,-0.00702411141432712,EPCI
200067759,CC Vallées et Plateau d'Ardenne,1990_1999,1994.5,9,26185,25948,2225,2848,-237,623,-860,-0.00100973347358335,0.00265427828709885,-0.00366401176068221,EPCI
200067759,CC Vallées et Plateau d'Ardenne,1999_2010,2004.5,11,25948,26036,2678,3596,88,918,-830,0.000307834676766428,0.00321127537808614,-0.00290344070131971,EPCI
200067767,CC du Royans-Vercors,2010_2015,2012.5,5,9502,9731,469,461,229,-8,237,0.00477423312185255,-0.000166785436571268,0.00494101855842381,EPCI
200067767,CC du Royans-Vercors,1968_1975,1971.5,7,8062,7654,758,746,-408,-12,-396,-0.00739158652932914,-0.000217399603803798,-0.00717418692552534,EPCI
200067767,CC du Royans-Vercors,1975_1982,1978.5,7,7654,8186,673,669,532,-4,536,0.0096457938166461,-7.25247655386925e-05,0.00971831858218479,EPCI
200067767,CC du Royans-Vercors,1982_1990,1986,8,8186,8422,757,788,236,31,205,0.00355906243393433,0.00046750396377951,0.00309155847015483,EPCI
200067767,CC du Royans-Vercors,1990_1999,1994.5,9,8422,8596,821,837,174,16,158,0.00227476659128856,0.000209173939428833,0.00206559265185972,EPCI
200067767,CC du Royans-Vercors,1999_2010,2004.5,11,8596,9502,969,1042,906,73,833,0.00915119336466796,0.00073734780973594,0.00841384555493203,EPCI
200067783,CC de Hanau-la Petite Pierre,2010_2015,2012.5,5,27063,27163,1339,1336,100,-3,103,0.00073792649423976,-2.21377948271928e-05,0.000760064289066953,EPCI
200067783,CC de Hanau-la Petite Pierre,1968_1975,1971.5,7,24988,25382,2343,2550,394,207,187,0.00223743529622134,0.00117550534598431,0.00106192995023703,EPCI
200067783,CC de Hanau-la Petite Pierre,1975_1982,1978.5,7,25382,25336,2305,2211,-46,-94,48,-0.000259102448823212,-0.000529470221508303,0.000270367772685091,EPCI
200067783,CC de Hanau-la Petite Pierre,1982_1990,1986,8,25336,25391,2608,2448,55,-160,215,0.000271095650977715,-0.000788641893753353,0.00105973754473107,EPCI
200067783,CC de Hanau-la Petite Pierre,1990_1999,1994.5,9,25391,25528,2579,2412,137,-167,304,0.000598079717291977,-0.000729046078742775,0.00132712579603475,EPCI
200067783,CC de Hanau-la Petite Pierre,1999_2010,2004.5,11,25528,27063,2982,3120,1535,138,1397,0.00532244070740484,0.000478499555453986,0.00484394115195086,EPCI
200067791,CA Pays Foix-Varilhes,2010_2015,2012.5,5,31144,31776,1415,1516,632,101,531,0.00402601823546944,0.000643398483832933,0.00338261975163651,EPCI
200067791,CA Pays Foix-Varilhes,1968_1975,1971.5,7,21693,22167,2203,1912,474,-291,765,0.00309263931683379,-0.0018986456565372,0.00499128497337099,EPCI
200067791,CA Pays Foix-Varilhes,1975_1982,1978.5,7,22167,23428,2097,1705,1261,-392,1653,0.00793520268882308,-0.00246677196987998,0.0104019746587031,EPCI
200067791,CA Pays Foix-Varilhes,1982_1990,1986,8,23428,26214,2208,2019,2786,-189,2975,0.0141443138275608,-0.000959538877749097,0.0151038527053099,EPCI
200067791,CA Pays Foix-Varilhes,1990_1999,1994.5,9,26214,27307,2582,2383,1093,-199,1292,0.00454914501716508,-0.000828252386473788,0.00537739740363887,EPCI
200067791,CA Pays Foix-Varilhes,1999_2010,2004.5,11,27307,31144,2930,3318,3837,388,3449,0.0120243114033618,0.00121590639158311,0.0108084050117787,EPCI
200067817,CC Saône-Beaujolais,2010_2015,2012.5,5,40798,43601,1653,2784,2803,1131,1672,0.0133781016704582,0.00539801390984238,0.00798008776061579,EPCI
200067817,CC Saône-Beaujolais,1968_1975,1971.5,7,31134,31267,2652,3457,133,805,-672,0.000609150979203665,0.00368696645307482,-0.00307781547387115,EPCI
200067817,CC Saône-Beaujolais,1975_1982,1978.5,7,31267,31451,2618,2859,184,241,-57,0.000838572959477091,0.00109834827844554,-0.000259775318968447,EPCI
200067817,CC Saône-Beaujolais,1982_1990,1986,8,31451,31914,2697,3374,463,677,-214,0.0018284202561758,0.00267352162728081,-0.000845101371105013,EPCI
200067817,CC Saône-Beaujolais,1990_1999,1994.5,9,31914,33987,3000,4049,2073,1049,1024,0.00701709564211339,0.0035508602646295,0.00346623537748389,EPCI
200067817,CC Saône-Beaujolais,1999_2010,2004.5,11,33987,40798,3668,5197,6811,1529,5282,0.0167436257539564,0.00375877312843919,0.0129848526255172,EPCI
200067825,CA Gap-Tallard-Durance,2010_2015,2012.5,5,48183,50146,2146,2632,1963,486,1477,0.00801847489698493,0.00198521589400646,0.00603325900297847,EPCI
200067825,CA Gap-Tallard-Durance,1968_1975,1971.5,7,28366,32115,1916,3404,3749,1488,2261,0.0178913036091155,0.00710116291554118,0.0107901406935743,EPCI
200067825,CA Gap-Tallard-Durance,1975_1982,1978.5,7,32115,35223,2109,3090,3108,981,2127,0.0132840402600569,0.00419293548748901,0.00909110477256791,EPCI
200067825,CA Gap-Tallard-Durance,1982_1990,1986,8,35223,38664,2559,3913,3441,1354,2087,0.011719346720342,0.00461144884026245,0.00710789788007957,EPCI
200067825,CA Gap-Tallard-Durance,1990_1999,1994.5,9,38664,42508,3148,4362,3844,1214,2630,0.0105871356027618,0.00334359589535714,0.00724353970740467,EPCI
200067825,CA Gap-Tallard-Durance,1999_2010,2004.5,11,42508,48183,4151,5763,5675,1612,4063,0.0114573169207026,0.00325448367862073,0.00820283324208189,EPCI
200067841,CC de l'Alsace Bossue,2010_2015,2012.5,5,25325,24853,1335,1183,-472,-152,-320,-0.00375564596070732,-0.00120944530938032,-0.002546200651327,EPCI
200067841,CC de l'Alsace Bossue,1968_1975,1971.5,7,24737,24893,2177,2563,156,386,-230,0.000898480671257529,0.00222316371221414,-0.00132468304095661,EPCI
200067841,CC de l'Alsace Bossue,1975_1982,1978.5,7,24893,24838,2098,2108,-55,10,-65,-0.000315935928006161,5.74428960011202e-05,-0.000373378824007282,EPCI
200067841,CC de l'Alsace Bossue,1982_1990,1986,8,24838,24712,2228,2424,-126,196,-322,-0.000635520834729064,0.0009885879651341,-0.00162410879986316,EPCI
200067841,CC de l'Alsace Bossue,1990_1999,1994.5,9,24712,25107,2266,2505,395,239,156,0.00176352386048473,0.00106704355102747,0.00069648030945726,EPCI
200067841,CC de l'Alsace Bossue,1999_2010,2004.5,11,25107,25325,2727,2923,218,196,22,0.000786250607259564,0.00070690421570126,7.93463915583047e-05,EPCI
200067866,CC Sèvre et Loire,2010_2015,2012.5,5,43836,46498,1353,3249,2662,1896,766,0.0118605659217408,0.00844764575042094,0.00341292017131985,EPCI
200067866,CC Sèvre et Loire,1968_1975,1971.5,7,22532,23961,1778,2878,1429,1100,329,0.00882312309819189,0.00679176725543113,0.00203135584276076,EPCI
200067866,CC Sèvre et Loire,1975_1982,1978.5,7,23961,28461,1768,3138,4500,1370,3130,0.0248914922654222,0.00757807653413965,0.0173134157312826,EPCI
200067866,CC Sèvre et Loire,1982_1990,1986,8,28461,30932,2004,3522,2471,1518,953,0.0104614065558541,0.0064267159659193,0.00403469058993485,EPCI
200067866,CC Sèvre et Loire,1990_1999,1994.5,9,30932,34060,2274,3885,3128,1611,1517,0.010761091653906,0.00554223742149701,0.00521885423240904,EPCI
200067866,CC Sèvre et Loire,1999_2010,2004.5,11,34060,43836,2626,6928,9776,4302,5474,0.0232043754226969,0.0102112544055281,0.0129931210171689,EPCI
200067874,CA de Haguenau,2010_2015,2012.5,5,94616,95665,3793,5469,1049,1676,-627,0.00220761527985047,0.0035271336597039,-0.00131951837985343,EPCI
200067874,CA de Haguenau,1968_1975,1971.5,7,65834,70709,5624,8064,4875,2440,2435,0.0102574565681341,0.00513398851820458,0.00512346804992957,EPCI
200067874,CA de Haguenau,1975_1982,1978.5,7,70709,75459,5205,7210,4750,2005,2745,0.00933135371535143,0.00393881351563782,0.00539254019971362,EPCI
200067874,CA de Haguenau,1982_1990,1986,8,75459,78537,5883,8436,3078,2553,525,0.00501005719093661,0.00415551527240454,0.000854541918532073,EPCI
200067874,CA de Haguenau,1990_1999,1994.5,9,78537,86838,6517,10179,8301,3662,4639,0.0112263772562657,0.00495253505751658,0.00627384219874916,EPCI
200067874,CA de Haguenau,1999_2010,2004.5,11,86838,94616,8069,12821,7778,4752,3026,0.00782887582206771,0.00478308278560886,0.00304579303645884,EPCI
200067882,CC Bazois Loire Morvan,2010_2015,2012.5,5,16873,15832,1477,524,-1041,-953,-88,-0.012655537146322,-0.0115857126805426,-0.00106982446577938,EPCI
200067882,CC Bazois Loire Morvan,1968_1975,1971.5,7,24377,22640,2894,1675,-1737,-1219,-518,-0.0105046950092206,-0.00737203409109953,-0.00313266091812105,EPCI
200067882,CC Bazois Loire Morvan,1975_1982,1978.5,7,22640,21017,2741,1342,-1623,-1399,-224,-0.0105703964222031,-0.00911151238118435,-0.00145888404101879,EPCI
200067882,CC Bazois Loire Morvan,1982_1990,1986,8,21017,18886,2933,1339,-2131,-1594,-537,-0.0132749412330416,-0.009929730795621,-0.00334521043742063,EPCI
200067882,CC Bazois Loire Morvan,1990_1999,1994.5,9,18886,17613,2997,1213,-1273,-1784,511,-0.00772375521593327,-0.0108241785586999,0.00310042334276662,EPCI
200067882,CC Bazois Loire Morvan,1999_2010,2004.5,11,17613,16873,3269,1412,-740,-1857,1117,-0.00389444730591793,-0.00977295763120214,0.00587851032528422,EPCI
200067890,CC Morvan Sommets et Grands Lacs,2010_2015,2012.5,5,13249,12778,1072,426,-471,-646,175,-0.00721328560977685,-0.00989338111234787,0.00268009550257102,EPCI
200067890,CC Morvan Sommets et Grands Lacs,1968_1975,1971.5,7,18749,16991,2275,1291,-1758,-984,-774,-0.0139667789735122,-0.00781758277015698,-0.00614919620335519,EPCI
200067890,CC Morvan Sommets et Grands Lacs,1975_1982,1978.5,7,16991,15779,2267,904,-1212,-1363,151,-0.0105162916262391,-0.0118264896753828,0.00131019804914365,EPCI
200067890,CC Morvan Sommets et Grands Lacs,1982_1990,1986,8,15779,14976,2356,1095,-803,-1261,458,-0.0065076109751715,-0.0102192994267637,0.00371168845159221,EPCI
200067890,CC Morvan Sommets et Grands Lacs,1990_1999,1994.5,9,14976,13889,2372,949,-1087,-1423,336,-0.00833746667584345,-0.0109146412876957,0.00257717461185225,EPCI
200067890,CC Morvan Sommets et Grands Lacs,1999_2010,2004.5,11,13889,13249,2545,1134,-640,-1411,771,-0.00427946072200858,-0.00943487356055328,0.00515541283854471,EPCI
200067908,CC Amognes Coeur du Nivernais,2010_2015,2012.5,5,8924,8757,599,385,-167,-214,47,-0.00377105086718965,-0.00483236458430291,0.00106131371711326,EPCI
200067908,CC Amognes Coeur du Nivernais,1968_1975,1971.5,7,10326,9057,1165,733,-1269,-432,-837,-0.0185580736656583,-0.00631764209894751,-0.0122404315667108,EPCI
200067908,CC Amognes Coeur du Nivernais,1975_1982,1978.5,7,9057,8435,1094,528,-622,-566,-56,-0.0101125527009317,-0.00920209779538158,-0.000910454905550121,EPCI
200067908,CC Amognes Coeur du Nivernais,1982_1990,1986,8,8435,8525,1130,712,90,-418,508,0.00132754380363154,-0.00616570344353314,0.00749324724716467,EPCI
200067908,CC Amognes Coeur du Nivernais,1990_1999,1994.5,9,8525,8603,1074,749,78,-325,403,0.00101250740317771,-0.00421878084657379,0.0052312882497515,EPCI
200067908,CC Amognes Coeur du Nivernais,1999_2010,2004.5,11,8603,8924,1222,979,321,-243,564,0.00333585133025283,-0.00252527063318205,0.00586112196343487,EPCI
200067916,"CC Loire, Vignobles et Nohain",2010_2015,2012.5,5,26730,26148,1803,1231,-582,-572,-10,-0.00439308691924589,-0.0043176043261317,-7.54825931141906e-05,EPCI
200067916,"CC Loire, Vignobles et Nohain",1968_1975,1971.5,7,27024,27596,3110,2517,572,-593,1165,0.00299669179047113,-0.00310671019536605,0.00610340198583718,EPCI
200067916,"CC Loire, Vignobles et Nohain",1975_1982,1978.5,7,27596,27645,3115,2226,49,-889,938,0.000253467132514285,-0.00459861797561631,0.00485208510813059,EPCI
200067916,"CC Loire, Vignobles et Nohain",1982_1990,1986,8,27645,27441,3366,2365,-204,-1001,797,-0.000925400858226344,-0.0045408149955126,0.00361541413728626,EPCI
200067916,"CC Loire, Vignobles et Nohain",1990_1999,1994.5,9,27441,26504,3455,2318,-937,-1137,200,-0.00385284537654895,-0.00467522432565225,0.000822378949103299,EPCI
200067916,"CC Loire, Vignobles et Nohain",1999_2010,2004.5,11,26504,26730,4121,2747,226,-1374,1600,0.000772194821139216,-0.00469467116922692,0.00546686599036613,EPCI
200067924,CC du Canton d'Erstein,2010_2015,2012.5,5,46302,47763,1767,2784,1461,1017,444,0.00623256701572417,0.00433848094113037,0.00189408607459379,EPCI
200067924,CC du Canton d'Erstein,1968_1975,1971.5,7,30252,33390,2615,3445,3138,830,2308,0.0141990271378545,0.00375563815309727,0.0104433889847572,EPCI
200067924,CC du Canton d'Erstein,1975_1982,1978.5,7,33390,36125,2563,3176,2735,613,2122,0.0113104408588627,0.00253502751242516,0.00877541334643752,EPCI
200067924,CC du Canton d'Erstein,1982_1990,1986,8,36125,37379,2813,3705,1254,892,362,0.00427459801222563,0.00304062314745236,0.00123397486477327,EPCI
200067924,CC du Canton d'Erstein,1990_1999,1994.5,9,37379,40656,2933,4265,3277,1332,1945,0.00938121668375458,0.00381317687603329,0.00556803980772129,EPCI
200067924,CC du Canton d'Erstein,1999_2010,2004.5,11,40656,46302,3717,5600,5646,1883,3763,0.0118918552346257,0.00396605798916049,0.00792579724546517,EPCI
200067932,CA Golfe du Morbihan - Vannes Agglomération,2010_2015,2012.5,5,158067,165761,7290,8539,7694,1249,6445,0.00955092132067814,0.00155044199759904,0.0080004793230791,EPCI
200067932,CA Golfe du Morbihan - Vannes Agglomération,1968_1975,1971.5,7,80067,91076,6387,11597,11009,5210,5799,0.0185747667313267,0.00879049274867947,0.00978427398264727,EPCI
200067932,CA Golfe du Morbihan - Vannes Agglomération,1975_1982,1978.5,7,91076,103732,6508,11208,12656,4700,7956,0.0187618798988101,0.00696751228859097,0.0117943676102191,EPCI
200067932,CA Golfe du Morbihan - Vannes Agglomération,1982_1990,1986,8,103732,117487,7668,12666,13755,4998,8757,0.0156863896319457,0.00569978737771462,0.00998660225423107,EPCI
200067932,CA Golfe du Morbihan - Vannes Agglomération,1990_1999,1994.5,9,117487,134404,9418,14448,16917,5030,11887,0.0150592087002897,0.00447761540240332,0.0105815932978863,EPCI
200067932,CA Golfe du Morbihan - Vannes Agglomération,1999_2010,2004.5,11,134404,158067,13386,19021,23663,5635,18028,0.0148518269796738,0.00353674703251751,0.0113150799471563,EPCI
200067940,CC Couserans-Pyrénées,2010_2015,2012.5,5,29981,29716,2204,1181,-265,-1023,758,-0.00177406975438044,-0.00684857871219316,0.00507450895781272,EPCI
200067940,CC Couserans-Pyrénées,1968_1975,1971.5,7,33563,31947,4049,1985,-1616,-2064,448,-0.00702463821987887,-0.00897206267687499,0.00194742445699612,EPCI
200067940,CC Couserans-Pyrénées,1975_1982,1978.5,7,31947,29778,3824,1530,-2169,-2294,125,-0.00999378601829148,-0.0105697303485296,0.000575944330238097,EPCI
200067940,CC Couserans-Pyrénées,1982_1990,1986,8,29778,28018,4245,1916,-1760,-2329,569,-0.00758641491159895,-0.0100390683688147,0.0024526534572158,EPCI
200067940,CC Couserans-Pyrénées,1990_1999,1994.5,9,28018,27980,4327,2108,-38,-2219,2181,-0.000150787690014087,-0.00880520747740155,0.00865441978738747,EPCI
200067940,CC Couserans-Pyrénées,1999_2010,2004.5,11,27980,29981,4964,2664,2001,-2300,4301,0.00629920053362376,-0.00724046038347559,0.0135396609170994,EPCI
200067957,CC Haut Chemin-Pays de Pange,2010_2015,2012.5,5,18155,19026,500,943,871,443,428,0.00941614756108455,0.00478915427044829,0.00462699329063627,EPCI
200067957,CC Haut Chemin-Pays de Pange,1968_1975,1971.5,7,7784,9541,699,895,1757,196,1561,0.0295022390893485,0.00329108643227792,0.0262111526570705,EPCI
200067957,CC Haut Chemin-Pays de Pange,1975_1982,1978.5,7,9541,13272,697,1138,3731,441,3290,0.0482804748131587,0.00570669777341275,0.0425737770397459,EPCI
200067957,CC Haut Chemin-Pays de Pange,1982_1990,1986,8,13272,14869,756,1423,1597,667,930,0.0143040826453946,0.00597421610800139,0.00832986653739324,EPCI
200067957,CC Haut Chemin-Pays de Pange,1990_1999,1994.5,9,14869,16253,743,1465,1384,722,662,0.00993783312827445,0.00518433202212006,0.0047535011061544,EPCI
200067957,CC Haut Chemin-Pays de Pange,1999_2010,2004.5,11,16253,18155,934,2211,1902,1277,625,0.0101115522457143,0.00678888129220668,0.00332267095350757,EPCI
200067965,CA de la Région de Compiègne et de la Basse Automne,2010_2015,2012.5,5,81512,81829,3301,5400,317,2099,-1782,0.000776592459012848,0.00514216899516709,-0.00436557653615424,EPCI
200067965,CA de la Région de Compiègne et de la Basse Automne,1968_1975,1971.5,7,55746,65309,4239,8452,9563,4213,5350,0.022875462377798,0.0100778336293698,0.0127976287484283,EPCI
200067965,CA de la Région de Compiègne et de la Basse Automne,1975_1982,1978.5,7,65309,69929,4205,8572,4620,4367,253,0.00981219691324475,0.00927486232037659,0.000537334592868165,EPCI
200067965,CA de la Région de Compiègne et de la Basse Automne,1982_1990,1986,8,69929,75986,4889,9946,6057,5057,1000,0.0104376803826161,0.00871443779014188,0.00172324259247417,EPCI
200067965,CA de la Région de Compiègne et de la Basse Automne,1990_1999,1994.5,9,75986,78923,5356,10557,2937,5201,-2264,0.00422262145004759,0.00747764867609722,-0.00325502722604963,EPCI
200067965,CA de la Région de Compiègne et de la Basse Automne,1999_2010,2004.5,11,78923,81512,6912,12634,2589,5722,-3133,0.00293863252772053,0.00649472975033483,-0.0035560972226143,EPCI
200067973,CC Thelloise,2010_2015,2012.5,5,58321,61008,2062,3691,2687,1629,1058,0.00904925289914527,0.00548613061879704,0.00356312228034823,EPCI
200067973,CC Thelloise,1968_1975,1971.5,7,29902,33786,2395,3399,3884,1004,2880,0.0175989464186099,0.0045492642132555,0.0130496822053544,EPCI
200067973,CC Thelloise,1975_1982,1978.5,7,33786,41517,2512,3508,7731,996,6735,0.0298741785773311,0.00384874943254712,0.026025429144784,EPCI
200067973,CC Thelloise,1982_1990,1986,8,41517,50724,2891,4956,9207,2065,7142,0.0253530821687453,0.00568633807738233,0.019666744091363,EPCI
200067973,CC Thelloise,1990_1999,1994.5,9,50724,55341,3442,5786,4617,2344,2273,0.00972642752479813,0.00493800002558519,0.00478842749921294,EPCI
200067973,CC Thelloise,1999_2010,2004.5,11,55341,58321,4340,7901,2980,3561,-581,0.00477940235668029,0.00571122543360352,-0.000931823076923237,EPCI
200067981,CA Guingamp-Paimpol Armor-Argoat Agglomération,2010_2015,2012.5,5,74607,73750,4825,3456,-857,-1369,512,-0.00230800073462611,-0.00368687631937357,0.00137887558474746,EPCI
200067981,CA Guingamp-Paimpol Armor-Argoat Agglomération,1968_1975,1971.5,7,77154,76173,7600,7590,-981,-10,-971,-0.00182638089323717,-1.86175422348335e-05,-0.00180776335100233,EPCI
200067981,CA Guingamp-Paimpol Armor-Argoat Agglomération,1975_1982,1978.5,7,76173,75545,7663,6314,-628,-1349,721,-0.00118195294304169,-0.00253894031873127,0.00135698737568958,EPCI
200067981,CA Guingamp-Paimpol Armor-Argoat Agglomération,1982_1990,1986,8,75545,72906,8232,6756,-2639,-1476,-1163,-0.00443483258818911,-0.00248041413420505,-0.00195441845398406,EPCI
200067981,CA Guingamp-Paimpol Armor-Argoat Agglomération,1990_1999,1994.5,9,72906,71873,8729,6273,-1033,-2456,1423,-0.00158432890279359,-0.00376680714933306,0.00218247824653947,EPCI
200067981,CA Guingamp-Paimpol Armor-Argoat Agglomération,1999_2010,2004.5,11,71873,74607,10481,8459,2734,-2022,4756,0.00339973548520334,-0.00251436179629888,0.00591409728150222,EPCI
200067999,CA du Beauvaisis,2010_2015,2012.5,5,99909,100436,4097,7093,527,2996,-2469,0.00105274115109144,0.0059848434320113,-0.00493210228091986,EPCI
200067999,CA du Beauvaisis,1968_1975,1971.5,7,74417,85131,5032,12363,10714,7331,3383,0.0194010636336084,0.0132750791019211,0.00612598453168725,EPCI
200067999,CA du Beauvaisis,1975_1982,1978.5,7,85131,87417,5216,10252,2286,5036,-2750,0.00379267766682911,0.00835517267285714,-0.00456249500602803,EPCI
200067999,CA du Beauvaisis,1982_1990,1986,8,87417,93130,6160,12048,5713,5888,-175,0.007944717451559,0.00818807917990187,-0.000243361728342871,EPCI
200067999,CA du Beauvaisis,1990_1999,1994.5,9,93130,96899,6734,12820,3769,6086,-2317,0.00441782241930189,0.0071336872496342,-0.00271586483033231,EPCI
200067999,CA du Beauvaisis,1999_2010,2004.5,11,96899,99909,8217,15418,3010,7201,-4191,0.00278483161958487,0.00666231644273444,-0.00387748482314957,EPCI
200068005,CC de l'Oise Picarde,2010_2015,2012.5,5,20871,21434,864,1424,563,560,3,0.00533775747188559,0.00530931471448655,2.8442757399035e-05,EPCI
200068005,CC de l'Oise Picarde,1968_1975,1971.5,7,15780,15792,1400,1775,12,375,-363,0.000108601221456839,0.00339378817052621,-0.00328518694906937,EPCI
200068005,CC de l'Oise Picarde,1975_1982,1978.5,7,15792,16094,1325,1482,302,157,145,0.00270981479057131,0.00140874477523078,0.00130107001534053,EPCI
200068005,CC de l'Oise Picarde,1982_1990,1986,8,16094,17326,1338,1887,1232,549,683,0.00926285360432066,0.00412768395192536,0.0051351696523953,EPCI
200068005,CC de l'Oise Picarde,1990_1999,1994.5,9,17326,18804,1490,2278,1478,788,690,0.00913719715416295,0.0048715232459272,0.00426567390823575,EPCI
200068005,CC de l'Oise Picarde,1999_2010,2004.5,11,18804,20871,1778,3026,2067,1248,819,0.00952608911812458,0.00575160097698088,0.0037744881411437,EPCI
200068047,CA Creil Sud Oise,2010_2015,2012.5,5,81546,86063,2734,8070,4517,5336,-819,0.010840801834723,0.0128064021673859,-0.00196560033266286,EPCI
200068047,CA Creil Sud Oise,1968_1975,1971.5,7,66540,76016,3574,11289,9476,7715,1761,0.0192021160075646,0.0156336349723893,0.00356848103517532,EPCI
200068047,CA Creil Sud Oise,1975_1982,1978.5,7,76016,79787,3568,10981,3771,7413,-3642,0.00694065252323717,0.0136438762012085,-0.0067032236779713,EPCI
200068047,CA Creil Sud Oise,1982_1990,1986,8,79787,79030,4163,12044,-757,7881,-8638,-0.0011909223759019,0.0123984930574411,-0.013589415433343,EPCI
200068047,CA Creil Sud Oise,1990_1999,1994.5,9,79030,78152,4743,12807,-878,8064,-8942,-0.00124054975519972,0.0113938419429732,-0.012634391698173,EPCI
200068047,CA Creil Sud Oise,1999_2010,2004.5,11,78152,81546,5727,16635,3394,10908,-7514,0.00387217118090355,0.0124447976550666,-0.00857262647416301,EPCI
200068070,CC Loue-Lison,2010_2015,2012.5,5,24273,25152,1104,1533,879,429,450,0.00713992755157733,0.00348467453882443,0.0036552530127529,EPCI
200068070,CC Loue-Lison,1968_1975,1971.5,7,18223,18002,1545,1943,-221,398,-619,-0.00174157735806535,0.00313641533262448,-0.00487799269068982,EPCI
200068070,CC Loue-Lison,1975_1982,1978.5,7,18002,19201,1574,1817,1199,243,956,0.00925391199315295,0.00187548007867904,0.00737843191447391,EPCI
200068070,CC Loue-Lison,1982_1990,1986,8,19201,20104,1734,2020,903,286,617,0.00576108649972906,0.00182466305528517,0.00393642344444389,EPCI
200068070,CC Loue-Lison,1990_1999,1994.5,9,20104,21183,1901,2158,1079,257,822,0.00582581252970638,0.00138761243756676,0.00443820009213961,EPCI
200068070,CC Loue-Lison,1999_2010,2004.5,11,21183,24273,2327,3356,3090,1029,2061,0.0124556284642194,0.00414784520701677,0.00830778325720267,EPCI
200068088,"CC Loire, Nièvre et Bertranges",2010_2015,2012.5,5,20725,20516,1549,926,-209,-623,414,-0.00202507306597333,-0.0060364618186669,0.00401138875269357,EPCI
200068088,"CC Loire, Nièvre et Bertranges",1968_1975,1971.5,7,22215,21228,2227,1790,-987,-437,-550,-0.0064713516582704,-0.00286522864707615,-0.00360612301119424,EPCI
200068088,"CC Loire, Nièvre et Bertranges",1975_1982,1978.5,7,21228,21759,2343,1566,531,-777,1308,0.00353572169542371,-0.00517373965601549,0.0087094613514392,EPCI
200068088,"CC Loire, Nièvre et Bertranges",1982_1990,1986,8,21759,20961,2605,1646,-798,-959,161,-0.0046595973365865,-0.00559969153607325,0.000940094199486749,EPCI
200068088,"CC Loire, Nièvre et Bertranges",1990_1999,1994.5,9,20961,20578,2777,1706,-383,-1071,688,-0.00204690492530824,-0.00572385163186715,0.00367694670655892,EPCI
200068088,"CC Loire, Nièvre et Bertranges",1999_2010,2004.5,11,20578,20725,3071,2240,147,-831,978,0.000647314605707772,-0.00365930909757251,0.00430662370328028,EPCI
200068096,CC Champsaur-Valgaudemar,2010_2015,2012.5,5,10837,11056,630,511,219,-119,338,0.00400942875621646,-0.00217863936981625,0.00618806812603271,EPCI
200068096,CC Champsaur-Valgaudemar,1968_1975,1971.5,7,9030,9052,836,753,22,-83,105,0.000347683333900894,-0.00131171439608065,0.00165939772998154,EPCI
200068096,CC Champsaur-Valgaudemar,1975_1982,1978.5,7,9052,8986,778,640,-66,-138,72,-0.00104487047420376,-0.00218472917333514,0.00113985869913138,EPCI
200068096,CC Champsaur-Valgaudemar,1982_1990,1986,8,8986,8999,944,812,13,-132,145,0.000180722503824837,-0.00183502850037527,0.00201575100420011,EPCI
200068096,CC Champsaur-Valgaudemar,1990_1999,1994.5,9,8999,9328,948,805,329,-143,472,0.00399765489640669,-0.00173758252336218,0.00573523741976887,EPCI
200068096,CC Champsaur-Valgaudemar,1999_2010,2004.5,11,9328,10837,1202,1178,1509,-24,1533,0.013724747286896,-0.000218286239155403,0.0139430335260514,EPCI
200068104,CA de la Provence Verte,2010_2015,2012.5,5,89787,96752,4283,5144,6965,861,6104,0.0150543531585079,0.00186099039044871,0.0131933627680592,EPCI
200068104,CA de la Provence Verte,1968_1975,1971.5,7,28110,31379,2647,2391,3269,-256,3525,0.0158403627082278,-0.00124048114203313,0.0170808438502609,EPCI
200068104,CA de la Provence Verte,1975_1982,1978.5,7,31379,38931,3052,2497,7552,-555,8107,0.0312868838152942,-0.00229928767445555,0.0335861714897498,EPCI
200068104,CA de la Provence Verte,1982_1990,1986,8,38931,54945,4129,4445,16014,316,15698,0.0440086026988136,0.00086841004451262,0.043140192654301,EPCI
200068104,CA de la Provence Verte,1990_1999,1994.5,9,54945,69361,5600,6001,14416,401,14015,0.0262260121359508,0.000729511020152349,0.0254965011157984,EPCI
200068104,CA de la Provence Verte,1999_2010,2004.5,11,69361,89787,8106,9820,20426,1714,18712,0.0237425109001279,0.00199229725265932,0.0217502136474686,EPCI
200068112,CC du Pays de Saverne,2010_2015,2012.5,5,36434,35712,1472,2050,-722,578,-1300,-0.00399512573580285,0.0031983139547009,-0.00719343969050375,EPCI
200068112,CC du Pays de Saverne,1968_1975,1971.5,7,28656,30167,2494,3201,1511,707,804,0.007367833666861,0.0034474244887298,0.0039204091781312,EPCI
200068112,CC du Pays de Saverne,1975_1982,1978.5,7,30167,31104,2384,2852,937,468,469,0.00437924909061138,0.00218728769947292,0.00219196139113846,EPCI
200068112,CC du Pays de Saverne,1982_1990,1986,8,31104,31455,2660,3356,351,696,-345,0.00140367482358195,0.00278335520573514,-0.0013796803821532,EPCI
200068112,CC du Pays de Saverne,1990_1999,1994.5,9,31455,33452,2702,3664,1997,962,1035,0.00686273275223659,0.00330593335385658,0.00355679939838,EPCI
200068112,CC du Pays de Saverne,1999_2010,2004.5,11,33452,36434,3094,4467,2982,1373,1609,0.00779301131432342,0.00358813029328171,0.00420488102104171,EPCI
200068120,CA Quimper Bretagne Occidentale,2010_2015,2012.5,5,98513,100529,4662,5398,2016,736,1280,0.00405976338787184,0.0014821358400167,0.00257762754785514,EPCI
200068120,CA Quimper Bretagne Occidentale,1968_1975,1971.5,7,72014,78933,5207,9025,6919,3818,3101,0.0131918036480503,0.00727941990580373,0.00591238374224656,EPCI
200068120,CA Quimper Bretagne Occidentale,1975_1982,1978.5,7,78933,85272,5456,8341,6339,2885,3454,0.0110963638338979,0.00505016716529349,0.00604619666860441,EPCI
200068120,CA Quimper Bretagne Occidentale,1982_1990,1986,8,85272,90117,6437,9521,4845,3084,1761,0.006931748958658,0.00441228354767828,0.00251946541097972,EPCI
200068120,CA Quimper Bretagne Occidentale,1990_1999,1994.5,9,90117,94125,7732,9874,4008,2142,1866,0.00484669184898601,0.0025902230390539,0.00225646880993211,EPCI
200068120,CA Quimper Bretagne Occidentale,1999_2010,2004.5,11,94125,98513,9667,12138,4388,2471,1917,0.00415084855629488,0.00233745368792267,0.00181339486837222,EPCI
200068146,CC Sarrebourg Moselle Sud,2010_2015,2012.5,5,46813,45923,2352,2332,-890,-20,-870,-0.00383161281470246,-8.61036587573586e-05,-0.0037455091559451,EPCI
200068146,CC Sarrebourg Moselle Sud,1968_1975,1971.5,7,44111,45092,3629,5221,981,1592,-611,0.00314717953562571,0.00510734946046497,-0.00196016992483926,EPCI
200068146,CC Sarrebourg Moselle Sud,1975_1982,1978.5,7,45092,45029,3513,4602,-63,1089,-1152,-0.000199711559658144,0.00345215695980507,-0.00365186851946321,EPCI
200068146,CC Sarrebourg Moselle Sud,1982_1990,1986,8,45029,45046,3651,4964,17,1313,-1296,4.71840168272397e-05,0.00364427141730387,-0.00359708740047663,EPCI
200068146,CC Sarrebourg Moselle Sud,1990_1999,1994.5,9,45046,45389,3981,5303,343,1322,-979,0.000843199188513832,0.00324988142045273,-0.0024066822319389,EPCI
200068146,CC Sarrebourg Moselle Sud,1999_2010,2004.5,11,45389,46813,4905,5874,1424,969,455,0.00281223394882746,0.00191366200590857,0.000898571942918886,EPCI
200068229,CC des Baronnies en Drôme Provençale,2010_2015,2012.5,5,21104,21082,1437,803,-22,-634,612,-0.000208578272919091,-0.00601084659230472,0.00580226831938562,EPCI
200068229,CC des Baronnies en Drôme Provençale,1968_1975,1971.5,7,15257,15841,1730,1293,584,-437,1021,0.00538058097864558,-0.00402622241039061,0.00940680338903619,EPCI
200068229,CC des Baronnies en Drôme Provençale,1975_1982,1978.5,7,15841,17207,1829,1301,1366,-528,1894,0.0118864839669481,-0.0045944828217779,0.016480966788726,EPCI
200068229,CC des Baronnies en Drôme Provençale,1982_1990,1986,8,17207,18426,2091,1638,1219,-453,1672,0.00859250961349511,-0.00319311472921517,0.0117856243427103,EPCI
200068229,CC des Baronnies en Drôme Provençale,1990_1999,1994.5,9,18426,19680,2448,1770,1254,-678,1932,0.00734239985490404,-0.00396981427561797,0.011312214130522,EPCI
200068229,CC des Baronnies en Drôme Provençale,1999_2010,2004.5,11,19680,21104,3098,2004,1424,-1094,2518,0.00637109182646478,-0.00489464498465763,0.0112657368111224,EPCI
200068278,CC Berry Loire Puisaye,2010_2015,2012.5,5,18851,18701,1243,986,-150,-257,107,-0.00159651711213094,-0.002735365985451,0.00113884887332007,EPCI
200068278,CC Berry Loire Puisaye,1968_1975,1971.5,7,16765,16974,1859,1547,209,-312,521,0.00177147887944829,-0.0026445043559228,0.00441598323537108,EPCI
200068278,CC Berry Loire Puisaye,1975_1982,1978.5,7,16974,17880,1770,1451,906,-319,1225,0.00745623289488151,-0.00262531820470994,0.0100815510995914,EPCI
200068278,CC Berry Loire Puisaye,1982_1990,1986,8,17880,18292,1975,1584,412,-391,803,0.0028516878545175,-0.00270633483280666,0.00555802268732416,EPCI
200068278,CC Berry Loire Puisaye,1990_1999,1994.5,9,18292,18718,2249,1802,426,-447,873,0.00256125463823853,-0.00268751366970099,0.00524876830793952,EPCI
200068278,CC Berry Loire Puisaye,1999_2010,2004.5,11,18718,18851,2829,2309,133,-520,653,0.000643874029740088,-0.00251740222154019,0.00316127625128028,EPCI
200068294,CC des Deux Vallées Vertes,2010_2015,2012.5,5,16368,16322,882,919,-46,37,-83,-0.000562705254426033,0.000452610748125287,-0.00101531600255132,EPCI
200068294,CC des Deux Vallées Vertes,1968_1975,1971.5,7,13533,14355,1190,1588,822,398,424,0.00845946164953237,0.00409594371838672,0.00436351793114565,EPCI
200068294,CC des Deux Vallées Vertes,1975_1982,1978.5,7,14355,14779,1228,1353,424,125,299,0.00416707832039487,0.00122850186332396,0.00293857645707091,EPCI
200068294,CC des Deux Vallées Vertes,1982_1990,1986,8,14779,14862,1400,1463,83,63,20,0.000700290777025714,0.000531546011477349,0.000168744765548365,EPCI
200068294,CC des Deux Vallées Vertes,1990_1999,1994.5,9,14862,15266,1586,1479,404,-107,511,0.00298450185543642,-0.000790449748840833,0.00377495160427725,EPCI
200068294,CC des Deux Vallées Vertes,1999_2010,2004.5,11,15266,16368,1977,2104,1102,127,975,0.00635648779371989,0.000732553493468626,0.00562393430025126,EPCI
200068369,CC de Mirecourt Dompaire,2010_2015,2012.5,5,19516,19338,1207,1083,-178,-124,-54,-0.00183083594986655,-0.0012754138077722,-0.000555422142094346,EPCI
200068369,CC de Mirecourt Dompaire,1968_1975,1971.5,7,21386,20653,1812,2218,-733,406,-1139,-0.00496988263746256,0.00275275900519755,-0.00772264164266011,EPCI
200068369,CC de Mirecourt Dompaire,1975_1982,1978.5,7,20653,20479,1947,1959,-174,12,-186,-0.00120792935835423,8.3305472989947e-05,-0.00129123483134418,EPCI
200068369,CC de Mirecourt Dompaire,1982_1990,1986,8,20479,19933,2158,2244,-546,86,-632,-0.00337221640227192,0.000531154964460413,-0.00390337136673233,EPCI
200068369,CC de Mirecourt Dompaire,1990_1999,1994.5,9,19933,19220,2098,2003,-713,-95,-618,-0.00403907050101271,-0.000538165073767472,-0.00350090542724524,EPCI
200068369,CC de Mirecourt Dompaire,1999_2010,2004.5,11,19220,19516,2385,2538,296,153,143,0.00139035095306617,0.000718661134524066,0.000671689818542101,EPCI
200068377,CC de la Porte des Vosges Méridionales,2010_2015,2012.5,5,30314,29683,1661,1482,-631,-179,-452,-0.00419819496765805,-0.0011909301096843,-0.00300726485797376,EPCI
200068377,CC de la Porte des Vosges Méridionales,1968_1975,1971.5,7,31388,33533,2418,4013,2145,1595,550,0.00948821241561904,0.00705533743725518,0.00243287497836386,EPCI
200068377,CC de la Porte des Vosges Méridionales,1975_1982,1978.5,7,33533,33920,2400,3903,387,1503,-1116,0.00164059893137103,0.00637162840788283,-0.00473102947651181,EPCI
200068377,CC de la Porte des Vosges Méridionales,1982_1990,1986,8,33920,32139,2733,3745,-1781,1012,-2793,-0.0067191455349862,0.00381795355497251,-0.0105370990899587,EPCI
200068377,CC de la Porte des Vosges Méridionales,1990_1999,1994.5,9,32139,31244,3027,3422,-895,395,-1290,-0.00313318000370322,0.00138280011336622,-0.00451598011706944,EPCI
200068377,CC de la Porte des Vosges Méridionales,1999_2010,2004.5,11,31244,30314,3735,3923,-930,188,-1118,-0.00274329442999399,0.000554558443912764,-0.00329785287390676,EPCI
200068435,CC Coeur du Perche,2010_2015,2012.5,5,11809,11614,622,597,-195,-25,-170,-0.00332459837717114,-0.000426230561175787,-0.00289836781599535,EPCI
200068435,CC Coeur du Perche,1968_1975,1971.5,7,10742,10129,1065,880,-613,-185,-428,-0.00835896717239359,-0.00252268992967833,-0.00583627724271527,EPCI
200068435,CC Coeur du Perche,1975_1982,1978.5,7,10129,10449,993,751,320,-242,562,0.00445326980075778,-0.00336778528682307,0.00782105508758084,EPCI
200068435,CC Coeur du Perche,1982_1990,1986,8,10449,11044,1000,942,595,-58,653,0.0069466435202874,-0.00067715180533894,0.00762379532562634,EPCI
200068435,CC Coeur du Perche,1990_1999,1994.5,9,11044,11332,1112,1042,288,-70,358,0.00286446007037866,-0.000696222933772591,0.00356068300415125,EPCI
200068435,CC Coeur du Perche,1999_2010,2004.5,11,11332,11809,1197,1480,477,283,194,0.00375534010871736,0.0022280110078973,0.00152732910082006,EPCI
200068443,CC Andaine - Passais,2010_2015,2012.5,5,13673,13309,983,536,-364,-447,83,-0.00538198240219778,-0.0066091926752264,0.00122721027302862,EPCI
200068443,CC Andaine - Passais,1968_1975,1971.5,7,15543,14645,1402,1227,-898,-175,-723,-0.00846559138767777,-0.00164975333278799,-0.00681583805488979,EPCI
200068443,CC Andaine - Passais,1975_1982,1978.5,7,14645,14226,1446,1120,-419,-326,-93,-0.00413822868842506,-0.00321971969552881,-0.000918508992896255,EPCI
200068443,CC Andaine - Passais,1982_1990,1986,8,14226,14062,1558,1355,-164,-203,39,-0.0014483442024974,-0.00179276751894495,0.000344423316447552,EPCI
200068443,CC Andaine - Passais,1990_1999,1994.5,9,14062,13663,1600,1222,-399,-378,-21,-0.00319318805375401,-0.00302512552460907,-0.000168062529144948,EPCI
200068443,CC Andaine - Passais,1999_2010,2004.5,11,13663,13673,2066,1370,10,-696,706,6.65145729592531e-05,-0.00462941427796402,0.00469592885092327,EPCI
200068450,CC Argentan Intercom,2010_2015,2012.5,5,34792,34085,1808,1778,-707,-30,-677,-0.00409759594586145,-0.00017387252952736,-0.00392372341633409,EPCI
200068450,CC Argentan Intercom,1968_1975,1971.5,7,34377,35767,2343,4443,1390,2100,-710,0.00567862611363545,0.00857921930837011,-0.00290059319473466,EPCI
200068450,CC Argentan Intercom,1975_1982,1978.5,7,35767,36298,2367,4009,531,1642,-1111,0.00210749805084198,0.00651697137379009,-0.0044094733229481,EPCI
200068450,CC Argentan Intercom,1982_1990,1986,8,36298,35999,2723,4057,-299,1334,-1633,-0.0010334010531946,0.00461055854502208,-0.00564395959821669,EPCI
200068450,CC Argentan Intercom,1990_1999,1994.5,9,35999,36180,2956,3898,181,942,-761,0.000557413038565935,0.00290101150458072,-0.00234359846601479,EPCI
200068450,CC Argentan Intercom,1999_2010,2004.5,11,36180,34792,3770,4376,-1388,606,-1994,-0.0035499571020351,0.00154990922466374,-0.00509986632669883,EPCI
200068468,CC des Pays de l'Aigle,2010_2015,2012.5,5,26242,26144,1437,1340,-98,-97,-1,-0.000748012500247697,-0.000740379719632924,-7.63278061477241e-06,EPCI
200068468,CC des Pays de l'Aigle,1968_1975,1971.5,7,23818,24538,1890,2846,720,956,-236,0.00426354013900765,0.00566103385123793,-0.00139749371223028,EPCI
200068468,CC des Pays de l'Aigle,1975_1982,1978.5,7,24538,25775,1771,2623,1237,852,385,0.00705075370193153,0.00485629923528348,0.00219445446664805,EPCI
200068468,CC des Pays de l'Aigle,1982_1990,1986,8,25775,26060,2234,2806,285,572,-287,0.00137551287543225,0.00276067847279736,-0.00138516559736511,EPCI
200068468,CC des Pays de l'Aigle,1990_1999,1994.5,9,26060,26078,2273,2946,18,673,-655,7.67224213011897e-05,0.0028685660853167,-0.00279184366401551,EPCI
200068468,CC des Pays de l'Aigle,1999_2010,2004.5,11,26078,26242,2890,3402,164,512,-348,0.000570083679809486,0.00177977343940522,-0.00120968975959574,EPCI
200068484,CC des Causses à l'Aubrac,2010_2015,2012.5,5,14415,14574,1032,621,159,-411,570,0.00219636611763963,-0.00567739920974771,0.00787376532738734,EPCI
200068484,CC des Causses à l'Aubrac,1968_1975,1971.5,7,15933,14979,1707,1280,-954,-427,-527,-0.0087816724365537,-0.00393058084948473,-0.00485109158706897,EPCI
200068484,CC des Causses à l'Aubrac,1975_1982,1978.5,7,14979,14323,1661,1104,-656,-557,-99,-0.00637709140338016,-0.00541469498732127,-0.000962396416058897,EPCI
200068484,CC des Causses à l'Aubrac,1982_1990,1986,8,14323,13806,1727,1079,-517,-648,131,-0.0045848767797575,-0.00574661538352584,0.00116173860376834,EPCI
200068484,CC des Causses à l'Aubrac,1990_1999,1994.5,9,13806,13589,1717,1064,-217,-653,436,-0.00175874474191162,-0.00529244385469258,0.00353369911278096,EPCI
200068484,CC des Causses à l'Aubrac,1999_2010,2004.5,11,13589,14415,2149,1481,826,-668,1494,0.00537884058452431,-0.00434995824511167,0.00972879882963599,EPCI
200068500,CA de Cambrai,2010_2015,2012.5,5,81280,82352,4308,5148,1072,840,232,0.00262398846327061,0.00205611036301055,0.000567878100260058,EPCI
200068500,CA de Cambrai,1968_1975,1971.5,7,81743,84477,6706,10975,2734,4269,-1535,0.00471093727554495,0.00735588559959816,-0.00264494832405322,EPCI
200068500,CA de Cambrai,1975_1982,1978.5,7,84477,83150,6786,9516,-1327,2730,-4057,-0.00225931565631643,0.00464802693424556,-0.00690734259056199,EPCI
200068500,CA de Cambrai,1982_1990,1986,8,83150,81912,7144,9942,-1238,2798,-4036,-0.00187333129125145,0.00423391030122903,-0.00610724159248048,EPCI
200068500,CA de Cambrai,1990_1999,1994.5,9,81912,80965,7471,9636,-947,2165,-3112,-0.00129122539985926,0.00295195669555999,-0.00424318209541925,EPCI
200068500,CA de Cambrai,1999_2010,2004.5,11,80965,81280,8910,11666,315,2756,-2441,0.00035306424930992,0.00308903197174013,-0.00273596772243021,EPCI
200068534,CC Terroir de Caux,2010_2015,2012.5,5,36100,37864,1589,2377,1764,788,976,0.0095872515061235,0.00428274046872183,0.00530451103740166,EPCI
200068534,CC Terroir de Caux,1968_1975,1971.5,7,28429,28249,1869,3137,-180,1268,-1448,-0.000906973050595949,0.00638912126753147,-0.00729609431812742,EPCI
200068534,CC Terroir de Caux,1975_1982,1978.5,7,28249,30346,1918,2690,2097,772,1325,0.01028202247855,0.00378527484665743,0.00649674763189261,EPCI
200068534,CC Terroir de Caux,1982_1990,1986,8,30346,31658,2266,3377,1312,1111,201,0.00530479186517652,0.0044920912821731,0.000812700583003415,EPCI
200068534,CC Terroir de Caux,1990_1999,1994.5,9,31658,32207,2667,3369,549,702,-153,0.00191215238790732,0.00244504731568477,-0.000532894927777449,EPCI
200068534,CC Terroir de Caux,1999_2010,2004.5,11,32207,36100,3337,4591,3893,1254,2639,0.0104275413546939,0.00335888437163786,0.00706865698305607,EPCI
200068542,CC Les Balcons du Dauphiné,2010_2015,2012.5,5,69991,75092,2320,4384,5101,2064,3037,0.0141689140726653,0.0057331187308334,0.0084357953418319,EPCI
200068542,CC Les Balcons du Dauphiné,1968_1975,1971.5,7,32782,35518,3280,3397,2736,117,2619,0.0115172509307222,0.000492514020063778,0.0110247369106584,EPCI
200068542,CC Les Balcons du Dauphiné,1975_1982,1978.5,7,35518,42858,3398,3657,7340,259,7081,0.027199433204927,0.000959762016359141,0.0262396711885679,EPCI
200068542,CC Les Balcons du Dauphiné,1982_1990,1986,8,42858,48934,3718,4842,6076,1124,4952,0.0167106016443226,0.00309129628838357,0.013619305355939,EPCI
200068542,CC Les Balcons du Dauphiné,1990_1999,1994.5,9,48934,55459,3962,5621,6525,1659,4866,0.0140051163293973,0.00356084107133641,0.0104442752580609,EPCI
200068542,CC Les Balcons du Dauphiné,1999_2010,2004.5,11,55459,69991,4903,9120,14532,4217,10315,0.0213819924865257,0.00620477995566192,0.0151772125308638,EPCI
200068559,CC de l'Ouest Vosgien,2010_2015,2012.5,5,24354,23612,1411,1178,-742,-233,-509,-0.00616910240426938,-0.00193719792479079,-0.00423190447947859,EPCI
200068559,CC de l'Ouest Vosgien,1968_1975,1971.5,7,26127,27138,2019,3539,1011,1520,-509,0.00543840577985089,0.00817643598948897,-0.00273803020963808,EPCI
200068559,CC de l'Ouest Vosgien,1975_1982,1978.5,7,27138,27440,1947,3105,302,1158,-856,0.00158222799449814,0.00606695370075778,-0.00448472570625963,EPCI
200068559,CC de l'Ouest Vosgien,1982_1990,1986,8,27440,25799,2056,2891,-1641,835,-2476,-0.00767862648065953,0.00390716216413815,-0.0115857886447977,EPCI
200068559,CC de l'Ouest Vosgien,1990_1999,1994.5,9,25799,24819,2273,2727,-980,454,-1434,-0.00429367156707428,0.00198910907290992,-0.00628278063998419,EPCI
200068559,CC de l'Ouest Vosgien,1999_2010,2004.5,11,24819,24354,2833,2972,-465,139,-604,-0.00171792102615442,0.000513529080936484,-0.00223145010709091,EPCI
200068567,CC Les Vals du Dauphiné,2010_2015,2012.5,5,58791,61612,2400,3908,2821,1508,1313,0.00941764450195759,0.00503431687662249,0.0043833276253351,EPCI
200068567,CC Les Vals du Dauphiné,1968_1975,1971.5,7,34887,36894,3252,3857,2007,605,1402,0.00802267761645581,0.00241839559439749,0.00560428202205832,EPCI
200068567,CC Les Vals du Dauphiné,1975_1982,1978.5,7,36894,40716,3111,3801,3822,690,3132,0.0141813575438157,0.00256021368530424,0.0116211438585114,EPCI
200068567,CC Les Vals du Dauphiné,1982_1990,1986,8,40716,43779,3554,4382,3063,828,2235,0.00910786582096312,0.00246206754807622,0.0066457982728869,EPCI
200068567,CC Les Vals du Dauphiné,1990_1999,1994.5,9,43779,46271,3828,4752,2492,924,1568,0.00617019824310772,0.00228782631486016,0.00388237192824755,EPCI
200068567,CC Les Vals du Dauphiné,1999_2010,2004.5,11,46271,58791,4987,7295,12520,2308,10212,0.022009008264265,0.00405725168322074,0.0179517565810443,EPCI
200068625,"CC Alpes-Provence-Verdon ""sources de Lumière""",2010_2015,2012.5,5,11079,11267,647,405,188,-242,430,0.00337100402597623,-0.00433927113982047,0.0077102751657967,EPCI
200068625,"CC Alpes-Provence-Verdon ""sources de Lumière""",1968_1975,1971.5,7,8664,8154,929,585,-510,-344,-166,-0.00862939479118941,-0.00582061138856697,-0.00280878340262243,EPCI
200068625,"CC Alpes-Provence-Verdon ""sources de Lumière""",1975_1982,1978.5,7,8154,8760,960,582,606,-378,984,0.0102936618870115,-0.00642079899882897,0.0167144608858405,EPCI
200068625,"CC Alpes-Provence-Verdon ""sources de Lumière""",1982_1990,1986,8,8760,9323,1058,808,563,-250,813,0.00781646031153738,-0.0034708971187999,0.0112873574303373,EPCI
200068625,"CC Alpes-Provence-Verdon ""sources de Lumière""",1990_1999,1994.5,9,9323,9541,1123,721,218,-402,620,0.00257150471158063,-0.00474194905530006,0.00731345376688069,EPCI
200068625,"CC Alpes-Provence-Verdon ""sources de Lumière""",1999_2010,2004.5,11,9541,11079,1333,1022,1538,-311,1849,0.0136793654526595,-0.00276611356032321,0.0164454790129827,EPCI
200068641,CA Le Muretain Agglo,2010_2015,2012.5,5,109342,118490,3520,6934,9148,3414,5734,0.0161994071641376,0.00604555925430321,0.0101538479098344,EPCI
200068641,CA Le Muretain Agglo,1968_1975,1971.5,7,33742,44389,2343,4043,10647,1700,8947,0.039955926735141,0.00637973846621018,0.0335761882689309,EPCI
200068641,CA Le Muretain Agglo,1975_1982,1978.5,7,44389,56855,2967,4102,12466,1135,11331,0.0359914854795134,0.00327694015877167,0.0327145453207417,EPCI
200068641,CA Le Muretain Agglo,1982_1990,1986,8,56855,70435,3728,5949,13580,2221,11359,0.0271348904245008,0.00443789334556821,0.0226969970789326,EPCI
200068641,CA Le Muretain Agglo,1990_1999,1994.5,9,70435,85111,5007,8157,14676,3150,11526,0.0212522335306069,0.0045614973849422,0.0166907361456647,EPCI
200068641,CA Le Muretain Agglo,1999_2010,2004.5,11,85111,109342,7021,13402,24231,6381,17850,0.0230362651820339,0.00606637811590766,0.0169698870661263,EPCI
200068658,"CA de Chaumont, du Bassin Nogentais et du Bassin de Bologne Vignory Froncles",2010_2015,2012.5,5,46788,45459,2216,2332,-1329,116,-1445,-0.00574661248398845,0.00050158543878304,-0.00624819792277148,EPCI
200068658,"CA de Chaumont, du Bassin Nogentais et du Bassin de Bologne Vignory Froncles",1968_1975,1971.5,7,48653,50128,3396,6451,1475,3055,-1580,0.00427572386674902,0.00885582129689372,-0.00458009743014471,EPCI
200068658,"CA de Chaumont, du Bassin Nogentais et du Bassin de Bologne Vignory Froncles",1975_1982,1978.5,7,50128,51695,3230,5498,1567,2268,-701,0.00440701543131983,0.00637850095611574,-0.00197148552479592,EPCI
200068658,"CA de Chaumont, du Bassin Nogentais et du Bassin de Bologne Vignory Froncles",1982_1990,1986,8,51695,50827,3669,5987,-868,2318,-3186,-0.00211443088309049,0.00564660228917483,-0.00776103317226532,EPCI
200068658,"CA de Chaumont, du Bassin Nogentais et du Bassin de Bologne Vignory Froncles",1990_1999,1994.5,9,50827,49175,4122,5376,-1652,1254,-2906,-0.00366464044160131,0.00278175491148186,-0.00644639535308317,EPCI
200068658,"CA de Chaumont, du Bassin Nogentais et du Bassin de Bologne Vignory Froncles",1999_2010,2004.5,11,49175,46788,4872,6057,-2387,1185,-3572,-0.00451329383904409,0.00224057528247476,-0.00675386912151884,EPCI
200068666,CA de Saint-Dizier Der et Blaise,2010_2015,2012.5,5,60068,59442,3080,3510,-626,430,-1056,-0.00209304783395126,0.00143771656325725,-0.00353076439720851,EPCI
200068666,CA de Saint-Dizier Der et Blaise,1968_1975,1971.5,7,70609,71846,4487,9786,1237,5299,-4062,0.00248412667232079,0.0106413801427873,-0.00815725347046648,EPCI
200068666,CA de Saint-Dizier Der et Blaise,1975_1982,1978.5,7,71846,71407,4572,8510,-439,3938,-4377,-0.000875193320679979,0.00785082299963043,-0.00872601632031041,EPCI
200068666,CA de Saint-Dizier Der et Blaise,1982_1990,1986,8,71407,69649,4935,8866,-1758,3931,-5689,-0.00311109562303213,0.0069566080171441,-0.0100677036401762,EPCI
200068666,CA de Saint-Dizier Der et Blaise,1990_1999,1994.5,9,69649,65593,5202,7780,-4056,2578,-6634,-0.00664442307120772,0.00422320578835638,-0.0108676288595641,EPCI
200068666,CA de Saint-Dizier Der et Blaise,1999_2010,2004.5,11,65593,60068,6854,8300,-5525,1446,-6971,-0.00796733925578352,0.0020852077038666,-0.0100525469596501,EPCI
200068674,CA Grand Lac - CA du Lac du Bourget,2010_2015,2012.5,5,68676,73756,2969,3875,5080,906,4174,0.0143748495061919,0.00256370347492321,0.0118111460312687,EPCI
200068674,CA Grand Lac - CA du Lac du Bourget,1968_1975,1971.5,7,38203,40670,3453,4004,2467,551,1916,0.00897960165081457,0.00200557783121152,0.00697402381960305,EPCI
200068674,CA Grand Lac - CA du Lac du Bourget,1975_1982,1978.5,7,40670,45339,3481,3781,4669,300,4369,0.015646410120842,0.00100533798163474,0.0146410721392073,EPCI
200068674,CA Grand Lac - CA du Lac du Bourget,1982_1990,1986,8,45339,52244,4011,4948,6905,937,5968,0.01787760780137,0.00242596937145311,0.0154516384299169,EPCI
200068674,CA Grand Lac - CA du Lac du Bourget,1990_1999,1994.5,9,52244,59053,4498,5947,6809,1449,5360,0.0137053234465405,0.00291658300397081,0.0107887404425697,EPCI
200068674,CA Grand Lac - CA du Lac du Bourget,1999_2010,2004.5,11,59053,68676,5997,7927,9623,1930,7693,0.0138186476254647,0.00277148393610588,0.0110471636893588,EPCI
200068682,CC Terre d'Eau,2010_2015,2012.5,5,18406,18149,917,885,-257,-32,-225,-0.00280829646580549,-0.000349671155275392,-0.0024586253105301,EPCI
200068682,CC Terre d'Eau,1968_1975,1971.5,7,18842,20241,1343,2765,1399,1422,-23,0.010284212674164,0.0104532883650188,-0.000169075690854734,EPCI
200068682,CC Terre d'Eau,1975_1982,1978.5,7,20241,20192,1269,2319,-49,1050,-1099,-0.000346192055210248,0.00741840118307675,-0.007764593238287,EPCI
200068682,CC Terre d'Eau,1982_1990,1986,8,20192,19767,1296,2174,-425,878,-1303,-0.00265554350953279,0.00548604047381126,-0.00814158398334405,EPCI
200068682,CC Terre d'Eau,1990_1999,1994.5,9,19767,19086,1433,2033,-681,600,-1281,-0.00388784475279047,0.00342541387911055,-0.00731325863190102,EPCI
200068682,CC Terre d'Eau,1999_2010,2004.5,11,19086,18406,1856,2346,-680,490,-1170,-0.00329260232763884,0.00237261050079858,-0.00566521282843741,EPCI
200068757,CA d'Épinal,2010_2015,2012.5,5,112531,111929,5334,6231,-602,897,-1499,-0.00107222426345033,0.00159764977460954,-0.00266987403805987,EPCI
200068757,CA d'Épinal,1968_1975,1971.5,7,106713,111668,8094,13852,4955,5758,-803,0.00650495096958181,0.00755913374023251,-0.0010541827706507,EPCI
200068757,CA d'Épinal,1975_1982,1978.5,7,111668,112825,8160,12170,1157,4010,-2853,0.00147362219122638,0.00510736818221069,-0.00363374599098431,EPCI
200068757,CA d'Épinal,1982_1990,1986,8,112825,112798,8894,12993,-27,4099,-4126,-2.99167153295921e-05,0.00454180059762955,-0.00457171731295914,EPCI
200068757,CA d'Épinal,1990_1999,1994.5,9,112798,112060,9404,12980,-738,3576,-4314,-0.000729085895752824,0.00353280645421693,-0.00426189234996976,EPCI
200068757,CA d'Épinal,1999_2010,2004.5,11,112060,112531,11435,14586,471,3151,-2680,0.000381372440751537,0.00255138972570721,-0.00217001728495567,EPCI
200068765,CC du Sisteronais-Buëch,2010_2015,2012.5,5,24892,24582,1400,1038,-310,-362,52,-0.00250326138547452,-0.00292316329529605,0.000419901909821532,EPCI
200068765,CC du Sisteronais-Buëch,1968_1975,1971.5,7,20171,21326,1710,1765,1155,55,1100,0.00798615719253992,0.000380293199644758,0.00760586399289516,EPCI
200068765,CC du Sisteronais-Buëch,1975_1982,1978.5,7,21326,20326,1830,1464,-1000,-366,-634,-0.0068373937646371,-0.00250248611785718,-0.00433490764677992,EPCI
200068765,CC du Sisteronais-Buëch,1982_1990,1986,8,20326,21099,2104,1872,773,-232,1005,0.00467649976280482,-0.00140355490940585,0.00608005467221067,EPCI
200068765,CC du Sisteronais-Buëch,1990_1999,1994.5,9,21099,22294,2360,1989,1195,-371,1566,0.00614010004710264,-0.0019062570020712,0.00804635704917383,EPCI
200068765,CC du Sisteronais-Buëch,1999_2010,2004.5,11,22294,24892,3040,2408,2598,-632,3230,0.0100711839436685,-0.00244995698706638,0.0125211409307348,EPCI
200068773,CC des Vosges Côté Sud Ouest,2010_2015,2012.5,5,12864,12342,831,524,-522,-307,-215,-0.00825070108751302,-0.00485242381966762,-0.0033982772678454,EPCI
200068773,CC des Vosges Côté Sud Ouest,1968_1975,1971.5,7,16786,16181,1482,1772,-605,290,-895,-0.00523020193567314,0.00250703894437225,-0.00773724088004539,EPCI
200068773,CC des Vosges Côté Sud Ouest,1975_1982,1978.5,7,16181,15431,1620,1366,-750,-254,-496,-0.00675696000707371,-0.00228835712239563,-0.00446860288467808,EPCI
200068773,CC des Vosges Côté Sud Ouest,1982_1990,1986,8,15431,14425,1578,1436,-1006,-142,-864,-0.00839155030812822,-0.00118449318464633,-0.00720705712348189,EPCI
200068773,CC des Vosges Côté Sud Ouest,1990_1999,1994.5,9,14425,13544,1667,1339,-881,-328,-553,-0.0069776719377237,-0.00259781656705264,-0.00437985537067106,EPCI
200068773,CC des Vosges Côté Sud Ouest,1999_2010,2004.5,11,13544,12864,1861,1362,-680,-499,-181,-0.00467186476622528,-0.0034283242916859,-0.00124354047453937,EPCI
200068781,CA Valence Romans Agglo,2010_2015,2012.5,5,213017,219366,9193,13771,6349,4578,1771,0.00589120388868936,0.00424790225270434,0.00164330163598501,EPCI
200068781,CA Valence Romans Agglo,1968_1975,1971.5,7,157205,172837,11083,20571,15632,9488,6144,0.0136347261748189,0.00827573451552466,0.00535899165929421,EPCI
200068781,CA Valence Romans Agglo,1975_1982,1978.5,7,172837,181327,11215,18475,8490,7260,1230,0.0068739575459944,0.00587808383791747,0.000995873708076928,EPCI
200068781,CA Valence Romans Agglo,1982_1990,1986,8,181327,190101,13027,21168,8774,8141,633,0.00592416370533844,0.00549676507011172,0.000427398635226718,EPCI
200068781,CA Valence Romans Agglo,1990_1999,1994.5,9,190101,199616,14658,23545,9515,8887,628,0.00544141893489747,0.00508227956641448,0.000359139368482986,EPCI
200068781,CA Valence Romans Agglo,1999_2010,2004.5,11,199616,213017,18600,29615,13401,11015,2386,0.00592443077342719,0.00486960711658089,0.0010548236568463,EPCI
200068799,CC Intercom de la Vire au Noireau,2010_2015,2012.5,5,48928,48137,2728,2634,-791,-94,-697,-0.00325443631878697,-0.000386747173155468,-0.0028676891456315,EPCI
200068799,CC Intercom de la Vire au Noireau,1968_1975,1971.5,7,48244,48198,3553,5340,-46,1787,-1833,-0.00013626804341893,0.00529371725194844,-0.00542998529536737,EPCI
200068799,CC Intercom de la Vire au Noireau,1975_1982,1978.5,7,48198,48580,3630,4783,382,1153,-771,0.00112840719491136,0.00340589920348901,-0.00227749200857765,EPCI
200068799,CC Intercom de la Vire au Noireau,1982_1990,1986,8,48580,47164,4068,4848,-1416,780,-2196,-0.00369080141964551,0.00203306857861829,-0.00572386999826379,EPCI
200068799,CC Intercom de la Vire au Noireau,1990_1999,1994.5,9,47164,47535,4364,4876,371,512,-141,0.000870978203257655,0.00120199687349844,-0.00033101867024078,EPCI
200068799,CC Intercom de la Vire au Noireau,1999_2010,2004.5,11,47535,48928,5730,6048,1393,318,1075,0.00262922745701832,0.000600211293131247,0.00202901616388708,EPCI
200068807,CC Lèze Ariège,2010_2015,2012.5,5,28524,30862,1124,1847,2338,723,1615,0.0158807427630514,0.00491093969960914,0.0109698030634423,EPCI
200068807,CC Lèze Ariège,1968_1975,1971.5,7,13813,15484,1280,1467,1671,187,1484,0.0164476626908725,0.0018406420844962,0.0146070206063763,EPCI
200068807,CC Lèze Ariège,1975_1982,1978.5,7,15484,17532,1435,1206,2048,-229,2277,0.0179041849602108,-0.00200198161908608,0.0199061665792969,EPCI
200068807,CC Lèze Ariège,1982_1990,1986,8,17532,20185,1643,1727,2653,84,2569,0.0177700377280428,0.000562639716982884,0.0172073980110599,EPCI
200068807,CC Lèze Ariège,1990_1999,1994.5,9,20185,22475,1841,2141,2290,300,1990,0.0120119965738272,0.00157362400530488,0.0104383725685224,EPCI
200068807,CC Lèze Ariège,1999_2010,2004.5,11,22475,28524,2251,3513,6049,1262,4787,0.0219039224138704,0.00456980494070168,0.0173341174731687,EPCI
200068815,CC Coeur de Garonne,2010_2015,2012.5,5,32708,34402,1520,1968,1694,448,1246,0.010150168197544,0.00268434200265626,0.00746582619488773,EPCI
200068815,CC Coeur de Garonne,1968_1975,1971.5,7,19705,19528,1824,1425,-177,-399,222,-0.00128818066153535,-0.00290386488108817,0.00161568421955282,EPCI
200068815,CC Coeur de Garonne,1975_1982,1978.5,7,19528,21114,1828,1189,1586,-639,2225,0.011217737124132,-0.00451963053109731,0.0157373676552293,EPCI
200068815,CC Coeur de Garonne,1982_1990,1986,8,21114,22473,2185,1624,1359,-561,1920,0.00782776060514734,-0.0032313272255244,0.0110590878306717,EPCI
200068815,CC Coeur de Garonne,1990_1999,1994.5,9,22473,23974,2406,2117,1501,-289,1790,0.00720979086186158,-0.00138816093209727,0.00859795179395884,EPCI
200068815,CC Coeur de Garonne,1999_2010,2004.5,11,23974,32708,3092,3638,8734,546,8188,0.0286434441722001,0.00179062520242973,0.0268528189697704,EPCI
200068831,CC Pays Ségali,2010_2015,2012.5,5,17612,17947,1086,859,335,-227,562,0.00377560614156858,-0.00255839580339124,0.00633400194495982,EPCI
200068831,CC Pays Ségali,1968_1975,1971.5,7,19271,18079,1697,1394,-1192,-303,-889,-0.00908000146783261,-0.00230808762143732,-0.00677191384639529,EPCI
200068831,CC Pays Ségali,1975_1982,1978.5,7,18079,16909,1671,1020,-1170,-651,-519,-0.00951232871057139,-0.00529275725690767,-0.00421957145366372,EPCI
200068831,CC Pays Ségali,1982_1990,1986,8,16909,16423,1880,1206,-486,-674,188,-0.00363876773099214,-0.0050463568944212,0.00140758916342906,EPCI
200068831,CC Pays Ségali,1990_1999,1994.5,9,16423,15943,2022,1220,-480,-802,322,-0.00329045564941843,-0.0054978029809033,0.00220734733148487,EPCI
200068831,CC Pays Ségali,1999_2010,2004.5,11,15943,17612,2358,1831,1669,-527,2196,0.00909204989168555,-0.00287088693404331,0.0119629368257289,EPCI
200068856,CC des Hauts du Perche,2010_2015,2012.5,5,8713,8445,614,380,-268,-234,-34,-0.00622884242415411,-0.00543861614646292,-0.000790226277691194,EPCI
200068856,CC des Hauts du Perche,1968_1975,1971.5,7,9230,9222,886,955,-8,69,-77,-0.000123865860883199,0.00106834305011759,-0.00119220891100079,EPCI
200068856,CC des Hauts du Perche,1975_1982,1978.5,7,9222,8834,762,846,-388,84,-472,-0.0061217595769848,0.00132532939295547,-0.00744708896994027,EPCI
200068856,CC des Hauts du Perche,1982_1990,1986,8,8834,8282,870,825,-552,-45,-507,-0.0080329902060553,-0.000654863332015378,-0.00737812687403992,EPCI
200068856,CC des Hauts du Perche,1990_1999,1994.5,9,8282,8324,993,793,42,-200,242,0.000562205023370899,-0.00267716677795666,0.00323937180132756,EPCI
200068856,CC des Hauts du Perche,1999_2010,2004.5,11,8324,8713,1206,1007,389,-199,588,0.0041607460336941,-0.00212850504037307,0.00628925107406717,EPCI
200068864,CC de la Mossig et du Vignoble,2010_2015,2012.5,5,23707,24463,939,1191,756,252,504,0.00629803147677843,0.00209934382559281,0.00419868765118562,EPCI
200068864,CC de la Mossig et du Vignoble,1968_1975,1971.5,7,15691,16614,1383,1712,923,329,594,0.00819891621081559,0.00292247392563199,0.0052764422851836,EPCI
200068864,CC de la Mossig et du Vignoble,1975_1982,1978.5,7,16614,18402,1455,1508,1788,53,1735,0.0147090779560197,0.000436007344333918,0.0142730706116858,EPCI
200068864,CC de la Mossig et du Vignoble,1982_1990,1986,8,18402,19465,1561,1943,1063,382,681,0.00704452508788767,0.00253152265623056,0.0045130024316571,EPCI
200068864,CC de la Mossig et du Vignoble,1990_1999,1994.5,9,19465,21450,1645,2185,1985,540,1445,0.0108480473325876,0.00295110607536388,0.00789694125722372,EPCI
200068864,CC de la Mossig et du Vignoble,1999_2010,2004.5,11,21450,23707,1931,2837,2257,906,1351,0.00913655103776967,0.00366757431999084,0.00546897671777883,EPCI
200068872,CC Éguzon - Argenton - Vallée de la Creuse,2010_2015,2012.5,5,20065,19882,1537,845,-183,-692,509,-0.00183076289120587,-0.00692288481264734,0.00509212192144147,EPCI
200068872,CC Éguzon - Argenton - Vallée de la Creuse,1968_1975,1971.5,7,21419,20842,2171,1914,-577,-257,-320,-0.00389357132085,-0.00173422500772695,-0.00215934631312305,EPCI
200068872,CC Éguzon - Argenton - Vallée de la Creuse,1975_1982,1978.5,7,20842,20518,2169,1382,-324,-787,463,-0.00223573015323741,-0.00543061614382051,0.00319488599058309,EPCI
200068872,CC Éguzon - Argenton - Vallée de la Creuse,1982_1990,1986,8,20518,19769,2413,1458,-749,-955,206,-0.00463764966962033,-0.00591315812348119,0.00127550845386086,EPCI
200068872,CC Éguzon - Argenton - Vallée de la Creuse,1990_1999,1994.5,9,19769,19670,2743,1538,-99,-1205,1106,-0.000557669090628044,-0.00678779044653326,0.00623012135590521,EPCI
200068872,CC Éguzon - Argenton - Vallée de la Creuse,1999_2010,2004.5,11,19670,20065,3533,2079,395,-1454,1849,0.00180912279323509,-0.00665940390218687,0.00846852669542196,EPCI
200068880,CC Champagne Boischauts,2010_2015,2012.5,5,10329,10111,554,476,-218,-78,-140,-0.00425721882543006,-0.00152322508432819,-0.00273399374110188,EPCI
200068880,CC Champagne Boischauts,1968_1975,1971.5,7,11507,10447,1017,884,-1060,-133,-927,-0.0137109496770543,-0.00172033613872474,-0.0119906135383296,EPCI
200068880,CC Champagne Boischauts,1975_1982,1978.5,7,10447,9869,1016,630,-578,-386,-192,-0.00809793713693196,-0.00540796493919678,-0.00268997219773519,EPCI
200068880,CC Champagne Boischauts,1982_1990,1986,8,9869,9453,1096,642,-416,-454,38,-0.0053688334887857,-0.0058592557786267,0.000490422289841001,EPCI
200068880,CC Champagne Boischauts,1990_1999,1994.5,9,9453,9263,1076,821,-190,-255,65,-0.00225347722937486,-0.00302440364995046,0.000770926420575609,EPCI
200068880,CC Champagne Boischauts,1999_2010,2004.5,11,9263,10329,1311,1299,1066,-12,1078,0.00995169224634318,-0.000112026554367841,0.010063718800711,EPCI
200068914,CC La Rochefoucauld - Porte du Périgord,2010_2015,2012.5,5,21769,21937,1329,1026,168,-303,471,0.00153873654700321,-0.00277522127227364,0.00431395781927685,EPCI
200068914,CC La Rochefoucauld - Porte du Périgord,1968_1975,1971.5,7,19160,19415,1742,1850,255,108,147,0.00189052631589148,0.000800693498495216,0.00108983281739627,EPCI
200068914,CC La Rochefoucauld - Porte du Périgord,1975_1982,1978.5,7,19415,19720,1763,1464,305,-299,604,0.00222925051957179,-0.00218539641099005,0.00441464693056184,EPCI
200068914,CC La Rochefoucauld - Porte du Périgord,1982_1990,1986,8,19720,20289,1952,1641,569,-311,880,0.00356201872469453,-0.00194690302878734,0.00550892175348187,EPCI
200068914,CC La Rochefoucauld - Porte du Périgord,1990_1999,1994.5,9,20289,19881,2044,1577,-408,-467,59,-0.00225460626931751,-0.00258064001904724,0.000326033749729737,EPCI
200068914,CC La Rochefoucauld - Porte du Périgord,1999_2010,2004.5,11,19881,21769,2544,2246,1888,-298,2186,0.00828159860649724,-0.00130715910208484,0.00958875770858208,EPCI
200068922,CC du Confluent et des Coteaux de Prayssas,2010_2015,2012.5,5,18012,18288,978,1009,276,31,245,0.00304601061394605,0.000342124380551911,0.00270388623339414,EPCI
200068922,CC du Confluent et des Coteaux de Prayssas,1968_1975,1971.5,7,17019,16000,1541,1409,-1019,-132,-887,-0.00878145080732817,-0.00113753827926135,-0.00764391252806682,EPCI
200068922,CC du Confluent et des Coteaux de Prayssas,1975_1982,1978.5,7,16000,16213,1419,1190,213,-229,442,0.00189102392458707,-0.00203307267009595,0.00392409659468302,EPCI
200068922,CC du Confluent et des Coteaux de Prayssas,1982_1990,1986,8,16213,16456,1544,1493,243,-51,294,0.00186132546754392,-0.000390648554916625,0.00225197402246054,EPCI
200068922,CC du Confluent et des Coteaux de Prayssas,1990_1999,1994.5,9,16456,16744,1752,1494,288,-258,546,0.00192961852157536,-0.00172861659224459,0.00365823511381995,EPCI
200068922,CC du Confluent et des Coteaux de Prayssas,1999_2010,2004.5,11,16744,18012,2229,2106,1268,-123,1391,0.00665826994770469,-0.000645873188933499,0.00730414313663819,EPCI
200068930,CC Fumel Vallée du Lot,2010_2015,2012.5,5,25105,24507,1533,1075,-598,-458,-140,-0.00481004220854298,-0.00368394537042255,-0.00112609683812043,EPCI
200068930,CC Fumel Vallée du Lot,1968_1975,1971.5,7,25788,26812,2059,2768,1024,709,315,0.00557839893697532,0.00386238754522998,0.00171601139174534,EPCI
200068930,CC Fumel Vallée du Lot,1975_1982,1978.5,7,26812,26893,2004,2230,81,226,-145,0.00043101874759266,0.00120259551797458,-0.000771576770381922,EPCI
200068930,CC Fumel Vallée du Lot,1982_1990,1986,8,26893,26294,2415,2302,-599,-113,-486,-0.00281169643414936,-0.000530420195423835,-0.00228127623872552,EPCI
200068930,CC Fumel Vallée du Lot,1990_1999,1994.5,9,26294,24875,2638,2176,-1419,-462,-957,-0.00614520642019945,-0.00200076488099517,-0.00414444153920428,EPCI
200068930,CC Fumel Vallée du Lot,1999_2010,2004.5,11,24875,25105,3228,2575,230,-653,883,0.000837054356624956,-0.00237650649946129,0.00321356085608624,EPCI
200068948,CC Albret Communauté,2010_2015,2012.5,5,26459,26371,1642,1206,-88,-436,348,-0.000666066789087982,-0.00330005818229955,0.00263399139321157,EPCI
200068948,CC Albret Communauté,1968_1975,1971.5,7,27629,26267,2671,2372,-1362,-299,-1063,-0.00719577798468363,-0.00157968988063172,-0.00561608810405191,EPCI
200068948,CC Albret Communauté,1975_1982,1978.5,7,26267,25442,2603,1883,-825,-720,-105,-0.00454848797318452,-0.00396958950387013,-0.000578898469314394,EPCI
200068948,CC Albret Communauté,1982_1990,1986,8,25442,25347,2800,2221,-95,-579,484,-0.000467512169013196,-0.00284936364061727,0.00238185147160407,EPCI
200068948,CC Albret Communauté,1990_1999,1994.5,9,25347,24950,3074,2068,-397,-1006,609,-0.00175252449253249,-0.00444090589291609,0.0026883814003836,EPCI
200068948,CC Albret Communauté,1999_2010,2004.5,11,24950,26459,3727,2700,1509,-1027,2536,0.00535268770586828,-0.00364294915435833,0.0089956368602266,EPCI
200068955,CC Anjou Loir et Sarthe,2010_2015,2012.5,5,26665,27576,1188,1864,911,676,235,0.00674141878445522,0.00500241393884932,0.0017390048456059,EPCI
200068955,CC Anjou Loir et Sarthe,1968_1975,1971.5,7,19499,18997,1645,2119,-502,474,-976,-0.00371908276544319,0.00351164388609576,-0.00723072665153896,EPCI
200068955,CC Anjou Loir et Sarthe,1975_1982,1978.5,7,18997,20542,1655,1989,1545,334,1211,0.0112326894329522,0.00242829661527899,0.00880439281767321,EPCI
200068955,CC Anjou Loir et Sarthe,1982_1990,1986,8,20542,21361,1879,2246,819,367,452,0.00489886774836923,0.00219521912533762,0.00270364862303161,EPCI
200068955,CC Anjou Loir et Sarthe,1990_1999,1994.5,9,21361,22641,1961,2473,1280,512,768,0.00648712779902638,0.00259485111961055,0.00389227667941583,EPCI
200068955,CC Anjou Loir et Sarthe,1999_2010,2004.5,11,22641,26665,2502,4085,4024,1583,2441,0.0149829005913291,0.00589411819981958,0.00908878239150954,EPCI
200068963,CC Maine Coeur de Sarthe,2010_2015,2012.5,5,20583,21161,727,1313,578,586,-8,0.0055542424210604,0.00563111774868753,-7.68753276271334e-05,EPCI
200068963,CC Maine Coeur de Sarthe,1968_1975,1971.5,7,12375,12800,897,1331,425,434,-9,0.00483549093048086,0.00493788956194986,-0.000102398631469007,EPCI
200068963,CC Maine Coeur de Sarthe,1975_1982,1978.5,7,12800,15064,921,1163,2264,242,2022,0.0235388553701346,0.00251607906341544,0.0210227763067191,EPCI
200068963,CC Maine Coeur de Sarthe,1982_1990,1986,8,15064,15812,1012,1411,748,399,349,0.00607605404261014,0.0032411036938522,0.00283495034875794,EPCI
200068963,CC Maine Coeur de Sarthe,1990_1999,1994.5,9,15812,16956,1047,1678,1144,631,513,0.00779159864208334,0.00429763876149877,0.00349395988058458,EPCI
200068963,CC Maine Coeur de Sarthe,1999_2010,2004.5,11,16956,20583,1413,2757,3627,1344,2283,0.0177783444061403,0.00658783977994283,0.0111905046261975,EPCI
200068989,CA Dinan Agglomération,2010_2015,2012.5,5,93060,96261,5273,4904,3201,-369,3570,0.00678668707908292,-0.00078234537087835,0.00756903244996127,EPCI
200068989,CA Dinan Agglomération,1968_1975,1971.5,7,75729,78973,6934,9024,3244,2090,1154,0.00601010918999534,0.00387211103794398,0.00213799815205136,EPCI
200068989,CA Dinan Agglomération,1975_1982,1978.5,7,78973,81952,7068,8130,2979,1062,1917,0.00530368473496012,0.0018907395731882,0.00341294516177192,EPCI
200068989,CA Dinan Agglomération,1982_1990,1986,8,81952,82330,7571,7906,378,335,43,0.000575396888968793,0.000509941687313613,6.54552016551802e-05,EPCI
200068989,CA Dinan Agglomération,1990_1999,1994.5,9,82330,81480,8443,7391,-850,-1052,202,-0.00115244319911312,-0.00142631793584353,0.000273874736730412,EPCI
200068989,CA Dinan Agglomération,1999_2010,2004.5,11,81480,93060,10718,10581,11580,-137,11717,0.0121538886489361,-0.000143789528920919,0.012297678177857,EPCI
200068997,CA Arlysère,2010_2015,2012.5,5,59027,60459,2506,3406,1432,900,532,0.00480560666891128,0.00302028352096379,0.00178532314794749,EPCI
200068997,CA Arlysère,1968_1975,1971.5,7,45022,47261,3220,5189,2239,1969,270,0.00695754516082769,0.00611853792839202,0.000839007232435675,EPCI
200068997,CA Arlysère,1975_1982,1978.5,7,47261,48659,3247,4519,1398,1272,126,0.00417316282335989,0.00379704085215578,0.00037612197120411,EPCI
200068997,CA Arlysère,1982_1990,1986,8,48659,52129,3680,5285,3470,1605,1865,0.00864775633801096,0.00399989882493014,0.00464785751308082,EPCI
200068997,CA Arlysère,1990_1999,1994.5,9,52129,53558,4196,5718,1429,1522,-93,0.00300938168509335,0.0032052336771953,-0.000195851992101947,EPCI
200068997,CA Arlysère,1999_2010,2004.5,11,53558,59027,5295,7263,5469,1968,3501,0.00887825153895672,0.00319480691692573,0.00568344462203099,EPCI
200069003,CC du Barséquanais en Champagne,2010_2015,2012.5,5,19610,19158,1104,1017,-452,-87,-365,-0.00465299258227969,-0.000895598129775073,-0.00375739445250462,EPCI
200069003,CC du Barséquanais en Champagne,1968_1975,1971.5,7,19263,19773,1899,2100,510,201,309,0.00374000690213494,0.00147400272025318,0.00226600418188176,EPCI
200069003,CC du Barséquanais en Champagne,1975_1982,1978.5,7,19773,20092,1819,1808,319,-11,330,0.00228895211009994,-7.89293831068945e-05,0.00236788149320683,EPCI
200069003,CC du Barséquanais en Champagne,1982_1990,1986,8,20092,19899,2046,2104,-193,58,-251,-0.0012058032688459,0.000362365749186849,-0.00156816901803274,EPCI
200069003,CC du Barséquanais en Champagne,1990_1999,1994.5,9,19899,19373,2141,1993,-526,-148,-378,-0.00297214497336185,-0.000836268927866071,-0.00213587604549577,EPCI
200069003,CC du Barséquanais en Champagne,1999_2010,2004.5,11,19373,19610,2445,2417,237,-28,265,0.00110600172417108,-0.000130666870366204,0.00123666859453728,EPCI
200069029,CA des Deux Baies en Montreuillois,2010_2015,2012.5,5,67709,66915,3733,3779,-794,46,-840,-0.00235640995147923,0.000136517453108369,-0.0024929274045876,EPCI
200069029,CA des Deux Baies en Montreuillois,1968_1975,1971.5,7,51852,56478,4192,7125,4626,2933,1693,0.0122830640296778,0.00778777060074472,0.00449529342893311,EPCI
200069029,CA des Deux Baies en Montreuillois,1975_1982,1978.5,7,56478,59529,4535,6732,3051,2197,854,0.00754437460297819,0.00543264208546152,0.00211173251751667,EPCI
200069029,CA des Deux Baies en Montreuillois,1982_1990,1986,8,59529,62423,4984,7593,2894,2609,285,0.00595141577633007,0.00536532265392023,0.000586093122409838,EPCI
200069029,CA des Deux Baies en Montreuillois,1990_1999,1994.5,9,62423,64043,5693,7481,1620,1788,-168,0.00285082651554602,0.00314646778382487,-0.000295641268278847,EPCI
200069029,CA des Deux Baies en Montreuillois,1999_2010,2004.5,11,64043,67709,7465,8994,3666,1529,2137,0.00507322341762739,0.00211591887767384,0.00295730453995356,EPCI
200069037,CA du Pays de Saint-Omer,2010_2015,2012.5,5,102792,105205,4603,6819,2413,2216,197,0.00465144427944253,0.00427169520233926,0.000379749077103265,EPCI
200069037,CA du Pays de Saint-Omer,1968_1975,1971.5,7,81471,89472,6434,12319,8001,5885,2116,0.0134726054793972,0.00990954671244252,0.00356305876695469,EPCI
200069037,CA du Pays de Saint-Omer,1975_1982,1978.5,7,89472,93892,6292,11644,4420,5352,-932,0.00691227430366648,0.00836979458670203,-0.00145752028303556,EPCI
200069037,CA du Pays de Saint-Omer,1982_1990,1986,8,93892,96912,6908,12908,3020,6000,-2980,0.00396511091792751,0.007877703810452,-0.00391259289252449,EPCI
200069037,CA du Pays de Saint-Omer,1990_1999,1994.5,9,96912,100399,7326,12470,3487,5144,-1657,0.00393537854704484,0.00580544515227952,-0.00187006660523467,EPCI
200069037,CA du Pays de Saint-Omer,1999_2010,2004.5,11,100399,102792,9450,15028,2393,5578,-3185,0.00214368367803819,0.0049968523009181,-0.00285316862287991,EPCI
200069052,CA Grand Belfort,2010_2015,2012.5,5,103989,105390,4181,6684,1401,2503,-1102,0.00268011121971035,0.00478823581936831,-0.00210812459965796,EPCI
200069052,CA Grand Belfort,1968_1975,1971.5,7,86292,93553,6128,11298,7261,5170,2091,0.0116084651063082,0.00826549574433458,0.00334296936197362,EPCI
200069052,CA Grand Belfort,1975_1982,1978.5,7,93553,95559,6203,10651,2006,4448,-2442,0.00303541717087863,0.00673057605985451,-0.00369515888897588,EPCI
200069052,CA Grand Belfort,1982_1990,1986,8,95559,96839,6618,11661,1280,5043,-3763,0.00166462744811002,0.00655837204751472,-0.0048937445994047,EPCI
200069052,CA Grand Belfort,1990_1999,1994.5,9,96839,99646,6950,12250,2807,5300,-2493,0.00317994529476118,0.0060041717357443,-0.00282422644098312,EPCI
200069052,CA Grand Belfort,1999_2010,2004.5,11,99646,103989,8644,15187,4343,6543,-2200,0.00388582294092932,0.00585423428563217,-0.00196841134470285,EPCI
200069060,CC des Vosges du Sud,2010_2015,2012.5,5,15276,15405,862,767,129,-95,224,0.00168324761060812,-0.00123960095354861,0.00292284856415673,EPCI
200069060,CC des Vosges du Sud,1968_1975,1971.5,7,11705,12312,1234,1177,607,-57,664,0.00724875963979765,-0.000680690773424162,0.00792945041322182,EPCI
200069060,CC des Vosges du Sud,1975_1982,1978.5,7,12312,13002,1150,989,690,-161,851,0.00782024753817168,-0.00182472442557339,0.00964497196374507,EPCI
200069060,CC des Vosges du Sud,1982_1990,1986,8,13002,13473,1295,1203,471,-92,563,0.00445796868291515,-0.000870770952926101,0.00532873963584125,EPCI
200069060,CC des Vosges du Sud,1990_1999,1994.5,9,13473,14215,1420,1280,742,-140,882,0.00597444985054296,-0.00112725468878169,0.00710170453932465,EPCI
200069060,CC des Vosges du Sud,1999_2010,2004.5,11,14215,15276,1955,1850,1061,-105,1166,0.00656557077826125,-0.000649750171269964,0.00721532094953122,EPCI
200069086,CC Leff Armor Communauté,2010_2015,2012.5,5,30150,31199,1688,1917,1049,229,820,0.00686367173344693,0.00149836113151511,0.00536531060193182,EPCI
200069086,CC Leff Armor Communauté,1968_1975,1971.5,7,23843,23040,2409,2088,-803,-321,-482,-0.00488216293583288,-0.00195164919352722,-0.00293051374230566,EPCI
200069086,CC Leff Armor Communauté,1975_1982,1978.5,7,23040,24075,2420,1851,1035,-569,1604,0.00629719043681232,-0.00346193367975479,0.00975912411656711,EPCI
200069086,CC Leff Armor Communauté,1982_1990,1986,8,24075,24551,2644,2258,476,-386,862,0.00245032576872406,-0.0019870288796796,0.00443735464840365,EPCI
200069086,CC Leff Armor Communauté,1990_1999,1994.5,9,24551,25801,2875,2476,1250,-399,1649,0.00553310296597465,-0.00176616646673911,0.00729926943271375,EPCI
200069086,CC Leff Armor Communauté,1999_2010,2004.5,11,25801,30150,3637,4016,4349,379,3970,0.0142618039247757,0.00124286587433663,0.0130189380504391,EPCI
200069094,CC Isle et Crempse-en-Périgord,2010_2015,2012.5,5,14172,14285,961,602,113,-359,472,0.00158963186326422,-0.00505024636205181,0.00663987822531603,EPCI
200069094,CC Isle et Crempse-en-Périgord,1968_1975,1971.5,7,12781,12965,1271,1094,184,-177,361,0.00204404705621308,-0.00196628439646585,0.00401033145267893,EPCI
200069094,CC Isle et Crempse-en-Périgord,1975_1982,1978.5,7,12965,13259,1313,886,294,-427,721,0.00320844294756939,-0.00465988142385078,0.00786832437142017,EPCI
200069094,CC Isle et Crempse-en-Périgord,1982_1990,1986,8,13259,13310,1522,992,51,-530,581,0.0004799983216488,-0.00498821785242871,0.00546821617407751,EPCI
200069094,CC Isle et Crempse-en-Périgord,1990_1999,1994.5,9,13310,13026,1632,952,-284,-680,396,-0.00239360544508915,-0.00573116796711487,0.00333756252202572,EPCI
200069094,CC Isle et Crempse-en-Périgord,1999_2010,2004.5,11,13026,14172,2163,1391,1146,-772,1918,0.00769498510480582,-0.00518370724337704,0.0128786923481829,EPCI
200069102,CC Randon - Margeride,2010_2015,2012.5,5,5257,5349,356,224,92,-132,224,0.00347584794036138,-0.00498708617530111,0.00846293411566248,EPCI
200069102,CC Randon - Margeride,1968_1975,1971.5,7,6476,5909,684,463,-567,-221,-346,-0.0130041942632763,-0.00506865420138281,-0.00793554006189345,EPCI
200069102,CC Randon - Margeride,1975_1982,1978.5,7,5909,5539,620,378,-370,-242,-128,-0.00919498423838971,-0.00601401671808192,-0.00318096752030779,EPCI
200069102,CC Randon - Margeride,1982_1990,1986,8,5539,5035,644,354,-504,-290,-214,-0.0118542349195715,-0.00682088914022963,-0.00503334577934187,EPCI
200069102,CC Randon - Margeride,1990_1999,1994.5,9,5035,4926,605,380,-109,-225,116,-0.00242884850393554,-0.0050136781044541,0.00258482960051856,EPCI
200069102,CC Randon - Margeride,1999_2010,2004.5,11,4926,5257,833,582,331,-251,582,0.00592962212441783,-0.00449648082546488,0.0104261029498827,EPCI
200069110,CA Chambéry Métropole-Coeur des Bauges,2010_2015,2012.5,5,127475,132894,5061,8016,5419,2955,2464,0.00836107033478162,0.0045593214318656,0.00380174890291602,EPCI
200069110,CA Chambéry Métropole-Coeur des Bauges,1968_1975,1971.5,7,83572,95998,5648,10907,12426,5259,7167,0.0200000628151316,0.00846453648356485,0.0115355263315667,EPCI
200069110,CA Chambéry Métropole-Coeur des Bauges,1975_1982,1978.5,7,95998,102856,5845,10555,6858,4710,2148,0.00990625873208084,0.00680351102771956,0.00310274770436128,EPCI
200069110,CA Chambéry Métropole-Coeur des Bauges,1982_1990,1986,8,102856,110134,6889,11836,7278,4947,2331,0.00858260295530378,0.00583376433359271,0.00274883862171106,EPCI
200069110,CA Chambéry Métropole-Coeur des Bauges,1990_1999,1994.5,9,110134,119095,8083,12962,8961,4879,4082,0.00872940179360482,0.00475290161265461,0.00397650018095021,EPCI
200069110,CA Chambéry Métropole-Coeur des Bauges,1999_2010,2004.5,11,119095,127475,10318,16876,8380,6558,1822,0.00620085281554883,0.00485264830123738,0.00134820451431145,EPCI
200069128,CC Mont Lozère,2010_2015,2012.5,5,5548,5456,361,247,-92,-114,22,-0.00333873038510146,-0.00413712243371268,0.000798392048611219,EPCI
200069128,CC Mont Lozère,1968_1975,1971.5,7,6346,5549,641,385,-797,-256,-541,-0.0189898011766602,-0.00609960991370765,-0.0128901912629525,EPCI
200069128,CC Mont Lozère,1975_1982,1978.5,7,5549,5433,597,378,-116,-219,103,-0.0030134879845326,-0.00568925748804,0.0026757695035074,EPCI
200069128,CC Mont Lozère,1982_1990,1986,8,5433,4987,675,401,-446,-274,-172,-0.0106500004768538,-0.00654282540506266,-0.00410717507179116,EPCI
200069128,CC Mont Lozère,1990_1999,1994.5,9,4987,5053,706,428,66,-278,344,0.00146191196918233,-0.00615775041564678,0.0076196623848291,EPCI
200069128,CC Mont Lozère,1999_2010,2004.5,11,5053,5548,800,552,495,-248,743,0.0085321362370121,-0.00427468643793738,0.0128068226749495,EPCI
200069136,CC des Cévennes Au Mont Lozère,2010_2015,2012.5,5,5079,5126,322,172,47,-150,197,0.00184394520451203,-0.00588493150376181,0.00772887670827384,EPCI
200069136,CC des Cévennes Au Mont Lozère,1968_1975,1971.5,7,4978,4498,578,252,-480,-326,-154,-0.014380646425911,-0.00976685569759787,-0.0046137907283131,EPCI
200069136,CC des Cévennes Au Mont Lozère,1975_1982,1978.5,7,4498,4208,497,249,-290,-248,-42,-0.00947558927908054,-0.00810326255590336,-0.00137232672317718,EPCI
200069136,CC des Cévennes Au Mont Lozère,1982_1990,1986,8,4208,4446,565,385,238,-180,418,0.00690086953292757,-0.0052191450249032,0.0121200145578308,EPCI
200069136,CC des Cévennes Au Mont Lozère,1990_1999,1994.5,9,4446,4796,645,392,350,-253,603,0.00845525899240229,-0.00611194435736509,0.0145672033497674,EPCI
200069136,CC des Cévennes Au Mont Lozère,1999_2010,2004.5,11,4796,5079,786,356,283,-430,713,0.00522562023296991,-0.00793998833984827,0.0131656085728182,EPCI
200069144,CC des Hautes Terres de l'Aubrac,2010_2015,2012.5,5,5313,5149,424,178,-164,-246,82,-0.00625120468996376,-0.00937680703494564,0.00312560234498188,EPCI
200069144,CC des Hautes Terres de l'Aubrac,1968_1975,1971.5,7,6681,6148,707,461,-533,-246,-287,-0.0118070081869994,-0.00544938839399973,-0.00635761979299969,EPCI
200069144,CC des Hautes Terres de l'Aubrac,1975_1982,1978.5,7,6148,5704,613,368,-444,-245,-199,-0.0106513176095926,-0.00587741624853645,-0.00477390136105614,EPCI
200069144,CC des Hautes Terres de l'Aubrac,1982_1990,1986,8,5704,5156,659,371,-548,-288,-260,-0.0125464534230253,-0.00659375654348775,-0.00595269687953755,EPCI
200069144,CC des Hautes Terres de l'Aubrac,1990_1999,1994.5,9,5156,5080,667,407,-76,-260,184,-0.00164861991810716,-0.00564001550931398,0.00399139559120682,EPCI
200069144,CC des Hautes Terres de l'Aubrac,1999_2010,2004.5,11,5080,5313,840,531,233,-309,542,0.00408517493283367,-0.00541767834440173,0.0095028532772354,EPCI
200069151,CC Gorges Causses Cévennes,2010_2015,2012.5,5,7035,7076,489,333,41,-156,197,0.00116289278230464,-0.00442466522047618,0.00558755800278081,EPCI
200069151,CC Gorges Causses Cévennes,1968_1975,1971.5,7,6608,6445,727,504,-163,-223,60,-0.00356169916651139,-0.00487275407442969,0.0013110549079183,EPCI
200069151,CC Gorges Causses Cévennes,1975_1982,1978.5,7,6445,6429,723,525,-16,-198,182,-0.00035502713888802,-0.00439346084373925,0.00403843370485123,EPCI
200069151,CC Gorges Causses Cévennes,1982_1990,1986,8,6429,6365,728,564,-64,-164,100,-0.00124981497367505,-0.0032026508700423,0.00195283589636726,EPCI
200069151,CC Gorges Causses Cévennes,1990_1999,1994.5,9,6365,6709,776,557,344,-219,563,0.00586554383748461,-0.00373416889653817,0.00959971273402278,EPCI
200069151,CC Gorges Causses Cévennes,1999_2010,2004.5,11,6709,7035,1047,759,326,-288,614,0.00432275097572687,-0.00381887202763601,0.00814162300336289,EPCI
200069169,CC Dômes Sancy Artense,2010_2015,2012.5,5,12027,12197,733,600,170,-133,303,0.00281112332438682,-0.00219929060084381,0.00501041392523063,EPCI
200069169,CC Dômes Sancy Artense,1968_1975,1971.5,7,14783,13546,1487,1077,-1237,-410,-827,-0.0124061965425105,-0.00411199723721044,-0.00829419930530008,EPCI
200069169,CC Dômes Sancy Artense,1975_1982,1978.5,7,13546,12888,1453,857,-658,-596,-62,-0.00708828091936209,-0.00642038818835837,-0.000667892731003724,EPCI
200069169,CC Dômes Sancy Artense,1982_1990,1986,8,12888,12115,1480,892,-773,-588,-185,-0.00770172500173838,-0.00585849198062376,-0.00184323302111462,EPCI
200069169,CC Dômes Sancy Artense,1990_1999,1994.5,9,12115,11397,1522,808,-718,-714,-4,-0.00676525540913076,-0.00672756596395454,-3.76894451762158e-05,EPCI
200069169,CC Dômes Sancy Artense,1999_2010,2004.5,11,11397,12027,1684,1233,630,-451,1081,0.00490325082518117,-0.0035101049558043,0.00841335578098547,EPCI
200069177,CC Mond'Arverne Communauté,2010_2015,2012.5,5,38816,39814,1386,2128,998,742,256,0.00509012619281424,0.00378444252010838,0.00130568367270586,EPCI
200069177,CC Mond'Arverne Communauté,1968_1975,1971.5,7,18247,21508,1853,2210,3261,357,2904,0.0237672258643635,0.0026019318103581,0.0211652940540054,EPCI
200069177,CC Mond'Arverne Communauté,1975_1982,1978.5,7,21508,26668,1806,1986,5160,180,4980,0.0311966378969841,0.00108825481035991,0.0301083830866242,EPCI
200069177,CC Mond'Arverne Communauté,1982_1990,1986,8,26668,31447,1952,2615,4779,663,4116,0.0208186521599312,0.00288821225822021,0.017930439901711,EPCI
200069177,CC Mond'Arverne Communauté,1990_1999,1994.5,9,31447,34706,2139,2973,3259,834,2425,0.0110167977061504,0.00281927256426187,0.00819752514188852,EPCI
200069177,CC Mond'Arverne Communauté,1999_2010,2004.5,11,34706,38816,2799,4501,4110,1702,2408,0.0102264775533758,0.00423490627636146,0.00599157127701434,EPCI
200069185,CC des Terres d'Apcher-Margeride-Aubrac,2010_2015,2012.5,5,11096,10637,679,429,-459,-250,-209,-0.00841364425023572,-0.0045825949075358,-0.00383104934269992,EPCI
200069185,CC des Terres d'Apcher-Margeride-Aubrac,1968_1975,1971.5,7,12912,12086,1043,1225,-826,182,-1008,-0.00939973703701957,0.00207112849968228,-0.0114708655367019,EPCI
200069185,CC des Terres d'Apcher-Margeride-Aubrac,1975_1982,1978.5,7,12086,11764,1041,1002,-322,-39,-283,-0.0038502454735988,-0.000466334079100476,-0.00338391139449833,EPCI
200069185,CC des Terres d'Apcher-Margeride-Aubrac,1982_1990,1986,8,11764,11209,1096,959,-555,-137,-418,-0.00602266481134839,-0.00148667581829681,-0.00453598899305158,EPCI
200069185,CC des Terres d'Apcher-Margeride-Aubrac,1990_1999,1994.5,9,11209,10709,1199,872,-500,-327,-173,-0.00505744756400839,-0.00330757070686149,-0.0017498768571469,EPCI
200069185,CC des Terres d'Apcher-Margeride-Aubrac,1999_2010,2004.5,11,10709,11096,1347,1124,387,-223,610,0.00323250181085344,-0.00186265608222304,0.00509515789307648,EPCI
200069193,CC de la Dombes,2010_2015,2012.5,5,36734,37907,1626,2154,1173,528,645,0.00630640916762992,0.00283869057161858,0.00346771859601134,EPCI
200069193,CC de la Dombes,1968_1975,1971.5,7,17364,18554,1602,1885,1190,283,907,0.00951444899015086,0.00226267988589302,0.00725176910425784,EPCI
200069193,CC de la Dombes,1975_1982,1978.5,7,18554,22582,1540,1919,4028,379,3649,0.0284644025782648,0.00267825436374438,0.0257861482145204,EPCI
200069193,CC de la Dombes,1982_1990,1986,8,22582,26068,1972,2642,3486,670,2816,0.0181063909727481,0.00348000055987988,0.0146263904128683,EPCI
200069193,CC de la Dombes,1990_1999,1994.5,9,26068,31083,2432,3144,5015,712,4303,0.0197426402106964,0.00280294313659338,0.016939697074103,EPCI
200069193,CC de la Dombes,1999_2010,2004.5,11,31083,36734,3168,4748,5651,1580,4071,0.0153014973095345,0.00427824557583869,0.0110232517336958,EPCI
200069227,CC Pays Fort Sancerrois Val de Loire,2010_2015,2012.5,5,19242,18798,1329,845,-444,-484,40,-0.00465809899662084,-0.00507774755487497,0.000419648558254129,EPCI
200069227,CC Pays Fort Sancerrois Val de Loire,1968_1975,1971.5,7,20442,19438,2566,1498,-1004,-1068,64,-0.00716870917166024,-0.00762567868061069,0.000456969508950454,EPCI
200069227,CC Pays Fort Sancerrois Val de Loire,1975_1982,1978.5,7,19438,19268,2431,1297,-170,-1134,964,-0.00125410214343047,-0.00836559900382442,0.00711149686039395,EPCI
200069227,CC Pays Fort Sancerrois Val de Loire,1982_1990,1986,8,19268,19812,2727,1710,544,-1017,1561,0.00348632890133738,-0.00651764061150756,0.0100039695128449,EPCI
200069227,CC Pays Fort Sancerrois Val de Loire,1990_1999,1994.5,9,19812,19420,2595,1750,-392,-845,453,-0.00221802009042338,-0.00478119126634631,0.00256317117592293,EPCI
200069227,CC Pays Fort Sancerrois Val de Loire,1999_2010,2004.5,11,19420,19242,3073,1987,-178,-1086,908,-0.000836747270153593,-0.005105098513409,0.00426835124325541,EPCI
200069235,CC du Haut Pays du Montreuillois,2010_2015,2012.5,5,15527,15835,871,1012,308,141,167,0.00393617366136323,0.00180194963068901,0.00213422403067422,EPCI
200069235,CC du Haut Pays du Montreuillois,1968_1975,1971.5,7,15220,14670,1346,1701,-550,355,-905,-0.00524416684747642,0.00338487132882569,-0.0086290381763021,EPCI
200069235,CC du Haut Pays du Montreuillois,1975_1982,1978.5,7,14670,14415,1305,1324,-255,19,-274,-0.00250190230730762,0.000186416250348411,-0.00268831855765604,EPCI
200069235,CC du Haut Pays du Montreuillois,1982_1990,1986,8,14415,14064,1472,1424,-351,-48,-303,-0.00307663120874291,-0.000420735891793902,-0.00265589531694901,EPCI
200069235,CC du Haut Pays du Montreuillois,1990_1999,1994.5,9,14064,13596,1548,1359,-468,-189,-279,-0.0037532399336212,-0.00151573151165472,-0.00223750842196648,EPCI
200069235,CC du Haut Pays du Montreuillois,1999_2010,2004.5,11,13596,15527,1889,2162,1931,273,1658,0.0121463395831869,0.0017172194232056,0.0104291201599813,EPCI
200069250,CA Troyes Champagne Métropole,2010_2015,2012.5,5,164460,169663,6913,10081,5203,3168,2035,0.00624879015636548,0.00380476017977433,0.00244402997659115,EPCI
200069250,CA Troyes Champagne Métropole,1968_1975,1971.5,7,135948,150522,10101,17911,14574,7810,6764,0.0146544521696759,0.00785311317724499,0.00680133899243088,EPCI
200069250,CA Troyes Champagne Métropole,1975_1982,1978.5,7,150522,154227,10037,15939,3705,5902,-2197,0.00347979622039785,0.00554325433003727,-0.00206345810963942,EPCI
200069250,CA Troyes Champagne Métropole,1982_1990,1986,8,154227,154651,11017,17216,424,6199,-5775,0.000343236673037373,0.00501821730226102,-0.00467498062922365,EPCI
200069250,CA Troyes Champagne Métropole,1990_1999,1994.5,9,154651,158427,12224,18368,3776,6144,-2368,0.00268392352183122,0.00436706200162368,-0.00168313847979246,EPCI
200069250,CA Troyes Champagne Métropole,1999_2010,2004.5,11,158427,164460,14722,21939,6033,7217,-1184,0.00340336562766863,0.00407128953006539,-0.000667923902396761,EPCI
200069268,CC Aubrac Lot Causses Tarn,2010_2015,2012.5,5,7597,7852,451,396,255,-55,310,0.00662481643696933,-0.00142888197660123,0.00805369841357055,EPCI
200069268,CC Aubrac Lot Causses Tarn,1968_1975,1971.5,7,6697,6608,740,542,-89,-198,109,-0.00190940743058932,-0.00424789518265938,0.00233848775207006,EPCI
200069268,CC Aubrac Lot Causses Tarn,1975_1982,1978.5,7,6608,6507,678,500,-101,-178,77,-0.00219794037039234,-0.00387359788049343,0.00167565751010109,EPCI
200069268,CC Aubrac Lot Causses Tarn,1982_1990,1986,8,6507,6493,749,526,-14,-223,209,-0.000269194633932934,-0.00428788595478888,0.00401869132085595,EPCI
200069268,CC Aubrac Lot Causses Tarn,1990_1999,1994.5,9,6493,6848,790,605,355,-185,540,0.00593218896738645,-0.00309142241962393,0.00902361138701038,EPCI
200069268,CC Aubrac Lot Causses Tarn,1999_2010,2004.5,11,6848,7597,972,973,749,1,748,0.00948073224313051,1.26578534621235e-05,0.00946807438966838,EPCI
200069300,CA Tarbes-Lourdes-Pyrénées,2010_2015,2012.5,5,123773,122581,6820,6511,-1192,-309,-883,-0.00193356960174595,-0.000501235744076762,-0.00143233385766919,EPCI
200069300,CA Tarbes-Lourdes-Pyrénées,1968_1975,1971.5,7,117003,122743,9036,12978,5740,3942,1798,0.00686533957460456,0.00471483773573017,0.00215050183887439,EPCI
200069300,CA Tarbes-Lourdes-Pyrénées,1975_1982,1978.5,7,122743,125023,9087,10411,2280,1324,956,0.00263274271118452,0.00152883831123171,0.00110390439995281,EPCI
200069300,CA Tarbes-Lourdes-Pyrénées,1982_1990,1986,8,125023,122914,10061,11385,-2109,1324,-3433,-0.00212433995681693,0.00133363020522789,-0.00345797016204482,EPCI
200069300,CA Tarbes-Lourdes-Pyrénées,1990_1999,1994.5,9,122914,122106,11614,12175,-808,561,-1369,-0.00073255420404339,0.00050861746097567,-0.00124117166501906,EPCI
200069300,CA Tarbes-Lourdes-Pyrénées,1999_2010,2004.5,11,122106,123773,14431,14384,1667,-47,1714,0.00123346216281961,-3.47766776559818e-05,0.00126823884047559,EPCI
200069383,CC du Grand Villefranchois,2010_2015,2012.5,5,27208,27485,1649,1278,277,-371,648,0.00202792418408504,-0.00271610062200559,0.00474402480609063,EPCI
200069383,CC du Grand Villefranchois,1968_1975,1971.5,7,24263,25268,2545,2333,1005,-212,1217,0.00581487208852094,-0.0012266197838472,0.00704149187236814,EPCI
200069383,CC du Grand Villefranchois,1975_1982,1978.5,7,25268,26139,2363,2177,871,-186,1057,0.00485312112623237,-0.00103637259412081,0.00588949372035318,EPCI
200069383,CC du Grand Villefranchois,1982_1990,1986,8,26139,26055,2555,2210,-84,-345,261,-0.000402264514436146,-0.00165215782714846,0.00124989331271231,EPCI
200069383,CC du Grand Villefranchois,1990_1999,1994.5,9,26055,25749,2817,2214,-306,-603,297,-0.00131179406242399,-0.00258500594654139,0.0012732118841174,EPCI
200069383,CC du Grand Villefranchois,1999_2010,2004.5,11,25749,27208,3418,2781,1459,-637,2096,0.00502305128050651,-0.00219306625475164,0.00721611753525815,EPCI
200069391,CC Lamballe Terre et Mer,2010_2015,2012.5,5,64704,67090,3464,3735,2386,271,2115,0.00726868521080726,0.000825571539031336,0.00644311367177592,EPCI
200069391,CC Lamballe Terre et Mer,1968_1975,1971.5,7,52289,52158,4786,5466,-131,680,-811,-0.000358285882660847,0.00185980458175096,-0.00221809046441181,EPCI
200069391,CC Lamballe Terre et Mer,1975_1982,1978.5,7,52158,53802,4670,4801,1644,131,1513,0.00444313700271159,0.000354045588415583,0.00408909141429601,EPCI
200069391,CC Lamballe Terre et Mer,1982_1990,1986,8,53802,54829,5413,5223,1027,-190,1217,0.00236637168090104,-0.00043779028176358,0.00280416196266462,EPCI
200069391,CC Lamballe Terre et Mer,1990_1999,1994.5,9,54829,56229,5934,5405,1400,-529,1929,0.00280541527591383,-0.00106004620068458,0.00386546147659841,EPCI
200069391,CC Lamballe Terre et Mer,1999_2010,2004.5,11,56229,64704,7161,8093,8475,932,7543,0.0128445539476847,0.00141252203884863,0.0114320319088361,EPCI
200069409,CA Saint-Brieuc Armor Agglomération,2010_2015,2012.5,5,149259,151307,7465,8273,2048,808,1240,0.00272928442561016,0.00107678799604151,0.00165249642956865,EPCI
200069409,CA Saint-Brieuc Armor Agglomération,1968_1975,1971.5,7,109431,123274,8336,15607,13843,7271,6572,0.0171620772416294,0.00901433674954039,0.00814774049208905,EPCI
200069409,CA Saint-Brieuc Armor Agglomération,1975_1982,1978.5,7,123274,129652,8576,13430,6378,4854,1524,0.00723237360375384,0.00550422412552856,0.00172814947822528,EPCI
200069409,CA Saint-Brieuc Armor Agglomération,1982_1990,1986,8,129652,132310,9986,14021,2658,4035,-1377,0.00253993468772284,0.00385576992662215,-0.00131583523889931,EPCI
200069409,CA Saint-Brieuc Armor Agglomération,1990_1999,1994.5,9,132310,137001,11592,14117,4691,2525,2166,0.00387867723196167,0.00208775527834219,0.00179092195361948,EPCI
200069409,CA Saint-Brieuc Armor Agglomération,1999_2010,2004.5,11,137001,149259,15061,19056,12258,3995,8263,0.00782086323187037,0.00254889448615778,0.00527196874571258,EPCI
200069417,CC Pays d'Orthe et Arrigans,2010_2015,2012.5,5,22676,23450,1129,1103,774,-26,800,0.00673526021734516,-0.000226249051228649,0.00696150926857381,EPCI
200069417,CC Pays d'Orthe et Arrigans,1968_1975,1971.5,7,18623,18159,1742,1512,-464,-230,-234,-0.00359795043340072,-0.00178346680965984,-0.00181448362374088,EPCI
200069417,CC Pays d'Orthe et Arrigans,1975_1982,1978.5,7,18159,18479,1788,1264,320,-524,844,0.00249863734958145,-0.00409151865993962,0.00659015600952106,EPCI
200069417,CC Pays d'Orthe et Arrigans,1982_1990,1986,8,18479,18616,1968,1299,137,-669,806,0.00092373560676795,-0.00451079650312233,0.00543453210989028,EPCI
200069417,CC Pays d'Orthe et Arrigans,1990_1999,1994.5,9,18616,19080,2115,1497,464,-618,1082,0.00273921592828841,-0.00364835224931516,0.00638756817760357,EPCI
200069417,CC Pays d'Orthe et Arrigans,1999_2010,2004.5,11,19080,22676,2479,2302,3596,-177,3773,0.0158207924574072,-0.000778720874572045,0.0165995133319792,EPCI
200069425,CA Mont-Saint-Michel-Normandie,2010_2015,2012.5,5,88560,88067,5031,4252,-493,-779,286,-0.00111585696331418,-0.0017631898061293,0.000647332842815121,EPCI
200069425,CA Mont-Saint-Michel-Normandie,1968_1975,1971.5,7,95042,92546,7393,9865,-2496,2472,-4968,-0.00379465075581031,0.00375816372931214,-0.00755281448512245,EPCI
200069425,CA Mont-Saint-Michel-Normandie,1975_1982,1978.5,7,92546,91268,7057,8435,-1278,1378,-2656,-0.00198454032224193,0.00213982516748778,-0.00412436548972972,EPCI
200069425,CA Mont-Saint-Michel-Normandie,1982_1990,1986,8,91268,87384,8144,8105,-3884,-39,-3845,-0.00542125588293752,-5.44358855392799e-05,-0.00536681999739824,EPCI
200069425,CA Mont-Saint-Michel-Normandie,1990_1999,1994.5,9,87384,85392,8431,7855,-1992,-576,-1416,-0.00255891814508746,-0.000739928138338544,-0.00181899000674892,EPCI
200069425,CA Mont-Saint-Michel-Normandie,1999_2010,2004.5,11,85392,88560,10624,10140,3168,-484,3652,0.00331711392340228,-0.000506781293853126,0.00382389521725541,EPCI
200069433,CC de Vezouze en Piémont,2010_2015,2012.5,5,12183,11870,770,580,-313,-190,-123,-0.00519194079138063,-0.00315165734940038,-0.00204028344198025,EPCI
200069433,CC de Vezouze en Piémont,1968_1975,1971.5,7,15536,14057,1614,1509,-1479,-105,-1374,-0.0141897090707077,-0.00100738299690623,-0.0131823260738015,EPCI
200069433,CC de Vezouze en Piémont,1975_1982,1978.5,7,14057,13066,1502,1067,-991,-435,-556,-0.0103895173384478,-0.00456048440184138,-0.00582903293660646,EPCI
200069433,CC de Vezouze en Piémont,1982_1990,1986,8,13066,12430,1520,1257,-636,-263,-373,-0.00621815312967944,-0.00257134319670706,-0.00364680993297237,EPCI
200069433,CC de Vezouze en Piémont,1990_1999,1994.5,9,12430,11891,1455,1116,-539,-339,-200,-0.00491356586457237,-0.00309035033040822,-0.00182321553416414,EPCI
200069433,CC de Vezouze en Piémont,1999_2010,2004.5,11,11891,12183,1760,1511,292,-249,541,0.00220786337755152,-0.00188273281167921,0.00409059618923073,EPCI
200069441,CC du Pays de Bitche,2010_2015,2012.5,5,35205,34640,1624,1661,-565,37,-602,-0.00323057727452836,0.000211559927712477,-0.00344213720224083,EPCI
200069441,CC du Pays de Bitche,1968_1975,1971.5,7,34350,34147,2800,3737,-203,937,-1140,-0.000846396495812751,0.00390676609151009,-0.00475316258732284,EPCI
200069441,CC du Pays de Bitche,1975_1982,1978.5,7,34147,34687,2689,3266,540,577,-37,0.00224397717965141,0.00239773117159049,-0.000153753991939078,EPCI
200069441,CC du Pays de Bitche,1982_1990,1986,8,34687,34652,2987,3768,-35,781,-816,-0.000126183658229473,0.00281569820220624,-0.00294188186043571,EPCI
200069441,CC du Pays de Bitche,1990_1999,1994.5,9,34652,35074,3132,3527,422,395,27,0.00134586833779338,0.00125975827826631,8.61100595270644e-05,EPCI
200069441,CC du Pays de Bitche,1999_2010,2004.5,11,35074,35205,3552,3963,131,411,-280,0.000338966774803273,0.00106347591178737,-0.000724509136984095,EPCI
200069458,CC des Vallées d'Auge et du Merlerault,2010_2015,2012.5,5,16095,15106,1202,689,-989,-513,-476,-0.012603235323885,-0.00653737079995246,-0.0060658645239325,EPCI
200069458,CC des Vallées d'Auge et du Merlerault,1968_1975,1971.5,7,19864,19090,1605,2224,-774,619,-1393,-0.0056616848339166,0.00452788489947594,-0.0101895697333925,EPCI
200069458,CC des Vallées d'Auge et du Merlerault,1975_1982,1978.5,7,19090,17750,1573,1761,-1340,188,-1528,-0.0103431552470959,0.00145112924362242,-0.0117942844907184,EPCI
200069458,CC des Vallées d'Auge et du Merlerault,1982_1990,1986,8,17750,16781,1763,1686,-969,-77,-892,-0.00699271413450087,-0.000555664590667251,-0.00643704954383362,EPCI
200069458,CC des Vallées d'Auge et du Merlerault,1990_1999,1994.5,9,16781,16682,1921,1826,-99,-95,-4,-0.000657228397363152,-0.000630673714641409,-2.65546827217435e-05,EPCI
200069458,CC des Vallées d'Auge et du Merlerault,1999_2010,2004.5,11,16682,16095,2496,1886,-587,-610,23,-0.00325121505030856,-0.00337860507783343,0.000127390027524867,EPCI
200069482,CC des Campagnes de l'Artois,2010_2015,2012.5,5,33133,33631,1443,1969,498,526,-28,0.0029881548776145,0.00315616358559283,-0.000168008707978326,EPCI
200069482,CC des Campagnes de l'Artois,1968_1975,1971.5,7,28135,27435,2442,2891,-700,449,-1149,-0.00359278507215643,0.0023045149962832,-0.00589730006843963,EPCI
200069482,CC des Campagnes de l'Artois,1975_1982,1978.5,7,27435,29063,2356,2662,1628,306,1322,0.00826919057798103,0.00155428274991535,0.00671490782806568,EPCI
200069482,CC des Campagnes de l'Artois,1982_1990,1986,8,29063,31081,2463,3392,2018,929,1089,0.00842665764084427,0.00387926905269788,0.00454738858814639,EPCI
200069482,CC des Campagnes de l'Artois,1990_1999,1994.5,9,31081,31120,2540,3191,39,651,-612,0.000139342962459432,0.00232595560413052,-0.00218661264167109,EPCI
200069482,CC des Campagnes de l'Artois,1999_2010,2004.5,11,31120,33133,3080,4364,2013,1284,729,0.00571436187524266,0.00364492829002065,0.00206943358522201,EPCI
200069516,CC Seulles Terre et Mer,2010_2015,2012.5,5,16051,16853,589,1040,802,451,351,0.00979920677199853,0.00551052650146052,0.00428868027053801,EPCI
200069516,CC Seulles Terre et Mer,1968_1975,1971.5,7,10225,10009,855,1132,-216,277,-493,-0.00304549784729025,0.00390556899860832,-0.00695106684589857,EPCI
200069516,CC Seulles Terre et Mer,1975_1982,1978.5,7,10009,11834,926,1062,1825,136,1689,0.0242159945724911,0.00180458918458016,0.022411405387911,EPCI
200069516,CC Seulles Terre et Mer,1982_1990,1986,8,11834,13767,1142,1450,1933,308,1625,0.0190921785656937,0.00304210605185393,0.0160500725138397,EPCI
200069516,CC Seulles Terre et Mer,1990_1999,1994.5,9,13767,14308,1326,1442,541,116,425,0.0042918947248376,0.000920258388320076,0.00337163633651752,EPCI
200069516,CC Seulles Terre et Mer,1999_2010,2004.5,11,14308,16051,1441,2079,1743,638,1105,0.0105050061265355,0.00384520591436009,0.0066598002121754,EPCI
200069524,CC Pré-Bocage Intercom,2010_2015,2012.5,5,24297,24781,1162,1574,484,412,72,0.00395266015252505,0.00336466112157091,0.000587999030954139,EPCI
200069524,CC Pré-Bocage Intercom,1968_1975,1971.5,7,19175,18465,1659,2203,-710,544,-1254,-0.00537554249073824,0.00411872551403043,-0.00949426800476867,EPCI
200069524,CC Pré-Bocage Intercom,1975_1982,1978.5,7,18465,19726,1465,1905,1261,440,821,0.00948188725662158,0.00330850943133505,0.00617337782528653,EPCI
200069524,CC Pré-Bocage Intercom,1982_1990,1986,8,19726,20436,1710,2281,710,571,139,0.00442984399556279,0.00356259284713571,0.000867251148427081,EPCI
200069524,CC Pré-Bocage Intercom,1990_1999,1994.5,9,20436,21416,1928,2437,980,509,471,0.0052180395440391,0.00271018584481215,0.00250785369922695,EPCI
200069524,CC Pré-Bocage Intercom,1999_2010,2004.5,11,21416,24297,2224,3533,2881,1309,1572,0.0115401321353643,0.0052433297345338,0.00629680240083051,EPCI
200069532,CA Lisieux Normandie,2010_2015,2012.5,5,76622,75681,3921,4358,-941,437,-1378,-0.002468369272149,0.00114630964073232,-0.00361467891288131,EPCI
200069532,CA Lisieux Normandie,1968_1975,1971.5,7,69857,71251,5169,9047,1394,3878,-2484,0.00282663867517763,0.00786348980081696,-0.00503685112563933,EPCI
200069532,CA Lisieux Normandie,1975_1982,1978.5,7,71251,72884,5196,7999,1633,2803,-1170,0.00324242848583278,0.00556554013826656,-0.00232311165243377,EPCI
200069532,CA Lisieux Normandie,1982_1990,1986,8,72884,73581,5906,8594,697,2688,-1991,0.00119042099504285,0.00459089187184388,-0.00340047087680103,EPCI
200069532,CA Lisieux Normandie,1990_1999,1994.5,9,73581,74002,6824,8685,421,1861,-1440,0.00063412092883941,0.00280308562605735,-0.00216896469721793,EPCI
200069532,CA Lisieux Normandie,1999_2010,2004.5,11,74002,76622,8631,10473,2620,1842,778,0.00316792748359473,0.00222722229953492,0.00094070518405981,EPCI
200069540,CC Norge et Tille,2010_2015,2012.5,5,15048,15753,355,736,705,381,324,0.0091992011985893,0.00497148320093975,0.00422771799764955,EPCI
200069540,CC Norge et Tille,1968_1975,1971.5,7,4891,7047,375,726,2156,351,1805,0.0535571212579289,0.00871917883187989,0.044837942426049,EPCI
200069540,CC Norge et Tille,1975_1982,1978.5,7,7047,9642,380,779,2595,399,2196,0.0458077034263245,0.00704326538231347,0.038764438044011,EPCI
200069540,CC Norge et Tille,1982_1990,1986,8,9642,11311,478,938,1669,460,1209,0.0201563434533114,0.0055553732705352,0.0146009701827762,EPCI
200069540,CC Norge et Tille,1990_1999,1994.5,9,11311,13185,524,1162,1874,638,1236,0.0171796929534123,0.005848796213595,0.0113308967398173,EPCI
200069540,CC Norge et Tille,1999_2010,2004.5,11,13185,15048,671,1659,1863,988,875,0.0120874951082344,0.00641033020232719,0.00567716490590718,EPCI
200069565,CC des Lacs et Montagnes du Haut-Doubs,2010_2015,2012.5,5,13784,15430,407,1192,1646,785,861,0.022817458317077,0.0108819591609389,0.0119354991561381,EPCI
200069565,CC des Lacs et Montagnes du Haut-Doubs,1968_1975,1971.5,7,7067,7005,561,710,-62,149,-211,-0.00125804826720322,0.0030233740615045,-0.00428142232870772,EPCI
200069565,CC des Lacs et Montagnes du Haut-Doubs,1975_1982,1978.5,7,7005,7502,471,698,497,227,270,0.00984031083362424,0.00449446792602154,0.00534584290760271,EPCI
200069565,CC des Lacs et Montagnes du Haut-Doubs,1982_1990,1986,8,7502,9355,555,1038,1853,483,1370,0.0279768666369225,0.00729240506510175,0.0206844615718207,EPCI
200069565,CC des Lacs et Montagnes du Haut-Doubs,1990_1999,1994.5,9,9355,10785,646,1506,1430,860,570,0.0159305957652967,0.00958063801269589,0.00634995775260076,EPCI
200069565,CC des Lacs et Montagnes du Haut-Doubs,1999_2010,2004.5,11,10785,13784,821,1937,2999,1116,1883,0.0225553578917748,0.00839339093271779,0.014161966959057,EPCI
200069581,CC Convergence Garonne,2010_2015,2012.5,5,30071,32227,1386,1944,2156,558,1598,0.0139450087192661,0.00360914418615513,0.0103358645331109,EPCI
200069581,CC Convergence Garonne,1968_1975,1971.5,7,24987,24151,2463,2049,-836,-414,-422,-0.00484961709380982,-0.00240160463736515,-0.00244801245644467,EPCI
200069581,CC Convergence Garonne,1975_1982,1978.5,7,24151,25003,2506,1843,852,-663,1515,0.00496514720186858,-0.00386372370286252,0.0088288709047311,EPCI
200069581,CC Convergence Garonne,1982_1990,1986,8,25003,25800,2807,2285,797,-522,1319,0.00393003670265713,-0.00257400145393603,0.00650403815659316,EPCI
200069581,CC Convergence Garonne,1990_1999,1994.5,9,25800,25847,2722,2408,47,-314,361,0.000202248019757434,-0.00135118889795392,0.00155343691771135,EPCI
200069581,CC Convergence Garonne,1999_2010,2004.5,11,25847,30071,3245,3871,4224,626,3598,0.0138557231595291,0.00205342866900218,0.0118022944905269,EPCI
200069599,CC Rurales de l'Entre-deux-Mers,2010_2015,2012.5,5,16134,16511,833,818,377,-15,392,0.00463028256946818,-0.000184228749448336,0.00481451131891652,EPCI
200069599,CC Rurales de l'Entre-deux-Mers,1968_1975,1971.5,7,15168,13700,1287,1184,-1468,-103,-1365,-0.0144365100673378,-0.00101291589709523,-0.0134235941702426,EPCI
200069599,CC Rurales de l'Entre-deux-Mers,1975_1982,1978.5,7,13700,13640,1192,911,-60,-281,221,-0.000626829234528947,-0.00293565024837724,0.00230882101384829,EPCI
200069599,CC Rurales de l'Entre-deux-Mers,1982_1990,1986,8,13640,13938,1360,1194,298,-166,464,0.00270518625594507,-0.0015069158338486,0.00421210208979366,EPCI
200069599,CC Rurales de l'Entre-deux-Mers,1990_1999,1994.5,9,13938,14275,1400,1359,337,-41,378,0.00265806335013941,-0.000323384561886397,0.0029814479120258,EPCI
200069599,CC Rurales de l'Entre-deux-Mers,1999_2010,2004.5,11,14275,16134,1756,1822,1859,66,1793,0.0111911660536073,0.000397319504861796,0.0107938465487455,EPCI
200069615,CC Bresse Haute Seille,2010_2015,2012.5,5,18703,19004,955,923,301,-32,333,0.00319821230746231,-0.000340009281856458,0.00353822158931877,EPCI
200069615,CC Bresse Haute Seille,1968_1975,1971.5,7,15139,14531,1679,1248,-608,-431,-177,-0.00583858841967488,-0.00413886777776295,-0.00169972064191193,EPCI
200069615,CC Bresse Haute Seille,1975_1982,1978.5,7,14531,15596,1632,1106,1065,-526,1591,0.0101555313136861,-0.00501578354084401,0.0151713148545301,EPCI
200069615,CC Bresse Haute Seille,1982_1990,1986,8,15596,16430,1683,1416,834,-267,1101,0.00653305553105765,-0.00209151777792853,0.00862457330898618,EPCI
200069615,CC Bresse Haute Seille,1990_1999,1994.5,9,16430,17184,1736,1585,754,-151,905,0.00499798025106468,-0.00100092177441746,0.00599890202548215,EPCI
200069615,CC Bresse Haute Seille,1999_2010,2004.5,11,17184,18703,2071,2193,1519,122,1397,0.00773019949266374,0.000620858682096758,0.00710934081056698,EPCI
200069623,CC Champagnole Nozeroy Jura,2010_2015,2012.5,5,22056,22102,1150,1012,46,-138,184,0.000416772514559849,-0.00125031754367955,0.0016670900582394,EPCI
200069623,CC Champagnole Nozeroy Jura,1968_1975,1971.5,7,21064,22309,1496,2676,1245,1180,65,0.00823727868711477,0.00780721996047826,0.000430058726636514,EPCI
200069623,CC Champagnole Nozeroy Jura,1975_1982,1978.5,7,22309,22710,1424,2356,401,932,-531,0.0025482658422018,0.00592265278037925,-0.00337438693817745,EPCI
200069623,CC Champagnole Nozeroy Jura,1982_1990,1986,8,22710,22194,1621,2234,-516,613,-1129,-0.00286879886437441,0.00340808857337503,-0.00627688743774944,EPCI
200069623,CC Champagnole Nozeroy Jura,1990_1999,1994.5,9,22194,21643,1916,2294,-551,378,-929,-0.00278942514222158,0.00191361652225001,-0.00470304166447159,EPCI
200069623,CC Champagnole Nozeroy Jura,1999_2010,2004.5,11,21643,22056,2455,2624,413,169,244,0.00171989525246685,0.00070378280306755,0.0010161124493993,EPCI
200069631,CC Terres de Chalosse,2010_2015,2012.5,5,17427,18166,850,956,739,106,633,0.00834078964872353,0.00119637848817956,0.00714441116054397,EPCI
200069631,CC Terres de Chalosse,1968_1975,1971.5,7,14897,14062,1452,1160,-835,-292,-543,-0.00820667225974048,-0.00286987820340625,-0.00533679405633423,EPCI
200069631,CC Terres de Chalosse,1975_1982,1978.5,7,14062,14120,1416,914,58,-502,560,0.00058818838471919,-0.00509087188153506,0.00567906026625425,EPCI
200069631,CC Terres de Chalosse,1982_1990,1986,8,14120,14405,1488,1073,285,-415,700,0.00250101439050132,-0.0036418279721335,0.00614284236263483,EPCI
200069631,CC Terres de Chalosse,1990_1999,1994.5,9,14405,14658,1674,1176,253,-498,751,0.00193641609985273,-0.00381160165109352,0.00574801775094626,EPCI
200069631,CC Terres de Chalosse,1999_2010,2004.5,11,14658,17427,1902,1686,2769,-216,2985,0.0158547801486968,-0.00123677591625804,0.0170915560649548,EPCI
200069649,CC Chalosse Tursan,2010_2015,2012.5,5,25180,26020,1388,1188,840,-200,1040,0.00658467315551725,-0.0015677793227422,0.00815245247825945,EPCI
200069649,CC Chalosse Tursan,1968_1975,1971.5,7,22951,23005,2143,2039,54,-104,158,0.000335781371291422,-0.000646690048413108,0.00098247141970453,EPCI
200069649,CC Chalosse Tursan,1975_1982,1978.5,7,23005,23038,2181,1748,33,-433,466,0.000204798525052619,-0.00268720488932678,0.0028920034143794,EPCI
200069649,CC Chalosse Tursan,1982_1990,1986,8,23038,23163,2346,1939,125,-407,532,0.000676622742272537,-0.00220308364883938,0.00287970639111192,EPCI
200069649,CC Chalosse Tursan,1990_1999,1994.5,9,23163,23138,2542,2005,-25,-537,512,-0.000119980622648397,-0.00257718377448756,0.00245720315183917,EPCI
200069649,CC Chalosse Tursan,1999_2010,2004.5,11,23138,25180,2996,2731,2042,-265,2307,0.00771815448943092,-0.00100162142002899,0.00871977590945991,EPCI
200069656,CC Coeur Haute Lande,2010_2015,2012.5,5,14871,15452,916,735,581,-181,762,0.00769453940466081,-0.00239709403140035,0.0100916334360612,EPCI
200069656,CC Coeur Haute Lande,1968_1975,1971.5,7,13007,12508,1445,1019,-499,-426,-73,-0.0055728756634752,-0.00475760527583253,-0.000815270387642664,EPCI
200069656,CC Coeur Haute Lande,1975_1982,1978.5,7,12508,12514,1352,908,6,-444,450,6.8513487024191e-05,-0.00506999803979014,0.00513851152681433,EPCI
200069656,CC Coeur Haute Lande,1982_1990,1986,8,12514,12999,1460,1116,485,-344,829,0.00476436539930814,-0.00337926123167422,0.00814362663098236,EPCI
200069656,CC Coeur Haute Lande,1990_1999,1994.5,9,12999,13115,1568,1238,116,-330,446,0.00098761869591657,-0.00280960491079714,0.00379722360671371,EPCI
200069656,CC Coeur Haute Lande,1999_2010,2004.5,11,13115,14871,1911,1602,1756,-309,2065,0.0114888037229868,-0.00202166306970553,0.0135104667926923,EPCI
200069664,CC Meuse Rognon,2010_2015,2012.5,5,11672,11202,727,528,-470,-199,-271,-0.00818640288367345,-0.00346615781670429,-0.00472024506696916,EPCI
200069664,CC Meuse Rognon,1968_1975,1971.5,7,15369,14410,1255,1803,-959,548,-1507,-0.00916206777619733,0.00523546730068419,-0.0143975350768815,EPCI
200069664,CC Meuse Rognon,1975_1982,1978.5,7,14410,13841,1151,1324,-569,173,-742,-0.00573878534167349,0.00174483280159844,-0.00748361814327194,EPCI
200069664,CC Meuse Rognon,1982_1990,1986,8,13841,12791,1177,1213,-1050,36,-1086,-0.00981320854355028,0.000336452864350295,-0.0101496614079006,EPCI
200069664,CC Meuse Rognon,1990_1999,1994.5,9,12791,12008,1389,1197,-783,-192,-591,-0.00699417105671885,-0.00171504577636018,-0.00527912528035867,EPCI
200069664,CC Meuse Rognon,1999_2010,2004.5,11,12008,11672,1651,1353,-336,-298,-38,-0.00257670033142399,-0.00228528779394151,-0.000291412537482475,EPCI
200069672,CC du Ternois,2010_2015,2012.5,5,38451,38404,2248,2318,-47,70,-117,-0.000244586599903229,0.00036427791474949,-0.00060886451465272,EPCI
200069672,CC du Ternois,1968_1975,1971.5,7,39158,38206,3494,4373,-952,879,-1831,-0.00350985066537546,0.003240712956791,-0.00675056362216645,EPCI
200069672,CC du Ternois,1975_1982,1978.5,7,38206,37830,3507,3674,-376,167,-543,-0.00141187845996926,0.000627084315996986,-0.00203896277596625,EPCI
200069672,CC du Ternois,1982_1990,1986,8,37830,37354,3724,4182,-476,458,-934,-0.00158155274443172,0.00152174612804565,-0.00310329887247738,EPCI
200069672,CC du Ternois,1990_1999,1994.5,9,37354,36999,3917,4037,-355,120,-475,-0.00106045017371503,0.00035846203055156,-0.00141891220426659,EPCI
200069672,CC du Ternois,1999_2010,2004.5,11,36999,38451,4844,5112,1452,268,1184,0.00350556819674885,0.000647033248435739,0.00285853494831312,EPCI
200069698,CC Mâconnais - Tournugeois,2010_2015,2012.5,5,15779,15805,802,808,26,6,20,0.000329334941657988,7.60003711518435e-05,0.000253334570506145,EPCI
200069698,CC Mâconnais - Tournugeois,1968_1975,1971.5,7,14831,14893,1428,1590,62,162,-100,0.000596137497071547,0.00155764958912243,-0.000961512092050883,EPCI
200069698,CC Mâconnais - Tournugeois,1975_1982,1978.5,7,14893,14995,1384,1151,102,-233,335,0.000975548151741723,-0.00222845803290021,0.00320400618464193,EPCI
200069698,CC Mâconnais - Tournugeois,1982_1990,1986,8,14995,14688,1452,1312,-307,-140,-167,-0.00258240712539104,-0.00117764494317507,-0.00140476218221597,EPCI
200069698,CC Mâconnais - Tournugeois,1990_1999,1994.5,9,14688,14600,1604,1417,-88,-187,99,-0.000667477711336906,-0.00141839013659092,0.000750912425254019,EPCI
200069698,CC Mâconnais - Tournugeois,1999_2010,2004.5,11,14600,15779,1899,1907,1179,8,1171,0.00708483528913728,4.80735218940613e-05,0.00703676176724322,EPCI
200069722,CC Interrégionale Aumale - Blangy-sur-Bresle,2010_2015,2012.5,5,22239,22032,1172,1216,-207,44,-251,-0.0018685645268125,0.000397182797969807,-0.00226574732478231,EPCI
200069722,CC Interrégionale Aumale - Blangy-sur-Bresle,1968_1975,1971.5,7,22763,22451,1696,2781,-312,1085,-1397,-0.00196966539236065,0.00684963766253625,-0.0088193030548969,EPCI
200069722,CC Interrégionale Aumale - Blangy-sur-Bresle,1975_1982,1978.5,7,22451,22087,1655,2181,-364,526,-890,-0.00233241232864589,0.00337046396941687,-0.00570287629806276,EPCI
200069722,CC Interrégionale Aumale - Blangy-sur-Bresle,1982_1990,1986,8,22087,21962,1966,2357,-125,391,-516,-0.00070918752954241,0.00221833859240866,-0.00292752612195107,EPCI
200069722,CC Interrégionale Aumale - Blangy-sur-Bresle,1990_1999,1994.5,9,21962,21750,1986,2317,-212,331,-543,-0.00107718937464651,0.00168183812739621,-0.00275902750204272,EPCI
200069722,CC Interrégionale Aumale - Blangy-sur-Bresle,1999_2010,2004.5,11,21750,22239,2560,2770,489,210,279,0.0020232938119944,0.000868899183065079,0.00115439462892932,EPCI
200069730,CC des Quatre Rivières,2010_2015,2012.5,5,29628,29954,1627,1662,326,35,291,0.00219099902199393,0.000235229956349042,0.00195576906564489,EPCI
200069730,CC des Quatre Rivières,1968_1975,1971.5,7,26544,26116,2077,3103,-428,1026,-1454,-0.00231953145176145,0.00556037212501693,-0.00787990357677838,EPCI
200069730,CC des Quatre Rivières,1975_1982,1978.5,7,26116,25841,2131,2398,-275,267,-542,-0.00151111075898958,0.00146715117327352,-0.00297826193226309,EPCI
200069730,CC des Quatre Rivières,1982_1990,1986,8,25841,26040,2537,2787,199,250,-51,0.00095938985585664,0.00120526363801085,-0.000245873782154214,EPCI
200069730,CC des Quatre Rivières,1990_1999,1994.5,9,26040,27149,2688,2829,1109,141,968,0.00464479778092986,0.000590546877467186,0.00405425090346267,EPCI
200069730,CC des Quatre Rivières,1999_2010,2004.5,11,27149,29628,3470,3798,2479,328,2151,0.00797523839202907,0.00105521508373761,0.00692002330829146,EPCI
200069748,CC Val de Gâtine,2010_2015,2012.5,5,21296,21506,1282,1211,210,-71,281,0.00196446790686333,-0.000664177244701412,0.00262864515156474,EPCI
200069748,CC Val de Gâtine,1968_1975,1971.5,7,21568,19914,1970,1797,-1654,-173,-1481,-0.0113335336226913,-0.0011854300584798,-0.0101481035642115,EPCI
200069748,CC Val de Gâtine,1975_1982,1978.5,7,19914,19147,1865,1458,-767,-407,-360,-0.00559528157151312,-0.00296907379348871,-0.00262620777802441,EPCI
200069748,CC Val de Gâtine,1982_1990,1986,8,19147,18799,1998,1627,-348,-371,23,-0.0022901696082126,-0.00244153139266343,0.000151361784450833,EPCI
200069748,CC Val de Gâtine,1990_1999,1994.5,9,18799,18973,2221,1802,174,-419,593,0.00102421736942859,-0.00246636251603782,0.00349057988546641,EPCI
200069748,CC Val de Gâtine,1999_2010,2004.5,11,18973,21296,2607,2680,2323,73,2250,0.0105555339478782,0.000331706404733151,0.0102238275431451,EPCI
200069755,CC Mellois-en-Poitou,2010_2015,2012.5,5,47902,48352,3050,2398,450,-652,1102,0.00187181544183446,-0.00271205259572459,0.00458386803755905,EPCI
200069755,CC Mellois-en-Poitou,1968_1975,1971.5,7,48979,46510,4336,4839,-2469,503,-2972,-0.00736195160559761,0.0014998224615697,-0.00886177406716731,EPCI
200069755,CC Mellois-en-Poitou,1975_1982,1978.5,7,46510,45973,4464,3669,-537,-795,258,-0.00165763540158381,-0.00245404123698162,0.000796405835397809,EPCI
200069755,CC Mellois-en-Poitou,1982_1990,1986,8,45973,45842,4887,4098,-131,-789,658,-0.000356632162722415,-0.00214796012509912,0.00179132796237671,EPCI
200069755,CC Mellois-en-Poitou,1990_1999,1994.5,9,45842,45321,5382,3971,-521,-1411,890,-0.0012692161122142,-0.00343735879910602,0.00216814268689182,EPCI
200069755,CC Mellois-en-Poitou,1999_2010,2004.5,11,45321,47902,6503,5192,2581,-1311,3892,0.00504785735254454,-0.00256402208027349,0.00761187943281803,EPCI
200069763,CC du Haut-Poitou,2010_2015,2012.5,5,39319,41521,1680,2683,2202,1003,1199,0.0109578948597562,0.00499126636890801,0.00596662849084817,EPCI
200069763,CC du Haut-Poitou,1968_1975,1971.5,7,25174,25218,2362,2292,44,-70,114,0.000249503889736324,-0.000396938006398698,0.000646441896135022,EPCI
200069763,CC du Haut-Poitou,1975_1982,1978.5,7,25218,28825,2291,2410,3607,119,3488,0.0192813936577163,0.000636120278699263,0.018645273379017,EPCI
200069763,CC du Haut-Poitou,1982_1990,1986,8,28825,30720,2490,2854,1895,364,1531,0.00799061114502342,0.00153487200885938,0.00645573913616404,EPCI
200069763,CC du Haut-Poitou,1990_1999,1994.5,9,30720,32565,2706,3165,1845,459,1386,0.00650150850301579,0.00161744845684783,0.00488406004616796,EPCI
200069763,CC du Haut-Poitou,1999_2010,2004.5,11,32565,39319,3397,5504,6754,2107,4647,0.0172812377959777,0.0053911116428968,0.0118901261530809,EPCI
200069821,CA Fécamp Caux Littoral Agglomération,2010_2015,2012.5,5,39264,39525,2137,2265,261,128,133,0.00132594119715335,0.000650270012397044,0.000675671184756303,EPCI
200069821,CA Fécamp Caux Littoral Agglomération,1968_1975,1971.5,7,36674,37011,2998,4629,337,1631,-1294,0.00130758394774722,0.0063283959014116,-0.00502081195366438,EPCI
200069821,CA Fécamp Caux Littoral Agglomération,1975_1982,1978.5,7,37011,37879,3094,3872,868,778,90,0.00331716150881478,0.00297321619108053,0.000343945317734252,EPCI
200069821,CA Fécamp Caux Littoral Agglomération,1982_1990,1986,8,37879,38340,3480,4634,461,1154,-693,0.0015132524130741,0.00378805484747832,-0.00227480243440423,EPCI
200069821,CA Fécamp Caux Littoral Agglomération,1990_1999,1994.5,9,38340,38803,3848,4545,463,697,-234,0.00133464825245833,0.00200917890272884,-0.000674530650270515,EPCI
200069821,CA Fécamp Caux Littoral Agglomération,1999_2010,2004.5,11,38803,39264,4350,5272,461,922,-461,0.0010742589032442,0.00214851780648839,-0.0010742589032442,EPCI
200069839,CC de la Côte d'Albâtre,2010_2015,2012.5,5,27707,28049,1457,1632,342,175,167,0.00245659085869732,0.00125702748617553,0.00119956337252179,EPCI
200069839,CC de la Côte d'Albâtre,1968_1975,1971.5,7,23162,22133,1909,2248,-1029,339,-1368,-0.00647087276032232,0.00213180356243855,-0.00860267632276087,EPCI
200069839,CC de la Côte d'Albâtre,1975_1982,1978.5,7,22133,26855,2046,2253,4722,207,4515,0.0280111827427332,0.00122793621934472,0.0267832465233885,EPCI
200069839,CC de la Côte d'Albâtre,1982_1990,1986,8,26855,27067,2389,3409,212,1020,-808,0.000983389502843934,0.00473140232500384,-0.0037480128221599,EPCI
200069839,CC de la Côte d'Albâtre,1990_1999,1994.5,9,27067,27803,2404,3182,736,778,-42,0.00298540913420431,0.00315577215544966,-0.000170363021245355,EPCI
200069839,CC de la Côte d'Albâtre,1999_2010,2004.5,11,27803,27707,3091,3648,-96,557,-653,-0.000314390541120146,0.00182412011879085,-0.002138510659911,EPCI
200069847,CC Plateau de Caux-Doudeville-Yerville,2010_2015,2012.5,5,19975,20993,787,1430,1018,643,375,0.00999109242588925,0.00631068018648997,0.00368041223939928,EPCI
200069847,CC Plateau de Caux-Doudeville-Yerville,1968_1975,1971.5,7,12998,13316,1015,1463,318,448,-130,0.00345894270349745,0.0048729758841725,-0.00141403318067506,EPCI
200069847,CC Plateau de Caux-Doudeville-Yerville,1975_1982,1978.5,7,13316,15478,923,1519,2162,596,1566,0.0217259799469609,0.00598921556354704,0.0157367643834139,EPCI
200069847,CC Plateau de Caux-Doudeville-Yerville,1982_1990,1986,8,15478,16804,1054,1845,1326,791,535,0.0103276271381307,0.00616074891874918,0.00416687821938156,EPCI
200069847,CC Plateau de Caux-Doudeville-Yerville,1990_1999,1994.5,9,16804,17580,1303,1950,776,647,129,0.00502870604077144,0.00419274846440608,0.000835957576365355,EPCI
200069847,CC Plateau de Caux-Doudeville-Yerville,1999_2010,2004.5,11,17580,19975,1677,2727,2395,1050,1345,0.0116785404949669,0.00512002819194789,0.00655851230301897,EPCI
200069854,CU du Grand-Poitiers,2010_2015,2012.5,5,186846,191073,7089,10948,4227,3859,368,0.00448418516793847,0.00409379478662753,0.000390390381310944,EPCI
200069854,CU du Grand-Poitiers,1968_1975,1971.5,7,125188,142859,8048,16608,17671,8560,9111,0.0190421063474986,0.00922417691893995,0.00981792942855864,EPCI
200069854,CU du Grand-Poitiers,1975_1982,1978.5,7,142859,150449,8434,15122,7590,6688,902,0.00742255826699179,0.00654045713961015,0.000882101127381633,EPCI
200069854,CU du Grand-Poitiers,1982_1990,1986,8,150449,157460,9639,15620,7011,5981,1030,0.00570965095501275,0.00487083473997022,0.000838816215042523,EPCI
200069854,CU du Grand-Poitiers,1990_1999,1994.5,9,157460,172889,10978,16462,15429,5484,9945,0.0104406058540951,0.00371095226546488,0.00672965358863024,EPCI
200069854,CU du Grand-Poitiers,1999_2010,2004.5,11,172889,186846,14884,22523,13957,7639,6318,0.0070826897192926,0.00387652552594943,0.00320616419334317,EPCI
200069912,CC des Forêts du Perche,2010_2015,2012.5,5,8041,7942,523,411,-99,-112,13,-0.00247459729493693,-0.0027995444144741,0.000324947119537173,EPCI
200069912,CC des Forêts du Perche,1968_1975,1971.5,7,7312,7261,623,840,-51,217,-268,-0.000999396520851348,0.00425233421617142,-0.00525173073702277,EPCI
200069912,CC des Forêts du Perche,1975_1982,1978.5,7,7261,7503,609,664,242,55,187,0.00469461105663038,0.00106695705832509,0.0036276539983053,EPCI
200069912,CC des Forêts du Perche,1982_1990,1986,8,7503,7278,710,662,-225,-48,-177,-0.00379862208384674,-0.000810372711220637,-0.0029882493726261,EPCI
200069912,CC des Forêts du Perche,1990_1999,1994.5,9,7278,7649,838,805,371,-33,404,0.00553960061807768,-0.000492740755785885,0.00603234137386356,EPCI
200069912,CC des Forêts du Perche,1999_2010,2004.5,11,7649,8041,1179,856,392,-323,715,0.00455384038043261,-0.0037522715379585,0.00830611191839111,EPCI
200069953,CC des Portes Euréliennes d'Ile-de-France,2010_2015,2012.5,5,47333,48345,1658,2989,1012,1331,-319,0.00423997883897598,0.00557649390778362,-0.00133651506880764,EPCI
200069953,CC des Portes Euréliennes d'Ile-de-France,1968_1975,1971.5,7,22281,26853,1869,2671,4572,802,3770,0.0270219681429904,0.00474007402683253,0.0222818941161579,EPCI
200069953,CC des Portes Euréliennes d'Ile-de-France,1975_1982,1978.5,7,26853,33175,1966,2979,6322,1013,5309,0.0306634479382542,0.00491333007931848,0.0257501178589357,EPCI
200069953,CC des Portes Euréliennes d'Ile-de-France,1982_1990,1986,8,33175,39152,2341,3851,5977,1510,4467,0.020922740410193,0.00528581864135712,0.0156369217688359,EPCI
200069953,CC des Portes Euréliennes d'Ile-de-France,1990_1999,1994.5,9,39152,43859,2914,4762,4707,1848,2859,0.0126941661904558,0.00498381540683288,0.00771035078362294,EPCI
200069953,CC des Portes Euréliennes d'Ile-de-France,1999_2010,2004.5,11,43859,47333,3612,6659,3474,3047,427,0.00695386513597729,0.0060991442341171,0.000854720901860191,EPCI
200069961,CC du Grand Châteaudun,2010_2015,2012.5,5,41932,40911,2459,2124,-1021,-335,-686,-0.00491792382684197,-0.00161361849362592,-0.00330430533321606,EPCI
200069961,CC du Grand Châteaudun,1968_1975,1971.5,7,40110,40980,3387,4245,870,858,12,0.00307019815222231,0.00302785059150201,4.23475607203077e-05,EPCI
200069961,CC du Grand Châteaudun,1975_1982,1978.5,7,40980,41852,3200,3908,872,708,164,0.00301244871853945,0.00244588726230038,0.000566561456239071,EPCI
200069961,CC du Grand Châteaudun,1982_1990,1986,8,41852,41422,3658,4096,-430,438,-868,-0.00129009771562838,0.00131409953359356,-0.00260419724922194,EPCI
200069961,CC du Grand Châteaudun,1990_1999,1994.5,9,41422,41324,4180,4033,-98,-147,49,-0.000263153776387082,-0.000394730664580623,0.000131576888193541,EPCI
200069961,CC du Grand Châteaudun,1999_2010,2004.5,11,41324,41932,5329,4751,608,-578,1186,0.00132868315500412,-0.00126312313090852,0.00259180628591264,EPCI
200069995,CC Médoc Coeur de Presqu'ile,2010_2015,2012.5,5,28770,29736,1565,1671,966,106,860,0.00662691254173065,0.000727176738533591,0.00589973580319705,EPCI
200069995,CC Médoc Coeur de Presqu'ile,1968_1975,1971.5,7,22901,23930,2294,2541,1029,247,782,0.00629865709227939,0.0015119225479038,0.00478673454437559,EPCI
200069995,CC Médoc Coeur de Presqu'ile,1975_1982,1978.5,7,23930,25667,2173,2314,1737,141,1596,0.0100607320035684,0.000816674273173945,0.00924405773039444,EPCI
200069995,CC Médoc Coeur de Presqu'ile,1982_1990,1986,8,25667,26939,2385,2638,1272,253,1019,0.00606443098535725,0.00120621150888002,0.00485821947647723,EPCI
200069995,CC Médoc Coeur de Presqu'ile,1990_1999,1994.5,9,26939,26746,2581,2598,-193,17,-210,-0.000798583331112379,7.03415369373598e-05,-0.000868924868049739,EPCI
200069995,CC Médoc Coeur de Presqu'ile,1999_2010,2004.5,11,26746,28770,3215,3614,2024,399,1625,0.00665369705890195,0.00131167249333097,0.00534202456557099,EPCI
200070035,CC du Civraisien en Poitou,2010_2015,2012.5,5,27555,27413,1878,1281,-142,-597,455,-0.00103279707828607,-0.00434211166011821,0.00330931458183214,EPCI
200070035,CC du Civraisien en Poitou,1968_1975,1971.5,7,30189,28263,2809,2597,-1926,-212,-1714,-0.0093735193639578,-0.0010317684865831,-0.0083417508773747,EPCI
200070035,CC du Civraisien en Poitou,1975_1982,1978.5,7,28263,27293,2588,1999,-970,-589,-381,-0.00497661394367444,-0.00302188207507654,-0.0019547318685979,EPCI
200070035,CC du Civraisien en Poitou,1982_1990,1986,8,27293,26343,3046,2039,-950,-1007,57,-0.00441866808414948,-0.00468378816919845,0.000265120085048969,EPCI
200070035,CC du Civraisien en Poitou,1990_1999,1994.5,9,26343,25886,3419,2098,-457,-1321,864,-0.00194258884114951,-0.00561522945111269,0.00367264060996318,EPCI
200070035,CC du Civraisien en Poitou,1999_2010,2004.5,11,25886,27555,4046,2793,1669,-1253,2922,0.00569631952540828,-0.00427650591092665,0.00997282543633492,EPCI
200070043,CC Vienne et Gartempe,2010_2015,2012.5,5,39960,39671,2904,1723,-289,-1181,892,-0.00145064911111858,-0.00592808512190674,0.00447743601078816,EPCI
200070043,CC Vienne et Gartempe,1968_1975,1971.5,7,47230,44497,4704,3993,-2733,-711,-2022,-0.00847920598484742,-0.00220589661735328,-0.00627330936749414,EPCI
200070043,CC Vienne et Gartempe,1975_1982,1978.5,7,44497,42915,4426,3129,-1582,-1297,-285,-0.00515813035011614,-0.00422888436415969,-0.000929245985956448,EPCI
200070043,CC Vienne et Gartempe,1982_1990,1986,8,42915,40415,4965,3103,-2500,-1862,-638,-0.00747447761102427,-0.00556699092469087,-0.00190748668633339,EPCI
200070043,CC Vienne et Gartempe,1990_1999,1994.5,9,40415,40606,5310,3217,191,-2093,2284,0.000524007883548672,-0.00574213874485534,0.00626614662840401,EPCI
200070043,CC Vienne et Gartempe,1999_2010,2004.5,11,40606,39960,6459,3935,-646,-2524,1878,-0.00145683643290817,-0.00569203584622326,0.00423519941331509,EPCI
200070068,CC Communauté Bray-Eawy,2010_2015,2012.5,5,25099,25437,1412,1542,338,130,208,0.00267894242709765,0.00103036247196064,0.00164857995513702,EPCI
200070068,CC Communauté Bray-Eawy,1968_1975,1971.5,7,23148,22159,1600,2676,-989,1076,-2065,-0.00621839230037036,0.00676540962102983,-0.0129838019214002,EPCI
200070068,CC Communauté Bray-Eawy,1975_1982,1978.5,7,22159,21840,1571,2004,-319,433,-752,-0.00206936784708633,0.00280889115294164,-0.00487825900002797,EPCI
200070068,CC Communauté Bray-Eawy,1982_1990,1986,8,21840,22170,1806,2315,330,509,-179,0.00187636727202767,0.00289415436806692,-0.00101778709603925,EPCI
200070068,CC Communauté Bray-Eawy,1990_1999,1994.5,9,22170,22925,2077,2407,755,330,425,0.00372781937810984,0.00162937800632616,0.00209844137178369,EPCI
200070068,CC Communauté Bray-Eawy,1999_2010,2004.5,11,22925,25099,2723,3263,2174,540,1634,0.00827037456249746,0.00205427887016956,0.0062160956923279,EPCI
200070092,CA du Libournais,2010_2015,2012.5,5,86603,90357,3923,5255,3754,1332,2422,0.00852292174217961,0.00302411607900459,0.00549880566317502,EPCI
200070092,CA du Libournais,1968_1975,1971.5,7,61501,62968,5841,6681,1467,840,627,0.00337328046183982,0.00193153073479581,0.00144174972704401,EPCI
200070092,CA du Libournais,1975_1982,1978.5,7,62968,66930,5672,5978,3962,306,3656,0.00875533948038298,0.000676207440938211,0.00807913203944477,EPCI
200070092,CA du Libournais,1982_1990,1986,8,66930,70423,6474,6616,3493,142,3351,0.00637933901234122,0.000259337572216563,0.00612000144012466,EPCI
200070092,CA du Libournais,1990_1999,1994.5,9,70423,73407,6873,7353,2984,480,2504,0.00462168994588419,0.00074343538003499,0.0038782545658492,EPCI
200070092,CA du Libournais,1999_2010,2004.5,11,73407,86603,8596,10639,13196,2043,11153,0.01514214876731,0.00234430205604838,0.0127978467112616,EPCI
200070100,CC du Val de Sully,2010_2015,2012.5,5,24454,24689,1288,1491,235,203,32,0.00191463028580974,0.00165391467242288,0.000260715613386858,EPCI
200070100,CC du Val de Sully,1968_1975,1971.5,7,15911,17722,1559,1780,1811,221,1590,0.0155186269696119,0.00189376949767213,0.0136248574719398,EPCI
200070100,CC du Val de Sully,1975_1982,1978.5,7,17722,20392,1667,1892,2670,225,2445,0.0202502906725104,0.00170648516903177,0.0185438055034786,EPCI
200070100,CC du Val de Sully,1982_1990,1986,8,20392,21340,1874,2450,948,576,372,0.0056962345472511,0.00346100326921586,0.00223523127803524,EPCI
200070100,CC du Val de Sully,1990_1999,1994.5,9,21340,22597,2112,2463,1257,351,906,0.0063795865632339,0.00178141199975744,0.00459817456347646,EPCI
200070100,CC du Val de Sully,1999_2010,2004.5,11,22597,24454,2768,3372,1857,604,1253,0.00720553104389343,0.00234364068417428,0.00486189035971916,EPCI
200070118,CC Val de Saône Centre,2010_2015,2012.5,5,19204,20166,691,1134,962,443,519,0.00982382552023076,0.00452386144018942,0.00529996408004133,EPCI
200070118,CC Val de Saône Centre,1968_1975,1971.5,7,9103,9457,851,884,354,33,321,0.00546504754524779,0.000509453584726489,0.0049555939605213,EPCI
200070118,CC Val de Saône Centre,1975_1982,1978.5,7,9457,11259,859,794,1802,-65,1867,0.0252290856636459,-0.000910039161008315,0.0261391248246542,EPCI
200070118,CC Val de Saône Centre,1982_1990,1986,8,11259,13213,1015,1256,1954,241,1713,0.0202055974137598,0.00249209261858553,0.0177135047951743,EPCI
200070118,CC Val de Saône Centre,1990_1999,1994.5,9,13213,15145,1187,1479,1932,292,1640,0.015278795469045,0.00230921753465897,0.012969577934386,EPCI
200070118,CC Val de Saône Centre,1999_2010,2004.5,11,15145,19204,1510,2459,4059,949,3110,0.0218208625013714,0.00510174883316123,0.0167191136682102,EPCI
200070126,CC Seine et Aube,2010_2015,2012.5,5,9906,10180,503,575,274,72,202,0.00547179125477815,0.00143784295745995,0.0040339482973182,EPCI
200070126,CC Seine et Aube,1968_1975,1971.5,7,8617,8281,740,849,-336,109,-445,-0.00566578316667221,0.00183800703918831,-0.00750379020586052,EPCI
200070126,CC Seine et Aube,1975_1982,1978.5,7,8281,8919,744,756,638,12,626,0.0106592808641466,0.000200488041331911,0.0104587928228147,EPCI
200070126,CC Seine et Aube,1982_1990,1986,8,8919,9262,800,866,343,66,277,0.0047281645828865,0.000909792601954836,0.00381837198093166,EPCI
200070126,CC Seine et Aube,1990_1999,1994.5,9,9262,9138,848,868,-124,20,-144,-0.00149648635897393,0.00024136876757644,-0.00173785512655037,EPCI
200070126,CC Seine et Aube,1999_2010,2004.5,11,9138,9906,1210,1222,768,12,756,0.00736325744030153,0.000115050897504711,0.00724820654279682,EPCI
200070142,CC Lyons Andelle,2010_2015,2012.5,5,20636,20960,943,1316,324,373,-49,0.00312060619958499,0.00359254972976913,-0.000471943530184149,EPCI
200070142,CC Lyons Andelle,1968_1975,1971.5,7,15713,16065,1244,1823,352,579,-227,0.00316995619840754,0.00521421772408513,-0.00204426152567759,EPCI
200070142,CC Lyons Andelle,1975_1982,1978.5,7,16065,17410,1252,1532,1345,280,1065,0.011552182872816,0.00240491539359738,0.00914726747921862,EPCI
200070142,CC Lyons Andelle,1982_1990,1986,8,17410,18126,1373,1851,716,478,238,0.00505053841979497,0.00337172816293575,0.00167881025685922,EPCI
200070142,CC Lyons Andelle,1990_1999,1994.5,9,18126,18696,1474,1946,570,472,98,0.00344617173193651,0.0028536720306562,0.000592499701280312,EPCI
200070142,CC Lyons Andelle,1999_2010,2004.5,11,18696,20636,1883,2746,1940,863,1077,0.00901562779367726,0.00401056019893994,0.00500506759473733,EPCI
200070159,CC Coeur de Beauce,2010_2015,2012.5,5,24447,24985,1102,1624,538,522,16,0.0043631179608512,0.00423335980588165,0.000129758154969553,EPCI
200070159,CC Coeur de Beauce,1968_1975,1971.5,7,23201,21692,1802,2017,-1509,215,-1724,-0.00956140376322212,0.00136229410808002,-0.0109236978713021,EPCI
200070159,CC Coeur de Beauce,1975_1982,1978.5,7,21692,21192,1737,1622,-500,-115,-385,-0.00332585377049777,-0.000764946367214486,-0.00256090740328328,EPCI
200070159,CC Coeur de Beauce,1982_1990,1986,8,21192,21705,2039,1937,513,-102,615,0.00299433619327028,-0.000595365091059587,0.00358970128432986,EPCI
200070159,CC Coeur de Beauce,1990_1999,1994.5,9,21705,22309,2188,2283,604,95,509,0.00305438133924807,0.000480407660974448,0.00257397367827362,EPCI
200070159,CC Coeur de Beauce,1999_2010,2004.5,11,22309,24447,2463,3347,2138,884,1254,0.00835446213048496,0.00345432391176273,0.00490013821872224,EPCI
200070167,CC Terres de Perche,2010_2015,2012.5,5,14872,15039,765,867,167,102,65,0.00223581101224846,0.00136558516915774,0.000870225843090717,EPCI
200070167,CC Terres de Perche,1968_1975,1971.5,7,12614,12598,1156,1327,-16,171,-187,-0.000181303139987765,0.00193767730861924,-0.00211898044860701,EPCI
200070167,CC Terres de Perche,1975_1982,1978.5,7,12598,12717,1056,1003,119,-53,172,0.00134398946527559,-0.000598583543358034,0.00194257300863362,EPCI
200070167,CC Terres de Perche,1982_1990,1986,8,12717,13539,1194,1277,822,83,739,0.00786007049473225,0.000793656753117733,0.00706641374161452,EPCI
200070167,CC Terres de Perche,1990_1999,1994.5,9,13539,13834,1413,1393,295,-20,315,0.00239786146741094,-0.000162566879146505,0.00256042834655745,EPCI
200070167,CC Terres de Perche,1999_2010,2004.5,11,13834,14872,1850,1832,1038,-18,1056,0.0065990346966307,-0.000114434127687238,0.00671346882431794,EPCI
200070183,CC des Terres du Val de Loire,2010_2015,2012.5,5,46995,48154,2296,2975,1159,679,480,0.00488448950538478,0.00286157754456969,0.0020229119608151,EPCI
200070183,CC des Terres du Val de Loire,1968_1975,1971.5,7,29208,31561,2900,3048,2353,148,2205,0.011129987792053,0.000700058730651867,0.0104299290614011,EPCI
200070183,CC des Terres du Val de Loire,1975_1982,1978.5,7,31561,37824,3102,3177,6263,75,6188,0.0261975113140547,0.000313717603154096,0.0258837937109006,EPCI
200070183,CC des Terres du Val de Loire,1982_1990,1986,8,37824,39939,3628,3763,2115,135,1980,0.00682436411254073,0.00043559770931111,0.00638876640322962,EPCI
200070183,CC des Terres du Val de Loire,1990_1999,1994.5,9,39939,41915,3949,4147,1976,198,1778,0.00538002820495764,0.000539091895031181,0.00484093630992646,EPCI
200070183,CC des Terres du Val de Loire,1999_2010,2004.5,11,41915,46995,4949,6366,5080,1417,3663,0.0104540341818307,0.00291601701489253,0.00753801716693813,EPCI
200070233,"CC Terres de Montaigu, Cc Montaigu-Rocheservière",2010_2015,2012.5,5,44386,47742,1601,3350,3356,1749,1607,0.0146842515131578,0.00765278781183342,0.00703146370132436,EPCI
200070233,"CC Terres de Montaigu, Cc Montaigu-Rocheservière",1968_1975,1971.5,7,25091,27901,1737,3607,2810,1870,940,0.0152803276076854,0.0101687589417693,0.00511156866591611,EPCI
200070233,"CC Terres de Montaigu, Cc Montaigu-Rocheservière",1975_1982,1978.5,7,27901,30530,1888,3756,2629,1868,761,0.0129469924575305,0.00919930844833282,0.00374768400919769,EPCI
200070233,"CC Terres de Montaigu, Cc Montaigu-Rocheservière",1982_1990,1986,8,30530,32525,2152,3911,1995,1759,236,0.00794378798516893,0.00700407171223666,0.000939716272932265,EPCI
200070233,"CC Terres de Montaigu, Cc Montaigu-Rocheservière",1990_1999,1994.5,9,32525,35357,2396,4006,2832,1610,1222,0.00931953314707945,0.00529818092047949,0.00402135222659996,EPCI
200070233,"CC Terres de Montaigu, Cc Montaigu-Rocheservière",1999_2010,2004.5,11,35357,44386,3245,6742,9029,3497,5532,0.020890460081008,0.00809103321555932,0.0127994268654487,EPCI
200070282,CC Lavalette Tude Dronne,2010_2015,2012.5,5,18252,18149,1200,695,-103,-505,402,-0.00113119976881104,-0.00554617362378229,0.00441497385497125,EPCI
200070282,CC Lavalette Tude Dronne,1968_1975,1971.5,7,20313,19160,1901,1732,-1153,-169,-984,-0.00831329508004886,-0.00121851419646857,-0.00709478088358029,EPCI
200070282,CC Lavalette Tude Dronne,1975_1982,1978.5,7,19160,18614,1851,1361,-546,-490,-56,-0.00412159521249966,-0.00369886749839713,-0.000422727714102529,EPCI
200070282,CC Lavalette Tude Dronne,1982_1990,1986,8,18614,18325,2094,1501,-289,-593,304,-0.00195405559149398,-0.00400953275348072,0.00205547716198674,EPCI
200070282,CC Lavalette Tude Dronne,1990_1999,1994.5,9,18325,17804,2107,1451,-521,-656,135,-0.00319965866002159,-0.00402874487710971,0.000829086217088128,EPCI
200070282,CC Lavalette Tude Dronne,1999_2010,2004.5,11,17804,18252,2607,1756,448,-851,1299,0.00226178233495533,-0.00429637671215845,0.00655815904711378,EPCI
200070290,CC Pays de l'Audunois et du Bassin de Landres,2010_2015,2012.5,5,23026,23367,1171,1320,341,149,192,0.00294447815594867,0.00128659016198344,0.00165788799396523,EPCI
200070290,CC Pays de l'Audunois et du Bassin de Landres,1968_1975,1971.5,7,31022,27150,2018,2788,-3872,770,-4642,-0.0188654323133931,0.0037516484714134,-0.0226170807848065,EPCI
200070290,CC Pays de l'Audunois et du Bassin de Landres,1975_1982,1978.5,7,27150,24314,1887,2088,-2836,201,-3037,-0.0156371262256896,0.00110827305055134,-0.0167453992762409,EPCI
200070290,CC Pays de l'Audunois et du Bassin de Landres,1982_1990,1986,8,24314,22314,2002,2015,-2000,13,-2013,-0.0106723955156859,6.93705708519582e-05,-0.0107417660865378,EPCI
200070290,CC Pays de l'Audunois et du Bassin de Landres,1990_1999,1994.5,9,22314,21870,2119,1797,-444,-322,-122,-0.00223066940454086,-0.00161773772131117,-0.000612931683229697,EPCI
200070290,CC Pays de l'Audunois et du Bassin de Landres,1999_2010,2004.5,11,21870,23026,2585,2722,1156,137,1019,0.00469354192016147,0.00055624155974232,0.00413730036041915,EPCI
200070308,CA Mâconnais Beaujolais Agglomération,2010_2015,2012.5,5,75480,76451,3282,4680,971,1398,-427,0.00255972897307122,0.00368537703846917,-0.00112564806539795,EPCI
200070308,CA Mâconnais Beaujolais Agglomération,1968_1975,1971.5,7,61870,68586,4649,8334,6716,3685,3031,0.0148307607254137,0.00813748559755053,0.00669327512786314,EPCI
200070308,CA Mâconnais Beaujolais Agglomération,1975_1982,1978.5,7,68586,70865,4450,7444,2279,2994,-715,0.00468066687943991,0.00614915166171263,-0.00146848478227272,EPCI
200070308,CA Mâconnais Beaujolais Agglomération,1982_1990,1986,8,70865,71928,4915,8141,1063,3226,-2163,0.00186285296670707,0.00565339950197274,-0.00379054653526566,EPCI
200070308,CA Mâconnais Beaujolais Agglomération,1990_1999,1994.5,9,71928,71323,5811,8171,-605,2360,-2965,-0.000938088900904965,0.00365932199361276,-0.00459741089451772,EPCI
200070308,CA Mâconnais Beaujolais Agglomération,1999_2010,2004.5,11,71323,75480,7152,9896,4157,2744,1413,0.00516318027992213,0.00340817096177684,0.00175500931814529,EPCI
200070316,"CC Entre Arroux, Loire et Somme",2010_2015,2012.5,5,24192,23306,1655,910,-886,-745,-141,-0.00743445903986173,-0.00625132278182504,-0.00118313625803669,EPCI
200070316,"CC Entre Arroux, Loire et Somme",1968_1975,1971.5,7,30988,31695,2514,3501,707,987,-280,0.00322789947894897,0.00450627551021589,-0.00127837603126692,EPCI
200070316,"CC Entre Arroux, Loire et Somme",1975_1982,1978.5,7,31695,30623,2379,2744,-1072,365,-1437,-0.00490330779206594,0.00166950311950006,-0.006572810911566,EPCI
200070316,"CC Entre Arroux, Loire et Somme",1982_1990,1986,8,30623,28903,2706,2525,-1720,-181,-1539,-0.00719970264602055,-0.00075764312728472,-0.00644205951873583,EPCI
200070316,"CC Entre Arroux, Loire et Somme",1990_1999,1994.5,9,28903,26093,2731,2322,-2810,-409,-2401,-0.0112999281681667,-0.00164472264084704,-0.00965520552731968,EPCI
200070316,"CC Entre Arroux, Loire et Somme",1999_2010,2004.5,11,26093,24192,3419,2367,-1901,-1052,-849,-0.00685323412009076,-0.00379253145414807,-0.00306070266594269,EPCI
200070324,CC du Territoire de Lunéville à Baccarat,2010_2015,2012.5,5,42799,42430,2167,2564,-369,397,-766,-0.00173031699536563,0.00186161476195164,-0.00359193175731728,EPCI
200070324,CC du Territoire de Lunéville à Baccarat,1968_1975,1971.5,7,43171,42611,3730,5456,-560,1726,-2286,-0.00186348121994262,0.005743515331466,-0.00760699655140862,EPCI
200070324,CC du Territoire de Lunéville à Baccarat,1975_1982,1978.5,7,42611,43024,3449,4690,413,1241,-828,0.00137890175781852,0.00414338276380819,-0.00276448100598967,EPCI
200070324,CC du Territoire de Lunéville à Baccarat,1982_1990,1986,8,43024,42633,3647,5311,-391,1664,-2055,-0.00114053637450473,0.00485384278050095,-0.00599437915500568,EPCI
200070324,CC du Territoire de Lunéville à Baccarat,1990_1999,1994.5,9,42633,41856,3907,5019,-777,1112,-1889,-0.00204162919443651,0.00292186829371094,-0.00496349748814745,EPCI
200070324,CC du Territoire de Lunéville à Baccarat,1999_2010,2004.5,11,41856,42799,4553,5968,943,1415,-472,0.0020274690865234,0.00304227863990521,-0.00101480955338181,EPCI
200070332,"CC du Pays de Chalindrey, de Vannier Amance et de la Région de Bourbonne-Les-Bains",2010_2015,2012.5,5,16511,15720,1117,621,-791,-496,-295,-0.00977056253532882,-0.00612667385274728,-0.00364388868258154,EPCI
200070332,"CC du Pays de Chalindrey, de Vannier Amance et de la Région de Bourbonne-Les-Bains",1968_1975,1971.5,7,23014,21170,2246,2126,-1844,-120,-1724,-0.0118601983590255,-0.000771813342235934,-0.0110883850167896,EPCI
200070332,"CC du Pays de Chalindrey, de Vannier Amance et de la Région de Bourbonne-Les-Bains",1975_1982,1978.5,7,21170,20109,2059,1625,-1061,-434,-627,-0.00731846141024928,-0.00299360249957416,-0.00432485891067511,EPCI
200070332,"CC du Pays de Chalindrey, de Vannier Amance et de la Région de Bourbonne-Les-Bains",1982_1990,1986,8,20109,18563,2165,1593,-1546,-572,-974,-0.00994981030518605,-0.0036813010960973,-0.00626850920908875,EPCI
200070332,"CC du Pays de Chalindrey, de Vannier Amance et de la Région de Bourbonne-Les-Bains",1990_1999,1994.5,9,18563,17259,2248,1507,-1304,-741,-563,-0.00806029638068595,-0.00458027578074255,-0.0034800205999434,EPCI
200070332,"CC du Pays de Chalindrey, de Vannier Amance et de la Région de Bourbonne-Les-Bains",1999_2010,2004.5,11,17259,16511,2627,1618,-748,-1009,261,-0.00401980080169573,-0.00542243183009491,0.00140263102839918,EPCI
200070340,CC Haute-Maurienne Vanoise,2010_2015,2012.5,5,9100,8738,388,485,-362,97,-459,-0.00808574963587338,0.00216662352121469,-0.0102523731570881,EPCI
200070340,CC Haute-Maurienne Vanoise,1968_1975,1971.5,7,13475,10163,647,1432,-3312,785,-4097,-0.0394963453213861,0.00936130165377056,-0.0488576469751567,EPCI
200070340,CC Haute-Maurienne Vanoise,1975_1982,1978.5,7,10163,10179,551,1029,16,478,-462,0.000224753869734862,0.00671452185832899,-0.00648976798859413,EPCI
200070340,CC Haute-Maurienne Vanoise,1982_1990,1986,8,10179,9682,658,1095,-497,437,-934,-0.00623774932775945,0.00548470111917682,-0.0117224504469363,EPCI
200070340,CC Haute-Maurienne Vanoise,1990_1999,1994.5,9,9682,9121,673,1043,-561,370,-931,-0.0066101720923355,0.00435965004307332,-0.0109698221354088,EPCI
200070340,CC Haute-Maurienne Vanoise,1999_2010,2004.5,11,9121,9100,803,1254,-21,451,-472,-0.000209526562171991,0.00449983235902705,-0.00470935892119904,EPCI
200070365,CC Corbières Salanque Méditerranée,2010_2015,2012.5,5,19618,21413,1085,1143,1795,58,1737,0.0176643416386104,0.000570769813392426,0.017093571825218,EPCI
200070365,CC Corbières Salanque Méditerranée,1968_1975,1971.5,7,11010,10507,1206,681,-503,-525,22,-0.00665805754734417,-0.00694926483569719,0.000291207288353025,EPCI
200070365,CC Corbières Salanque Méditerranée,1975_1982,1978.5,7,10507,11286,1222,717,779,-505,1284,0.0102697062737662,-0.00665751176925795,0.0169272180430242,EPCI
200070365,CC Corbières Salanque Méditerranée,1982_1990,1986,8,11286,13201,1359,1072,1915,-287,2202,0.0197843624608445,-0.002965071554184,0.0227494340150285,EPCI
200070365,CC Corbières Salanque Méditerranée,1990_1999,1994.5,9,13201,14802,1578,1219,1601,-359,1960,0.0128000867414488,-0.00287022557163031,0.0156703123130792,EPCI
200070365,CC Corbières Salanque Méditerranée,1999_2010,2004.5,11,14802,19618,2002,2064,4816,62,4754,0.0259384410197161,0.000333925112795348,0.0256045159069208,EPCI
200070373,CC Loir-Lucé-Bercé,2010_2015,2012.5,5,24713,24210,1840,1097,-503,-743,240,-0.00410428431178167,-0.00606259094165762,0.00195830662987595,EPCI
200070373,CC Loir-Lucé-Bercé,1968_1975,1971.5,7,25405,24484,2476,2330,-921,-146,-775,-0.00526127675335852,-0.000834035185657269,-0.00442724156770126,EPCI
200070373,CC Loir-Lucé-Bercé,1975_1982,1978.5,7,24484,24238,2403,1829,-246,-574,328,-0.00144155901737286,-0.00336363770720335,0.00192207868983048,EPCI
200070373,CC Loir-Lucé-Bercé,1982_1990,1986,8,24238,23740,2677,2025,-498,-652,154,-0.00259166835932723,-0.00339310797245251,0.000801439613125287,EPCI
200070373,CC Loir-Lucé-Bercé,1990_1999,1994.5,9,23740,23839,3139,2093,99,-1046,1145,0.000462496454868289,-0.00488657870497202,0.00534907515984031,EPCI
200070373,CC Loir-Lucé-Bercé,1999_2010,2004.5,11,23839,24713,3879,2688,874,-1191,2065,0.00327868370561601,-0.00446786303591381,0.00774654674152983,EPCI
200070407,CA Pays d'Issoire,2010_2015,2012.5,5,53783,55468,2772,2998,1685,226,1459,0.00618884138686671,0.000830076055449184,0.00535876533141752,EPCI
200070407,CA Pays d'Issoire,1968_1975,1971.5,7,48029,48927,4355,4853,898,498,400,0.00264984696943782,0.00146951424363033,0.00118033272580749,EPCI
200070407,CA Pays d'Issoire,1975_1982,1978.5,7,48927,48674,4312,3813,-253,-499,246,-0.000740352192971083,-0.00146022033317222,0.000719868140201132,EPCI
200070407,CA Pays d'Issoire,1982_1990,1986,8,48674,47892,4688,4262,-782,-426,-356,-0.00202251829359112,-0.00110178106530667,-0.000920737228284451,EPCI
200070407,CA Pays d'Issoire,1990_1999,1994.5,9,47892,48468,4955,4439,576,-516,1092,0.00132925050631094,-0.00119078691190355,0.00252003741821449,EPCI
200070407,CA Pays d'Issoire,1999_2010,2004.5,11,48468,53783,6074,6403,5315,329,4986,0.00950430408182612,0.000588319104970987,0.00891598497685513,EPCI
200070431,CC Saint-Marcellin Vercors Isère Communauté,2010_2015,2012.5,5,43642,44248,1961,2370,606,409,197,0.00276184353481224,0.00186401651111915,0.000897827023693087,EPCI
200070431,CC Saint-Marcellin Vercors Isère Communauté,1968_1975,1971.5,7,29774,30646,2718,3092,872,374,498,0.00413231724594376,0.00177234707566854,0.00235997017027522,EPCI
200070431,CC Saint-Marcellin Vercors Isère Communauté,1975_1982,1978.5,7,30646,33211,2748,2674,2565,-74,2639,0.011548893451979,-0.00033318445046645,0.0118820779024454,EPCI
200070431,CC Saint-Marcellin Vercors Isère Communauté,1982_1990,1986,8,33211,35188,3080,3215,1977,135,1842,0.00725418114476684,0.000495353795924898,0.00675882734884194,EPCI
200070431,CC Saint-Marcellin Vercors Isère Communauté,1990_1999,1994.5,9,35188,37586,3311,3730,2398,419,1979,0.00735206415471135,0.00128461838232863,0.00606744577238272,EPCI
200070431,CC Saint-Marcellin Vercors Isère Communauté,1999_2010,2004.5,11,37586,43642,4122,5275,6056,1153,4903,0.0136733963755826,0.00260327378154669,0.0110701225940359,EPCI
200070449,CC Inter-Caux-Vexin,2010_2015,2012.5,5,52245,54009,1869,2937,1764,1068,696,0.00666340371580931,0.00403430565106822,0.00262909806474109,EPCI
200070449,CC Inter-Caux-Vexin,1968_1975,1971.5,7,29354,32731,2383,3265,3377,882,2495,0.015677888179424,0.00409472827191351,0.0115831599075104,EPCI
200070449,CC Inter-Caux-Vexin,1975_1982,1978.5,7,32731,38651,2284,3096,5920,812,5108,0.0240342783217096,0.00329659358061287,0.0207376847410967,EPCI
200070449,CC Inter-Caux-Vexin,1982_1990,1986,8,38651,43419,2602,4102,4768,1500,3268,0.0146467888758821,0.00460784046011392,0.0100389484157682,EPCI
200070449,CC Inter-Caux-Vexin,1990_1999,1994.5,9,43419,47270,3037,4902,3851,1865,1986,0.00948679611179037,0.00459435854284317,0.00489243756894721,EPCI
200070449,CC Inter-Caux-Vexin,1999_2010,2004.5,11,47270,52245,3707,6364,4975,2657,2318,0.00913862709743762,0.00488066978852096,0.00425795730891667,EPCI
200070464,CC Coeur de Maurienne Arvan,2010_2015,2012.5,5,15562,14797,720,771,-765,51,-816,-0.010030869383271,0.000668724625551402,-0.0106995940088224,EPCI
200070464,CC Coeur de Maurienne Arvan,1968_1975,1971.5,7,15089,15552,1011,1768,463,757,-294,0.00432694089054841,0.00707450162882322,-0.0027475607382748,EPCI
200070464,CC Coeur de Maurienne Arvan,1975_1982,1978.5,7,15552,15748,956,1572,196,616,-420,0.00179076226929786,0.00562810998922186,-0.00383734771992399,EPCI
200070464,CC Coeur de Maurienne Arvan,1982_1990,1986,8,15748,15746,1178,1729,-2,551,-553,-1.58759138783049e-05,0.004373814273473,-0.0043896901873513,EPCI
200070464,CC Coeur de Maurienne Arvan,1990_1999,1994.5,9,15746,15666,1226,1645,-80,419,-499,-0.000565796078912051,0.00296335696330187,-0.00352915304221392,EPCI
200070464,CC Coeur de Maurienne Arvan,1999_2010,2004.5,11,15666,15562,1529,1888,-104,359,-463,-0.000605336141952129,0.00208957379770014,-0.00269490993965227,EPCI
200070506,CC Pays de Nexon Monts de Chalus,2010_2015,2012.5,5,12813,13164,951,620,351,-331,682,0.00541974407256363,-0.00511092674649163,0.0105306708190553,EPCI
200070506,CC Pays de Nexon Monts de Chalus,1968_1975,1971.5,7,13691,13033,1440,864,-658,-576,-82,-0.00701160037730864,-0.00613781431205133,-0.000873786065257307,EPCI
200070506,CC Pays de Nexon Monts de Chalus,1975_1982,1978.5,7,13033,12544,1527,714,-489,-813,324,-0.00544826677106525,-0.00905816131876492,0.00360989454769967,EPCI
200070506,CC Pays de Nexon Monts de Chalus,1982_1990,1986,8,12544,11789,1693,791,-755,-902,147,-0.00772941949786143,-0.00923435283055763,0.0015049333326962,EPCI
200070506,CC Pays de Nexon Monts de Chalus,1990_1999,1994.5,9,11789,11783,1723,762,-6,-961,955,-5.65626868027636e-05,-0.0090594570029093,0.00900289431610653,EPCI
200070506,CC Pays de Nexon Monts de Chalus,1999_2010,2004.5,11,11783,12813,2113,1317,1030,-796,1826,0.00764749987241986,-0.00591010669752059,0.0135576065699405,EPCI
200070514,CA du Grand Cognac,2010_2015,2012.5,5,69870,69833,3624,3333,-37,-291,254,-0.000105933418930726,-0.000833152024563277,0.000727218605632551,EPCI
200070514,CA du Grand Cognac,1968_1975,1971.5,7,68025,70546,5261,7920,2521,2659,-138,0.00521206359725146,0.00549737290959605,-0.000285309312344586,EPCI
200070514,CA du Grand Cognac,1975_1982,1978.5,7,70546,69786,5347,6472,-760,1125,-1885,-0.00154616955042741,0.00228873782135637,-0.00383490737178378,EPCI
200070514,CA du Grand Cognac,1982_1990,1986,8,69786,70312,5992,7014,526,1022,-496,0.000939073738567275,0.001824588138433,-0.00088551439986572,EPCI
200070514,CA du Grand Cognac,1990_1999,1994.5,9,70312,69214,6574,7161,-1098,587,-1685,-0.00174728582256045,0.000934113641022755,-0.00268139946358321,EPCI
200070514,CA du Grand Cognac,1999_2010,2004.5,11,69214,69870,7898,8102,656,204,452,0.000857933111012121,0.00026679627232694,0.000591136838685181,EPCI
200070530,CC du Grand Autunois Morvan,2010_2015,2012.5,5,37565,36476,2467,1652,-1089,-815,-274,-0.00586637637071019,-0.00439035513510451,-0.00147602123560569,EPCI
200070530,CC du Grand Autunois Morvan,1968_1975,1971.5,7,45633,44795,4513,4938,-838,425,-1263,-0.00264429951426681,0.00134108268921646,-0.00398538220348327,EPCI
200070530,CC du Grand Autunois Morvan,1975_1982,1978.5,7,44795,43671,4299,3737,-1124,-562,-562,-0.00362374117341591,-0.00181187058670795,-0.00181187058670795,EPCI
200070530,CC du Grand Autunois Morvan,1982_1990,1986,8,43671,41772,4620,3924,-1899,-696,-1203,-0.00554183799951891,-0.00203113177865464,-0.00351070622086427,EPCI
200070530,CC du Grand Autunois Morvan,1990_1999,1994.5,9,41772,39791,4628,3828,-1981,-800,-1181,-0.00538384405474024,-0.00217419245017274,-0.0032096516045675,EPCI
200070530,CC du Grand Autunois Morvan,1999_2010,2004.5,11,39791,37565,5504,4045,-2226,-1459,-767,-0.00521978299865478,-0.00342123243263132,-0.00179855056602346,EPCI
200070548,CC La Clayette Chauffailles en Brionnais,2010_2015,2012.5,5,15784,15305,1025,640,-479,-385,-94,-0.00614448423552061,-0.00493867730829945,-0.00120580692722116,EPCI
200070548,CC La Clayette Chauffailles en Brionnais,1968_1975,1971.5,7,17287,17803,1514,1906,516,392,124,0.00421058377186512,0.00319873805924637,0.00101184571261875,EPCI
200070548,CC La Clayette Chauffailles en Brionnais,1975_1982,1978.5,7,17803,17484,1613,1667,-319,54,-373,-0.00257963920069471,0.000436678736167756,-0.00301631793686246,EPCI
200070548,CC La Clayette Chauffailles en Brionnais,1982_1990,1986,8,17484,16500,1592,1628,-984,36,-1020,-0.00721457362128608,0.000263947815412905,-0.00747852143669899,EPCI
200070548,CC La Clayette Chauffailles en Brionnais,1990_1999,1994.5,9,16500,15851,1768,1377,-649,-391,-258,-0.00444871845995343,-0.00268019864074236,-0.00176851981921107,EPCI
200070548,CC La Clayette Chauffailles en Brionnais,1999_2010,2004.5,11,15851,15784,2168,1694,-67,-474,407,-0.000385000513314693,-0.0027237349747935,0.00233873446147881,EPCI
200070555,CC de la Veyle,2010_2015,2012.5,5,20967,21816,777,1230,849,453,396,0.00797037010096524,0.00425274164397792,0.00371762845698732,EPCI
200070555,CC de la Veyle,1968_1975,1971.5,7,12517,13555,1133,1526,1038,393,645,0.0114461201630938,0.00433364665134475,0.00711247351174902,EPCI
200070555,CC de la Veyle,1975_1982,1978.5,7,13555,15315,1018,1384,1760,366,1394,0.0175925660387495,0.00365845407396722,0.0139341119647823,EPCI
200070555,CC de la Veyle,1982_1990,1986,8,15315,16990,1170,1742,1675,572,1103,0.0130585522395186,0.00445939813791321,0.00859915410160537,EPCI
200070555,CC de la Veyle,1990_1999,1994.5,9,16990,17882,1269,1771,892,502,390,0.00570171376059014,0.00320881200427831,0.00249290175631183,EPCI
200070555,CC de la Veyle,1999_2010,2004.5,11,17882,20967,1571,2503,3085,932,2153,0.0145738278261909,0.00440285495429818,0.0101709728718927,EPCI
200070563,CC Terres Touloises,2010_2015,2012.5,5,43991,45013,1646,2735,1022,1089,-67,0.00460381904004348,0.00490563496536922,-0.000301815925325746,EPCI
200070563,CC Terres Touloises,1968_1975,1971.5,7,34369,36819,2528,4737,2450,2209,241,0.00988554535187025,0.00891313048256383,0.00097241486930642,EPCI
200070563,CC Terres Touloises,1975_1982,1978.5,7,36819,39540,2361,4625,2721,2264,457,0.010237592275733,0.00851815836540221,0.00171943391033075,EPCI
200070563,CC Terres Touloises,1982_1990,1986,8,39540,41664,2628,5487,2124,2859,-735,0.0065620148994725,0.00883276864293403,-0.00227075374346153,EPCI
200070563,CC Terres Touloises,1990_1999,1994.5,9,41664,42338,2780,5299,674,2519,-1845,0.00178465519928195,0.00666995021808787,-0.00488529501880593,EPCI
200070563,CC Terres Touloises,1999_2010,2004.5,11,42338,43991,3381,6549,1653,3168,-1515,0.0034878903650275,0.00668459569050643,-0.00319670532547893,EPCI
200070571,CC Coeur de Berry,2010_2015,2012.5,5,18018,18188,882,937,170,55,115,0.00187992038553975,0.000608209536498153,0.00127171084904159,EPCI
200070571,CC Coeur de Berry,1968_1975,1971.5,7,14080,15505,1491,1562,1425,71,1354,0.0138677345925553,0.000690953793734334,0.013176780798821,EPCI
200070571,CC Coeur de Berry,1975_1982,1978.5,7,15505,16701,1478,1342,1196,-136,1332,0.0106716899138135,-0.00121350320090187,0.0118851931147154,EPCI
200070571,CC Coeur de Berry,1982_1990,1986,8,16701,17406,1552,1577,705,25,680,0.0051816757479024,0.000183747366946894,0.00499792838095551,EPCI
200070571,CC Coeur de Berry,1990_1999,1994.5,9,17406,17417,1634,1721,11,87,-76,7.01987285183225e-05,0.000555208125554006,-0.000485009397035683,EPCI
200070571,CC Coeur de Berry,1999_2010,2004.5,11,17417,18018,2069,2193,601,124,477,0.00308880760936181,0.000637291420234383,0.00245151618912743,EPCI
200070589,CC de Seille et Grand Couronné,2010_2015,2012.5,5,18074,18543,557,994,469,437,32,0.00513673157277927,0.00478625095374103,0.000350480619038245,EPCI
200070589,CC de Seille et Grand Couronné,1968_1975,1971.5,7,12015,12332,984,1153,317,169,148,0.00372716306649878,0.00198703646131954,0.00174012660517924,EPCI
200070589,CC de Seille et Grand Couronné,1975_1982,1978.5,7,12332,14242,943,1201,1910,258,1652,0.0207841631804311,0.00280749429348231,0.0179766688869488,EPCI
200070589,CC de Seille et Grand Couronné,1982_1990,1986,8,14242,15393,1010,1521,1151,511,640,0.00976203015451893,0.00433396820934767,0.00542806194517126,EPCI
200070589,CC de Seille et Grand Couronné,1990_1999,1994.5,9,15393,16167,1005,1618,774,613,161,0.0054659135598274,0.00432894704415271,0.00113696651567469,EPCI
200070589,CC de Seille et Grand Couronné,1999_2010,2004.5,11,16167,18074,1128,2254,1907,1126,781,0.0101881230832452,0.00601564058297543,0.00417248250026981,EPCI
200070647,CA Bergeracoise,2010_2015,2012.5,5,59804,60592,3466,2986,788,-480,1268,0.00262149468535111,-0.0015968495545286,0.00421834423987971,EPCI
200070647,CA Bergeracoise,1968_1975,1971.5,7,49712,50909,4325,5123,1197,798,399,0.00340483655563406,0.00226989103708937,0.00113494551854469,EPCI
200070647,CA Bergeracoise,1975_1982,1978.5,7,50909,52399,4465,4376,1490,-89,1579,0.00412961516671917,-0.000246668288481883,0.00437628345520105,EPCI
200070647,CA Bergeracoise,1982_1990,1986,8,52399,55967,5156,5009,3568,-147,3715,0.00826833594634557,-0.000340651733215471,0.00860898767956104,EPCI
200070647,CA Bergeracoise,1990_1999,1994.5,9,55967,56003,5897,4919,36,-978,1014,7.14502641181447e-05,-0.00194106550854293,0.00201251577266108,EPCI
200070647,CA Bergeracoise,1999_2010,2004.5,11,56003,59804,7197,6375,3801,-822,4623,0.00598760790949338,-0.0012948733758494,0.00728248128534277,EPCI
200070662,CC Bretagne Porte de Loire Communauté,2010_2015,2012.5,5,30766,31832,1232,2155,1066,923,143,0.00683563482573768,0.00591865942228507,0.000916975403452616,EPCI
200070662,CC Bretagne Porte de Loire Communauté,1968_1975,1971.5,7,20037,19653,1920,2172,-384,252,-636,-0.00276054922759084,0.00181161043060649,-0.00457215965819732,EPCI
200070662,CC Bretagne Porte de Loire Communauté,1975_1982,1978.5,7,19653,20630,1971,1935,977,-36,1013,0.00695497839758685,-0.000256273513114766,0.00721125191070162,EPCI
200070662,CC Bretagne Porte de Loire Communauté,1982_1990,1986,8,20630,21163,2103,2202,533,99,434,0.00319359454117407,0.000593181725283739,0.00260041281589033,EPCI
200070662,CC Bretagne Porte de Loire Communauté,1990_1999,1994.5,9,21163,22692,2187,2556,1529,369,1160,0.00778101213025106,0.00187782437937387,0.0059031877508772,EPCI
200070662,CC Bretagne Porte de Loire Communauté,1999_2010,2004.5,11,22692,30766,2631,4668,8074,2037,6037,0.0280589628464529,0.00707903236539814,0.0209799304810548,EPCI
200070670,CC du Pays de Dol et de la Baie du Mont-Saint-Michel,2010_2015,2012.5,5,22748,23489,1244,1380,741,136,605,0.00643159384609837,0.00118042748052548,0.0052511663655729,EPCI
200070670,CC du Pays de Dol et de la Baie du Mont-Saint-Michel,1968_1975,1971.5,7,20536,19845,1805,2013,-691,208,-899,-0.00487768773233277,0.00146824753737368,-0.00634593526970645,EPCI
200070670,CC du Pays de Dol et de la Baie du Mont-Saint-Michel,1975_1982,1978.5,7,19845,19631,1827,1718,-214,-109,-105,-0.00154767779658083,-0.000788303176763131,-0.000759374619817695,EPCI
200070670,CC du Pays de Dol et de la Baie du Mont-Saint-Michel,1982_1990,1986,8,19631,19867,2037,1934,236,-103,339,0.00149488051660973,-0.000652426666147467,0.0021473071827572,EPCI
200070670,CC du Pays de Dol et de la Baie du Mont-Saint-Michel,1990_1999,1994.5,9,19867,19753,2078,1939,-114,-139,25,-0.000639205092445083,-0.000779381647805847,0.000140176555360764,EPCI
200070670,CC du Pays de Dol et de la Baie du Mont-Saint-Michel,1999_2010,2004.5,11,19753,22748,2556,2756,2995,200,2795,0.012916511332937,0.000862538319394793,0.0120539730135422,EPCI
200070688,CC Couesnon Marches de Bretagne,2010_2015,2012.5,5,21426,21925,1167,1328,499,161,338,0.00461509699085427,0.00148903930967442,0.00312605768117985,EPCI
200070688,CC Couesnon Marches de Bretagne,1968_1975,1971.5,7,21262,20630,1890,2141,-632,251,-883,-0.00430145282005401,0.00170833015479993,-0.00600978297485394,EPCI
200070688,CC Couesnon Marches de Bretagne,1975_1982,1978.5,7,20630,19858,1875,1756,-772,-119,-653,-0.00543366657785316,-0.000837572956948868,-0.00459609362090429,EPCI
200070688,CC Couesnon Marches de Bretagne,1982_1990,1986,8,19858,19531,1955,1808,-327,-147,-180,-0.00207334785833324,-0.000932055459250723,-0.00114129239908252,EPCI
200070688,CC Couesnon Marches de Bretagne,1990_1999,1994.5,9,19531,18960,2014,1809,-571,-205,-366,-0.0032913992114918,-0.00118167572391562,-0.00210972348757618,EPCI
200070688,CC Couesnon Marches de Bretagne,1999_2010,2004.5,11,18960,21426,2617,2991,2466,374,2092,0.011177795440745,0.00169525364754203,0.00948254179320301,EPCI
200070712,CC Thiers Dore et Montagne,2010_2015,2012.5,5,37503,37707,2086,1862,204,-224,428,0.00108555355404594,-0.00119198037307005,0.00227753392711599,EPCI
200070712,CC Thiers Dore et Montagne,1968_1975,1971.5,7,43640,43407,4143,4503,-233,360,-593,-0.000764485138193716,0.00118117875429072,-0.00194566389248444,EPCI
200070712,CC Thiers Dore et Montagne,1975_1982,1978.5,7,43407,43195,4063,3643,-212,-420,208,-0.000699179832961305,-0.00138516759360259,0.000685987760641281,EPCI
200070712,CC Thiers Dore et Montagne,1982_1990,1986,8,43195,41717,4216,3827,-1478,-389,-1089,-0.00434254728318972,-0.00114293023894506,-0.00319961704424466,EPCI
200070712,CC Thiers Dore et Montagne,1990_1999,1994.5,9,41717,39570,4294,3851,-2147,-443,-1704,-0.00585362971118697,-0.0012078052920614,-0.00464582441912557,EPCI
200070712,CC Thiers Dore et Montagne,1999_2010,2004.5,11,39570,37503,4965,4584,-2067,-381,-1686,-0.00486542760354469,-0.000896820472641765,-0.00396860713090293,EPCI
200070720,CC Médoc Atlantique,2010_2015,2012.5,5,24461,25624,1631,1114,1163,-517,1680,0.00933316482992153,-0.00414896493299177,0.0134821297629133,EPCI
200070720,CC Médoc Atlantique,1968_1975,1971.5,7,16423,16819,1660,1497,396,-163,559,0.0034095720392664,-0.00140343495555662,0.00481300699482302,EPCI
200070720,CC Médoc Atlantique,1975_1982,1978.5,7,16819,16875,1771,1242,56,-529,585,0.000474975195483562,-0.00448681925733579,0.00496179445281936,EPCI
200070720,CC Médoc Atlantique,1982_1990,1986,8,16875,17958,2092,1426,1083,-666,1749,0.00780561386792256,-0.00480012819578617,0.0126057420637087,EPCI
200070720,CC Médoc Atlantique,1990_1999,1994.5,9,17958,19250,2574,1510,1292,-1064,2356,0.00774935677565525,-0.0063818232270102,0.0141311800026655,EPCI
200070720,CC Médoc Atlantique,1999_2010,2004.5,11,19250,24461,3199,2195,5211,-1004,6215,0.0220178890742897,-0.0042421724487789,0.0262600615230686,EPCI
200070738,CC Mad et Moselle,2010_2015,2012.5,5,20557,20308,1240,1111,-249,-129,-120,-0.00243435582999141,-0.00126117229746543,-0.00117318353252598,EPCI
200070738,CC Mad et Moselle,1968_1975,1971.5,7,16385,16212,1947,1526,-173,-421,248,-0.00151521852189385,-0.00368732368622722,0.00217210516433338,EPCI
200070738,CC Mad et Moselle,1975_1982,1978.5,7,16212,16488,1869,1304,276,-565,841,0.00241450091264883,-0.00494272831756011,0.00735722923020894,EPCI
200070738,CC Mad et Moselle,1982_1990,1986,8,16488,17449,1981,1674,961,-307,1268,0.00710631799271155,-0.00227017650755718,0.00937649450026873,EPCI
200070738,CC Mad et Moselle,1990_1999,1994.5,9,17449,18652,2144,1887,1203,-257,1460,0.00743539948995009,-0.00158844361505999,0.00902384310501008,EPCI
200070738,CC Mad et Moselle,1999_2010,2004.5,11,18652,20557,2644,2540,1905,-104,2009,0.00887993444822222,-0.000484783822895071,0.00936471827111729,EPCI
200070746,CA Sarreguemines Confluences,2010_2015,2012.5,5,65976,65661,3125,3122,-315,-3,-312,-0.000956721570007479,-9.11163400007123e-06,-0.000947609936007408,EPCI
200070746,CA Sarreguemines Confluences,1968_1975,1971.5,7,60240,62086,4476,7029,1846,2553,-707,0.00432130103829254,0.0059763171997621,-0.00165501616146957,EPCI
200070746,CA Sarreguemines Confluences,1975_1982,1978.5,7,62086,63555,4438,6537,1469,2099,-630,0.00334632248598754,0.00478143696261937,-0.00143511447663182,EPCI
200070746,CA Sarreguemines Confluences,1982_1990,1986,8,63555,63341,4970,7006,-214,2036,-2250,-0.000421516630512153,0.00401031710150815,-0.0044318337320203,EPCI
200070746,CA Sarreguemines Confluences,1990_1999,1994.5,9,63341,65488,5354,6568,2147,1214,933,0.00371065538190818,0.00209815353220146,0.00161250184970672,EPCI
200070746,CA Sarreguemines Confluences,1999_2010,2004.5,11,65488,65976,6487,7655,488,1168,-680,0.000675147789829467,0.00161592749696889,-0.000940779707139421,EPCI
200070753,CA Riom Limagne et Volcans,2010_2015,2012.5,5,63069,66264,2532,3626,3195,1094,2101,0.00993248252040124,0.0034009814952485,0.00653150102515274,EPCI
200070753,CA Riom Limagne et Volcans,1968_1975,1971.5,7,38932,43253,3334,4838,4321,1504,2817,0.015149328085071,0.0052729899189879,0.00987633816608306,EPCI
200070753,CA Riom Limagne et Volcans,1975_1982,1978.5,7,43253,50104,3290,4363,6851,1073,5778,0.0212270483563404,0.00332456909740961,0.0179024792589308,EPCI
200070753,CA Riom Limagne et Volcans,1982_1990,1986,8,50104,55715,3715,5083,5611,1368,4243,0.0133569887710312,0.00325652479749968,0.0101004639735315,EPCI
200070753,CA Riom Limagne et Volcans,1990_1999,1994.5,9,55715,57534,4261,5343,1819,1082,737,0.0035760083711851,0.00212712537527338,0.00144888299591172,EPCI
200070753,CA Riom Limagne et Volcans,1999_2010,2004.5,11,57534,63069,5462,7495,5535,2033,3502,0.00838525987606498,0.00307989762024211,0.00530536225582286,EPCI
200070761,CC Ambert Livradois Forez,2010_2015,2012.5,5,28219,27618,1994,1049,-601,-945,344,-0.00429629956011424,-0.00675541278587014,0.0024591132257559,EPCI
200070761,CC Ambert Livradois Forez,1968_1975,1971.5,7,37007,34072,4080,2578,-2935,-1502,-1433,-0.0117350510076987,-0.00600546733000457,-0.00572958367769411,EPCI
200070761,CC Ambert Livradois Forez,1975_1982,1978.5,7,34072,31928,3856,2232,-2144,-1624,-520,-0.00924168283019933,-0.00700022990496442,-0.00224145292523491,EPCI
200070761,CC Ambert Livradois Forez,1982_1990,1986,8,31928,29975,3891,2380,-1953,-1511,-442,-0.00785891433169339,-0.0060802967512487,-0.00177861758044469,EPCI
200070761,CC Ambert Livradois Forez,1990_1999,1994.5,9,29975,29009,4000,2468,-966,-1532,566,-0.00363311468187899,-0.00576183405035053,0.00212871936847154,EPCI
200070761,CC Ambert Livradois Forez,1999_2010,2004.5,11,29009,28219,4538,2719,-790,-1819,1029,-0.0025069085098236,-0.00577223617641662,0.00326532766659302,EPCI
200070779,CC Brie des Rivières et Châteaux,2010_2015,2012.5,5,36631,38552,1144,2440,1921,1296,625,0.0102750500675692,0.00693204835375832,0.00334300171381092,EPCI
200070779,CC Brie des Rivières et Châteaux,1968_1975,1971.5,7,17202,19315,1506,1908,2113,402,1711,0.0166886307281082,0.00317502581765239,0.0135136049104558,EPCI
200070779,CC Brie des Rivières et Châteaux,1975_1982,1978.5,7,19315,24624,1585,1871,5309,286,5023,0.0353001334721812,0.00190164591694176,0.0333984875552394,EPCI
200070779,CC Brie des Rivières et Châteaux,1982_1990,1986,8,24624,29060,1733,2592,4436,859,3577,0.0209209735216092,0.0040511984344144,0.0168697750871948,EPCI
200070779,CC Brie des Rivières et Châteaux,1990_1999,1994.5,9,29060,32941,2114,3610,3881,1496,2385,0.0140258323004472,0.00540650479811105,0.00861932750233613,EPCI
200070779,CC Brie des Rivières et Châteaux,1999_2010,2004.5,11,32941,36631,2446,4924,3690,2478,1212,0.00969917081818639,0.00651342690717232,0.00318574391101407,EPCI
200070787,CC du Plateau de Lannemezan,2010_2015,2012.5,5,17553,17942,999,701,389,-298,687,0.00439351484243788,-0.00336572602325576,0.00775924086569364,EPCI
200070787,CC du Plateau de Lannemezan,1968_1975,1971.5,7,21213,20712,1659,1870,-501,211,-712,-0.00340860017913447,0.00143555815927619,-0.00484415833841066,EPCI
200070787,CC du Plateau de Lannemezan,1975_1982,1978.5,7,20712,19311,1559,1159,-1401,-400,-1001,-0.00995559180956551,-0.00284242449951906,-0.00711316731004645,EPCI
200070787,CC du Plateau de Lannemezan,1982_1990,1986,8,19311,18267,1744,1285,-1044,-459,-585,-0.0069232640709076,-0.0030438488587611,-0.0038794152121465,EPCI
200070787,CC du Plateau de Lannemezan,1990_1999,1994.5,9,18267,17330,1867,1157,-937,-710,-227,-0.00583370078427448,-0.00442041361455163,-0.00141328716972285,EPCI
200070787,CC du Plateau de Lannemezan,1999_2010,2004.5,11,17330,17553,2433,1545,223,-888,1111,0.00116301866836044,-0.00463121335203618,0.00579423202039662,EPCI
200070795,CC du Pays de Trie et du Magnoac,2010_2015,2012.5,5,6883,6974,546,200,91,-346,437,0.00263032221080972,-0.0100010053290128,0.0126313275398225,EPCI
200070795,CC du Pays de Trie et du Magnoac,1968_1975,1971.5,7,8613,7938,934,602,-675,-332,-343,-0.0115910621933706,-0.00570108540473931,-0.00588997678863127,EPCI
200070795,CC du Pays de Trie et du Magnoac,1975_1982,1978.5,7,7938,7443,910,393,-495,-517,22,-0.00915602044302799,-0.00956295468494035,0.000406934241912356,EPCI
200070795,CC du Pays de Trie et du Magnoac,1982_1990,1986,8,7443,6967,904,408,-476,-496,20,-0.00822713005919007,-0.00857280779276948,0.000345677733579415,EPCI
200070795,CC du Pays de Trie et du Magnoac,1990_1999,1994.5,9,6967,6718,932,455,-249,-477,228,-0.00403563760140535,-0.00773092022437893,0.00369528262297357,EPCI
200070795,CC du Pays de Trie et du Magnoac,1999_2010,2004.5,11,6718,6883,1216,546,165,-670,835,0.00220826301341925,-0.00896688617570243,0.0111751491891217,EPCI
200070803,CC des Coteaux du Val-d'Arros,2010_2015,2012.5,5,10659,11311,411,495,652,84,568,0.0119449979823423,0.00153892612042447,0.0104060718619178,EPCI
200070803,CC des Coteaux du Val-d'Arros,1968_1975,1971.5,7,8143,8121,848,597,-22,-251,229,-0.000386405781009347,-0.00440853868333391,0.00402213290232457,EPCI
200070803,CC des Coteaux du Val-d'Arros,1975_1982,1978.5,7,8121,8523,816,484,402,-332,734,0.0069260308107657,-0.00572000554520949,0.0126460363559752,EPCI
200070803,CC des Coteaux du Val-d'Arros,1982_1990,1986,8,8523,9002,871,608,479,-263,742,0.0068582084526374,-0.00376557165562346,0.0106237801082609,EPCI
200070803,CC des Coteaux du Val-d'Arros,1990_1999,1994.5,9,9002,9169,914,667,167,-247,414,0.00204447088609716,-0.00302385813692215,0.00506832902301931,EPCI
200070803,CC des Coteaux du Val-d'Arros,1999_2010,2004.5,11,9169,10659,998,1068,1490,70,1420,0.0137828815805736,0.00064751792660413,0.0131353636539695,EPCI
200070811,CC Pyrénées Vallées des Gaves,2010_2015,2012.5,5,15838,15539,941,590,-299,-351,52,-0.00380456881552949,-0.0044662329573607,0.000661664141831214,EPCI
200070811,CC Pyrénées Vallées des Gaves,1968_1975,1971.5,7,17079,15690,1438,1291,-1389,-147,-1242,-0.0120448828680998,-0.00127472842448572,-0.0107701544436141,EPCI
200070811,CC Pyrénées Vallées des Gaves,1975_1982,1978.5,7,15690,15571,1351,1093,-119,-258,139,-0.00108703116535103,-0.00235675664420643,0.0012697254788554,EPCI
200070811,CC Pyrénées Vallées des Gaves,1982_1990,1986,8,15571,15362,1565,1329,-209,-236,27,-0.0016877344570454,-0.00190576713809911,0.000218032681053712,EPCI
200070811,CC Pyrénées Vallées des Gaves,1990_1999,1994.5,9,15362,15444,1683,1330,82,-353,435,0.000591691738926148,-0.00254716077854793,0.00313885251747408,EPCI
200070811,CC Pyrénées Vallées des Gaves,1999_2010,2004.5,11,15444,15838,2134,1441,394,-693,1087,0.00229276413546153,-0.00403270443115442,0.00632546856661596,EPCI
200070829,CC Neste Barousse,2010_2015,2012.5,5,7153,7252,660,266,99,-394,493,0.0027528709628406,-0.0109558702965576,0.0137087412593982,EPCI
200070829,CC Neste Barousse,1968_1975,1971.5,7,7607,7180,1015,502,-427,-513,86,-0.00821882396791784,-0.00987413746028537,0.00165531349236753,EPCI
200070829,CC Neste Barousse,1975_1982,1978.5,7,7180,6902,867,327,-278,-540,262,-0.00562528398688533,-0.0109268106220075,0.00530152663512215,EPCI
200070829,CC Neste Barousse,1982_1990,1986,8,6902,6836,947,410,-66,-537,471,-0.00120033644701123,-0.0097663738188641,0.00856603737185287,EPCI
200070829,CC Neste Barousse,1990_1999,1994.5,9,6836,6665,1137,415,-171,-722,551,-0.00281079913311477,-0.0118678185620401,0.00905701942892538,EPCI
200070829,CC Neste Barousse,1999_2010,2004.5,11,6665,7153,1372,594,488,-778,1266,0.00644448559153066,-0.0102742003897763,0.016718685981307,EPCI
200070845,CC Orne Lorraine Confluences,2010_2015,2012.5,5,53654,53132,2686,2991,-522,305,-827,-0.00195341766005908,0.00114136472474716,-0.00309478238480624,EPCI
200070845,CC Orne Lorraine Confluences,1968_1975,1971.5,7,65180,60669,4061,6673,-4511,2612,-7123,-0.0101933794815915,0.00590226273684704,-0.0160956422184385,EPCI
200070845,CC Orne Lorraine Confluences,1975_1982,1978.5,7,60669,55225,3911,4880,-5444,969,-6413,-0.01334122206494,0.00237465910744432,-0.0157158811723844,EPCI
200070845,CC Orne Lorraine Confluences,1982_1990,1986,8,55225,52725,4283,5243,-2500,960,-3460,-0.0057740187748605,0.00221722320954643,-0.00799124198440693,EPCI
200070845,CC Orne Lorraine Confluences,1990_1999,1994.5,9,52725,51768,4659,4919,-957,260,-1217,-0.002033211176799,0.000552387571544138,-0.00258559874834314,EPCI
200070845,CC Orne Lorraine Confluences,1999_2010,2004.5,11,51768,53654,5872,6421,1886,549,1337,0.00325837206904889,0.000948486885423032,0.00230988518362586,EPCI
200070852,CC Usses et Rhône,2010_2015,2012.5,5,18409,19871,678,1097,1462,419,1043,0.0154017443172469,0.00441404300200169,0.0109877013152453,EPCI
200070852,CC Usses et Rhône,1968_1975,1971.5,7,10562,10655,969,985,93,16,77,0.0012531575845709,0.000215597003797143,0.00103756058077375,EPCI
200070852,CC Usses et Rhône,1975_1982,1978.5,7,10655,10874,909,923,219,14,205,0.00291070693000983,0.000186072589133049,0.00272463434087678,EPCI
200070852,CC Usses et Rhône,1982_1990,1986,8,10874,12409,1020,1158,1535,138,1397,0.0166429000048915,0.00149623465842022,0.0151466653464713,EPCI
200070852,CC Usses et Rhône,1990_1999,1994.5,9,12409,14023,1157,1440,1614,283,1331,0.0136790270225786,0.00239849110742859,0.01128053591515,EPCI
200070852,CC Usses et Rhône,1999_2010,2004.5,11,14023,18409,1540,2177,4386,637,3749,0.0250486512165207,0.00363793680458816,0.0214107144119325,EPCI
200070894,CC de Gevrey-Chambertin et de Nuits-Saint-Georges,2010_2015,2012.5,5,29597,29787,1123,1554,190,431,-241,0.00128062968224008,0.00290500733181828,-0.0016243776495782,EPCI
200070894,CC de Gevrey-Chambertin et de Nuits-Saint-Georges,1968_1975,1971.5,7,20446,22258,1546,2196,1812,650,1162,0.0122044785078264,0.00437798621969488,0.00782649228813147,EPCI
200070894,CC de Gevrey-Chambertin et de Nuits-Saint-Georges,1975_1982,1978.5,7,22258,23404,1571,1928,1146,357,789,0.00719798950688566,0.00224230563172616,0.0049556838751595,EPCI
200070894,CC de Gevrey-Chambertin et de Nuits-Saint-Georges,1982_1990,1986,8,23404,25314,1824,2425,1910,601,1309,0.00985457143292789,0.0031008363514082,0.00675373508151969,EPCI
200070894,CC de Gevrey-Chambertin et de Nuits-Saint-Georges,1990_1999,1994.5,9,25314,27290,2025,2862,1976,837,1139,0.00838638505217992,0.00355233010560455,0.00483405494657537,EPCI
200070894,CC de Gevrey-Chambertin et de Nuits-Saint-Georges,1999_2010,2004.5,11,27290,29597,2407,3726,2307,1319,988,0.00740479638005143,0.00423360486575112,0.00317119151430031,EPCI
200070902,CC Auxonne Pontailler Val de Saône,2010_2015,2012.5,5,22549,23395,1031,1505,846,474,372,0.00739351913532804,0.00414246816802068,0.00325105096730737,EPCI
200070902,CC Auxonne Pontailler Val de Saône,1968_1975,1971.5,7,17091,17765,1546,1870,674,324,350,0.0055407535530676,0.00266350764272092,0.00287724591034668,EPCI
200070902,CC Auxonne Pontailler Val de Saône,1975_1982,1978.5,7,17765,18923,1677,1674,1158,-3,1161,0.00906193927215693,-2.34765266118055e-05,0.00908541579876873,EPCI
200070902,CC Auxonne Pontailler Val de Saône,1982_1990,1986,8,18923,19138,1728,1976,215,248,-33,0.00141321939660011,0.00163013214119454,-0.000216912744594435,EPCI
200070902,CC Auxonne Pontailler Val de Saône,1990_1999,1994.5,9,19138,19902,1836,1975,764,139,625,0.00435884355830707,0.000793035673566338,0.00356580788474073,EPCI
200070902,CC Auxonne Pontailler Val de Saône,1999_2010,2004.5,11,19902,22549,2258,3054,2647,796,1851,0.0114165396121395,0.00343315660417947,0.00798338300796004,EPCI
200070910,CC Tille et Venelle,2010_2015,2012.5,5,5081,4987,224,287,-94,63,-157,-0.00372774784205787,0.00249838419201751,-0.00622613203407538,EPCI
200070910,CC Tille et Venelle,1968_1975,1971.5,7,4897,5035,346,674,138,328,-190,0.0039779989527533,0.00945495403263104,-0.00547695507987774,EPCI
200070910,CC Tille et Venelle,1975_1982,1978.5,7,5035,4948,321,485,-87,164,-251,-0.00248691273031509,0.00468797342266294,-0.00717488615297803,EPCI
200070910,CC Tille et Venelle,1982_1990,1986,8,4948,4735,367,495,-213,128,-341,-0.00548511749291769,0.00329622084081439,-0.00878133833373208,EPCI
200070910,CC Tille et Venelle,1990_1999,1994.5,9,4735,4800,434,473,65,39,26,0.00151605819778555,0.000909634918671332,0.000606423279114221,EPCI
200070910,CC Tille et Venelle,1999_2010,2004.5,11,4800,5081,531,670,281,139,142,0.00518541384395266,0.00256502677690185,0.00262038706705081,EPCI
200070928,CC Terre de Picardie,2010_2015,2012.5,5,17541,18318,734,1217,777,483,294,0.00870631846129011,0.00541203580026142,0.00329428266102869,EPCI
200070928,CC Terre de Picardie,1968_1975,1971.5,7,15637,15159,1379,1701,-478,322,-800,-0.00442524901499464,0.00298102548708844,-0.00740627450208307,EPCI
200070928,CC Terre de Picardie,1975_1982,1978.5,7,15159,15008,1291,1479,-151,188,-339,-0.00142912393040817,0.00177930661534262,-0.0032084305457508,EPCI
200070928,CC Terre de Picardie,1982_1990,1986,8,15008,15486,1443,1712,478,269,209,0.00392681452433452,0.00220986005658156,0.00171695446775296,EPCI
200070928,CC Terre de Picardie,1990_1999,1994.5,9,15486,15964,1357,1882,478,525,-47,0.0033834662904968,0.00371615021445778,-0.000332683923960982,EPCI
200070928,CC Terre de Picardie,1999_2010,2004.5,11,15964,17541,1651,2486,1577,835,742,0.00860085028773239,0.00455403296782279,0.00404681731990959,EPCI
200070936,CC Ponthieu-Marquenterre,2010_2015,2012.5,5,33420,33189,1986,1767,-231,-219,-12,-0.00138624376449281,-0.00131423110140228,-7.20126630905356e-05,EPCI
200070936,CC Ponthieu-Marquenterre,1968_1975,1971.5,7,32940,31872,2941,3547,-1068,606,-1674,-0.00469748121050728,0.00266542473180469,-0.00736290594231198,EPCI
200070936,CC Ponthieu-Marquenterre,1975_1982,1978.5,7,31872,31204,3107,2652,-668,-455,-213,-0.00302136783593587,-0.00205796761280063,-0.000963400223135241,EPCI
200070936,CC Ponthieu-Marquenterre,1982_1990,1986,8,31204,30981,3324,2822,-223,-502,279,-0.000896120540042622,-0.00201727583453541,0.00112115529449279,EPCI
200070936,CC Ponthieu-Marquenterre,1990_1999,1994.5,9,30981,31115,3431,2991,134,-440,574,0.000479659962712375,-0.00157500286263765,0.00205466282535003,EPCI
200070936,CC Ponthieu-Marquenterre,1999_2010,2004.5,11,31115,33420,4320,4078,2305,-242,2547,0.00651792300309873,-0.000684311222017306,0.00720223422511603,EPCI
200070944,CC du Vimeu,2010_2015,2012.5,5,23129,23127,1089,1224,-2,135,-137,-1.72949040668779e-05,0.00116740602451426,-0.00118470092858114,EPCI
200070944,CC du Vimeu,1968_1975,1971.5,7,21817,22779,1677,2741,962,1064,-102,0.00618326314693207,0.006838869010744,-0.000655605863811925,EPCI
200070944,CC du Vimeu,1975_1982,1978.5,7,22779,22790,1693,2203,11,510,-499,6.89715724848661e-05,0.00319777290611652,-0.00312880133363165,EPCI
200070944,CC du Vimeu,1982_1990,1986,8,22790,22747,1796,2458,-43,662,-705,-0.00023604397322019,0.00363397930864572,-0.00387002328186591,EPCI
200070944,CC du Vimeu,1990_1999,1994.5,9,22747,22524,1881,2221,-223,340,-563,-0.00109405232981052,0.00166806184814161,-0.00276211417795213,EPCI
200070944,CC du Vimeu,1999_2010,2004.5,11,22524,23129,2395,2778,605,383,222,0.00241252674520487,0.00152726899737763,0.000885257747827241,EPCI
200070951,CC du Territoire Nord Picardie,2010_2015,2012.5,5,31822,31608,1460,1847,-214,387,-601,-0.00134861407692122,0.00243884882134818,-0.0037874628982694,EPCI
200070951,CC du Territoire Nord Picardie,1968_1975,1971.5,7,26659,27323,2246,3468,664,1222,-558,0.00352075960312503,0.00647947023346204,-0.002958710630337,EPCI
200070951,CC du Territoire Nord Picardie,1975_1982,1978.5,7,27323,28009,2236,2796,686,560,126,0.00354871737772622,0.00289691214508263,0.000651805232643591,EPCI
200070951,CC du Territoire Nord Picardie,1982_1990,1986,8,28009,29501,2443,3163,1492,720,772,0.00650837225218126,0.00314076945145476,0.0033676028007265,EPCI
200070951,CC du Territoire Nord Picardie,1990_1999,1994.5,9,29501,29793,2640,3186,292,546,-254,0.00109496631759654,0.00204743701851955,-0.000952470700923014,EPCI
200070951,CC du Territoire Nord Picardie,1999_2010,2004.5,11,29793,31822,2987,4175,2029,1188,841,0.00600746449678136,0.00351743115927859,0.00249003333750277,EPCI
200070969,CC Avre Luce Noye,2010_2015,2012.5,5,21872,22925,839,1573,1053,734,319,0.00944850556902144,0.00658613778505388,0.00286236778396756,EPCI
200070969,CC Avre Luce Noye,1968_1975,1971.5,7,16904,16727,1513,1970,-177,457,-634,-0.00150259853581358,0.00387959056986897,-0.00538218910568255,EPCI
200070969,CC Avre Luce Noye,1975_1982,1978.5,7,16727,17839,1328,1830,1112,502,610,0.00923709987531018,0.00416998573507708,0.00506711414023311,EPCI
200070969,CC Avre Luce Noye,1982_1990,1986,8,17839,18833,1522,2105,994,583,411,0.00680096957545762,0.0039888986544183,0.00281207092103932,EPCI
200070969,CC Avre Luce Noye,1990_1999,1994.5,9,18833,19732,1605,2175,899,570,329,0.00519467166930454,0.00329361829978152,0.00190105336952302,EPCI
200070969,CC Avre Luce Noye,1999_2010,2004.5,11,19732,21872,2000,3231,2140,1231,909,0.00940445535881618,0.00540975913397323,0.00399469622484295,EPCI
200070977,CC du Grand Roye,2010_2015,2012.5,5,24786,24792,1509,1533,6,24,-18,4.84097402666528e-05,0.000193638961066611,-0.000145229220799958,EPCI
200070977,CC du Grand Roye,1968_1975,1971.5,7,21518,22206,2113,2667,688,554,134,0.00450622670678036,0.00362856045865744,0.000877666248122918,EPCI
200070977,CC du Grand Roye,1975_1982,1978.5,7,22206,22525,2237,2391,319,154,165,0.00203968889287753,0.000984677396561568,0.00105501149631597,EPCI
200070977,CC du Grand Roye,1982_1990,1986,8,22525,22864,2387,2717,339,330,9,0.00186897156590171,0.00181935285176273,4.96187141389836e-05,EPCI
200070977,CC du Grand Roye,1990_1999,1994.5,9,22864,23842,2643,2740,978,97,881,0.00466474734018929,0.000462658989773375,0.00420208835041592,EPCI
200070977,CC du Grand Roye,1999_2010,2004.5,11,23842,24786,3253,3487,944,234,710,0.00353626026200238,0.000876572988674318,0.00265968727332806,EPCI
200070985,CC de l'Est de la Somme,2010_2015,2012.5,5,21081,20535,1267,1150,-546,-117,-429,-0.00523453452026135,-0.00112168596862743,-0.00411284855163392,EPCI
200070985,CC de l'Est de la Somme,1968_1975,1971.5,7,21721,22510,1743,2797,789,1054,-265,0.0051101726767897,0.00682651711195988,-0.00171634443517018,EPCI
200070985,CC de l'Est de la Somme,1975_1982,1978.5,7,22510,22621,1731,2427,111,696,-585,0.00070296460060626,0.00440777803623384,-0.00370481343562758,EPCI
200070985,CC de l'Est de la Somme,1982_1990,1986,8,22621,21895,1929,2609,-726,680,-1406,-0.00406924535708264,0.00381141438404435,-0.00788065974112699,EPCI
200070985,CC de l'Est de la Somme,1990_1999,1994.5,9,21895,21106,2099,2331,-789,232,-1021,-0.00406957895142879,0.00119663158014129,-0.00526621053157008,EPCI
200070985,CC de l'Est de la Somme,1999_2010,2004.5,11,21106,21081,2760,2861,-25,101,-126,-0.000107739593012024,0.000435267955768577,-0.000543007548780601,EPCI
200070993,CA de la Baie de Somme,2010_2015,2012.5,5,51226,49772,2839,2741,-1454,-98,-1356,-0.00574237691032065,-0.000387037783501667,-0.00535533912681898,EPCI
200070993,CA de la Baie de Somme,1968_1975,1971.5,7,49283,50952,4301,6633,1669,2332,-663,0.00476916774735492,0.00666369034561514,-0.00189452259826022,EPCI
200070993,CA de la Baie de Somme,1975_1982,1978.5,7,50952,50585,4283,5562,-367,1279,-1646,-0.00103217028987146,0.00359712752246756,-0.00462929781233902,EPCI
200070993,CA de la Baie de Somme,1982_1990,1986,8,50585,49775,4663,5600,-810,937,-1747,-0.00201574561397866,0.00233179461765186,-0.00434754023163052,EPCI
200070993,CA de la Baie de Somme,1990_1999,1994.5,9,49775,50079,4816,5755,304,939,-635,0.000676774307469152,0.00209043116682084,-0.00141365685935168,EPCI
200070993,CA de la Baie de Somme,1999_2010,2004.5,11,50079,51226,6166,6691,1147,525,622,0.00206079845148111,0.000943259971253339,0.00111753848022777,EPCI
200071017,CC des Terres d'Auxois,2010_2015,2012.5,5,15987,15911,1036,808,-76,-228,152,-0.000952585613394064,-0.00285775684018219,0.00190517122678813,EPCI
200071017,CC des Terres d'Auxois,1968_1975,1971.5,7,15862,15385,1717,1543,-477,-174,-303,-0.00435240114148561,-0.00158766834091928,-0.00276473280056633,EPCI
200071017,CC des Terres d'Auxois,1975_1982,1978.5,7,15385,15339,1658,1297,-46,-361,315,-0.000427680519749951,-0.00335636233977679,0.00292868182002684,EPCI
200071017,CC des Terres d'Auxois,1982_1990,1986,8,15339,15466,1805,1557,127,-248,375,0.00103121401353046,-0.00201370925476814,0.00304492326829859,EPCI
200071017,CC des Terres d'Auxois,1990_1999,1994.5,9,15466,15455,1986,1478,-11,-508,497,-7.905138669273e-05,-0.00365073676726426,0.00357168538057153,EPCI
200071017,CC des Terres d'Auxois,1999_2010,2004.5,11,15455,15987,2298,1738,532,-560,1092,0.00308140291892478,-0.00324358201992082,0.0063249849388456,EPCI
200071025,CC Haute-Provence-Pays de Banon,2010_2015,2012.5,5,9512,9642,471,412,130,-59,189,0.00271856794114767,-0.00123381160405932,0.00395237954520699,EPCI
200071025,CC Haute-Provence-Pays de Banon,1968_1975,1971.5,7,5333,5285,576,372,-48,-204,156,-0.00129078226533497,-0.00548582462767361,0.00419504236233864,EPCI
200071025,CC Haute-Provence-Pays de Banon,1975_1982,1978.5,7,5285,6351,629,376,1066,-253,1319,0.0265960495760316,-0.00631219563108442,0.032908245207116,EPCI
200071025,CC Haute-Provence-Pays de Banon,1982_1990,1986,8,6351,7385,699,681,1034,-18,1052,0.019033704140047,-0.000331341077873159,0.0193650452179202,EPCI
200071025,CC Haute-Provence-Pays de Banon,1990_1999,1994.5,9,7385,8060,895,742,675,-153,828,0.00976544496047693,-0.0022135008577081,0.011978945818185,EPCI
200071025,CC Haute-Provence-Pays de Banon,1999_2010,2004.5,11,8060,9512,1040,808,1452,-232,1684,0.0151721830955427,-0.00242420556347514,0.0175963886590178,EPCI
200071033,CC Jabron-Lure-Vançon-Durance,2010_2015,2012.5,5,4957,5253,210,243,296,33,263,0.0116672622788399,0.00130074207838417,0.0103665202004557,EPCI
200071033,CC Jabron-Lure-Vançon-Durance,1968_1975,1971.5,7,1929,2187,187,150,258,-37,295,0.0180944720016514,-0.00259494365915155,0.0206894156608029,EPCI
200071033,CC Jabron-Lure-Vançon-Durance,1975_1982,1978.5,7,2187,2616,224,164,429,-60,489,0.0259181379433107,-0.00362491439766583,0.0295430523409765,EPCI
200071033,CC Jabron-Lure-Vançon-Durance,1982_1990,1986,8,2616,3458,217,283,842,66,776,0.0354959536412667,0.00278234315952922,0.0327136104817375,EPCI
200071033,CC Jabron-Lure-Vançon-Durance,1990_1999,1994.5,9,3458,3903,259,344,445,85,360,0.0135414325858978,0.00258656577483441,0.0109548668110634,EPCI
200071033,CC Jabron-Lure-Vançon-Durance,1999_2010,2004.5,11,3903,4957,298,504,1054,206,848,0.0219701600093347,0.00429397814224189,0.0176761818670928,EPCI
200071041,CC du Chaourçois et du Val d'Armance,2010_2015,2012.5,5,10668,10631,714,521,-37,-193,156,-0.000694627637103595,-0.00362332794489173,0.00292870030778813,EPCI
200071041,CC du Chaourçois et du Val d'Armance,1968_1975,1971.5,7,10705,9985,1157,836,-720,-321,-399,-0.00989740299232678,-0.00441259216741235,-0.00548481082491442,EPCI
200071041,CC du Chaourçois et du Val d'Armance,1975_1982,1978.5,7,9985,10085,1178,693,100,-485,585,0.00142461444877062,-0.00690938007653752,0.00833399452530814,EPCI
200071041,CC du Chaourçois et du Val d'Armance,1982_1990,1986,8,10085,9950,1265,861,-135,-404,269,-0.00168315942514685,-0.00503701042784688,0.00335385100270002,EPCI
200071041,CC du Chaourçois et du Val d'Armance,1990_1999,1994.5,9,9950,10136,1263,835,186,-428,614,0.00205999575386429,-0.00474020528308556,0.00680020103694985,EPCI
200071041,CC du Chaourçois et du Val d'Armance,1999_2010,2004.5,11,10136,10668,1603,1158,532,-445,977,0.00466129960579109,-0.00389901940709969,0.00856031901289078,EPCI
200071058,CC Les Avant-Monts,2010_2015,2012.5,5,24174,26251,1337,1282,2077,-55,2132,0.016621913650912,-0.000440156596437247,0.0170620702473493,EPCI
200071058,CC Les Avant-Monts,1968_1975,1971.5,7,17096,16556,1715,1098,-540,-617,77,-0.00457463919235346,-0.00522694885496682,0.000652309662613364,EPCI
200071058,CC Les Avant-Monts,1975_1982,1978.5,7,16556,16830,1721,857,274,-864,1138,0.00234767066127239,-0.00740287390999762,0.00975054457127002,EPCI
200071058,CC Les Avant-Monts,1982_1990,1986,8,16830,17349,2118,1182,519,-936,1455,0.00380369822332338,-0.00685984881894159,0.010663547042265,EPCI
200071058,CC Les Avant-Monts,1990_1999,1994.5,9,17349,18274,2168,1428,925,-740,1665,0.00578828964278144,-0.00463063171422515,0.0104189213570066,EPCI
200071058,CC Les Avant-Monts,1999_2010,2004.5,11,18274,24174,2536,2268,5900,-268,6168,0.0257624783357548,-0.00117022782948853,0.0269327061652434,EPCI
200071066,CA de Saint-Dié-Des-Vosges,2010_2015,2012.5,5,79113,76363,4202,3805,-2750,-397,-2353,-0.00705081047812017,-0.00101788063993226,-0.00603292983818792,EPCI
200071066,CA de Saint-Dié-Des-Vosges,1968_1975,1971.5,7,80222,80851,6927,9145,629,2218,-1589,0.00111636024683781,0.00393654535371425,-0.00282018510687644,EPCI
200071066,CA de Saint-Dié-Des-Vosges,1975_1982,1978.5,7,80851,78864,6770,7446,-1987,676,-2663,-0.0035484186536574,0.00120721238544157,-0.00475563103909898,EPCI
200071066,CA de Saint-Dié-Des-Vosges,1982_1990,1986,8,78864,77499,7331,8136,-1365,805,-2170,-0.00218009724257329,0.00128569837382527,-0.00346579561639856,EPCI
200071066,CA de Saint-Dié-Des-Vosges,1990_1999,1994.5,9,77499,77670,7668,8609,171,941,-770,0.000244924364776633,0.00134780015938486,-0.00110287579460823,EPCI
200071066,CA de Saint-Dié-Des-Vosges,1999_2010,2004.5,11,77670,79113,8917,10078,1443,1161,282,0.00167486718624166,0.00134755426419027,0.000327312922051384,EPCI
200071074,CC Les Portes de l'Ile de France,2010_2015,2012.5,5,21677,22494,752,1330,817,578,239,0.00742680620722491,0.00525421540731457,0.00217259079991035,EPCI
200071074,CC Les Portes de l'Ile de France,1968_1975,1971.5,7,10862,13539,854,1400,2677,546,2131,0.0319724725757429,0.00652109451862369,0.0254513780571192,EPCI
200071074,CC Les Portes de l'Ile de France,1975_1982,1978.5,7,13539,14767,884,1258,1228,374,854,0.0124801713925371,0.00380096425147303,0.00867920714106407,EPCI
200071074,CC Les Portes de l'Ile de France,1982_1990,1986,8,14767,17259,951,1614,2492,663,1829,0.0196835643469779,0.00523683915009886,0.0144467251968791,EPCI
200071074,CC Les Portes de l'Ile de France,1990_1999,1994.5,9,17259,19480,1150,2074,2221,924,1297,0.013541370729212,0.00563360042944255,0.00790777029976947,EPCI
200071074,CC Les Portes de l'Ile de France,1999_2010,2004.5,11,19480,21677,1418,2797,2197,1379,818,0.00976220541065809,0.00612748350536982,0.00363472190528826,EPCI
200071082,CA Montluçon Communauté,2010_2015,2012.5,5,64345,63316,3822,3141,-1029,-681,-348,-0.00321904156440245,-0.0021303861082197,-0.00108865545618275,EPCI
200071082,CA Montluçon Communauté,1968_1975,1971.5,7,77305,77667,6269,7899,362,1630,-1268,0.000667625645618175,0.00300615967502106,-0.00233853402940289,EPCI
200071082,CA Montluçon Communauté,1975_1982,1978.5,7,77667,73821,6390,6055,-3846,-335,-3511,-0.00722905984011824,-0.000629676299126263,-0.00659938354099197,EPCI
200071082,CA Montluçon Communauté,1982_1990,1986,8,73821,69144,6770,5670,-4677,-1100,-3577,-0.00814811735036836,-0.00191638423891494,-0.00623173311145341,EPCI
200071082,CA Montluçon Communauté,1990_1999,1994.5,9,69144,66185,7250,6029,-2959,-1221,-1738,-0.0048479257218218,-0.00200044518632795,-0.00284748053549385,EPCI
200071082,CA Montluçon Communauté,1999_2010,2004.5,11,66185,64345,8506,6910,-1840,-1596,-244,-0.00255986523544571,-0.00222040484552791,-0.000339460389917801,EPCI
200071116,CA Ecla (Espace Communautaire Lons Agglomération),2010_2015,2012.5,5,34560,34338,1777,1595,-222,-182,-40,-0.00128803602477778,-0.00105595746175476,-0.000232078563023024,EPCI
200071116,CA Ecla (Espace Communautaire Lons Agglomération),1968_1975,1971.5,7,31697,34795,2516,4305,3098,1789,1309,0.0134107943162862,0.00774432247638349,0.00566647183990273,EPCI
200071116,CA Ecla (Espace Communautaire Lons Agglomération),1975_1982,1978.5,7,34795,34938,2334,3384,143,1050,-907,0.000586080790589305,0.00430339042041098,-0.00371730962982168,EPCI
200071116,CA Ecla (Espace Communautaire Lons Agglomération),1982_1990,1986,8,34938,34287,2574,3438,-651,864,-1515,-0.00234833689494973,0.00311668675458766,-0.00546502364953739,EPCI
200071116,CA Ecla (Espace Communautaire Lons Agglomération),1990_1999,1994.5,9,34287,34280,3061,3573,-7,512,-519,-2.26863931034327e-05,0.00165934760985108,-0.00168203400295451,EPCI
200071116,CA Ecla (Espace Communautaire Lons Agglomération),1999_2010,2004.5,11,34280,34560,3786,4040,280,254,26,0.000739805358024759,0.000671109146208174,6.86962118165847e-05,EPCI
200071140,CA Moulins Communauté,2010_2015,2012.5,5,65360,65433,3457,3177,73,-280,353,0.000223278484146494,-0.000856410624123539,0.00107968910827003,EPCI
200071140,CA Moulins Communauté,1968_1975,1971.5,7,67114,68978,5857,7648,1864,1791,73,0.00392123186910021,0.00376766431199489,0.000153567557105319,EPCI
200071140,CA Moulins Communauté,1975_1982,1978.5,7,68978,69207,5424,6483,229,1059,-830,0.000473597883506427,0.00219013169708867,-0.00171653381358225,EPCI
200071140,CA Moulins Communauté,1982_1990,1986,8,69207,68205,6133,6498,-1002,365,-1367,-0.00182135651744042,0.000663468192480792,-0.00248482470992121,EPCI
200071140,CA Moulins Communauté,1990_1999,1994.5,9,68205,65665,6481,6386,-2540,-95,-2445,-0.00420799003937966,-0.000157385454228767,-0.00405060458515089,EPCI
200071140,CA Moulins Communauté,1999_2010,2004.5,11,65665,65360,7882,7625,-305,-257,-48,-0.000423147582832351,-0.000356553864878407,-6.65937179539437e-05,EPCI
200071157,CC des Hautes-Vosges,2010_2015,2012.5,5,38078,36731,1950,1630,-1347,-320,-1027,-0.00717724017931598,-0.00170506077014188,-0.0054721794091741,EPCI
200071157,CC des Hautes-Vosges,1968_1975,1971.5,7,39583,40413,2752,4582,830,1830,-1000,0.00296893891317707,0.00654597374833016,-0.00357703483515309,EPCI
200071157,CC des Hautes-Vosges,1975_1982,1978.5,7,40413,40008,2960,4138,-405,1178,-1583,-0.00143783407723253,0.00418214455056769,-0.00561997862780022,EPCI
200071157,CC des Hautes-Vosges,1982_1990,1986,8,40008,39087,3244,4346,-921,1102,-2023,-0.00290695450502687,0.00347824523837091,-0.00638519974339778,EPCI
200071157,CC des Hautes-Vosges,1990_1999,1994.5,9,39087,38678,3553,4005,-409,452,-861,-0.00116809146596808,0.00129089814820922,-0.0024589896141773,EPCI
200071157,CC des Hautes-Vosges,1999_2010,2004.5,11,38678,38078,4319,4348,-600,29,-629,-0.00142028819874374,6.86472629392805e-05,-0.00148893546168302,EPCI
200071165,CA Les Sables d'Olonne Agglomération,2010_2015,2012.5,5,49540,51234,3416,1845,1694,-1571,3265,0.00674725084035521,-0.00625733829409565,0.0130045891344509,EPCI
200071165,CA Les Sables d'Olonne Agglomération,1968_1975,1971.5,7,31215,34025,2822,3572,2810,750,2060,0.0123899559140106,0.00330692773505621,0.00908302817895439,EPCI
200071165,CA Les Sables d'Olonne Agglomération,1975_1982,1978.5,7,34025,36225,3033,3185,2200,152,2048,0.00899073887386392,0.000621178322194235,0.00836956055166969,EPCI
200071165,CA Les Sables d'Olonne Agglomération,1982_1990,1986,8,36225,39711,3724,3417,3486,-307,3793,0.0115510464063682,-0.00101726082809955,0.0125683072344677,EPCI
200071165,CA Les Sables d'Olonne Agglomération,1990_1999,1994.5,9,39711,43935,4496,3720,4224,-776,5000,0.0112947585821155,-0.00207498405769925,0.0133697426398147,EPCI
200071165,CA Les Sables d'Olonne Agglomération,1999_2010,2004.5,11,43935,49540,6379,4471,5605,-1908,7513,0.0109751678189087,-0.00373606069553575,0.0147112285144445,EPCI
200071173,CC du Pays Arnay Liernais,2010_2015,2012.5,5,7573,7330,499,294,-243,-205,-38,-0.00650152785911839,-0.00548482802929741,-0.00101669982982098,EPCI
200071173,CC du Pays Arnay Liernais,1968_1975,1971.5,7,10603,10014,1076,965,-589,-111,-478,-0.00813145455251896,-0.00153241333672259,-0.00659904121579637,EPCI
200071173,CC du Pays Arnay Liernais,1975_1982,1978.5,7,10014,9171,965,758,-843,-207,-636,-0.0124839610193043,-0.00306545662039856,-0.00941850439890571,EPCI
200071173,CC du Pays Arnay Liernais,1982_1990,1986,8,9171,8151,1011,725,-1020,-286,-734,-0.0146301381811808,-0.00410217599982127,-0.0105279621813595,EPCI
200071173,CC du Pays Arnay Liernais,1990_1999,1994.5,9,8151,7729,1020,663,-422,-357,-65,-0.00588938153165564,-0.00498224930521579,-0.000907132226439848,EPCI
200071173,CC du Pays Arnay Liernais,1999_2010,2004.5,11,7729,7573,1160,765,-156,-395,239,-0.00185193740680067,-0.00468920048516837,0.0028372630783677,EPCI
200071181,CC Somme Sud-Ouest,2010_2015,2012.5,5,38226,38630,1910,2213,404,303,101,0.00210486498785989,0.00157864874089492,0.000526216246964972,EPCI
200071181,CC Somme Sud-Ouest,1968_1975,1971.5,7,34348,34255,2920,4116,-93,1196,-1289,-0.000387246908463923,0.0049800785217511,-0.00536732543021502,EPCI
200071181,CC Somme Sud-Ouest,1975_1982,1978.5,7,34255,35023,2982,3114,768,132,636,0.00317251452983802,0.00054527593481591,0.00262723859502211,EPCI
200071181,CC Somme Sud-Ouest,1982_1990,1986,8,35023,35286,3337,3514,263,177,86,0.000935599423232958,0.000629661969248036,0.000305937453984922,EPCI
200071181,CC Somme Sud-Ouest,1990_1999,1994.5,9,35286,35902,3420,3692,616,272,344,0.00192481892838647,0.000849920046300521,0.00107489888208595,EPCI
200071181,CC Somme Sud-Ouest,1999_2010,2004.5,11,35902,38226,4161,4911,2324,750,1574,0.005718370371953,0.00184542933690394,0.00387294103504906,EPCI
200071199,CC Plaine Limagne,2010_2015,2012.5,5,19500,20894,1106,1239,1394,133,1261,0.0139053059479883,0.00132668987882529,0.012578616069163,EPCI
200071199,CC Plaine Limagne,1968_1975,1971.5,7,15651,15825,1827,1494,174,-333,507,0.00158069874957922,-0.00302513036557403,0.00460582911515326,EPCI
200071199,CC Plaine Limagne,1975_1982,1978.5,7,15825,16357,1790,1250,532,-540,1072,0.0047347410947336,-0.00480594020894012,0.00954068130367371,EPCI
200071199,CC Plaine Limagne,1982_1990,1986,8,16357,16850,1922,1431,493,-491,984,0.0037187369731102,-0.00370365081906108,0.00742238779217128,EPCI
200071199,CC Plaine Limagne,1990_1999,1994.5,9,16850,17016,1931,1539,166,-392,558,0.00108986248001486,-0.00257365115762545,0.00366351363764031,EPCI
200071199,CC Plaine Limagne,1999_2010,2004.5,11,17016,19500,2306,2309,2484,3,2481,0.0124643484489337,1.50535609286639e-05,0.0124492948880051,EPCI
200071207,CC de Pouilly-en-Auxois/Bligny-sur-Ouche,2010_2015,2012.5,5,8628,8604,470,469,-24,-1,-23,-0.000556948270986069,-2.32061779577529e-05,-0.000533742093028316,EPCI
200071207,CC de Pouilly-en-Auxois/Bligny-sur-Ouche,1968_1975,1971.5,7,8201,7535,844,798,-666,-46,-620,-0.0120267034916819,-0.000830673214140191,-0.0111960302775417,EPCI
200071207,CC de Pouilly-en-Auxois/Bligny-sur-Ouche,1975_1982,1978.5,7,7535,7533,859,589,-2,-270,268,-3.79226001916422e-05,-0.00511955102587169,0.00508162842568005,EPCI
200071207,CC de Pouilly-en-Auxois/Bligny-sur-Ouche,1982_1990,1986,8,7533,7360,895,668,-173,-227,54,-0.0028999664629964,-0.00380515830693747,0.000905191843941071,EPCI
200071207,CC de Pouilly-en-Auxois/Bligny-sur-Ouche,1990_1999,1994.5,9,7360,7567,954,692,207,-262,469,0.00308661548144951,-0.00390673070598923,0.00699334618743874,EPCI
200071207,CC de Pouilly-en-Auxois/Bligny-sur-Ouche,1999_2010,2004.5,11,7567,8628,1184,997,1061,-187,1248,0.0120001620392922,-0.00211501442162832,0.0141151764609205,EPCI
200071215,CC Chavanon Combrailles et Volcans,2010_2015,2012.5,5,13184,12826,1016,546,-358,-470,112,-0.00549079267745734,-0.00720858256537695,0.00171778988791961,EPCI
200071215,CC Chavanon Combrailles et Volcans,1968_1975,1971.5,7,19672,17535,1906,1492,-2137,-414,-1723,-0.0162939960499218,-0.0031566281537986,-0.0131373678961232,EPCI
200071215,CC Chavanon Combrailles et Volcans,1975_1982,1978.5,7,17535,16180,1928,1180,-1355,-748,-607,-0.0114232495079815,-0.00630597094610342,-0.00511727856187804,EPCI
200071215,CC Chavanon Combrailles et Volcans,1982_1990,1986,8,16180,14715,2019,1166,-1465,-853,-612,-0.011793471605725,-0.00686677903050061,-0.00492669257522436,EPCI
200071215,CC Chavanon Combrailles et Volcans,1990_1999,1994.5,9,14715,13514,2038,970,-1201,-1068,-133,-0.00941552666417,-0.00837284136330855,-0.00104268530086146,EPCI
200071215,CC Chavanon Combrailles et Volcans,1999_2010,2004.5,11,13514,13184,2357,1203,-330,-1154,824,-0.0022449501365196,-0.00785052259861701,0.00560557246209742,EPCI
200071223,CC Nièvre et Somme,2010_2015,2012.5,5,28403,28340,1241,1682,-63,441,-504,-0.000444009224433772,0.00310806457103641,-0.00355207379547018,EPCI
200071223,CC Nièvre et Somme,1968_1975,1971.5,7,25256,27598,2156,3396,2342,1240,1102,0.0127490933531897,0.00675016044319184,0.00599893290999791,EPCI
200071223,CC Nièvre et Somme,1975_1982,1978.5,7,27598,27932,2011,2659,334,648,-314,0.00172000303330488,0.0033370118729987,-0.00161700883969381,EPCI
200071223,CC Nièvre et Somme,1982_1990,1986,8,27932,27668,2285,2786,-264,501,-765,-0.00118635500451347,0.0022513782472017,-0.00343773325171518,EPCI
200071223,CC Nièvre et Somme,1990_1999,1994.5,9,27668,27587,2308,3017,-81,709,-790,-0.00032570955291833,0.00285096386443328,-0.00317667341735161,EPCI
200071223,CC Nièvre et Somme,1999_2010,2004.5,11,27587,28403,2775,3853,816,1078,-262,0.00265352584980638,0.00350551576726873,-0.000851989917462343,EPCI
200071298,CC des Terres du Lauragais,2010_2015,2012.5,5,35804,38545,1521,2366,2741,845,1896,0.0148627220962554,0.00458190447695578,0.0102808176192996,EPCI
200071298,CC des Terres du Lauragais,1968_1975,1971.5,7,19327,19144,1816,1633,-183,-183,0,-0.00135818132109455,-0.00135818132109455,0,EPCI
200071298,CC des Terres du Lauragais,1975_1982,1978.5,7,19144,20509,1791,1423,1365,-368,1733,0.00988777324831602,-0.0026657146925863,0.0125534879409023,EPCI
200071298,CC des Terres du Lauragais,1982_1990,1986,8,20509,23164,2307,1797,2655,-510,3165,0.0153333090583718,-0.00294538140104318,0.018278690459415,EPCI
200071298,CC des Terres du Lauragais,1990_1999,1994.5,9,23164,26397,2660,2540,3233,-120,3353,0.0146226599477139,-0.000542752611730799,0.0151654125594447,EPCI
200071298,CC des Terres du Lauragais,1999_2010,2004.5,11,26397,35804,3434,4431,9407,997,8410,0.0280974229720004,0.00297790270044481,0.0251195202715555,EPCI
200071314,CC Save Garonne et Côteaux de Cadours,2010_2015,2012.5,5,29646,32591,1019,2225,2945,1206,1739,0.0191223273566172,0.00783073914841439,0.0112915882082028,EPCI
200071314,CC Save Garonne et Côteaux de Cadours,1968_1975,1971.5,7,12231,13393,1265,1125,1162,-140,1302,0.0130499121786409,-0.00157227857573987,0.0146221907543808,EPCI
200071314,CC Save Garonne et Côteaux de Cadours,1975_1982,1978.5,7,13393,15692,1375,1067,2299,-308,2607,0.0228892935921097,-0.00306650823243575,0.0259558018245454,EPCI
200071314,CC Save Garonne et Côteaux de Cadours,1982_1990,1986,8,15692,17829,1650,1470,2137,-180,2317,0.016087446241781,-0.0013550492856905,0.0174424955274715,EPCI
200071314,CC Save Garonne et Côteaux de Cadours,1990_1999,1994.5,9,17829,20696,1821,2034,2867,213,2654,0.0167062476565441,0.00124116873067453,0.0154650789258695,EPCI
200071314,CC Save Garonne et Côteaux de Cadours,1999_2010,2004.5,11,20696,29646,2142,3809,8950,1667,7283,0.0332110984660383,0.00618579901037831,0.02702529945566,EPCI
200071363,CA Vichy Communauté,2010_2015,2012.5,5,82685,83364,5429,4099,679,-1330,2009,0.00163700931857891,-0.00320651309824735,0.00484352241682625,EPCI
200071363,CA Vichy Communauté,1968_1975,1971.5,7,83724,84140,8051,8033,416,-18,434,0.000708308363017718,-3.06479580151897e-05,0.000738956321032908,EPCI
200071363,CA Vichy Communauté,1975_1982,1978.5,7,84140,84652,8214,6730,512,-1484,1996,0.000867040925117024,-0.00251306393139387,0.0033801048565109,EPCI
200071363,CA Vichy Communauté,1982_1990,1986,8,84652,83512,9246,7007,-1140,-2239,1099,-0.00169336474881598,-0.00332582778298157,0.00163246303416558,EPCI
200071363,CA Vichy Communauté,1990_1999,1994.5,9,83512,81737,9837,7139,-1775,-2698,923,-0.00238421527527977,-0.00362400721842524,0.00123979194314548,EPCI
200071363,CA Vichy Communauté,1999_2010,2004.5,11,81737,82685,11738,8799,948,-2939,3887,0.00104886161436668,-0.00325169228335831,0.00430055389772499,EPCI
200071371,CC Bresse et Saône,2010_2015,2012.5,5,23723,25089,972,1401,1366,429,937,0.01125981209197,0.00353620745787346,0.00772360463409657,EPCI
200071371,CC Bresse et Saône,1968_1975,1971.5,7,16082,16185,1406,1653,103,247,-144,0.000912452210357628,0.00218811355299354,-0.00127566134263591,EPCI
200071371,CC Bresse et Saône,1975_1982,1978.5,7,16185,17106,1344,1290,921,-54,975,0.00793767933660461,-0.000465401394328609,0.00840308073093322,EPCI
200071371,CC Bresse et Saône,1982_1990,1986,8,17106,17939,1487,1585,833,98,735,0.00596117683724495,0.000701314922028818,0.00525986191521614,EPCI
200071371,CC Bresse et Saône,1990_1999,1994.5,9,17939,19366,1719,1821,1427,102,1325,0.00854091587255557,0.00061049293552955,0.00793042293702602,EPCI
200071371,CC Bresse et Saône,1999_2010,2004.5,11,19366,23723,2044,2922,4357,878,3479,0.018619038769303,0.00375201194387149,0.0148670268254316,EPCI
200071389,CC Saint-Pourçain Sioule Limagne,2010_2015,2012.5,5,33552,33839,2231,1568,287,-663,950,0.00170495364643353,-0.00393862114141264,0.00564357478784617,EPCI
200071389,CC Saint-Pourçain Sioule Limagne,1968_1975,1971.5,7,35993,34257,3860,2840,-1736,-1020,-716,-0.0070370590839417,-0.00413467757236206,-0.00290238151157964,EPCI
200071389,CC Saint-Pourçain Sioule Limagne,1975_1982,1978.5,7,34257,33168,3762,2212,-1089,-1550,461,-0.00460441953638557,-0.00655358152561767,0.00194916198923209,EPCI
200071389,CC Saint-Pourçain Sioule Limagne,1982_1990,1986,8,33168,32176,4026,2563,-992,-1463,471,-0.00378839618479454,-0.00558712058301856,0.00179872439822402,EPCI
200071389,CC Saint-Pourçain Sioule Limagne,1990_1999,1994.5,9,32176,32336,4080,2736,160,-1344,1504,0.000551299424250473,-0.00463091516370398,0.00518221458795445,EPCI
200071389,CC Saint-Pourçain Sioule Limagne,1999_2010,2004.5,11,32336,33552,4775,3581,1216,-1194,2410,0.0033615750538718,-0.00330075708414715,0.00666233213801895,EPCI
200071405,CC Ardèche Rhône Coiron,2010_2015,2012.5,5,21137,22230,922,1328,1093,406,687,0.0101345438709448,0.00376452407283037,0.00637001979811444,EPCI
200071405,CC Ardèche Rhône Coiron,1968_1975,1971.5,7,16000,14975,1290,1538,-1025,248,-1273,-0.00941349562202809,0.00227760674562241,-0.0116911023676505,EPCI
200071405,CC Ardèche Rhône Coiron,1975_1982,1978.5,7,14975,17260,1230,1232,2285,2,2283,0.0204942587967798,1.79380820978379e-05,0.020476320714682,EPCI
200071405,CC Ardèche Rhône Coiron,1982_1990,1986,8,17260,17539,1447,1815,279,368,-89,0.00200642106444549,0.00264646219253025,-0.00064004112808476,EPCI
200071405,CC Ardèche Rhône Coiron,1990_1999,1994.5,9,17539,18972,1486,2132,1433,646,787,0.00876454513898151,0.00395107896704958,0.00481346617193192,EPCI
200071405,CC Ardèche Rhône Coiron,1999_2010,2004.5,11,18972,21137,1816,2922,2165,1106,1059,0.00987212482499378,0.00504321942560883,0.00482890539938495,EPCI
200071413,CA Privas Centre Ardèche,2010_2015,2012.5,5,42590,43552,2227,2331,962,104,858,0.00447722144676033,0.000484023940190306,0.00399319750657002,EPCI
200071413,CA Privas Centre Ardèche,1968_1975,1971.5,7,39555,39271,3288,3975,-284,687,-971,-0.00102886684979731,0.00248884340074207,-0.00351771025053938,EPCI
200071413,CA Privas Centre Ardèche,1975_1982,1978.5,7,39271,39594,3222,3315,323,93,230,0.00117086473213779,0.00033712204361862,0.000833742688519168,EPCI
200071413,CA Privas Centre Ardèche,1982_1990,1986,8,39594,40193,3494,3774,599,280,319,0.00187866992828201,0.000878176260298768,0.00100049366798324,EPCI
200071413,CA Privas Centre Ardèche,1990_1999,1994.5,9,40193,40149,3717,4007,-44,290,-334,-0.00012169455318578,0.00080207773690628,-0.000923772290092061,EPCI
200071413,CA Privas Centre Ardèche,1999_2010,2004.5,11,40149,42590,4698,5018,2441,320,2121,0.00538005264263619,0.000705291620501262,0.00467476102213493,EPCI
200071454,CA Evreux Portes de Normandie,2010_2015,2012.5,5,109742,111814,4269,7627,2072,3358,-1286,0.00374793001681706,0.0060741066585288,-0.00232617664171175,EPCI
200071454,CA Evreux Portes de Normandie,1968_1975,1971.5,7,67147,79692,4100,10423,12545,6323,6222,0.0247711094317022,0.0124852710192629,0.0122858384124393,EPCI
200071454,CA Evreux Portes de Normandie,1975_1982,1978.5,7,79692,86436,4595,9878,6744,5283,1461,0.0116726066770163,0.00914388805970895,0.00252871861730736,EPCI
200071454,CA Evreux Portes de Normandie,1982_1990,1986,8,86436,99446,5630,12621,13010,6991,6019,0.0176808030328568,0.00950088347445825,0.00817991955839854,EPCI
200071454,CA Evreux Portes de Normandie,1990_1999,1994.5,9,99446,104325,6729,14013,4879,7284,-2405,0.00533599075732494,0.00796625469898644,-0.0026302639416615,EPCI
200071454,CA Evreux Portes de Normandie,1999_2010,2004.5,11,104325,109742,8488,16529,5417,8041,-2624,0.0046125259980756,0.0068468380192959,-0.0022343120212203,EPCI
200071470,CC Entr'Allier Besbre et Loire,2010_2015,2012.5,5,25704,25348,1675,1077,-356,-598,242,-0.00278547142582242,-0.00467896604674664,0.00189349462092423,EPCI
200071470,CC Entr'Allier Besbre et Loire,1968_1975,1971.5,7,34363,32558,3306,3202,-1805,-104,-1701,-0.00767855241025972,-0.000442420748291973,-0.00723613166196775,EPCI
200071470,CC Entr'Allier Besbre et Loire,1975_1982,1978.5,7,32558,30883,3033,2464,-1675,-569,-1106,-0.00751692602779008,-0.00255351099093287,-0.00496341503685721,EPCI
200071470,CC Entr'Allier Besbre et Loire,1982_1990,1986,8,30883,28990,3351,2303,-1893,-1048,-845,-0.00787568893068102,-0.00436012783906694,-0.00351556109161409,EPCI
200071470,CC Entr'Allier Besbre et Loire,1990_1999,1994.5,9,28990,26908,3371,2296,-2082,-1075,-1007,-0.0082466199428467,-0.00425798099834784,-0.00398863894449886,EPCI
200071470,CC Entr'Allier Besbre et Loire,1999_2010,2004.5,11,26908,25704,3675,2842,-1204,-833,-371,-0.00415289988493661,-0.00287322724597359,-0.00127967263896303,EPCI
200071496,CC du Bocage Bourbonnais,2010_2015,2012.5,5,14013,13884,946,630,-129,-316,187,-0.00184796484417171,-0.00452679760277722,0.00267883275860551,EPCI
200071496,CC du Bocage Bourbonnais,1968_1975,1971.5,7,18769,16251,2031,1418,-2518,-613,-1905,-0.0203685753275937,-0.00495867223026805,-0.0154099030973257,EPCI
200071496,CC du Bocage Bourbonnais,1975_1982,1978.5,7,16251,15575,1822,1091,-676,-731,55,-0.00605124284269587,-0.00654357768936491,0.000492334846669043,EPCI
200071496,CC du Bocage Bourbonnais,1982_1990,1986,8,15575,14787,1896,1166,-788,-730,-58,-0.00646881756437001,-0.00599268632232247,-0.000476131242047539,EPCI
200071496,CC du Bocage Bourbonnais,1990_1999,1994.5,9,14787,14156,1938,1173,-631,-765,134,-0.00483381863611831,-0.00586033479656182,0.00102651616044351,EPCI
200071496,CC du Bocage Bourbonnais,1999_2010,2004.5,11,14156,14013,2303,1385,-143,-918,775,-0.000922582549250928,-0.00592259286861784,0.00500001031936692,EPCI
200071504,CC des Collines du Perche Normand,2010_2015,2012.5,5,13313,12834,842,607,-479,-235,-244,-0.00730183156736464,-0.00358231820110791,-0.00371951336625673,EPCI
200071504,CC des Collines du Perche Normand,1968_1975,1971.5,7,13006,12858,1177,1355,-148,178,-326,-0.00163360759777476,0.00196474427299937,-0.00359835187077412,EPCI
200071504,CC des Collines du Perche Normand,1975_1982,1978.5,7,12858,13047,1141,1051,189,-90,279,0.00208675089245336,-0.000993690901168267,0.00308044179362163,EPCI
200071504,CC des Collines du Perche Normand,1982_1990,1986,8,13047,13053,1221,1231,6,10,-4,5.74729168849597e-05,9.57881948082662e-05,-3.83152779233065e-05,EPCI
200071504,CC des Collines du Perche Normand,1990_1999,1994.5,9,13053,13265,1429,1332,212,-97,309,0.0017917137803265,-0.000819793569300332,0.00261150734962683,EPCI
200071504,CC des Collines du Perche Normand,1999_2010,2004.5,11,13265,13313,1696,1711,48,15,33,0.000328418814024678,0.000102630879382712,0.000225787934641966,EPCI
200071512,CC Commentry Montmarault Néris Communauté,2010_2015,2012.5,5,26723,26321,1659,1246,-402,-413,11,-0.0030269132643671,-0.00310973924921297,8.28259848458658e-05,EPCI
200071512,CC Commentry Montmarault Néris Communauté,1968_1975,1971.5,7,31729,30094,3391,2566,-1635,-825,-810,-0.00752940704168659,-0.0037992420852547,-0.00373016495643189,EPCI
200071512,CC Commentry Montmarault Néris Communauté,1975_1982,1978.5,7,30094,29200,3254,2152,-894,-1102,208,-0.00429889135083916,-0.00529908083738787,0.00100018948654871,EPCI
200071512,CC Commentry Montmarault Néris Communauté,1982_1990,1986,8,29200,28281,3492,2220,-919,-1272,353,-0.00398933490086928,-0.00552169096181254,0.00153235606094326,EPCI
200071512,CC Commentry Montmarault Néris Communauté,1990_1999,1994.5,9,28281,27188,3307,2238,-1093,-1069,-24,-0.00436981352555665,-0.00427386153597444,-9.59519895822143e-05,EPCI
200071512,CC Commentry Montmarault Néris Communauté,1999_2010,2004.5,11,27188,26723,3793,2903,-465,-890,425,-0.00156705104304677,-0.0029993019963691,0.00143225095332232,EPCI
200071520,CC Domfront Tinchebray Interco,2010_2015,2012.5,5,16770,16297,1057,830,-473,-227,-246,-0.00570576673649181,-0.00273828551624449,-0.00296748122024733,EPCI
200071520,CC Domfront Tinchebray Interco,1968_1975,1971.5,7,17873,17374,1479,1777,-499,298,-797,-0.00403702327663902,0.0024108876481732,-0.00644791092481222,EPCI
200071520,CC Domfront Tinchebray Interco,1975_1982,1978.5,7,17374,17550,1424,1716,176,292,-116,0.00144091055463602,0.00239060160200976,-0.000949691047373741,EPCI
200071520,CC Domfront Tinchebray Interco,1982_1990,1986,8,17550,17009,1473,1719,-541,246,-787,-0.00390626738318423,0.00177623248847194,-0.00568249987165617,EPCI
200071520,CC Domfront Tinchebray Interco,1990_1999,1994.5,9,17009,16808,1821,1527,-201,-294,93,-0.00131997830451047,-0.00193071453495562,0.000610736230445144,EPCI
200071520,CC Domfront Tinchebray Interco,1999_2010,2004.5,11,16808,16770,2105,2012,-38,-93,55,-0.000205741351215871,-0.000503524885870422,0.000297783534654551,EPCI
200071538,CC Terres de Bresse,2010_2015,2012.5,5,21572,22078,1199,1169,506,-30,536,0.00464785997301265,-0.000275564820534347,0.00492342479354699,EPCI
200071538,CC Terres de Bresse,1968_1975,1971.5,7,17335,16929,1812,1421,-406,-391,-15,-0.00337991112319203,-0.0032550375595273,-0.00012487356366473,EPCI
200071538,CC Terres de Bresse,1975_1982,1978.5,7,16929,17846,1841,1110,917,-731,1648,0.0075643614366312,-0.00603004166867765,0.0135944031053088,EPCI
200071538,CC Terres de Bresse,1982_1990,1986,8,17846,18199,1953,1484,353,-469,822,0.00245140655059806,-0.00325696791000138,0.00570837446059944,EPCI
200071538,CC Terres de Bresse,1990_1999,1994.5,9,18199,18684,2055,1551,485,-504,989,0.00292659582463894,-0.00304124597034645,0.00596784179498539,EPCI
200071538,CC Terres de Bresse,1999_2010,2004.5,11,18684,21572,2428,2369,2888,-59,2947,0.0131519758483374,-0.000268686487206339,0.0134206623355437,EPCI
200071546,CC Sud Retz Atlantique,2010_2015,2012.5,5,27440,29057,1428,1950,1617,522,1095,0.0115173427491395,0.00371802901363688,0.00779931373550264,EPCI
200071546,CC Sud Retz Atlantique,1968_1975,1971.5,7,19542,19244,2034,2333,-298,299,-597,-0.00219283103761603,0.00220018953103085,-0.00439302056864687,EPCI
200071546,CC Sud Retz Atlantique,1975_1982,1978.5,7,19244,20381,1887,2156,1137,269,868,0.00823425515664567,0.00194812193239902,0.00628613322424665,EPCI
200071546,CC Sud Retz Atlantique,1982_1990,1986,8,20381,20898,1981,2307,517,326,191,0.00313620341619147,0.00197756733786929,0.00115863607832219,EPCI
200071546,CC Sud Retz Atlantique,1990_1999,1994.5,9,20898,21618,2256,2066,720,-190,910,0.00377074035173064,-0.000995056481706697,0.00476579683343734,EPCI
200071546,CC Sud Retz Atlantique,1999_2010,2004.5,11,21618,27440,3008,4051,5822,1043,4779,0.021916300909091,0.00392626277021332,0.0179900381388777,EPCI
200071553,CC Loire Layon Aubance,2010_2015,2012.5,5,54210,56034,2194,3602,1824,1408,416,0.00664060289207913,0.00512607942546459,0.00151452346661454,EPCI
200071553,CC Loire Layon Aubance,1968_1975,1971.5,7,33678,34896,2835,3887,1218,1052,166,0.00508824484002846,0.0043947730473809,0.000693471792647556,EPCI
200071553,CC Loire Layon Aubance,1975_1982,1978.5,7,34896,39527,3092,3745,4631,653,3978,0.0179610762552189,0.00253262422687496,0.015428452028344,EPCI
200071553,CC Loire Layon Aubance,1982_1990,1986,8,39527,43167,3184,4474,3640,1290,2350,0.0110723916376048,0.00392400692651378,0.00714838471109099,EPCI
200071553,CC Loire Layon Aubance,1990_1999,1994.5,9,43167,46365,3664,4888,3198,1224,1974,0.00797256294495874,0.00305141245923374,0.004921150485725,EPCI
200071553,CC Loire Layon Aubance,1999_2010,2004.5,11,46365,54210,4598,7832,7845,3234,4611,0.0143124128600902,0.00590010748113853,0.00841230537895169,EPCI
200071579,CC Bresse Louhannaise Intercom',2010_2015,2012.5,5,28221,28539,1750,1278,318,-472,790,0.00224355125000786,-0.00333005091196135,0.00557360216196921,EPCI
200071579,CC Bresse Louhannaise Intercom',1968_1975,1971.5,7,27012,26245,2444,2490,-767,46,-813,-0.00410664699805685,0.000246291736519707,-0.00435293873457656,EPCI
200071579,CC Bresse Louhannaise Intercom',1975_1982,1978.5,7,26245,25962,2464,1856,-283,-608,325,-0.00154759612664757,-0.00332487083039477,0.0017772747037472,EPCI
200071579,CC Bresse Louhannaise Intercom',1982_1990,1986,8,25962,25427,2757,1980,-535,-777,242,-0.00259940678812964,-0.00377521322313408,0.00117580643500444,EPCI
200071579,CC Bresse Louhannaise Intercom',1990_1999,1994.5,9,25427,25113,3076,2113,-314,-963,649,-0.00137970968292545,-0.00423140262629683,0.00285169294337138,EPCI
200071579,CC Bresse Louhannaise Intercom',1999_2010,2004.5,11,25113,28221,3733,2934,3108,-799,3907,0.0106637973953978,-0.00274143311419654,0.0134052305095943,EPCI
200071587,CC Loches Sud Touraine,2010_2015,2012.5,5,52490,52301,3163,2467,-189,-696,507,-0.000721176610500418,-0.00265576148628725,0.00193458487578684,EPCI
200071587,CC Loches Sud Touraine,1968_1975,1971.5,7,55336,51932,4644,5249,-3404,605,-4009,-0.00902878221932435,0.00160470424285876,-0.0106334864621831,EPCI
200071587,CC Loches Sud Touraine,1975_1982,1978.5,7,51932,50754,4689,3769,-1178,-920,-258,-0.00327245352058403,-0.00255573619604186,-0.000716717324542173,EPCI
200071587,CC Loches Sud Touraine,1982_1990,1986,8,50754,50319,5140,4374,-435,-766,331,-0.00107538300696841,-0.00189366295020185,0.000818279943233435,EPCI
200071587,CC Loches Sud Touraine,1990_1999,1994.5,9,50319,50315,5901,4662,-4,-1239,1235,-8.83284937136519e-06,-0.00273597509278037,0.002727142243409,EPCI
200071587,CC Loches Sud Touraine,1999_2010,2004.5,11,50315,52490,6807,5700,2175,-1107,3282,0.00385463113457862,-0.00196187432918553,0.00581650546376416,EPCI
200071595,"CC Arbois, Poligny, Salins, Coeur du Jura",2010_2015,2012.5,5,22571,22191,1379,998,-380,-381,1,-0.00339005976268947,-0.00339898097259128,8.92120990181452e-06,EPCI
200071595,"CC Arbois, Poligny, Salins, Coeur du Jura",1968_1975,1971.5,7,23173,22652,2112,2418,-521,306,-827,-0.00324325205647613,0.00190486589113569,-0.00514811794761183,EPCI
200071595,"CC Arbois, Poligny, Salins, Coeur du Jura",1975_1982,1978.5,7,22652,23003,2203,2230,351,27,324,0.00219905637902174,0.000169158183001672,0.00202989819602006,EPCI
200071595,"CC Arbois, Poligny, Salins, Coeur du Jura",1982_1990,1986,8,23003,23063,2280,2323,60,43,17,0.000325672967011359,0.000233398959691474,9.2274007319885e-05,EPCI
200071595,"CC Arbois, Poligny, Salins, Coeur du Jura",1990_1999,1994.5,9,23063,22405,2393,2203,-658,-190,-468,-0.0032109951975674,-0.000927187063127365,-0.00228380813444004,EPCI
200071595,"CC Arbois, Poligny, Salins, Coeur du Jura",1999_2010,2004.5,11,22405,22571,2890,2515,166,-375,541,0.000671293235747328,-0.00151647568316414,0.00218776891891147,EPCI
200071629,CC Challans-Gois Communauté,2010_2015,2012.5,5,42558,45769,2106,2346,3211,240,2971,0.0146541656343133,0.00109529733797421,0.0135588682963391,EPCI
200071629,CC Challans-Gois Communauté,1968_1975,1971.5,7,23872,27688,1939,3436,3816,1497,2319,0.0214106861895653,0.00839931793128388,0.0130113682582814,EPCI
200071629,CC Challans-Gois Communauté,1975_1982,1978.5,7,27688,29762,1933,3146,2074,1213,861,0.0103724686055635,0.00606644378907837,0.00430602481648514,EPCI
200071629,CC Challans-Gois Communauté,1982_1990,1986,8,29762,31603,2409,3084,1841,675,1166,0.00753066902848953,0.00276110895938644,0.00476956006910309,EPCI
200071629,CC Challans-Gois Communauté,1990_1999,1994.5,9,31603,34351,3029,3331,2748,302,2446,0.00930738879458537,0.00102286441628995,0.00828452437829542,EPCI
200071629,CC Challans-Gois Communauté,1999_2010,2004.5,11,34351,42558,4027,4996,8207,969,7238,0.0196669614073528,0.00232207695914766,0.0173448844482051,EPCI
200071645,CC Saint Cyr Mère Boitier entre Charolais et Mâconnais,2010_2015,2012.5,5,7862,7867,407,422,5,15,-10,0.000127161753857852,0.000381485261573555,-0.000254323507715704,EPCI
200071645,CC Saint Cyr Mère Boitier entre Charolais et Mâconnais,1968_1975,1971.5,7,8064,7563,813,704,-501,-109,-392,-0.009121257271404,-0.00198446515485636,-0.00713679211654764,EPCI
200071645,CC Saint Cyr Mère Boitier entre Charolais et Mâconnais,1975_1982,1978.5,7,7563,7398,735,596,-165,-139,-26,-0.00314621788846081,-0.0026504502211882,-0.000495767667272613,EPCI
200071645,CC Saint Cyr Mère Boitier entre Charolais et Mâconnais,1982_1990,1986,8,7398,6952,783,616,-446,-167,-279,-0.00774241011372612,-0.00289906387666426,-0.00484334623706185,EPCI
200071645,CC Saint Cyr Mère Boitier entre Charolais et Mâconnais,1990_1999,1994.5,9,6952,7142,830,671,190,-159,349,0.0030004324481101,-0.00251088820657635,0.00551132065468645,EPCI
200071645,CC Saint Cyr Mère Boitier entre Charolais et Mâconnais,1999_2010,2004.5,11,7142,7862,961,948,720,-13,733,0.00876988460309236,-0.000158345138666945,0.00892822974175931,EPCI
200071652,CC du Pays Fertois et du Bocage Carrougien,2010_2015,2012.5,5,5097,5018,264,250,-79,-14,-65,-0.00311926164581067,-0.000552780544827207,-0.00256648110098346,EPCI
200071652,CC du Pays Fertois et du Bocage Carrougien,1968_1975,1971.5,7,5275,4789,474,430,-486,-44,-442,-0.0137132559021678,-0.001241529340937,-0.0124717265612308,EPCI
200071652,CC du Pays Fertois et du Bocage Carrougien,1975_1982,1978.5,7,4789,4572,477,319,-217,-158,-59,-0.00660251773585885,-0.00480736314408156,-0.00179515459177729,EPCI
200071652,CC du Pays Fertois et du Bocage Carrougien,1982_1990,1986,8,4572,4527,525,431,-45,-94,49,-0.00123564564530954,-0.00258112645909103,0.00134548081378149,EPCI
200071652,CC du Pays Fertois et du Bocage Carrougien,1990_1999,1994.5,9,4527,4697,488,450,170,-38,208,0.00410446016205568,-0.000917467565635975,0.00502192772769165,EPCI
200071652,CC du Pays Fertois et du Bocage Carrougien,1999_2010,2004.5,11,4697,5097,646,559,400,-87,487,0.00745749915059846,-0.00162200606525516,0.00907950521585362,EPCI
200071678,CA du Choletais,2010_2015,2012.5,5,101904,103248,3893,6131,1344,2238,-894,0.00262397011209314,0.00436937880272653,-0.00174540869063339,EPCI
200071678,CA du Choletais,1968_1975,1971.5,7,74842,87893,4303,12344,13051,8041,5010,0.0232286707385241,0.0143116804389297,0.00891699029959433,EPCI
200071678,CA du Choletais,1975_1982,1978.5,7,87893,96585,4625,12797,8692,8172,520,0.0135630526242514,0.0127516412845585,0.000811411339692904,EPCI
200071678,CA du Choletais,1982_1990,1986,8,96585,99243,5190,12271,2658,7081,-4423,0.0033992567204848,0.00905573244460228,-0.00565647572411748,EPCI
200071678,CA du Choletais,1990_1999,1994.5,9,99243,98688,6013,11386,-555,5373,-5928,-0.000622920305865971,0.00603054198814029,-0.00665346229400626,EPCI
200071678,CA du Choletais,1999_2010,2004.5,11,98688,101904,7986,14344,3216,6358,-3142,0.00291951123511103,0.00577184466195147,-0.00285233342684044,EPCI
200071751,CA du Bassin de Bourg-en-Bresse,2010_2015,2012.5,5,125006,130712,5477,7552,5706,2075,3631,0.00896690266310563,0.0032608347399131,0.00570606792319252,EPCI
200071751,CA du Bassin de Bourg-en-Bresse,1968_1975,1971.5,7,87147,93701,6626,10507,6554,3881,2673,0.0104127699779948,0.00616599943310921,0.00424677054488557,EPCI
200071751,CA du Bassin de Bourg-en-Bresse,1975_1982,1978.5,7,93701,100418,6434,9751,6717,3317,3400,0.00993944460169649,0.00490831289918524,0.00503113170251125,EPCI
200071751,CA du Bassin de Bourg-en-Bresse,1982_1990,1986,8,100418,105910,7362,10979,5492,3617,1875,0.00667822591507217,0.00439824164872834,0.00227998426634383,EPCI
200071751,CA du Bassin de Bourg-en-Bresse,1990_1999,1994.5,9,105910,111693,8414,11723,5783,3309,2474,0.00592463266591747,0.00339004141302454,0.00253459125289293,EPCI
200071751,CA du Bassin de Bourg-en-Bresse,1999_2010,2004.5,11,111693,125006,10918,15544,13313,4626,8687,0.0102896416246643,0.00357544371334012,0.00671419791132417,EPCI
200071769,CC Picardie des Châteaux,2010_2015,2012.5,5,17654,17655,812,1061,1,249,-248,1.13286206300245e-05,0.0028208265368761,-0.00280949791624607,EPCI
200071769,CC Picardie des Châteaux,1968_1975,1971.5,7,17299,17462,1299,1854,163,555,-392,0.00134066861141591,0.00456485324745907,-0.00322418463604316,EPCI
200071769,CC Picardie des Châteaux,1975_1982,1978.5,7,17462,17377,1339,1535,-85,196,-281,-0.000696842613547855,0.00160683708535741,-0.00230367969890526,EPCI
200071769,CC Picardie des Châteaux,1982_1990,1986,8,17377,17217,1452,1761,-160,309,-469,-0.00115560988625829,0.00223177159283632,-0.00338738147909462,EPCI
200071769,CC Picardie des Châteaux,1990_1999,1994.5,9,17217,16803,1518,1884,-414,366,-780,-0.00270077143670466,0.00238763851650702,-0.00508840995321168,EPCI
200071769,CC Picardie des Châteaux,1999_2010,2004.5,11,16803,17654,1756,2329,851,573,278,0.00450145987751704,0.0030309477201143,0.00147051215740275,EPCI
200071777,"CC d'Arcis, Mailly, Ramerupt",2010_2015,2012.5,5,11737,11536,582,710,-201,128,-329,-0.00344877219153317,0.00219623303739426,-0.00564500522892742,EPCI
200071777,"CC d'Arcis, Mailly, Ramerupt",1968_1975,1971.5,7,11070,11055,874,1401,-15,527,-542,-0.000193685870631732,0.00680483025486153,-0.00699851612549326,EPCI
200071777,"CC d'Arcis, Mailly, Ramerupt",1975_1982,1978.5,7,11055,10957,840,1039,-98,199,-297,-0.00127123313859401,0.00258138157734906,-0.00385261471594307,EPCI
200071777,"CC d'Arcis, Mailly, Ramerupt",1982_1990,1986,8,10957,10379,929,1094,-578,165,-743,-0.00675135493369772,0.00192728990321821,-0.00867864483691593,EPCI
200071777,"CC d'Arcis, Mailly, Ramerupt",1990_1999,1994.5,9,10379,10334,927,1111,-45,184,-229,-0.000482672822438524,0.00197359554063752,-0.00245626836307604,EPCI
200071777,"CC d'Arcis, Mailly, Ramerupt",1999_2010,2004.5,11,10334,11737,1118,1694,1403,576,827,0.0116405771292172,0.00477902525048403,0.00686155187873315,EPCI
200071785,CA Chauny Tergnier la Fère,2010_2015,2012.5,5,56502,55853,3123,3393,-649,270,-919,-0.00230789198752734,0.000960139963994427,-0.00326803195152177,EPCI
200071785,CA Chauny Tergnier la Fère,1968_1975,1971.5,7,60378,58652,4463,7040,-1726,2577,-4303,-0.00413473194073899,0.00617335122322386,-0.0103080831639628,EPCI
200071785,CA Chauny Tergnier la Fère,1975_1982,1978.5,7,58652,58220,4498,6299,-432,1801,-2233,-0.00105554777387917,0.00440055912212127,-0.00545610689600045,EPCI
200071785,CA Chauny Tergnier la Fère,1982_1990,1986,8,58220,57363,5005,6847,-857,1842,-2699,-0.00185196326314085,0.00398053247456879,-0.00583249573770965,EPCI
200071785,CA Chauny Tergnier la Fère,1990_1999,1994.5,9,57363,56702,5259,6489,-661,1230,-1891,-0.00128695035694837,0.00239477903032752,-0.00368172938727589,EPCI
200071785,CA Chauny Tergnier la Fère,1999_2010,2004.5,11,56702,56502,6856,7995,-200,1139,-1339,-0.00032117093395545,0.00182906846887629,-0.00215023940283174,EPCI
200071819,CC du Périgord Nontronnais,2010_2015,2012.5,5,16086,15452,1126,484,-634,-642,8,-0.00800992494834796,-0.008110996556529,0.000101071608181047,EPCI
200071819,CC du Périgord Nontronnais,1968_1975,1971.5,7,19355,18458,1870,1437,-897,-433,-464,-0.00675606067583767,-0.0032612868145348,-0.00349477386130288,EPCI
200071819,CC du Périgord Nontronnais,1975_1982,1978.5,7,18458,17670,1969,1071,-788,-898,110,-0.00621341561520739,-0.00708077058687339,0.000867354971666005,EPCI
200071819,CC du Périgord Nontronnais,1982_1990,1986,8,17670,17092,2212,1161,-578,-1051,473,-0.0041485917873062,-0.00754354665823325,0.00339495487092705,EPCI
200071819,CC du Périgord Nontronnais,1990_1999,1994.5,9,17092,16327,2275,1081,-765,-1194,429,-0.00507489439392705,-0.00792081556385478,0.00284592116992772,EPCI
200071819,CC du Périgord Nontronnais,1999_2010,2004.5,11,16327,16086,2578,1212,-241,-1366,1125,-0.00135098211565265,-0.00765743390033828,0.00630645178468563,EPCI
200071827,CA du Grand Angoulême,2010_2015,2012.5,5,139070,141345,6409,7655,2275,1246,1029,0.00325053292892208,0.00178029188107117,0.00147024104785091,EPCI
200071827,CA du Grand Angoulême,1968_1975,1971.5,7,112529,122133,8184,13614,9604,5430,4174,0.0117686619370461,0.00665387695940859,0.00511478497763747,EPCI
200071827,CA du Grand Angoulême,1975_1982,1978.5,7,122133,128967,8014,12802,6834,4788,2046,0.0078083189858329,0.00547062208138249,0.00233769690445041,EPCI
200071827,CA du Grand Angoulême,1982_1990,1986,8,128967,131788,9505,13899,2821,4394,-1573,0.00270841279084921,0.00421863374795868,-0.00151022095710947,EPCI
200071827,CA du Grand Angoulême,1990_1999,1994.5,9,131788,133639,10493,13702,1851,3209,-1358,0.00155093076086943,0.00268878271833063,-0.0011378519574612,EPCI
200071827,CA du Grand Angoulême,1999_2010,2004.5,11,133639,139070,13207,16726,5431,3519,1912,0.00362795322288823,0.00235072130203345,0.00127723192085478,EPCI
200071843,CC du Vexin Normand,2010_2015,2012.5,5,32476,33395,1415,1959,919,544,375,0.00559656924214447,0.0033128766787014,0.00228369256344306,EPCI
200071843,CC du Vexin Normand,1968_1975,1971.5,7,21131,22032,1800,2580,901,780,121,0.00598279519863998,0.00517933435620331,0.000803460842436667,EPCI
200071843,CC du Vexin Normand,1975_1982,1978.5,7,22032,23306,1735,2266,1274,531,743,0.00806303201202607,0.00336065149009878,0.00470238052192729,EPCI
200071843,CC du Vexin Normand,1982_1990,1986,8,23306,26500,2101,2851,3194,750,2444,0.0161837985249744,0.00380020316021629,0.0123835953647581,EPCI
200071843,CC du Vexin Normand,1990_1999,1994.5,9,26500,29435,2377,3351,2935,974,1961,0.0117394516083396,0.00389581801244386,0.0078436335958957,EPCI
200071843,CC du Vexin Normand,1999_2010,2004.5,11,29435,32476,3157,4285,3041,1128,1913,0.0089779634452507,0.00333020150155962,0.00564776194369109,EPCI
200071850,CC du Pithiverais-Gâtinais,2010_2015,2012.5,5,25475,25982,1420,1498,507,78,429,0.00394905935985568,0.000607547593823951,0.00334151176603173,EPCI
200071850,CC du Pithiverais-Gâtinais,1968_1975,1971.5,7,16997,17706,1869,1485,709,-384,1093,0.00585517596604213,-0.00317120955001435,0.00902638551605648,EPCI
200071850,CC du Pithiverais-Gâtinais,1975_1982,1978.5,7,17706,19174,1860,1396,1468,-464,1932,0.0114437890514028,-0.00361711043586572,0.0150608994872685,EPCI
200071850,CC du Pithiverais-Gâtinais,1982_1990,1986,8,19174,21446,2092,2023,2272,-69,2341,0.0140962980418868,-0.000428100600743922,0.0145243986426308,EPCI
200071850,CC du Pithiverais-Gâtinais,1990_1999,1994.5,9,21446,23140,2379,2335,1694,-44,1738,0.00848295293725676,-0.000220336439928747,0.00870328937718551,EPCI
200071850,CC du Pithiverais-Gâtinais,1999_2010,2004.5,11,23140,25475,3014,3090,2335,76,2259,0.00877783369670215,0.000285702510042554,0.0084921311866596,EPCI
200071868,CC des Vallées du Haut-Anjou,2010_2015,2012.5,5,33539,35792,1278,2745,2253,1467,786,0.0130880006220409,0.00852201372060982,0.00456598690143103,EPCI
200071868,CC des Vallées du Haut-Anjou,1968_1975,1971.5,7,22020,21689,1785,2656,-331,871,-1202,-0.00216136255832511,0.00568745253263193,-0.00784881509095704,EPCI
200071868,CC des Vallées du Haut-Anjou,1975_1982,1978.5,7,21689,24279,1770,2509,2590,739,1851,0.0162457733440329,0.00463537702750591,0.011610396316527,EPCI
200071868,CC des Vallées du Haut-Anjou,1982_1990,1986,8,24279,25516,2013,3024,1237,1011,226,0.006231073771791,0.00509265608996014,0.00113841768183085,EPCI
200071868,CC des Vallées du Haut-Anjou,1990_1999,1994.5,9,25516,26830,2155,3034,1314,879,435,0.0055950338469104,0.00374279661448573,0.00185223723242468,EPCI
200071868,CC des Vallées du Haut-Anjou,1999_2010,2004.5,11,26830,33539,2852,5273,6709,2421,4288,0.0204970814132837,0.00739654704152031,0.0131005343717634,EPCI
200071876,CA Saumur Val de Loire,2010_2015,2012.5,5,99666,100424,4817,5760,758,943,-185,0.00151647404138688,0.00188658973750374,-0.000370115696116852,EPCI
200071876,CA Saumur Val de Loire,1968_1975,1971.5,7,90303,92204,6850,12408,1901,5558,-3657,0.00298055176757406,0.0087143117959898,-0.00573376002841575,EPCI
200071876,CA Saumur Val de Loire,1975_1982,1978.5,7,92204,95207,6733,10261,3003,3528,-525,0.00458906263488346,0.00539134631231063,-0.000802283677427177,EPCI
200071876,CA Saumur Val de Loire,1982_1990,1986,8,95207,95852,7554,11012,645,3458,-2813,0.000844339592203536,0.00452670745711601,-0.00368236786491247,EPCI
200071876,CA Saumur Val de Loire,1990_1999,1994.5,9,95852,96268,8396,11112,416,2716,-2300,0.00048129728192392,0.0031423159079456,-0.00266101862602168,EPCI
200071876,CA Saumur Val de Loire,1999_2010,2004.5,11,96268,99666,10522,13927,3398,3405,-7,0.0031584890999603,0.00316499569904792,-6.50659908761706e-06,EPCI
200071884,CC Le Grand Charolais,2010_2015,2012.5,5,40533,40327,2382,1912,-206,-470,264,-0.00101852841553141,-0.00232382696747457,0.00130529855194316,EPCI
200071884,CC Le Grand Charolais,1968_1975,1971.5,7,45366,46375,3643,5465,1009,1822,-813,0.00314745646121217,0.00568351404591534,-0.00253605758470317,EPCI
200071884,CC Le Grand Charolais,1975_1982,1978.5,7,46375,44870,3687,4413,-1505,726,-2231,-0.00470192559493399,0.00226817141655952,-0.00697009701149351,EPCI
200071884,CC Le Grand Charolais,1982_1990,1986,8,44870,42869,3933,3985,-2001,52,-2053,-0.00568632952596604,0.00014777068233395,-0.00583410020829999,EPCI
200071884,CC Le Grand Charolais,1990_1999,1994.5,9,42869,40540,4203,3738,-2329,-465,-1864,-0.00618742444737219,-0.00123535953972867,-0.00495206490764352,EPCI
200071884,CC Le Grand Charolais,1999_2010,2004.5,11,40540,40533,4966,4401,-7,-565,558,-1.56984111352454e-05,-0.00126708604163052,0.00125138763049528,EPCI
200071892,CA du Saint-Quentinois,2010_2015,2012.5,5,83008,82743,4244,5459,-265,1215,-1480,-0.000639309586473513,0.00293117414175592,-0.00357048372822943,EPCI
200071892,CA du Saint-Quentinois,1968_1975,1971.5,7,86480,91400,6362,11776,4920,5414,-494,0.00793593896793676,0.00873275885618082,-0.000796819888244057,EPCI
200071892,CA du Saint-Quentinois,1975_1982,1978.5,7,91400,89121,6163,10767,-2279,4604,-6883,-0.00360071347330948,0.0072741047964532,-0.0108748182697627,EPCI
200071892,CA du Saint-Quentinois,1982_1990,1986,8,89121,87569,6804,10929,-1552,4125,-5677,-0.00219358343529286,0.00583023947846845,-0.0080238229137613,EPCI
200071892,CA du Saint-Quentinois,1990_1999,1994.5,9,87569,85389,7584,11138,-2180,3554,-5734,-0.00279716586057632,0.00456015021490287,-0.00735731607547919,EPCI
200071892,CA du Saint-Quentinois,1999_2010,2004.5,11,85389,83008,9408,12863,-2381,3455,-5836,-0.00256763417242933,0.00372581943122358,-0.00629345360365292,EPCI
200071900,CC Vendée Grand Littoral,2010_2015,2012.5,5,30519,33213,1868,1560,2694,-308,3002,0.0170623114106416,-0.00195070226966504,0.0190130136803067,EPCI
200071900,CC Vendée Grand Littoral,1968_1975,1971.5,7,17602,17519,1547,1641,-83,94,-177,-0.000674990048502022,0.000764446560954097,-0.00143943660945612,EPCI
200071900,CC Vendée Grand Littoral,1975_1982,1978.5,7,17519,19077,1709,1543,1558,-166,1724,0.0122454279935857,-0.00130471184013815,0.0135501398337239,EPCI
200071900,CC Vendée Grand Littoral,1982_1990,1986,8,19077,20717,2096,1691,1640,-405,2045,0.010362219561445,-0.00255896275755197,0.012921182318997,EPCI
200071900,CC Vendée Grand Littoral,1990_1999,1994.5,9,20717,23026,2512,1850,2309,-662,2971,0.0118102402667406,-0.00338604549873637,0.015196285765477,EPCI
200071900,CC Vendée Grand Littoral,1999_2010,2004.5,11,23026,30519,3586,3186,7493,-400,7893,0.0259421924974583,-0.00138487615093865,0.027327068648397,EPCI
200071918,CC du Pays de Saint-Fulgent - les Essarts,2010_2015,2012.5,5,25322,27421,1039,2037,2099,998,1101,0.016054624538151,0.00763340413962586,0.00842122039852512,EPCI
200071918,CC du Pays de Saint-Fulgent - les Essarts,1968_1975,1971.5,7,17290,17782,1309,2058,492,749,-257,0.00401638844253327,0.00611437996637687,-0.0020979915238436,EPCI
200071918,CC du Pays de Saint-Fulgent - les Essarts,1975_1982,1978.5,7,17782,18799,1259,2115,1017,856,161,0.00797692853920196,0.00671411094351708,0.00126281759568487,EPCI
200071918,CC du Pays de Saint-Fulgent - les Essarts,1982_1990,1986,8,18799,19740,1441,2304,941,863,78,0.00612409569769934,0.00561646608620035,0.000507629611498989,EPCI
200071918,CC du Pays de Saint-Fulgent - les Essarts,1990_1999,1994.5,9,19740,20580,1577,2232,840,655,185,0.00464103600177923,0.00361890307281595,0.00102213292896328,EPCI
200071918,CC du Pays de Saint-Fulgent - les Essarts,1999_2010,2004.5,11,20580,25322,1960,3794,4742,1834,2908,0.019029139744871,0.00735964620246591,0.0116694935424051,EPCI
200071926,CC du Limouxin,2010_2015,2012.5,5,28029,28602,1708,1171,573,-537,1110,0.0040555931444104,-0.00380079148088723,0.00785638462529763,EPCI
200071926,CC du Limouxin,1968_1975,1971.5,7,25780,25204,2173,2093,-576,-80,-496,-0.0032228362539074,-0.000447616146376028,-0.00277522010753137,EPCI
200071926,CC du Limouxin,1975_1982,1978.5,7,25204,24858,2286,1715,-346,-571,225,-0.00197277719153122,-0.00325565253284487,0.00128287534131365,EPCI
200071926,CC du Limouxin,1982_1990,1986,8,24858,25412,2599,1962,554,-637,1191,0.00275903303037839,-0.00317238996453255,0.00593142299491094,EPCI
200071926,CC du Limouxin,1990_1999,1994.5,9,25412,25316,2886,1894,-96,-992,896,-0.000420455638324713,-0.0043447082626887,0.00392425262436398,EPCI
200071926,CC du Limouxin,1999_2010,2004.5,11,25316,28029,3525,2468,2713,-1057,3770,0.00929778391696168,-0.00362246870631349,0.0129202526232752,EPCI
200071934,CC Pays de Fontenay-Vendée,2010_2015,2012.5,5,35801,35344,1969,1761,-457,-208,-249,-0.00256613768503566,-0.00116795763345168,-0.00139818005158398,EPCI
200071934,CC Pays de Fontenay-Vendée,1968_1975,1971.5,7,30799,32560,2540,3885,1761,1345,416,0.00797481927502108,0.00609093238211434,0.00188388689290674,EPCI
200071934,CC Pays de Fontenay-Vendée,1975_1982,1978.5,7,32560,33958,2843,3526,1398,683,715,0.00602377407530597,0.00294294541733475,0.00308082865797122,EPCI
200071934,CC Pays de Fontenay-Vendée,1982_1990,1986,8,33958,33792,3111,3395,-166,284,-450,-0.000612359782424465,0.00104765167595511,-0.00166001145837957,EPCI
200071934,CC Pays de Fontenay-Vendée,1990_1999,1994.5,9,33792,33470,3291,3228,-322,-63,-259,-0.00106327575027354,-0.00020803221201004,-0.0008552435382635,EPCI
200071934,CC Pays de Fontenay-Vendée,1999_2010,2004.5,11,33470,35801,4074,4191,2331,117,2214,0.00613934268894334,0.000308152335738469,0.00583119035320487,EPCI
200071942,CC Haut Limousin en Marche,2010_2015,2012.5,5,24651,23771,1903,847,-880,-1056,176,-0.00724385931400218,-0.00869263117680261,0.00144877186280044,EPCI
200071942,CC Haut Limousin en Marche,1968_1975,1971.5,7,34336,32129,3436,2684,-2207,-752,-1455,-0.00944586450636076,-0.00321852746206764,-0.00622733704429311,EPCI
200071942,CC Haut Limousin en Marche,1975_1982,1978.5,7,32129,29623,3410,1895,-2506,-1515,-991,-0.0115341037708965,-0.00697293184872632,-0.00456117192217015,EPCI
200071942,CC Haut Limousin en Marche,1982_1990,1986,8,29623,27615,3689,1999,-2008,-1690,-318,-0.0087356187180162,-0.00735218906048177,-0.00138342965753444,EPCI
200071942,CC Haut Limousin en Marche,1990_1999,1994.5,9,27615,25370,3827,1877,-2245,-1950,-295,-0.0093770618730108,-0.00814488670484234,-0.00123217516816846,EPCI
200071942,CC Haut Limousin en Marche,1999_2010,2004.5,11,25370,24651,4504,2174,-719,-2330,1611,-0.00261021526614846,-0.00845869481241435,0.00584847954626589,EPCI
200071967,CC Pays d'Évian Vallée d'Abondance,2010_2015,2012.5,5,36541,39469,1418,2232,2928,814,2114,0.015535568636349,0.0043189729747227,0.0112165956616263,EPCI
200071967,CC Pays d'Évian Vallée d'Abondance,1968_1975,1971.5,7,20834,21894,1732,2310,1060,578,482,0.00711466972921682,0.00387950858819558,0.00323516114102123,EPCI
200071967,CC Pays d'Évian Vallée d'Abondance,1975_1982,1978.5,7,21894,23913,1741,2022,2019,281,1738,0.0126811057894933,0.00176492854227223,0.0109161772472211,EPCI
200071967,CC Pays d'Évian Vallée d'Abondance,1982_1990,1986,8,23913,28686,1944,2819,4773,875,3898,0.0230090867102633,0.00421809152974656,0.0187909951805167,EPCI
200071967,CC Pays d'Évian Vallée d'Abondance,1990_1999,1994.5,9,28686,30883,2213,3833,2197,1620,577,0.00823333924138514,0.00607101027357484,0.0021623289678103,EPCI
200071967,CC Pays d'Évian Vallée d'Abondance,1999_2010,2004.5,11,30883,36541,2783,4453,5658,1670,3988,0.0154110945337407,0.00454869704336284,0.0108623974903778,EPCI
200071983,CC Thiérache Sambre et Oise,2010_2015,2012.5,5,17589,17166,1156,1096,-423,-60,-363,-0.00485677222539938,-0.000688903861758777,-0.0041678683636406,EPCI
200071983,CC Thiérache Sambre et Oise,1968_1975,1971.5,7,21641,20006,2052,2314,-1635,262,-1897,-0.0111597534837299,0.00178829077231635,-0.0129480442560462,EPCI
200071983,CC Thiérache Sambre et Oise,1975_1982,1978.5,7,20006,19095,2051,1924,-911,-127,-784,-0.00663584317288257,-0.000925084613563213,-0.00571075855931936,EPCI
200071983,CC Thiérache Sambre et Oise,1982_1990,1986,8,19095,18457,1986,2193,-638,207,-845,-0.00423884293081389,0.00137529856846156,-0.00561414149927545,EPCI
200071983,CC Thiérache Sambre et Oise,1990_1999,1994.5,9,18457,18242,1883,2157,-215,274,-489,-0.00130105007365844,0.00165808241945308,-0.00295913249311152,EPCI
200071983,CC Thiérache Sambre et Oise,1999_2010,2004.5,11,18242,17589,2361,2575,-653,214,-867,-0.00330841700641849,0.00108422854421678,-0.00439264555063526,EPCI
200071991,CC Retz-en-Valois,2010_2015,2012.5,5,29669,29936,1253,1729,267,476,-209,0.00179341422216694,0.00319724782678452,-0.00140383360461757,EPCI
200071991,CC Retz-en-Valois,1968_1975,1971.5,7,23116,24144,2015,2773,1028,758,270,0.00623519893546098,0.00459754940961034,0.00163764952585065,EPCI
200071991,CC Retz-en-Valois,1975_1982,1978.5,7,24144,24357,2074,2368,213,294,-81,0.00125555619767392,0.00173302123059218,-0.000477465032918253,EPCI
200071991,CC Retz-en-Valois,1982_1990,1986,8,24357,26584,2036,3062,2227,1026,1201,0.0109963007826888,0.00506609995646101,0.00593020082622775,EPCI
200071991,CC Retz-en-Valois,1990_1999,1994.5,9,26584,28254,2189,3307,1670,1118,552,0.0067924659117744,0.00454729155051724,0.00224517436125717,EPCI
200071991,CC Retz-en-Valois,1999_2010,2004.5,11,28254,29669,2742,4120,1415,1378,37,0.0044523998056627,0.0043359766305323,0.000116423175130402,EPCI
200072007,CC de la Montagne d'Ardèche,2010_2015,2012.5,5,5262,5005,386,131,-257,-255,-2,-0.00996477330880285,-0.00988722643480439,-7.75468739984651e-05,EPCI
200072007,CC de la Montagne d'Ardèche,1968_1975,1971.5,7,8895,7360,898,561,-1535,-337,-1198,-0.0266984637878391,-0.00586148683811191,-0.0208369769497272,EPCI
200072007,CC de la Montagne d'Ardèche,1975_1982,1978.5,7,7360,6362,825,341,-998,-484,-514,-0.0206015616403571,-0.00999113811015314,-0.010610423530204,EPCI
200072007,CC de la Montagne d'Ardèche,1982_1990,1986,8,6362,5753,832,358,-609,-474,-135,-0.012498898664202,-0.00972820684208822,-0.00277069182211373,EPCI
200072007,CC de la Montagne d'Ardèche,1990_1999,1994.5,9,5753,5286,770,305,-467,-465,-2,-0.00936252293908213,-0.00932242648109891,-4.00964579832224e-05,EPCI
200072007,CC de la Montagne d'Ardèche,1999_2010,2004.5,11,5286,5262,833,392,-24,-441,417,-0.000413608400815835,-0.00760005436499096,0.00718644596417513,EPCI
200072015,CA Annonay Rhône Agglo,2010_2015,2012.5,5,46512,48268,2105,2643,1756,538,1218,0.00743922886896065,0.00227921704527382,0.00516001182368683,EPCI
200072015,CA Annonay Rhône Agglo,1968_1975,1971.5,7,36284,37718,2781,4912,1434,2131,-697,0.00555258180295137,0.00825143083827711,-0.00269884903532574,EPCI
200072015,CA Annonay Rhône Agglo,1975_1982,1978.5,7,37718,39735,2716,3929,2017,1213,804,0.00746990116129198,0.00449231041578938,0.0029775907455026,EPCI
200072015,CA Annonay Rhône Agglo,1982_1990,1986,8,39735,41516,2965,4312,1781,1347,434,0.00549585758310878,0.004156608739162,0.00133924884394678,EPCI
200072015,CA Annonay Rhône Agglo,1990_1999,1994.5,9,41516,42728,3352,4549,1212,1197,15,0.00320239986523974,0.00316276620354122,3.96336616985118e-05,EPCI
200072015,CA Annonay Rhône Agglo,1999_2010,2004.5,11,42728,46512,4252,6173,3784,1921,1863,0.00774400368661499,0.00393135070877045,0.00381265297784454,EPCI
200072023,CC Coeur de Charente,2010_2015,2012.5,5,22026,22174,1524,1119,148,-405,553,0.00134026888010519,-0.00366762767866623,0.00500789655877141,EPCI
200072023,CC Coeur de Charente,1968_1975,1971.5,7,20632,20254,2148,1706,-378,-442,64,-0.00263808037238311,-0.00308473948305115,0.00044665911066804,EPCI
200072023,CC Coeur de Charente,1975_1982,1978.5,7,20254,20440,2117,1520,186,-597,783,0.00130677600656504,-0.00419432944042649,0.00550110544699152,EPCI
200072023,CC Coeur de Charente,1982_1990,1986,8,20440,20356,2322,1635,-84,-687,603,-0.000514624611421044,-0.00420889414340782,0.00369426953198678,EPCI
200072023,CC Coeur de Charente,1990_1999,1994.5,9,20356,20541,2660,1735,185,-925,1110,0.00100574765647687,-0.00502873828238437,0.00603448593886125,EPCI
200072023,CC Coeur de Charente,1999_2010,2004.5,11,20541,22026,3176,2352,1485,-824,2309,0.00636569225610928,-0.00353220903638656,0.00989790129249584,EPCI
200072031,CA de la Région de Château-Thierry,2010_2015,2012.5,5,53273,53879,2524,3342,606,818,-212,0.00226479185298834,0.00305709527350571,-0.000792303420517371,EPCI
200072031,CA de la Région de Château-Thierry,1968_1975,1971.5,7,40519,42601,3768,4756,2082,988,1094,0.00718378435975109,0.00340901966735546,0.00377476469239562,EPCI
200072031,CA de la Région de Château-Thierry,1975_1982,1978.5,7,42601,45895,3500,4573,3294,1073,2221,0.0106965825119318,0.00348434518375922,0.00721223732817262,EPCI
200072031,CA de la Région de Château-Thierry,1982_1990,1986,8,45895,49583,3934,5438,3688,1504,2184,0.00970830458313277,0.00395913505776347,0.0057491695253693,EPCI
200072031,CA de la Région de Château-Thierry,1990_1999,1994.5,9,49583,50674,4502,5819,1091,1317,-226,0.00242125156230433,0.00292281238089349,-0.000501560818589164,EPCI
200072031,CA de la Région de Château-Thierry,1999_2010,2004.5,11,50674,53273,5465,7104,2599,1639,960,0.00455732385465346,0.00287397221922933,0.00168335163542413,EPCI
200072049,CC de Charente Limousine,2010_2015,2012.5,5,36472,35776,2474,1488,-696,-986,290,-0.00384609782217238,-0.00544863858141087,0.00160254075923849,EPCI
200072049,CC de Charente Limousine,1968_1975,1971.5,7,44072,41021,4241,3835,-3051,-406,-2645,-0.0101963086359442,-0.00135683425309517,-0.00883947438284906,EPCI
200072049,CC de Charente Limousine,1975_1982,1978.5,7,41021,39489,3887,3077,-1532,-810,-722,-0.00542266947150294,-0.00286707720099046,-0.00255559227051248,EPCI
200072049,CC de Charente Limousine,1982_1990,1986,8,39489,38034,4370,3227,-1455,-1143,-312,-0.00468171340163304,-0.00367779960004575,-0.00100391380158729,EPCI
200072049,CC de Charente Limousine,1990_1999,1994.5,9,38034,36468,4639,3000,-1566,-1639,73,-0.0046608082111449,-0.00487807449429533,0.000217266283150433,EPCI
200072049,CC de Charente Limousine,1999_2010,2004.5,11,36468,36472,5569,3573,4,-1996,2000,9.97088502563415e-06,-0.00497547162779144,0.00498544251281707,EPCI
200072056,CC Porte du Jura,2010_2015,2012.5,5,10252,10597,655,551,345,-104,449,0.0066415848921062,-0.00200210095298274,0.00864368584508894,EPCI
200072056,CC Porte du Jura,1968_1975,1971.5,7,9955,9770,1012,956,-185,-56,-129,-0.00267619422774756,-0.00081009122569656,-0.001866103002051,EPCI
200072056,CC Porte du Jura,1975_1982,1978.5,7,9770,9788,1003,769,18,-234,252,0.000262988793452879,-0.00341885431488742,0.0036818431083403,EPCI
200072056,CC Porte du Jura,1982_1990,1986,8,9788,9565,1090,816,-223,-274,51,-0.00287667226216048,-0.00353456591852903,0.000657893656368541,EPCI
200072056,CC Porte du Jura,1990_1999,1994.5,9,9565,9462,1108,824,-103,-284,181,-0.00120225734033763,-0.00331496198695036,0.00211270464661273,EPCI
200072056,CC Porte du Jura,1999_2010,2004.5,11,9462,10252,1414,1165,790,-249,1039,0.00731654802931714,-0.00230610184721515,0.00962264987653229,EPCI
200072064,CC Val-de-Cher-Controis,2010_2015,2012.5,5,47693,47938,3124,2376,245,-748,993,0.00102529980474708,-0.00313030307735027,0.00415560288209736,EPCI
200072064,CC Val-de-Cher-Controis,1968_1975,1971.5,7,41032,42087,3910,4122,1055,212,843,0.00363324920898211,0.000730093679909202,0.00290315552907291,EPCI
200072064,CC Val-de-Cher-Controis,1975_1982,1978.5,7,42087,43443,4024,3364,1356,-660,2016,0.00454039501463255,-0.00220992677703354,0.00675032179166609,EPCI
200072064,CC Val-de-Cher-Controis,1982_1990,1986,8,43443,43408,4789,3556,-35,-1233,1198,-0.000100742187414959,-0.00354900334521843,0.00344826115780347,EPCI
200072064,CC Val-de-Cher-Controis,1990_1999,1994.5,9,43408,44454,5366,3771,1046,-1595,2641,0.00264919078132486,-0.0040396360384447,0.00668882681976956,EPCI
200072064,CC Val-de-Cher-Controis,1999_2010,2004.5,11,44454,47693,6855,5328,3239,-1527,4766,0.00641409091860923,-0.00302387058743942,0.00943796150604865,EPCI
200072072,CA Territoires Vendômois,2010_2015,2012.5,5,55249,54592,3265,2727,-657,-538,-119,-0.00238971783061581,-0.0019568770058924,-0.000432840824723412,EPCI
200072072,CA Territoires Vendômois,1968_1975,1971.5,7,48098,49152,4048,5184,1054,1136,-82,0.0031015056497059,0.00334279925812705,-0.000241293608421143,EPCI
200072072,CA Territoires Vendômois,1975_1982,1978.5,7,49152,50675,3992,4394,1523,402,1121,0.00436882343491352,0.00115316285018728,0.00321566058472623,EPCI
200072072,CA Territoires Vendômois,1982_1990,1986,8,50675,51677,4775,4716,1002,-59,1061,0.00245051209812019,-0.000144291630528035,0.00259480372864823,EPCI
200072072,CA Territoires Vendômois,1990_1999,1994.5,9,51677,53250,5431,5223,1573,-208,1781,0.00333722242827794,-0.000441285610350802,0.00377850803862874,EPCI
200072072,CA Territoires Vendômois,1999_2010,2004.5,11,53250,55249,7050,6498,1999,-552,2551,0.00335583972768316,-0.000926675102391749,0.00428251483007491,EPCI
200072080,CC du Pays de Saint-Éloy,2010_2015,2012.5,5,16216,16109,1344,643,-107,-701,594,-0.00132318124948505,-0.00866869211111234,0.00734551086162729,EPCI
200072080,CC du Pays de Saint-Éloy,1968_1975,1971.5,7,25493,22248,2833,1737,-3245,-1096,-2149,-0.0192623196132939,-0.00650585586938988,-0.0127564637439041,EPCI
200072080,CC du Pays de Saint-Éloy,1975_1982,1978.5,7,22248,20306,2476,1271,-1942,-1205,-737,-0.0129632027149781,-0.00804359385764603,-0.00491960885733205,EPCI
200072080,CC du Pays de Saint-Éloy,1982_1990,1986,8,20306,17976,2744,1254,-2330,-1490,-840,-0.0151193958810439,-0.00966862655053883,-0.00545076933050511,EPCI
200072080,CC du Pays de Saint-Éloy,1990_1999,1994.5,9,17976,16669,2736,1205,-1307,-1531,224,-0.00835234900805437,-0.00978381509665742,0.00143146608860304,EPCI
200072080,CC du Pays de Saint-Éloy,1999_2010,2004.5,11,16669,16216,3049,1367,-453,-1682,1229,-0.00250162006672239,-0.00928857605348136,0.00678695598675897,EPCI
200072098,CC Combrailles Sioule et Morge,2010_2015,2012.5,5,17930,18604,899,1044,674,145,529,0.00740756602506543,0.00159361583625295,0.00581395018881248,EPCI
200072098,CC Combrailles Sioule et Morge,1968_1975,1971.5,7,16016,15573,1580,1305,-443,-275,-168,-0.0039990647949586,-0.00248248943253637,-0.00151657536242222,EPCI
200072098,CC Combrailles Sioule et Morge,1975_1982,1978.5,7,15573,16178,1620,1246,605,-374,979,0.00545965691287398,-0.00337506063704937,0.00883471754992335,EPCI
200072098,CC Combrailles Sioule et Morge,1982_1990,1986,8,16178,16209,1549,1471,31,-78,109,0.000239322249786067,-0.000602165660752039,0.000841487910538107,EPCI
200072098,CC Combrailles Sioule et Morge,1990_1999,1994.5,9,16209,16006,1693,1344,-203,-349,146,-0.00139935239043987,-0.00240578317371189,0.00100643078327202,EPCI
200072098,CC Combrailles Sioule et Morge,1999_2010,2004.5,11,16006,17930,1900,1964,1924,64,1860,0.010372666576683,0.00034503672604351,0.0100276298506395,EPCI
200072106,CC Adour Madiran,2010_2015,2012.5,5,24553,24601,1629,999,48,-630,678,0.000390685527955181,-0.00512774755441176,0.00551843308236694,EPCI
200072106,CC Adour Madiran,1968_1975,1971.5,7,21768,21728,2202,1737,-40,-465,425,-0.000262715499189214,-0.00305406767807462,0.0027913521788854,EPCI
200072106,CC Adour Madiran,1975_1982,1978.5,7,21728,22378,2273,1405,650,-868,1518,0.00421981875394217,-0.00563508104372586,0.00985489979766803,EPCI
200072106,CC Adour Madiran,1982_1990,1986,8,22378,22986,2541,1626,608,-915,1523,0.00335649565348106,-0.00505130513640653,0.0084078007898876,EPCI
200072106,CC Adour Madiran,1990_1999,1994.5,9,22986,22623,2738,1721,-363,-1017,654,-0.0017671308998628,-0.00495088739713628,0.00318375649727348,EPCI
200072106,CC Adour Madiran,1999_2010,2004.5,11,22623,24553,3402,2355,1930,-1047,2977,0.00747021464188147,-0.00405249467878233,0.0115227093206638,EPCI
200072130,CA du Pays de Meaux,2010_2015,2012.5,5,89424,95047,2745,7816,5623,5071,552,0.0122711610893369,0.0110665228319451,0.00120463825739178,EPCI
200072130,CA du Pays de Meaux,1968_1975,1971.5,7,44358,58868,3160,7808,14510,4648,9862,0.0412576118637804,0.0132160840760063,0.0280415277877741,EPCI
200072130,CA du Pays de Meaux,1975_1982,1978.5,7,58868,65405,3214,8055,6537,4841,1696,0.0151567239488573,0.011224369073951,0.00393235487490621,EPCI
200072130,CA du Pays de Meaux,1982_1990,1986,8,65405,75833,3758,10429,10428,6671,3757,0.0186638888784225,0.0119396627069387,0.00672422617148383,EPCI
200072130,CA du Pays de Meaux,1990_1999,1994.5,9,75833,82536,4535,12809,6703,8274,-1571,0.00945564789105946,0.0116717933239782,-0.00221614543291876,EPCI
200072130,CA du Pays de Meaux,1999_2010,2004.5,11,82536,89424,5738,15608,6888,9870,-2982,0.00731338958740824,0.0104795521526886,-0.0031661625652804,EPCI
200072304,CC Vallée de l'Ubaye - Serre-Ponçon,2010_2015,2012.5,5,8098,7833,493,336,-265,-157,-108,-0.00663221696552285,-0.00392927571164939,-0.00270294125387346,EPCI
200072304,CC Vallée de l'Ubaye - Serre-Ponçon,1968_1975,1971.5,7,5789,6273,570,574,484,4,480,0.0115367760107379,9.53452562870899e-05,0.0114414307544508,EPCI
200072304,CC Vallée de l'Ubaye - Serre-Ponçon,1975_1982,1978.5,7,6273,6629,557,617,356,60,296,0.00791678102586535,0.0013342889369436,0.00658249208892175,EPCI
200072304,CC Vallée de l'Ubaye - Serre-Ponçon,1982_1990,1986,8,6629,7204,587,862,575,275,300,0.0104520530593402,0.00499880798490182,0.00545324507443834,EPCI
200072304,CC Vallée de l'Ubaye - Serre-Ponçon,1990_1999,1994.5,9,7204,7524,638,818,320,180,140,0.00484073246334682,0.00272291201063259,0.00211782045271423,EPCI
200072304,CC Vallée de l'Ubaye - Serre-Ponçon,1999_2010,2004.5,11,7524,8098,934,849,574,-85,659,0.00670594905499344,-0.000993041236366625,0.00769899029136007,EPCI
200072312,CA Seine Normandie Agglomération,2010_2015,2012.5,5,85566,84652,3449,5227,-914,1778,-2692,-0.00214554960776669,0.00417372779278904,-0.00631927740055574,EPCI
200072312,CA Seine Normandie Agglomération,1968_1975,1971.5,7,54535,62894,4358,7799,8359,3441,4918,0.0205815192496184,0.00847242585691313,0.0121090933927052,EPCI
200072312,CA Seine Normandie Agglomération,1975_1982,1978.5,7,62894,67850,4378,7451,4956,3073,1883,0.0108944334780681,0.00675516426111848,0.00413926921694959,EPCI
200072312,CA Seine Normandie Agglomération,1982_1990,1986,8,67850,76669,4970,9252,8819,4282,4537,0.0153920139160448,0.00747347812546819,0.00791853579057664,EPCI
200072312,CA Seine Normandie Agglomération,1990_1999,1994.5,9,76669,81451,5871,10355,4782,4484,298,0.00674533217240025,0.00632498315789267,0.000420349014507586,EPCI
200072312,CA Seine Normandie Agglomération,1999_2010,2004.5,11,81451,85566,7496,11941,4115,4445,-330,0.00449063422609042,0.0048507579914877,-0.000360123765397287,EPCI
200072320,CC Val de Gers,2010_2015,2012.5,5,10100,10102,545,355,2,-190,192,3.9600823821262e-05,-0.00376207826301989,0.00380167908684115,EPCI
200072320,CC Val de Gers,1968_1975,1971.5,7,9490,8674,885,715,-816,-170,-646,-0.0127619478388988,-0.00265873913310392,-0.0101032087057949,EPCI
200072320,CC Val de Gers,1975_1982,1978.5,7,8674,8897,790,537,223,-253,476,0.00363288238563841,-0.00412161095769739,0.00775449334333581,EPCI
200072320,CC Val de Gers,1982_1990,1986,8,8897,8851,910,607,-46,-303,257,-0.000647751902583482,-0.0042667136191912,0.00361896171660772,EPCI
200072320,CC Val de Gers,1990_1999,1994.5,9,8851,9079,973,698,228,-275,503,0.00282995315684387,-0.00341332069356168,0.00624327385040555,EPCI
200072320,CC Val de Gers,1999_2010,2004.5,11,9079,10100,1009,915,1021,-94,1115,0.00973538988445588,-0.000896304259685458,0.0106316941441413,EPCI
200072346,CA du Pays de Fontainebleau,2010_2015,2012.5,5,68914,68441,3061,3575,-473,514,-987,-0.0013765097714199,0.00149582668606729,-0.00287233645748719,EPCI
200072346,CA du Pays de Fontainebleau,1968_1975,1971.5,7,50824,54567,4165,6440,3743,2275,1468,0.0102032186609109,0.00620152884145666,0.00400168981945423,EPCI
200072346,CA du Pays de Fontainebleau,1975_1982,1978.5,7,54567,57729,4109,5105,3162,996,2166,0.00807965745816297,0.0025450154422297,0.00553464201593327,EPCI
200072346,CA du Pays de Fontainebleau,1982_1990,1986,8,57729,63228,4933,6284,5499,1351,4148,0.01143837283919,0.00281019125399995,0.00862818158519008,EPCI
200072346,CA du Pays de Fontainebleau,1990_1999,1994.5,9,63228,67884,5529,7581,4656,2052,2604,0.0079260377222572,0.00349317641882985,0.00443286130342735,EPCI
200072346,CA du Pays de Fontainebleau,1999_2010,2004.5,11,67884,68914,6841,8573,1030,1732,-702,0.00136993607567737,0.00230362066317787,-0.000933684587500498,EPCI
200072452,CA Fougères Agglomération,2010_2015,2012.5,5,54040,55413,2718,3199,1373,481,892,0.00503055299064892,0.00176234230772187,0.00326821068292705,EPCI
200072452,CA Fougères Agglomération,1968_1975,1971.5,7,52699,52966,4337,6535,267,2198,-1931,0.000722220422484599,0.00594546999483576,-0.00522324957235116,EPCI
200072452,CA Fougères Agglomération,1975_1982,1978.5,7,52966,53418,3999,5894,452,1895,-1443,0.00121467562968691,0.00509250070410774,-0.00387782507442083,EPCI
200072452,CA Fougères Agglomération,1982_1990,1986,8,53418,52072,4342,5511,-1346,1169,-2515,-0.00318496614378627,0.0027661407296331,-0.00595110687341937,EPCI
200072452,CA Fougères Agglomération,1990_1999,1994.5,9,52072,51709,4678,5379,-363,701,-1064,-0.000776978958535013,0.00150044696951252,-0.00227742592804753,EPCI
200072452,CA Fougères Agglomération,1999_2010,2004.5,11,51709,54040,5707,7272,2331,1565,766,0.00401646861245419,0.00269659947597203,0.00131986913648216,EPCI
200072460,"CA de Béthune-Bruay, Artois-Lys Romane",2010_2015,2012.5,5,276826,277730,14087,17914,904,3827,-2923,0.000652266384907119,0.00276130913168091,-0.00210904274677379,EPCI
200072460,"CA de Béthune-Bruay, Artois-Lys Romane",1968_1975,1971.5,7,289809,279330,22972,34869,-10479,11897,-22376,-0.00524735666304954,0.00595741981298792,-0.0112047764760375,EPCI
200072460,"CA de Béthune-Bruay, Artois-Lys Romane",1975_1982,1978.5,7,279330,274466,22802,28965,-4864,6163,-11027,-0.00250635196431415,0.00317570870807321,-0.00568206067238736,EPCI
200072460,"CA de Béthune-Bruay, Artois-Lys Romane",1982_1990,1986,8,274466,277070,24582,31591,2604,7009,-4405,0.00118104565223764,0.00317893585888389,-0.00199789020664625,EPCI
200072460,"CA de Béthune-Bruay, Artois-Lys Romane",1990_1999,1994.5,9,277070,273369,26079,30438,-3701,4359,-8060,-0.00149306770382096,0.00175851989217929,-0.00325158759600025,EPCI
200072460,"CA de Béthune-Bruay, Artois-Lys Romane",1999_2010,2004.5,11,273369,276826,31730,39771,3457,8041,-4584,0.00114307272710157,0.00265879311501988,-0.00151572038791831,EPCI
200072478,CC Pays d'Opale,2010_2015,2012.5,5,26865,27676,1200,1733,811,533,278,0.00596598350361344,0.00392092380693707,0.00204505969667637,EPCI
200072478,CC Pays d'Opale,1968_1975,1971.5,7,19602,19523,1610,2625,-79,1015,-1094,-0.000576739928170755,0.00741001300118122,-0.00798675292935198,EPCI
200072478,CC Pays d'Opale,1975_1982,1978.5,7,19523,21050,1680,2268,1527,588,939,0.010816263426952,0.00416500517029977,0.00665125825665219,EPCI
200072478,CC Pays d'Opale,1982_1990,1986,8,21050,22856,1901,2842,1806,941,865,0.0103422532949848,0.00538873773564825,0.00495351555933659,EPCI
200072478,CC Pays d'Opale,1990_1999,1994.5,9,22856,24089,2052,2757,1233,705,528,0.005855034079981,0.00334776887784802,0.00250726520213298,EPCI
200072478,CC Pays d'Opale,1999_2010,2004.5,11,24089,26865,2683,3893,2776,1210,1566,0.0099646855111688,0.004343396782606,0.00562128872856281,EPCI
200072544,CC des Deux Morin,2010_2015,2012.5,5,25813,26443,1125,1652,630,527,103,0.00483429407602931,0.00404392536201182,0.00079036871401749,EPCI
200072544,CC des Deux Morin,1968_1975,1971.5,7,15842,16894,1653,1555,1052,-98,1150,0.00922715127216334,-0.000859563521551337,0.0100867147937147,EPCI
200072544,CC des Deux Morin,1975_1982,1978.5,7,16894,18344,1535,1493,1450,-42,1492,0.0118328921464304,-0.00034274584148281,0.0121756379879132,EPCI
200072544,CC des Deux Morin,1982_1990,1986,8,18344,21010,1890,2078,2666,188,2478,0.0171066676343812,0.00120632164863603,0.0159003459857451,EPCI
200072544,CC des Deux Morin,1990_1999,1994.5,9,21010,23045,2102,2638,2035,536,1499,0.0103251975612288,0.00271956063529173,0.00760563692593712,EPCI
200072544,CC des Deux Morin,1999_2010,2004.5,11,23045,25813,2545,3342,2768,797,1971,0.0103651144503225,0.00298446395119474,0.00738065049912777,EPCI
200072635,CC Pyrénées Haut Garonnaises,2010_2015,2012.5,5,16364,15588,1170,567,-776,-603,-173,-0.00966943002011522,-0.00751374523470294,-0.00215568478541229,EPCI
200072635,CC Pyrénées Haut Garonnaises,1968_1975,1971.5,7,18647,17164,2044,1252,-1483,-792,-691,-0.0117689276969103,-0.00628522638971878,-0.00548370130719151,EPCI
200072635,CC Pyrénées Haut Garonnaises,1975_1982,1978.5,7,17164,16439,1932,925,-725,-1007,282,-0.00614640546283041,-0.00853714524285548,0.00239073978002507,EPCI
200072635,CC Pyrénées Haut Garonnaises,1982_1990,1986,8,16439,16152,2112,1106,-287,-1006,719,-0.00219916322900804,-0.0077085651860003,0.00550940195699226,EPCI
200072635,CC Pyrénées Haut Garonnaises,1990_1999,1994.5,9,16152,15790,2200,1165,-362,-1035,673,-0.00251539250101163,-0.00719179900151114,0.00467640650049952,EPCI
200072635,CC Pyrénées Haut Garonnaises,1999_2010,2004.5,11,15790,16364,2555,1432,574,-1123,1697,0.00325136259554126,-0.00636111532193874,0.00961247791748001,EPCI
200072643,CC Coeur et Coteaux du Comminges,2010_2015,2012.5,5,43744,44116,2910,1994,372,-916,1288,0.00169504855393487,-0.00417382923495792,0.00586887778889279,EPCI
200072643,CC Coeur et Coteaux du Comminges,1968_1975,1971.5,7,43923,43008,4082,3399,-915,-683,-232,-0.00300290451836482,-0.00224151233447342,-0.000761392183891409,EPCI
200072643,CC Coeur et Coteaux du Comminges,1975_1982,1978.5,7,43008,42316,4113,2666,-692,-1447,755,-0.00231458574536048,-0.00483989244730724,0.00252530670194676,EPCI
200072643,CC Coeur et Coteaux du Comminges,1982_1990,1986,8,42316,41582,4648,2999,-734,-1649,915,-0.00218484521890616,-0.00490846017162978,0.00272361495272362,EPCI
200072643,CC Coeur et Coteaux du Comminges,1990_1999,1994.5,9,41582,40090,5067,3109,-1492,-1958,466,-0.0040518196564312,-0.00531733437486078,0.00126551471842958,EPCI
200072643,CC Coeur et Coteaux du Comminges,1999_2010,2004.5,11,40090,43744,6175,3945,3654,-2230,5884,0.00796129975094373,-0.00485870236579215,0.0128200021167359,EPCI
200072650,CC Touraine Vallée de l'Indre,2010_2015,2012.5,5,47310,51279,1593,2929,3969,1336,2633,0.0162424213641617,0.00546734062547744,0.0107750807386842,EPCI
200072650,CC Touraine Vallée de l'Indre,1968_1975,1971.5,7,26758,30340,2057,3330,3582,1273,2309,0.0181096667529488,0.00643595917825344,0.0116737075746954,EPCI
200072650,CC Touraine Vallée de l'Indre,1975_1982,1978.5,7,30340,34745,2047,2641,4405,594,3811,0.0195557136463889,0.00263702472325879,0.0169186889231301,EPCI
200072650,CC Touraine Vallée de l'Indre,1982_1990,1986,8,34745,38716,2414,3526,3971,1112,2859,0.013619065275926,0.00381374983299667,0.00980531544292938,EPCI
200072650,CC Touraine Vallée de l'Indre,1990_1999,1994.5,9,38716,41344,2655,3978,2628,1323,1305,0.00732383984692597,0.00368700156677438,0.0036368382801516,EPCI
200072650,CC Touraine Vallée de l'Indre,1999_2010,2004.5,11,41344,47310,3347,5704,5966,2357,3609,0.0123294229854944,0.00487101072356862,0.00745841226192582,EPCI
200072668,CC Touraine Val de Vienne,2010_2015,2012.5,5,25595,25560,1610,1281,-35,-329,294,-0.000273640633612904,-0.0025722219559613,0.00229858132234839,EPCI
200072668,CC Touraine Val de Vienne,1968_1975,1971.5,7,25970,24740,2101,2686,-1230,585,-1815,-0.0069075550788994,0.00328530058630581,-0.0101928556652052,EPCI
200072668,CC Touraine Val de Vienne,1975_1982,1978.5,7,24740,24742,2107,1969,2,-138,140,1.1548277580653e-05,-0.000796831153065059,0.000808379430645712,EPCI
200072668,CC Touraine Val de Vienne,1982_1990,1986,8,24742,24484,2406,2265,-258,-141,-117,-0.00130943711955811,-0.000715622611851525,-0.000593814507706585,EPCI
200072668,CC Touraine Val de Vienne,1990_1999,1994.5,9,24484,24336,2727,2195,-148,-532,384,-0.000673451737502773,-0.0024207859753478,0.00174733423784503,EPCI
200072668,CC Touraine Val de Vienne,1999_2010,2004.5,11,24336,25595,3570,2878,1259,-692,1951,0.0045960098025466,-0.00252616265556969,0.00712217245811629,EPCI
200072676,CC Maine Saosnois,2010_2015,2012.5,5,28480,28370,1764,1584,-110,-180,70,-0.000773668108979053,-0.00126600236014754,0.000492334251168489,EPCI
200072676,CC Maine Saosnois,1968_1975,1971.5,7,29235,27938,2292,2978,-1297,686,-1983,-0.00646172586611193,0.00341769001091194,-0.00987941587702387,EPCI
200072676,CC Maine Saosnois,1975_1982,1978.5,7,27938,27039,2308,2461,-899,153,-1052,-0.00466160100504875,0.000793353674941557,-0.00545495467999031,EPCI
200072676,CC Maine Saosnois,1982_1990,1986,8,27039,26589,2556,2622,-450,66,-516,-0.00209563506147559,0.000307359809016419,-0.00240299487049201,EPCI
200072676,CC Maine Saosnois,1990_1999,1994.5,9,26589,27272,2845,2885,683,40,643,0.00282207885647168,0.000165275482077404,0.00265680337439427,EPCI
200072676,CC Maine Saosnois,1999_2010,2004.5,11,27272,28480,3529,3661,1208,132,1076,0.00394791362515878,0.00043139453519947,0.00351651908995931,EPCI
200072684,CC Le Gesnois Bilurien,2010_2015,2012.5,5,30100,30772,1217,2027,672,810,-138,0.00442576767726055,0.00533463068241227,-0.00090886300515172,EPCI
200072684,CC Le Gesnois Bilurien,1968_1975,1971.5,7,21018,21115,1615,2261,97,646,-549,0.000657998520753766,0.00438213447842199,-0.00372413595766822,EPCI
200072684,CC Le Gesnois Bilurien,1975_1982,1978.5,7,21115,22960,1570,1812,1845,242,1603,0.0120390187025616,0.0015791016401192,0.0104599170624424,EPCI
200072684,CC Le Gesnois Bilurien,1982_1990,1986,8,22960,24675,1872,2362,1715,490,1225,0.00904529034673818,0.00258436867049662,0.00646092167624156,EPCI
200072684,CC Le Gesnois Bilurien,1990_1999,1994.5,9,24675,26069,2034,2637,1394,603,791,0.0061249349079755,0.00264945175718022,0.00347548315079528,EPCI
200072684,CC Le Gesnois Bilurien,1999_2010,2004.5,11,26069,30100,2568,4295,4031,1727,2304,0.0131565505139588,0.00563665659578439,0.00751989391817442,EPCI
200072692,CC des Vallées de la Braye et de l'Anille,2010_2015,2012.5,5,16167,15691,1088,681,-476,-407,-69,-0.0059591390834236,-0.00509531430032228,-0.000863824783101321,EPCI
200072692,CC des Vallées de la Braye et de l'Anille,1968_1975,1971.5,7,17819,17363,1436,1824,-456,388,-844,-0.00369655064174246,0.00314531063376332,-0.00684186127550578,EPCI
200072692,CC des Vallées de la Braye et de l'Anille,1975_1982,1978.5,7,17363,17120,1519,1494,-243,-25,-218,-0.00201142218060502,-0.000206936438333849,-0.00180448574227117,EPCI
200072692,CC des Vallées de la Braye et de l'Anille,1982_1990,1986,8,17120,16713,1757,1539,-407,-218,-189,-0.00300304568633358,-0.00160851095729907,-0.00139453472903451,EPCI
200072692,CC des Vallées de la Braye et de l'Anille,1990_1999,1994.5,9,16713,16278,1874,1514,-435,-360,-75,-0.00292597283992457,-0.00242149476407551,-0.000504478075849065,EPCI
200072692,CC des Vallées de la Braye et de l'Anille,1999_2010,2004.5,11,16278,16167,2374,1802,-111,-572,461,-0.000621840693738829,-0.00320444033169919,0.00258259963796036,EPCI
200072700,CC Haute Sarthe Alpes Mancelles,2010_2015,2012.5,5,23217,23210,1159,1395,-7,236,-243,-6.03079154217756e-05,0.00203323829136272,-0.0020935462067845,EPCI
200072700,CC Haute Sarthe Alpes Mancelles,1968_1975,1971.5,7,21987,21472,1765,2343,-515,578,-1093,-0.00338021827301016,0.00379372070252402,-0.00717393897553419,EPCI
200072700,CC Haute Sarthe Alpes Mancelles,1975_1982,1978.5,7,21472,21189,1696,1808,-283,112,-395,-0.00189357373630294,0.000749400206593392,-0.00264297394289634,EPCI
200072700,CC Haute Sarthe Alpes Mancelles,1982_1990,1986,8,21189,20318,2004,1779,-871,-225,-646,-0.00523313250604085,-0.00135184249581997,-0.00388129001022088,EPCI
200072700,CC Haute Sarthe Alpes Mancelles,1990_1999,1994.5,9,20318,20877,2083,2044,559,-39,598,0.00302020519755764,-0.000210711990527277,0.00323091718808491,EPCI
200072700,CC Haute Sarthe Alpes Mancelles,1999_2010,2004.5,11,20877,23217,2637,3043,2340,406,1934,0.00970466914962431,0.0016838015704049,0.00802086757921941,EPCI
200072718,CC de la Champagne Conlinoise et du Pays de Sillé,2010_2015,2012.5,5,18322,18759,882,1167,437,285,152,0.00472535216203229,0.00308175141002106,0.00164360075201123,EPCI
200072718,CC de la Champagne Conlinoise et du Pays de Sillé,1968_1975,1971.5,7,16606,15694,1327,1769,-912,442,-1354,-0.0080369017495765,0.00389507738301843,-0.0119319791325949,EPCI
200072718,CC de la Champagne Conlinoise et du Pays de Sillé,1975_1982,1978.5,7,15694,15549,1252,1307,-145,55,-200,-0.00132514205564438,0.000502640090072006,-0.00182778214571639,EPCI
200072718,CC de la Champagne Conlinoise et du Pays de Sillé,1982_1990,1986,8,15549,15831,1411,1621,282,210,72,0.00224924015599237,0.00167496607361134,0.000574274082381031,EPCI
200072718,CC de la Champagne Conlinoise et du Pays de Sillé,1990_1999,1994.5,9,15831,16511,1519,1761,680,242,438,0.00468391119600864,0.00166692133740307,0.00301698985860556,EPCI
200072718,CC de la Champagne Conlinoise et du Pays de Sillé,1999_2010,2004.5,11,16511,18322,1930,2678,1811,748,1063,0.0095063279021812,0.00392641262884127,0.00557991527333993,EPCI
200072726,CC Châteaubriant-Derval,2010_2015,2012.5,5,43344,44363,2117,2823,1019,706,313,0.00465831705049635,0.00322745028228697,0.00143086676820938,EPCI
200072726,CC Châteaubriant-Derval,1968_1975,1971.5,7,41455,41394,3396,5213,-61,1817,-1878,-0.000210343414172143,0.00626547514017678,-0.00647581855434892,EPCI
200072726,CC Châteaubriant-Derval,1975_1982,1978.5,7,41394,42338,3327,4647,944,1320,-376,0.00322649183322654,0.00451161993629135,-0.00128512810306481,EPCI
200072726,CC Châteaubriant-Derval,1982_1990,1986,8,42338,41162,3671,4634,-1176,963,-2139,-0.00351499878793959,0.00287835359930768,-0.00639335238724727,EPCI
200072726,CC Châteaubriant-Derval,1990_1999,1994.5,9,41162,39485,3841,4264,-1677,423,-2100,-0.00461096423539675,0.00116305180177271,-0.00577401603716946,EPCI
200072726,CC Châteaubriant-Derval,1999_2010,2004.5,11,39485,43344,4696,5832,3859,1136,2723,0.00851307114866851,0.002506050485848,0.00600702066282051,EPCI
200072734,CC Estuaire et Sillon,2010_2015,2012.5,5,34754,37575,1204,2567,2821,1363,1458,0.0157313069002731,0.00760076969339677,0.00813053720687637,EPCI
200072734,CC Estuaire et Sillon,1968_1975,1971.5,7,17555,19548,1705,2137,1993,432,1561,0.0154806266962215,0.00335555982577406,0.0121250668704475,EPCI
200072734,CC Estuaire et Sillon,1975_1982,1978.5,7,19548,24309,1511,2405,4761,894,3867,0.0316289894819481,0.00593915492477665,0.0256898345571715,EPCI
200072734,CC Estuaire et Sillon,1982_1990,1986,8,24309,27183,1685,3062,2874,1377,1497,0.0140661510065672,0.00673941890606924,0.00732673210049793,EPCI
200072734,CC Estuaire et Sillon,1990_1999,1994.5,9,27183,28556,1983,2968,1373,985,388,0.00549004801882447,0.0039385996347721,0.00155144838405236,EPCI
200072734,CC Estuaire et Sillon,1999_2010,2004.5,11,28556,34754,2517,5151,6198,2634,3564,0.018017445175718,0.0076569781530883,0.0103604670226297,EPCI
200072825,CC Mirebellois et Fontenois,2010_2015,2012.5,5,11921,12542,529,694,621,165,456,0.0102080424616884,0.00271228181349208,0.0074957606481963,EPCI
200072825,CC Mirebellois et Fontenois,1968_1975,1971.5,7,7629,8170,773,791,541,18,523,0.00983550139304246,0.000327244038955202,0.00950825735408726,EPCI
200072825,CC Mirebellois et Fontenois,1975_1982,1978.5,7,8170,9483,712,794,1313,82,1231,0.021518513556634,0.00134388279637775,0.0201746307602563,EPCI
200072825,CC Mirebellois et Fontenois,1982_1990,1986,8,9483,9644,914,910,161,-4,165,0.00210662061600297,-5.23384003975894e-05,0.00215895901640056,EPCI
200072825,CC Mirebellois et Fontenois,1990_1999,1994.5,9,9644,10175,916,990,531,74,457,0.00597307598999342,0.000832406070168574,0.00514066991982484,EPCI
200072825,CC Mirebellois et Fontenois,1999_2010,2004.5,11,10175,11921,1139,1548,1746,409,1337,0.0145012115245688,0.00339690464693509,0.0111043068776338,EPCI
200072874,CC Val Briard,2010_2015,2012.5,5,26552,27300,824,1477,748,653,95,0.00557179056108548,0.00486414336415617,0.000707647196929305,EPCI
200072874,CC Val Briard,1968_1975,1971.5,7,11367,14032,1127,1309,2665,182,2483,0.0305466923483577,0.0020861155750098,0.0284605767733479,EPCI
200072874,CC Val Briard,1975_1982,1978.5,7,14032,16684,1148,1286,2652,138,2514,0.025038284841626,0.00130289717501674,0.0237353876666092,EPCI
200072874,CC Val Briard,1982_1990,1986,8,16684,20600,1340,1917,3916,577,3339,0.0267054796252775,0.00393489830025156,0.0227705813250259,EPCI
200072874,CC Val Briard,1990_1999,1994.5,9,20600,23257,1478,2469,2657,991,1666,0.013570711434123,0.00506156380550091,0.00850914762862212,EPCI
200072874,CC Val Briard,1999_2010,2004.5,11,23257,26552,1887,3547,3295,1660,1635,0.0121181931293086,0.00610506846575184,0.00601312466355678,EPCI
200072882,CC de Vie et Boulogne,2010_2015,2012.5,5,39414,42882,1358,2866,3468,1508,1960,0.0170092525037513,0.00739618015445702,0.00961307234929427,EPCI
200072882,CC de Vie et Boulogne,1968_1975,1971.5,7,21995,22610,1653,2440,615,787,-172,0.00394736059895928,0.00505133787216415,-0.00110397727320487,EPCI
200072882,CC de Vie et Boulogne,1975_1982,1978.5,7,22610,25490,1631,2814,2880,1183,1697,0.0172752247413606,0.00709603849619081,0.0101791862451697,EPCI
200072882,CC de Vie et Boulogne,1982_1990,1986,8,25490,27428,1895,3048,1938,1153,785,0.00920185046526201,0.00547457873397683,0.00372727173128518,EPCI
200072882,CC de Vie et Boulogne,1990_1999,1994.5,9,27428,29679,1866,3117,2251,1251,1000,0.00880244181119272,0.00489198343216441,0.00391045837902831,EPCI
200072882,CC de Vie et Boulogne,1999_2010,2004.5,11,29679,39414,2655,5695,9735,3040,6695,0.0261246333544063,0.00815807759603442,0.0179665557583719,EPCI
200072981,CC Touraine Ouest Val de Loire,2010_2015,2012.5,5,32638,33440,1673,1959,802,286,516,0.00486691203038636,0.00173558209562406,0.0031313299347623,EPCI
200072981,CC Touraine Ouest Val de Loire,1968_1975,1971.5,7,28557,26936,2597,2873,-1621,276,-1897,-0.00831359335805793,0.00141551620408636,-0.00972910956214428,EPCI
200072981,CC Touraine Ouest Val de Loire,1975_1982,1978.5,7,26936,27968,2370,2028,1032,-342,1374,0.00538549529649468,-0.001784728092443,0.00717022338893768,EPCI
200072981,CC Touraine Ouest Val de Loire,1982_1990,1986,8,27968,28145,2762,2600,177,-162,339,0.000788900949147298,-0.000722044936507696,0.00151094588565499,EPCI
200072981,CC Touraine Ouest Val de Loire,1990_1999,1994.5,9,28145,29049,3012,3008,904,-4,908,0.00351888126352029,-1.55702710775234e-05,0.00353445153459781,EPCI
200072981,CC Touraine Ouest Val de Loire,1999_2010,2004.5,11,29049,32638,3673,4115,3589,442,3147,0.0106465660093109,0.00131116806244509,0.00933539794686582,EPCI
200072999,CC du Grand Langres,2010_2015,2012.5,5,21957,21242,1165,1085,-715,-80,-635,-0.00659925690541219,-0.000738378395011154,-0.00586087851040103,EPCI
200072999,CC du Grand Langres,1968_1975,1971.5,7,24575,24278,1890,3240,-297,1350,-1647,-0.00173550306380388,0.00788865029001763,-0.00962415335382151,EPCI
200072999,CC du Grand Langres,1975_1982,1978.5,7,24278,23852,1759,2501,-426,742,-1168,-0.0025257362635156,0.00439928710687459,-0.00692502337039019,EPCI
200072999,CC du Grand Langres,1982_1990,1986,8,23852,23591,1923,2747,-261,824,-1085,-0.00137440312873882,0.00433911179341298,-0.00571351492215181,EPCI
200072999,CC du Grand Langres,1990_1999,1994.5,9,23591,23025,2042,2829,-566,787,-1353,-0.00269466299621346,0.00374681939579504,-0.0064414823920085,EPCI
200072999,CC du Grand Langres,1999_2010,2004.5,11,23025,21957,2357,2756,-1068,399,-1467,-0.00430838189269567,0.00160959211159698,-0.00591797400429264,EPCI
200073013,CC Carnelle Pays-De-France,2010_2015,2012.5,5,30344,31712,1111,1703,1368,592,776,0.0088582750994759,0.00383340559860361,0.00502486950087229,EPCI
200073013,CC Carnelle Pays-De-France,1968_1975,1971.5,7,14082,18726,1180,1710,4644,530,4114,0.0415567892445732,0.00474269989225318,0.03681408935232,EPCI
200073013,CC Carnelle Pays-De-France,1975_1982,1978.5,7,18726,23140,1284,1755,4414,471,3943,0.0306974244053291,0.00327559739350023,0.0274218270118289,EPCI
200073013,CC Carnelle Pays-De-France,1982_1990,1986,8,23140,25937,1577,1992,2797,415,2382,0.0143656835964154,0.00213148326510991,0.0122342003313055,EPCI
200073013,CC Carnelle Pays-De-France,1990_1999,1994.5,9,25937,28253,1846,2559,2316,713,1603,0.00954853534811728,0.00293959659033144,0.00660893875778584,EPCI
200073013,CC Carnelle Pays-De-France,1999_2010,2004.5,11,28253,30344,2298,3587,2091,1289,802,0.00651194362692542,0.00401429714734905,0.00249764647957637,EPCI
200073096,CA Hermitage-Tournonais-Herbasse-Pays de Saint-Félicien,2010_2015,2012.5,5,54735,56710,2229,3359,1975,1130,845,0.00711463027004378,0.0040706492177972,0.00304398105224658,EPCI
200073096,CA Hermitage-Tournonais-Herbasse-Pays de Saint-Félicien,1968_1975,1971.5,7,35615,36494,2894,3855,879,961,-82,0.00348906783080549,0.00381455538726289,-0.000325487556457395,EPCI
200073096,CA Hermitage-Tournonais-Herbasse-Pays de Saint-Félicien,1975_1982,1978.5,7,36494,40571,2898,3487,4077,589,3488,0.0152444087530867,0.00220234406562867,0.0130420646874581,EPCI
200073096,CA Hermitage-Tournonais-Herbasse-Pays de Saint-Félicien,1982_1990,1986,8,40571,44476,3178,4496,3905,1318,2587,0.0115532532310689,0.00389940787670905,0.00765384535435988,EPCI
200073096,CA Hermitage-Tournonais-Herbasse-Pays de Saint-Félicien,1990_1999,1994.5,9,44476,47388,3546,5010,2912,1464,1448,0.00707147610965708,0.00355516518699793,0.00351631092265915,EPCI
200073096,CA Hermitage-Tournonais-Herbasse-Pays de Saint-Félicien,1999_2010,2004.5,11,47388,54735,4567,6817,7347,2250,5097,0.0131893426533418,0.00403920252756487,0.00915014012577695,EPCI
200073104,CC de l'Ile-Rousse - Balagne,2010_2015,2012.5,5,10039,10422,573,475,383,-98,481,0.00751639711213237,-0.00192325565793465,0.00943965277006702,EPCI
200073104,CC de l'Ile-Rousse - Balagne,1968_1975,1971.5,7,6361,6509,702,496,148,-206,354,0.00329115211512687,-0.00458092794402794,0.00787208005915482,EPCI
200073104,CC de l'Ile-Rousse - Balagne,1975_1982,1978.5,7,6509,7132,712,435,623,-277,900,0.0131436085063938,-0.0058439479233886,0.0189875564297824,EPCI
200073104,CC de l'Ile-Rousse - Balagne,1982_1990,1986,8,7132,7025,797,543,-107,-254,147,-0.00188777650190541,-0.00448126384564463,0.00259348734373921,EPCI
200073104,CC de l'Ile-Rousse - Balagne,1990_1999,1994.5,9,7025,8136,899,726,1111,-173,1284,0.0164475111870515,-0.00256113360518443,0.0190086447922359,EPCI
200073104,CC de l'Ile-Rousse - Balagne,1999_2010,2004.5,11,8136,10039,1119,912,1903,-207,2110,0.0192908782184231,-0.00209837718928722,0.0213892554077103,EPCI
200073112,CC Sud Sarthe,2010_2015,2012.5,5,23859,23535,1444,1222,-324,-222,-102,-0.00273083043829525,-0.00187112455957267,-0.000859705878722579,EPCI
200073112,CC Sud Sarthe,1968_1975,1971.5,7,21415,21361,1817,2292,-54,475,-529,-0.000360618046218231,0.00317210318432703,-0.00353272123054526,EPCI
200073112,CC Sud Sarthe,1975_1982,1978.5,7,21361,22252,1924,1876,891,-48,939,0.00585493965388428,-0.000315417624451679,0.00617035727833596,EPCI
200073112,CC Sud Sarthe,1982_1990,1986,8,22252,22036,2101,2083,-216,-18,-198,-0.00121855852918606,-0.000101546544098839,-0.00111701198508723,EPCI
200073112,CC Sud Sarthe,1990_1999,1994.5,9,22036,22334,2390,2225,298,-165,463,0.00149363674509928,-0.000827013634031481,0.00232065037913076,EPCI
200073112,CC Sud Sarthe,1999_2010,2004.5,11,22334,23859,3033,3038,1525,5,1520,0.00602272992746067,1.9746655499871e-05,0.0060029832719608,EPCI
200073120,CC Nebbiu - Conca d'Oro,2010_2015,2012.5,5,6612,7061,360,289,449,-71,520,0.0132268114198006,-0.00209154479021346,0.0153183562100141,EPCI
200073120,CC Nebbiu - Conca d'Oro,1968_1975,1971.5,7,4240,4230,390,268,-10,-122,112,-0.000337268281644598,-0.0041146730360641,0.0037774047544195,EPCI
200073120,CC Nebbiu - Conca d'Oro,1975_1982,1978.5,7,4230,4585,482,252,355,-230,585,0.0115791124032478,-0.0075019601485831,0.0190810725518309,EPCI
200073120,CC Nebbiu - Conca d'Oro,1982_1990,1986,8,4585,4941,559,372,356,-187,543,0.00939102581311291,-0.00493292648048347,0.0143239522935964,EPCI
200073120,CC Nebbiu - Conca d'Oro,1990_1999,1994.5,9,4941,5386,557,411,445,-146,591,0.00962774635232955,-0.00315876621896655,0.0127865125712961,EPCI
200073120,CC Nebbiu - Conca d'Oro,1999_2010,2004.5,11,5386,6612,810,575,1226,-235,1461,0.0188188090938601,-0.00360719423903518,0.0224260033328953,EPCI
200073138,CC Pasquale Paoli,2010_2015,2012.5,5,6314,6272,380,193,-42,-187,145,-0.00133393093968393,-0.00593916870764033,0.00460523776795641,EPCI
200073138,CC Pasquale Paoli,1968_1975,1971.5,7,7443,6477,814,380,-966,-434,-532,-0.0196636065518432,-0.00883437395807447,-0.0108292325937687,EPCI
200073138,CC Pasquale Paoli,1975_1982,1978.5,7,6477,5976,755,252,-501,-503,2,-0.0114349740164015,-0.0114806226152694,4.56485988678708e-05,EPCI
200073138,CC Pasquale Paoli,1982_1990,1986,8,5976,4889,779,336,-1087,-443,-644,-0.0247831846902932,-0.0101002307431462,-0.014682953947147,EPCI
200073138,CC Pasquale Paoli,1990_1999,1994.5,9,4889,5520,811,352,631,-459,1090,0.0135791568220129,-0.00987770678495077,0.0234568636069637,EPCI
200073138,CC Pasquale Paoli,1999_2010,2004.5,11,5520,6314,988,436,794,-552,1346,0.0122923492494316,-0.00854581459154436,0.0208381638409759,EPCI
200073146,CC Cagire Garonne Salat,2010_2015,2012.5,5,17390,17764,1051,702,374,-349,723,0.00426479025650095,-0.00397971069390062,0.00824450095040157,EPCI
200073146,CC Cagire Garonne Salat,1968_1975,1971.5,7,17736,17147,1882,1234,-589,-648,59,-0.00481312832690506,-0.00529525832909079,0.000482130002185736,EPCI
200073146,CC Cagire Garonne Salat,1975_1982,1978.5,7,17147,16789,1847,911,-358,-936,578,-0.00300965062848668,-0.00786880722978641,0.00485915660129973,EPCI
200073146,CC Cagire Garonne Salat,1982_1990,1986,8,16789,16428,1971,1046,-361,-925,564,-0.00271340129892672,-0.00695262105680669,0.00423921975787997,EPCI
200073146,CC Cagire Garonne Salat,1990_1999,1994.5,9,16428,16079,2043,1196,-349,-847,498,-0.00238305858914623,-0.00578352614615144,0.00340046755700522,EPCI
200073146,CC Cagire Garonne Salat,1999_2010,2004.5,11,16079,17390,2425,1616,1311,-809,2120,0.00715101596203671,-0.00441279322142464,0.0115638091834614,EPCI
200073161,CC Touraine-Est Vallées,2010_2015,2012.5,5,37391,38711,1350,2220,1320,870,450,0.00696288164531711,0.00458917199350446,0.00237370965181265,EPCI
200073161,CC Touraine-Est Vallées,1968_1975,1971.5,7,17105,19770,1336,1882,2665,546,2119,0.0209003909177254,0.00428203130997302,0.0166183596077524,EPCI
200073161,CC Touraine-Est Vallées,1975_1982,1978.5,7,19770,24732,1479,1900,4962,421,4541,0.0325075215749067,0.00275809483737116,0.0297494267375355,EPCI
200073161,CC Touraine-Est Vallées,1982_1990,1986,8,24732,29512,1709,2607,4780,898,3882,0.0223331080220834,0.00419563410121986,0.0181374739208636,EPCI
200073161,CC Touraine-Est Vallées,1990_1999,1994.5,9,29512,33228,2248,3124,3716,876,2840,0.0132645295401677,0.00312694506921068,0.010137584470957,EPCI
200073161,CC Touraine-Est Vallées,1999_2010,2004.5,11,33228,37391,2990,4844,4163,1854,2309,0.0107884289720668,0.00480464744516258,0.0059837815269042,EPCI
200073237,CC de Gâtine et Choisilles - Pays de Racan,2010_2015,2012.5,5,20285,21316,729,1292,1031,563,468,0.00996457255043071,0.00544137181948835,0.00452320073094236,EPCI
200073237,CC de Gâtine et Choisilles - Pays de Racan,1968_1975,1971.5,7,13731,13452,1100,1328,-279,228,-507,-0.00292831217132528,0.00239302930129808,-0.00532134147262335,EPCI
200073237,CC de Gâtine et Choisilles - Pays de Racan,1975_1982,1978.5,7,13452,14120,1062,1068,668,6,662,0.0069475139430546,6.24028198477958e-05,0.0068851111232068,EPCI
200073237,CC de Gâtine et Choisilles - Pays de Racan,1982_1990,1986,8,14120,15436,1174,1475,1316,301,1015,0.0112010436002243,0.00256194082345557,0.00863910277676877,EPCI
200073237,CC de Gâtine et Choisilles - Pays de Racan,1990_1999,1994.5,9,15436,17293,1264,1728,1857,464,1393,0.012702145740682,0.00317382639939495,0.009528319341287,EPCI
200073237,CC de Gâtine et Choisilles - Pays de Racan,1999_2010,2004.5,11,17293,20285,1600,2796,2992,1196,1796,0.0146130048258069,0.00584129470978108,0.00877171011602577,EPCI
200073245,CC du Bassin d'Aubenas,2010_2015,2012.5,5,37299,39556,2246,1962,2257,-284,2541,0.011819479035371,-0.00148725389722878,0.0133067329325997,EPCI
200073245,CC du Bassin d'Aubenas,1968_1975,1971.5,7,27737,30348,2812,3006,2611,194,2417,0.0129348486343659,0.000961072629286474,0.0119737760050794,EPCI
200073245,CC du Bassin d'Aubenas,1975_1982,1978.5,7,30348,31317,2643,2544,969,-99,1068,0.00450016168267964,-0.000459768840645288,0.00495993052332493,EPCI
200073245,CC du Bassin d'Aubenas,1982_1990,1986,8,31317,32500,2960,2775,1183,-185,1368,0.00464563368179105,-0.000726493855563267,0.00537212753735432,EPCI
200073245,CC du Bassin d'Aubenas,1990_1999,1994.5,9,32500,33608,3495,3011,1108,-484,1592,0.0037318398756101,-0.00163015388068167,0.00536199375629177,EPCI
200073245,CC du Bassin d'Aubenas,1999_2010,2004.5,11,33608,37299,4381,4225,3691,-156,3847,0.00951795423586876,-0.000402276039229349,0.00992023027509811,EPCI
200073252,CC de la Castagniccia-Casinca,2010_2015,2012.5,5,11622,12367,575,620,745,45,700,0.01250388418308,0.00075526817213235,0.0117486160109477,EPCI
200073252,CC de la Castagniccia-Casinca,1968_1975,1971.5,7,8648,8471,780,595,-177,-185,8,-0.00294985700912342,-0.00308318387959228,0.000133326870468855,EPCI
200073252,CC de la Castagniccia-Casinca,1975_1982,1978.5,7,8471,8440,765,471,-31,-294,263,-0.000523613843763204,-0.00496588613117361,0.00444227228741041,EPCI
200073252,CC de la Castagniccia-Casinca,1982_1990,1986,8,8440,8729,873,740,289,-133,422,0.00421743183285117,-0.00194089423449552,0.00615832606734669,EPCI
200073252,CC de la Castagniccia-Casinca,1990_1999,1994.5,9,8729,10001,959,955,1272,-4,1276,0.0152297272372386,-4.78922240164735e-05,0.0152776194612551,EPCI
200073252,CC de la Castagniccia-Casinca,1999_2010,2004.5,11,10001,11622,1170,1175,1621,5,1616,0.0137495553081717,4.24107196427257e-05,0.013707144588529,EPCI
200073260,CC Sud Vendée Littoral,2010_2015,2012.5,5,53062,54732,3056,2795,1670,-261,1931,0.00621674551401763,-0.000971599149196767,0.0071883446632144,EPCI
200073260,CC Sud Vendée Littoral,1968_1975,1971.5,7,43736,43057,3785,4674,-679,889,-1568,-0.00223275259307076,0.00292329463216481,-0.00515604722523558,EPCI
200073260,CC Sud Vendée Littoral,1975_1982,1978.5,7,43057,43993,3891,4032,936,141,795,0.00307696861841245,0.000463517708542901,0.00261345090986955,EPCI
200073260,CC Sud Vendée Littoral,1982_1990,1986,8,43993,45068,4415,4175,1075,-240,1315,0.00302229920850428,-0.000674745869805606,0.00369704507830988,EPCI
200073260,CC Sud Vendée Littoral,1990_1999,1994.5,9,45068,46498,4953,4126,1430,-827,2257,0.00347679013019708,-0.00201070310326782,0.00548749323346491,EPCI
200073260,CC Sud Vendée Littoral,1999_2010,2004.5,11,46498,53062,6570,5854,6564,-716,7280,0.0120770493213194,-0.00131736247929078,0.0133944118006101,EPCI
200073344,CA Rambouillet Territoires,2010_2015,2012.5,5,77872,77701,2469,3971,-171,1502,-1673,-0.000439568518927014,0.00386100535338231,-0.00430057387230932,EPCI
200073344,CA Rambouillet Territoires,1968_1975,1971.5,7,34360,45609,2665,4463,11249,1798,9451,0.0412884625305414,0.00659940044714316,0.0346890620833983,EPCI
200073344,CA Rambouillet Territoires,1975_1982,1978.5,7,45609,57037,2840,5099,11428,2259,9169,0.0324577854211241,0.0064160078111935,0.0260417776099306,EPCI
200073344,CA Rambouillet Territoires,1982_1990,1986,8,57037,67692,3340,6200,10655,2860,7795,0.021639283650976,0.00580838585094241,0.0158308978000336,EPCI
200073344,CA Rambouillet Territoires,1990_1999,1994.5,9,67692,72203,4061,7562,4511,3501,1010,0.00719392973627864,0.00558322944063656,0.00161070029564208,EPCI
200073344,CA Rambouillet Territoires,1999_2010,2004.5,11,72203,77872,5047,9361,5669,4314,1355,0.00689501251401015,0.00524697195015695,0.00164804056385319,EPCI
200073393,CC des Rives du Haut-Allier,2010_2015,2012.5,5,17898,17270,1360,656,-628,-704,76,-0.00711816154152256,-0.00797959510387243,0.000861433562349865,EPCI
200073393,CC des Rives du Haut-Allier,1968_1975,1971.5,7,23943,21766,2485,1843,-2177,-642,-1535,-0.0135258194184748,-0.00398878092175507,-0.00953703849671968,EPCI
200073393,CC des Rives du Haut-Allier,1975_1982,1978.5,7,21766,20500,2336,1382,-1266,-954,-312,-0.00852406709186115,-0.0064233491355731,-0.00210071795628806,EPCI
200073393,CC des Rives du Haut-Allier,1982_1990,1986,8,20500,18714,2495,1397,-1786,-1098,-688,-0.0113294552401533,-0.00696514101550296,-0.00436431422465031,EPCI
200073393,CC des Rives du Haut-Allier,1990_1999,1994.5,9,18714,17838,2620,1467,-876,-1153,277,-0.00531260389600796,-0.00699250261654929,0.00167989872054133,EPCI
200073393,CC des Rives du Haut-Allier,1999_2010,2004.5,11,17838,17898,2873,1773,60,-1100,1160,0.000305315828179165,-0.00559745684995135,0.00590277267813052,EPCI
200073401,CC Mézenc-Loire-Meygal,2010_2015,2012.5,5,11035,11036,701,499,1,-202,203,1.81234934966135e-05,-0.00366094568631592,0.00367906917981253,EPCI
200073401,CC Mézenc-Loire-Meygal,1968_1975,1971.5,7,13332,11740,1416,1016,-1592,-400,-1192,-0.018002462242929,-0.0045232317193289,-0.0134792305236001,EPCI
200073401,CC Mézenc-Loire-Meygal,1975_1982,1978.5,7,11740,10966,1269,776,-774,-493,-281,-0.00969586580490833,-0.00617579049330724,-0.00352007531160109,EPCI
200073401,CC Mézenc-Loire-Meygal,1982_1990,1986,8,10966,10633,1212,870,-333,-342,9,-0.00384723091014461,-0.0039512101239323,0.000103979213787692,EPCI
200073401,CC Mézenc-Loire-Meygal,1990_1999,1994.5,9,10633,10491,1338,879,-142,-459,317,-0.00149273208988487,-0.00482509879758561,0.00333236670770074,EPCI
200073401,CC Mézenc-Loire-Meygal,1999_2010,2004.5,11,10491,11035,1532,1215,544,-317,861,0.0046064219066162,-0.00268425688308334,0.00729067878969953,EPCI
200073419,CA du Puy-en-Velay,2010_2015,2012.5,5,81255,82412,4377,4058,1157,-319,1476,0.0028317417481305,-0.000780748157004002,0.0036124899051345,EPCI
200073419,CA du Puy-en-Velay,1968_1975,1971.5,7,75775,78175,6837,8061,2400,1224,1176,0.00446443322050483,0.00227686094245746,0.00218757227804737,EPCI
200073419,CA du Puy-en-Velay,1975_1982,1978.5,7,78175,79602,6660,7066,1427,406,1021,0.00258752972272114,0.000736185751524024,0.00185134397119711,EPCI
200073419,CA du Puy-en-Velay,1982_1990,1986,8,79602,79594,7506,7482,-8,-24,16,-1.25630508216457e-05,-3.7689152464937e-05,2.51261016432913e-05,EPCI
200073419,CA du Puy-en-Velay,1990_1999,1994.5,9,79594,79189,7747,7505,-405,-242,-163,-0.000566651929830853,-0.000338592017331028,-0.000228059912499825,EPCI
200073419,CA du Puy-en-Velay,1999_2010,2004.5,11,79189,81255,9253,9424,2066,171,1895,0.00234410289529241,0.000194018197045016,0.00215008469824739,EPCI
200073427,CC Marches du Velay-Rochebaron,2010_2015,2012.5,5,29238,30312,1254,1766,1074,512,562,0.00724097813847124,0.00345193743658964,0.0037890407018816,EPCI
200073427,CC Marches du Velay-Rochebaron,1968_1975,1971.5,7,17724,18004,1890,1655,280,-235,515,0.00224169486259407,-0.00188142247396288,0.00412311733655695,EPCI
200073427,CC Marches du Velay-Rochebaron,1975_1982,1978.5,7,18004,19638,1911,1636,1634,-275,1909,0.0124876865310317,-0.002101660829886,0.0145893473609177,EPCI
200073427,CC Marches du Velay-Rochebaron,1982_1990,1986,8,19638,21602,1954,2004,1964,50,1914,0.0119861953170204,0.000305147538620682,0.0116810477783997,EPCI
200073427,CC Marches du Velay-Rochebaron,1990_1999,1994.5,9,21602,24436,2121,2517,2834,396,2438,0.0137910705211677,0.00192705149131348,0.0118640190298542,EPCI
200073427,CC Marches du Velay-Rochebaron,1999_2010,2004.5,11,24436,29238,2628,3890,4802,1262,3540,0.0164438984507791,0.00432157431172079,0.0121223241390583,EPCI
200077014,CA Vienne Condrieu,2010_2015,2012.5,5,85554,88227,3155,5713,2673,2558,115,0.00617202555611751,0.00590648760663995,0.000265537949477559,EPCI
200077014,CA Vienne Condrieu,1968_1975,1971.5,7,57371,61962,4507,7206,4591,2699,1892,0.0110581723711694,0.00650098175338403,0.00455719061778532,EPCI
200077014,CA Vienne Condrieu,1975_1982,1978.5,7,61962,68708,4311,7067,6746,2756,3990,0.014872996559588,0.00607619011536087,0.00879680644422709,EPCI
200077014,CA Vienne Condrieu,1982_1990,1986,8,68708,74155,4620,8414,5447,3794,1653,0.00958209919105646,0.00667422146702188,0.00290787772403458,EPCI
200077014,CA Vienne Condrieu,1990_1999,1994.5,9,74155,79411,5278,9204,5256,3926,1330,0.00763784292433312,0.00570513152985765,0.00193271139447546,EPCI
200077014,CA Vienne Condrieu,1999_2010,2004.5,11,79411,85554,6539,12468,6143,5929,214,0.00679670783880715,0.00655993501160469,0.000236772827202463,EPCI
200077055,CA Coulommiers Pays de Brie,2010_2015,2012.5,5,71785,75243,2806,4899,3458,2093,1365,0.00945387530539099,0.00572208242168402,0.00373179288370697,EPCI
200077055,CA Coulommiers Pays de Brie,1968_1975,1971.5,7,39726,43106,3962,4309,3380,347,3033,0.0117334912610654,0.00120459215017446,0.0105288991108909,EPCI
200077055,CA Coulommiers Pays de Brie,1975_1982,1978.5,7,43106,48067,3999,4001,4961,2,4959,0.0156836709647639,6.322786117623e-06,0.0156773481786462,EPCI
200077055,CA Coulommiers Pays de Brie,1982_1990,1986,8,48067,57727,4678,5587,9660,909,8751,0.0231551541833712,0.00217888562657189,0.0209762685567993,EPCI
200077055,CA Coulommiers Pays de Brie,1990_1999,1994.5,9,57727,64287,5270,7649,6560,2379,4181,0.0120309557597111,0.00436305545005378,0.00766790030965736,EPCI
200077055,CA Coulommiers Pays de Brie,1999_2010,2004.5,11,64287,71785,6664,9876,7498,3212,4286,0.0100793769701431,0.0043178125937716,0.00576156437637145,EPCI
240100578,CC du Plateau d'Hauteville,2010_2015,2012.5,5,6618,6221,359,310,-397,-49,-348,-0.0122962839942412,-0.0015176773695663,-0.0107786066246749,EPCI
240100578,CC du Plateau d'Hauteville,1968_1975,1971.5,7,5922,5953,521,423,31,-98,129,0.000746144583458674,-0.00235877965093387,0.00310492423439255,EPCI
240100578,CC du Plateau d'Hauteville,1975_1982,1978.5,7,5953,5651,506,467,-302,-39,-263,-0.00740994902411452,-0.000956913946822735,-0.00645303507729178,EPCI
240100578,CC du Plateau d'Hauteville,1982_1990,1986,8,5651,6126,554,673,475,119,356,0.0101397483355892,0.0025402737935476,0.00759947454204157,EPCI
240100578,CC du Plateau d'Hauteville,1990_1999,1994.5,9,6126,5885,746,579,-241,-167,-74,-0.0044495454980813,-0.00308329501319326,-0.00136625048488803,EPCI
240100578,CC du Plateau d'Hauteville,1999_2010,2004.5,11,5885,6618,829,680,733,-149,882,0.0107286406763702,-0.00218085601743406,0.0129094966938043,EPCI
240100610,CC de la Côtière à Montluel,2010_2015,2012.5,5,22787,24598,668,1657,1811,989,822,0.0154125551441366,0.00841690614994541,0.00699564899419123,EPCI
240100610,CC de la Côtière à Montluel,1968_1975,1971.5,7,9278,11949,734,1526,2671,792,1879,0.0368041857517785,0.0109131093655592,0.0258910763862193,EPCI
240100610,CC de la Côtière à Montluel,1975_1982,1978.5,7,11949,14053,704,1550,2104,846,1258,0.0234402615714857,0.00942512418701374,0.014015137384472,EPCI
240100610,CC de la Côtière à Montluel,1982_1990,1986,8,14053,18016,875,2051,3963,1176,2787,0.0315402199497123,0.00935939910695476,0.0221808208427576,EPCI
240100610,CC de la Côtière à Montluel,1990_1999,1994.5,9,18016,20103,921,2538,2087,1617,470,0.0122532192222538,0.00949374963219181,0.00275946959006194,EPCI
240100610,CC de la Côtière à Montluel,1999_2010,2004.5,11,20103,22787,1152,3373,2684,2221,463,0.0114579763922287,0.00948143277464228,0.00197654361758639,EPCI
240100750,CC du Pays de Gex,2010_2015,2012.5,5,77067,90151,1496,4056,13084,2560,10524,0.0318591485342929,0.00623352340628171,0.0256256251280112,EPCI
240100750,CC du Pays de Gex,1968_1975,1971.5,7,22157,33281,1561,2497,11124,936,10188,0.0598411380542017,0.00503517666475483,0.0548059613894468,EPCI
240100750,CC du Pays de Gex,1975_1982,1978.5,7,33281,39677,1453,2696,6396,1243,5153,0.0254301103710348,0.00494209305678491,0.0204880173142499,EPCI
240100750,CC du Pays de Gex,1982_1990,1986,8,39677,50936,1880,3654,11259,1774,9485,0.031717390868842,0.0049974821388512,0.0267199087299908,EPCI
240100750,CC du Pays de Gex,1990_1999,1994.5,9,50936,57902,2210,4994,6966,2784,4182,0.0143443494320028,0.00573279770581335,0.00861155172618945,EPCI
240100750,CC du Pays de Gex,1999_2010,2004.5,11,57902,77067,2939,6471,19165,3532,15633,0.0263337871656031,0.00485316651546622,0.0214806206501369,EPCI
240100800,CC de Miribel et du Plateau,2010_2015,2012.5,5,22622,23284,740,1421,662,681,-19,0.00578538010355323,0.00595142575607213,-0.000166045652518899,EPCI
240100800,CC de Miribel et du Plateau,1968_1975,1971.5,7,11869,13528,855,1458,1659,603,1056,0.0188659918012659,0.00685725922613824,0.0120087325751277,EPCI
240100800,CC de Miribel et du Plateau,1975_1982,1978.5,7,13528,15972,918,1520,2444,602,1842,0.0240087612766642,0.00591377835047129,0.0180949829261929,EPCI
240100800,CC de Miribel et du Plateau,1982_1990,1986,8,15972,17920,1099,1848,1948,749,1199,0.0144889897008789,0.00557097191270958,0.00891801778816928,EPCI
240100800,CC de Miribel et du Plateau,1990_1999,1994.5,9,17920,20722,1273,2524,2802,1251,1551,0.0162730458036364,0.00726537483952504,0.00900767096411138,EPCI
240100800,CC de Miribel et du Plateau,1999_2010,2004.5,11,20722,22622,1612,2958,1900,1346,554,0.0080070633683651,0.00567237225990496,0.00233469110846014,EPCI
240100883,CC de la Plaine de l'Ain,2010_2015,2012.5,5,72679,76879,2772,5036,4200,2264,1936,0.0112994161106248,0.0060909233510606,0.00520849275956419,EPCI
240100883,CC de la Plaine de l'Ain,1968_1975,1971.5,7,40313,44609,3632,4717,4296,1085,3211,0.0145710860161474,0.00368008108182494,0.0108910049343225,EPCI
240100883,CC de la Plaine de l'Ain,1975_1982,1978.5,7,44609,48594,3449,4622,3985,1173,2812,0.0122985027727545,0.0036201113556941,0.00867839141706036,EPCI
240100883,CC de la Plaine de l'Ain,1982_1990,1986,8,48594,56073,4053,6207,7479,2154,5325,0.0180553554751874,0.00520005825558948,0.012855297219598,EPCI
240100883,CC de la Plaine de l'Ain,1990_1999,1994.5,9,56073,61664,4687,6819,5591,2132,3459,0.010616613737916,0.0040484028777029,0.0065682108602131,EPCI
240100883,CC de la Plaine de l'Ain,1999_2010,2004.5,11,61664,72679,5745,10034,11015,4289,6726,0.0150532847303471,0.0058614197193335,0.00919186501101356,EPCI
240100891,CC du Pays Bellegardien (Ccpb),2010_2015,2012.5,5,20943,21641,875,1432,698,557,141,0.00657858484793428,0.00524967300902492,0.00132891183890936,EPCI
240100891,CC du Pays Bellegardien (Ccpb),1968_1975,1971.5,7,16777,17669,1309,2178,892,869,23,0.00742784931613039,0.00723632405349474,0.000191525262635649,EPCI
240100891,CC du Pays Bellegardien (Ccpb),1975_1982,1978.5,7,17669,17232,1233,1774,-437,541,-978,-0.00357126085615767,0.00442117190659336,-0.00799243276275102,EPCI
240100891,CC du Pays Bellegardien (Ccpb),1982_1990,1986,8,17232,18015,1309,1921,783,612,171,0.00557003324406846,0.00435358920226041,0.00121644404180806,EPCI
240100891,CC du Pays Bellegardien (Ccpb),1990_1999,1994.5,9,18015,18795,1435,2300,780,865,-85,0.00472067776943463,0.00523511060328328,-0.000514432833848645,EPCI
240100891,CC du Pays Bellegardien (Ccpb),1999_2010,2004.5,11,18795,20943,1814,2858,2148,1044,1104,0.00988614684557598,0.0048049987461738,0.00508114809940218,EPCI
240200444,CC de la Thiérache du Centre,2010_2015,2012.5,5,27322,26745,1615,1659,-577,44,-621,-0.00425984072560792,0.000324840540600951,-0.00458468126620887,EPCI
240200444,CC de la Thiérache du Centre,1968_1975,1971.5,7,32783,30697,2878,3793,-2086,915,-3001,-0.00934819686045818,0.00410047944742053,-0.0134486763078787,EPCI
240200444,CC de la Thiérache du Centre,1975_1982,1978.5,7,30697,29338,2824,2957,-1359,133,-1492,-0.00644788344822878,0.000631029064469777,-0.00707891251269855,EPCI
240200444,CC de la Thiérache du Centre,1982_1990,1986,8,29338,28360,3055,3159,-978,104,-1082,-0.00422902020257065,0.000449711759782565,-0.00467873196235322,EPCI
240200444,CC de la Thiérache du Centre,1990_1999,1994.5,9,28360,27374,2997,3032,-986,35,-1021,-0.00392406331557971,0.000139292308362363,-0.00406335562394207,EPCI
240200444,CC de la Thiérache du Centre,1999_2010,2004.5,11,27374,27322,3337,3689,-52,352,-404,-0.000172841363371923,0.00117000307513302,-0.00134284443850494,EPCI
240200469,CC du Pays de la Serre,2010_2015,2012.5,5,15323,14677,830,898,-646,68,-714,-0.00857766509040747,0.000902912114779734,-0.0094805772051872,EPCI
240200469,CC du Pays de la Serre,1968_1975,1971.5,7,16651,15820,1376,1951,-831,575,-1406,-0.00728693663981717,0.00504210417315869,-0.0123290408129759,EPCI
240200469,CC du Pays de la Serre,1975_1982,1978.5,7,15820,15495,1449,1467,-325,18,-343,-0.00296097494108416,0.00016399245827543,-0.00312496739935959,EPCI
240200469,CC du Pays de la Serre,1982_1990,1986,8,15495,15387,1549,1802,-108,253,-361,-0.000873917182312778,0.0020472319178253,-0.00292114910013808,EPCI
240200469,CC du Pays de la Serre,1990_1999,1994.5,9,15387,15061,1580,1633,-326,53,-379,-0.00237654662480336,0.000386371077038582,-0.00276291770184194,EPCI
240200469,CC du Pays de la Serre,1999_2010,2004.5,11,15061,15323,1804,2006,262,202,60,0.001569079388547,0.00120974823086448,0.000359331157682519,EPCI
240200477,CA du Soissonnais,2010_2015,2012.5,5,51750,52076,2698,3231,326,533,-207,0.00125674061541381,0.00205473235587595,-0.000797991740462143,EPCI
240200477,CA du Soissonnais,1968_1975,1971.5,7,47584,53179,3320,7205,5595,3885,1710,0.0160077749268766,0.0111153182468124,0.00489245668006415,EPCI
240200477,CA du Soissonnais,1975_1982,1978.5,7,53179,54661,3344,6809,1482,3465,-1983,0.00393441867948896,0.00919889387613309,-0.00526447519664414,EPCI
240200477,CA du Soissonnais,1982_1990,1986,8,54661,53764,3616,7073,-897,3457,-4354,-0.00206615967708512,0.00796289186586763,-0.0100290515429528,EPCI
240200477,CA du Soissonnais,1990_1999,1994.5,9,53764,52452,4519,6548,-1312,2029,-3341,-0.00274130602193856,0.00423941304764736,-0.00698071906958592,EPCI
240200477,CA du Soissonnais,1999_2010,2004.5,11,52452,51750,5808,7309,-702,1501,-2203,-0.00122416223986244,0.00261747510261185,-0.00384163734247428,EPCI
240200493,CC du Pays du Vermandois,2010_2015,2012.5,5,31915,31443,1661,1927,-472,266,-738,-0.0029755115348854,0.00167687726330406,-0.00465238879818946,EPCI
240200493,CC du Pays du Vermandois,1968_1975,1971.5,7,31644,33569,3009,3964,1925,955,970,0.00847203842886346,0.00420301127250109,0.00426902715636237,EPCI
240200493,CC du Pays du Vermandois,1975_1982,1978.5,7,33569,33270,2760,3472,-299,712,-1011,-0.00127731668089492,0.00304163704614444,-0.00431895372703936,EPCI
240200493,CC du Pays du Vermandois,1982_1990,1986,8,33270,32898,2976,3802,-372,826,-1198,-0.0014045407556158,0.00311868458101788,-0.00452322533663369,EPCI
240200493,CC du Pays du Vermandois,1990_1999,1994.5,9,32898,32604,3043,3829,-294,786,-1080,-0.000996934443417419,0.00266527371607514,-0.00366220815949256,EPCI
240200493,CC du Pays du Vermandois,1999_2010,2004.5,11,32604,31915,3669,4530,-689,861,-1550,-0.00193983077559512,0.00242408461217329,-0.00436391538776841,EPCI
240200501,CC du Val de l'Aisne,2010_2015,2012.5,5,20082,20361,849,1240,279,391,-112,0.00276329386421814,0.00387257312153869,-0.00110927925732054,EPCI
240200501,CC du Val de l'Aisne,1968_1975,1971.5,7,16111,16176,1354,1847,65,493,-428,0.000575364568625503,0.00436391895895958,-0.00378855439033408,EPCI
240200501,CC du Val de l'Aisne,1975_1982,1978.5,7,16176,16434,1310,1423,258,113,145,0.0022630850959573,0.00099119618543866,0.00127188891051864,EPCI
240200501,CC du Val de l'Aisne,1982_1990,1986,8,16434,17634,1442,1943,1200,501,699,0.00884848053778775,0.00369424062452639,0.00515423991326137,EPCI
240200501,CC du Val de l'Aisne,1990_1999,1994.5,9,17634,18472,1447,1925,838,478,360,0.00517190786729538,0.00295008587179856,0.00222182199549682,EPCI
240200501,CC du Val de l'Aisne,1999_2010,2004.5,11,18472,20082,1827,2625,1610,798,812,0.00762600547899872,0.0037798461939385,0.00384615928506022,EPCI
240200519,CC du Canton d'Oulchy-le-Château,2010_2015,2012.5,5,5712,5720,223,387,8,164,-156,0.00027995525104374,0.00573908264639667,-0.00545912739535293,EPCI
240200519,CC du Canton d'Oulchy-le-Château,1968_1975,1971.5,7,5562,5052,445,646,-510,201,-711,-0.0136451283739978,0.0053777858885756,-0.0190229142625734,EPCI
240200519,CC du Canton d'Oulchy-le-Château,1975_1982,1978.5,7,5052,5042,398,511,-10,113,-123,-0.000283013618733285,0.00319805389168613,-0.00348106751041941,EPCI
240200519,CC du Canton d'Oulchy-le-Château,1982_1990,1986,8,5042,5347,456,666,305,210,95,0.00736861904259389,0.00507347540637612,0.00229514363621777,EPCI
240200519,CC du Canton d'Oulchy-le-Château,1990_1999,1994.5,9,5347,5468,411,620,121,209,-88,0.00248945610662554,0.00429996963871685,-0.0018105135320913,EPCI
240200519,CC du Canton d'Oulchy-le-Château,1999_2010,2004.5,11,5468,5712,492,740,244,248,-4,0.00397664104442042,0.00404183188121419,-6.51908367937772e-05,EPCI
240200576,CC de la Champagne Picarde,2010_2015,2012.5,5,20458,20983,900,1335,525,435,90,0.00508057900115522,0.00420962260095718,0.000870956400198037,EPCI
240200576,CC de la Champagne Picarde,1968_1975,1971.5,7,18265,17928,1470,2119,-337,649,-986,-0.00265688190350355,0.00511666574294897,-0.00777354764645252,EPCI
240200576,CC de la Champagne Picarde,1975_1982,1978.5,7,17928,18479,1414,1919,551,505,46,0.00433382335289179,0.00397201595863948,0.000361807394252309,EPCI
240200576,CC de la Champagne Picarde,1982_1990,1986,8,18479,19143,1629,2086,664,457,207,0.00442252077728567,0.00304381324581257,0.00137870753147309,EPCI
240200576,CC de la Champagne Picarde,1990_1999,1994.5,9,19143,19509,1588,2190,366,602,-236,0.00210652494614716,0.00346483064912729,-0.00135830570298014,EPCI
240200576,CC de la Champagne Picarde,1999_2010,2004.5,11,19509,20458,1738,2829,949,1091,-142,0.00432734571663218,0.00497485160889959,-0.000647505892267407,EPCI
240200584,CC du Canton de Charly-sur-Marne,2010_2015,2012.5,5,15488,15679,775,985,191,210,-19,0.00245434836262581,0.00269849819974566,-0.000244149837119845,EPCI
240200584,CC du Canton de Charly-sur-Marne,1968_1975,1971.5,7,10012,10243,1023,1096,231,73,158,0.00326391097901779,0.00103145238730865,0.00223245859170914,EPCI
240200584,CC du Canton de Charly-sur-Marne,1975_1982,1978.5,7,10243,11275,1003,943,1032,-60,1092,0.0138077933338165,-0.000802778682198636,0.0146105720160152,EPCI
240200584,CC du Canton de Charly-sur-Marne,1982_1990,1986,8,11275,12849,1074,1313,1574,239,1335,0.0164689043712134,0.00250067861799238,0.013968225753221,EPCI
240200584,CC du Canton de Charly-sur-Marne,1990_1999,1994.5,9,12849,14255,1265,1634,1406,369,1037,0.0116047896833413,0.00304563825971049,0.00855915142363084,EPCI
240200584,CC du Canton de Charly-sur-Marne,1999_2010,2004.5,11,14255,15488,1493,2154,1233,661,572,0.00757012855703909,0.00405827654193255,0.00351185201510654,EPCI
240200592,CC du Chemin des Dames,2010_2015,2012.5,5,5282,5414,300,348,132,48,84,0.00494888092228041,0.00179959306264742,0.00314928785963299,EPCI
240200592,CC du Chemin des Dames,1968_1975,1971.5,7,4484,4175,428,414,-309,-14,-295,-0.0101483185990493,-0.000459794370183464,-0.00968852422886584,EPCI
240200592,CC du Chemin des Dames,1975_1982,1978.5,7,4175,4230,392,383,55,-9,64,0.00187141101589439,-0.000306230893509991,0.00217764190940438,EPCI
240200592,CC du Chemin des Dames,1982_1990,1986,8,4230,4309,464,455,79,-9,88,0.00231566020613516,-0.00026380939057236,0.00257946959670752,EPCI
240200592,CC du Chemin des Dames,1990_1999,1994.5,9,4309,4616,560,477,307,-83,390,0.00767627609155963,-0.0020753450019526,0.00975162109351223,EPCI
240200592,CC du Chemin des Dames,1999_2010,2004.5,11,4616,5282,657,701,666,44,622,0.0123277575380418,0.000814446443954715,0.0115133110940871,EPCI
240200600,CC des Trois Rivières,2010_2015,2012.5,5,22154,21727,1312,1448,-427,136,-563,-0.00388490223426852,0.00123734591068037,-0.00512224814494889,EPCI
240200600,CC des Trois Rivières,1968_1975,1971.5,7,27513,26227,2369,3698,-1286,1329,-2615,-0.00681512892094793,0.00704300648206828,-0.0138581354030162,EPCI
240200600,CC des Trois Rivières,1975_1982,1978.5,7,26227,25187,2278,2887,-1040,609,-1649,-0.00576353048980205,0.00337499045027832,-0.00913852094008037,EPCI
240200600,CC des Trois Rivières,1982_1990,1986,8,25187,23757,2405,2961,-1430,556,-1986,-0.00727971910619696,0.00283043623989196,-0.0101101553460889,EPCI
240200600,CC des Trois Rivières,1990_1999,1994.5,9,23757,23206,2383,2815,-551,432,-983,-0.00260397686303093,0.00204159347518941,-0.00464557033822034,EPCI
240200600,CC des Trois Rivières,1999_2010,2004.5,11,23206,22154,2896,3409,-1052,513,-1565,-0.00420864588878311,0.00205231496287618,-0.00626096085165929,EPCI
240200634,CC des Portes de la Thiérache,2010_2015,2012.5,5,7474,7146,372,401,-328,29,-357,-0.00893535460510508,0.000790016108378193,-0.00972537071348328,EPCI
240200634,CC des Portes de la Thiérache,1968_1975,1971.5,7,9750,9085,757,1117,-665,360,-1025,-0.0100410462726749,0.00543575437317738,-0.0154768006458523,EPCI
240200634,CC des Portes de la Thiérache,1975_1982,1978.5,7,9085,8734,678,932,-351,254,-605,-0.00561293781065131,0.00406178405671063,-0.00967472186736194,EPCI
240200634,CC des Portes de la Thiérache,1982_1990,1986,8,8734,8022,762,942,-712,180,-892,-0.0105731678758535,0.00267299187872701,-0.0132461597545805,EPCI
240200634,CC des Portes de la Thiérache,1990_1999,1994.5,9,8022,7670,732,891,-352,159,-511,-0.00497327566100725,0.00224645122187543,-0.00721972688288268,EPCI
240200634,CC des Portes de la Thiérache,1999_2010,2004.5,11,7670,7474,826,967,-196,141,-337,-0.00235053173790345,0.00169094375022646,-0.00404147548812991,EPCI
240300491,CC du Pays de Lapalisse,2010_2015,2012.5,5,8610,8460,577,397,-150,-180,30,-0.00350885848191695,-0.00421063017830035,0.000701771696383391,EPCI
240300491,CC du Pays de Lapalisse,1968_1975,1971.5,7,10262,9628,1047,840,-634,-207,-427,-0.00906894572349004,-0.0029609964743887,-0.00610794924910134,EPCI
240300491,CC du Pays de Lapalisse,1975_1982,1978.5,7,9628,9187,969,726,-441,-243,-198,-0.00667562955462264,-0.00367840812193493,-0.00299722143268772,EPCI
240300491,CC du Pays de Lapalisse,1982_1990,1986,8,9187,9118,1002,768,-69,-234,165,-0.00094192604615817,-0.00319435789566684,0.00225243184950867,EPCI
240300491,CC du Pays de Lapalisse,1990_1999,1994.5,9,9118,8613,1071,793,-505,-278,-227,-0.00631086806847536,-0.00347410162977456,-0.00283676643870081,EPCI
240300491,CC du Pays de Lapalisse,1999_2010,2004.5,11,8613,8610,1398,898,-3,-500,497,-3.16696228157554e-05,-0.00527827046929256,0.00524660084647681,EPCI
240300558,CC du Pays de Tronçais,2010_2015,2012.5,5,7700,7496,751,253,-204,-498,294,-0.00535576326942799,-0.0130743632753683,0.00771860000594034,EPCI
240300558,CC du Pays de Tronçais,1968_1975,1971.5,7,12194,11053,1391,866,-1141,-525,-616,-0.0139365661146331,-0.00641253042084346,-0.00752403569378966,EPCI
240300558,CC du Pays de Tronçais,1975_1982,1978.5,7,11053,10011,1426,599,-1042,-827,-215,-0.0140457669780272,-0.0111476480718124,-0.00289811890621482,EPCI
240300558,CC du Pays de Tronçais,1982_1990,1986,8,10011,9238,1514,577,-773,-937,164,-0.00999460319840428,-0.012115062350459,0.00212045915205473,EPCI
240300558,CC du Pays de Tronçais,1990_1999,1994.5,9,9238,8342,1477,581,-896,-896,0,-0.0112718156636021,-0.0112718156636021,0,EPCI
240300558,CC du Pays de Tronçais,1999_2010,2004.5,11,8342,7700,1671,715,-642,-956,314,-0.0072538056760566,-0.0108016171749379,0.00354781149888127,EPCI
240300566,CC du Val de Cher,2010_2015,2012.5,5,5724,5562,346,233,-162,-113,-49,-0.00572556728082674,-0.00399375989341618,-0.00173180738741056,EPCI
240300566,CC du Val de Cher,1968_1975,1971.5,7,5381,5100,521,419,-281,-102,-179,-0.00763267786495081,-0.00277058057731311,-0.0048620972876377,EPCI
240300566,CC du Val de Cher,1975_1982,1978.5,7,5100,5454,496,298,354,-198,552,0.0096330656711745,-0.00538798588387726,0.0150210515550518,EPCI
240300566,CC du Val de Cher,1982_1990,1986,8,5454,5538,575,356,84,-219,303,0.00191234374211979,-0.00498575332766946,0.00689809706978925,EPCI
240300566,CC du Val de Cher,1990_1999,1994.5,9,5538,5421,607,476,-117,-131,14,-0.00236975706745368,-0.00265331774219173,0.000283560674738048,EPCI
240300566,CC du Val de Cher,1999_2010,2004.5,11,5421,5724,739,621,303,-118,421,0.00495656710386516,-0.00193028025827092,0.00688684736213608,EPCI
240300657,CC du Pays d'Huriel,2010_2015,2012.5,5,7552,7670,412,382,118,-30,148,0.0031056498762414,-0.000789572002434255,0.00389522187867566,EPCI
240300657,CC du Pays d'Huriel,1968_1975,1971.5,7,8856,7706,972,539,-1150,-433,-717,-0.0196747257478089,-0.00740796195547936,-0.0122667637923296,EPCI
240300657,CC du Pays d'Huriel,1975_1982,1978.5,7,7706,7425,922,418,-281,-504,223,-0.00529259624255374,-0.00949277048486507,0.00420017424231133,EPCI
240300657,CC du Pays d'Huriel,1982_1990,1986,8,7425,7554,886,504,129,-382,511,0.00215538696430162,-0.00638261876250557,0.00853800572680719,EPCI
240300657,CC du Pays d'Huriel,1990_1999,1994.5,9,7554,7153,877,482,-401,-395,-6,-0.00604226886664783,-0.00595186085368053,-9.04080129672993e-05,EPCI
240300657,CC du Pays d'Huriel,1999_2010,2004.5,11,7153,7552,944,848,399,-96,495,0.00494679333675485,-0.00119020591561019,0.00613699925236504,EPCI
240400440,CC Pays Forcalquier et Montagne de Lure,2010_2015,2012.5,5,9235,9625,589,418,390,-171,561,0.00830696625532701,-0.00364228520425877,0.0119492514595858,EPCI
240400440,CC Pays Forcalquier et Montagne de Lure,1968_1975,1971.5,7,5160,5484,554,415,324,-139,463,0.00873769303577143,-0.00374857818509947,0.0124862712208709,EPCI
240400440,CC Pays Forcalquier et Montagne de Lure,1975_1982,1978.5,7,5484,6276,661,413,792,-248,1040,0.0194580405656288,-0.00609292179327771,0.0255509623589066,EPCI
240400440,CC Pays Forcalquier et Montagne de Lure,1982_1990,1986,8,6276,7461,766,669,1185,-97,1282,0.0218549737187252,-0.00178897253225008,0.0236439462509753,EPCI
240400440,CC Pays Forcalquier et Montagne de Lure,1990_1999,1994.5,9,7461,8018,1016,750,557,-266,823,0.00803203630457361,-0.00383576599105311,0.0118678022956267,EPCI
240400440,CC Pays Forcalquier et Montagne de Lure,1999_2010,2004.5,11,8018,9235,1474,878,1217,-596,1813,0.0129293799233807,-0.00633189025006977,0.0192612701734505,EPCI
240500439,CC du Briançonnais,2010_2015,2012.5,5,20017,21017,716,1115,1000,399,601,0.00979762986551824,0.00390925431634178,0.00588837554917646,EPCI
240500439,CC du Briançonnais,1968_1975,1971.5,7,13273,14643,865,1713,1370,848,522,0.0141318535954336,0.0087473079189253,0.00538454567650826,EPCI
240500439,CC du Briançonnais,1975_1982,1978.5,7,14643,16072,953,1753,1429,800,629,0.0133911868636079,0.00749681559894072,0.00589437126466714,EPCI
240500439,CC du Briançonnais,1982_1990,1986,8,16072,18347,1059,2146,2275,1087,1188,0.0166861144500268,0.0079726621570018,0.00871345229302497,EPCI
240500439,CC du Briançonnais,1990_1999,1994.5,9,18347,18613,1269,2330,266,1061,-795,0.00160063386235332,0.00638448318780778,-0.00478384932545447,EPCI
240500439,CC du Briançonnais,1999_2010,2004.5,11,18613,20017,1582,2716,1404,1134,270,0.0066329604881461,0.00535739116350262,0.00127556932464348,EPCI
240500462,CC du Pays des Ecrins,2010_2015,2012.5,5,6611,6710,255,351,99,96,3,0.00297722769178876,0.00288700867082547,9.02190209632961e-05,EPCI
240500462,CC du Pays des Ecrins,1968_1975,1971.5,7,4946,5012,386,497,66,111,-45,0.0018954895927592,0.00318786886054957,-0.00129237926779037,EPCI
240500462,CC du Pays des Ecrins,1975_1982,1978.5,7,5012,5468,411,490,456,79,377,0.0125173922723703,0.00216858331034485,0.0103488089620254,EPCI
240500462,CC du Pays des Ecrins,1982_1990,1986,8,5468,5462,396,621,-6,225,-231,-0.000137227559710684,0.00514603348915066,-0.00528326104886134,EPCI
240500462,CC du Pays des Ecrins,1990_1999,1994.5,9,5462,5912,495,651,450,156,294,0.00883537694712566,0.00306293067500356,0.0057724462721221,EPCI
240500462,CC du Pays des Ecrins,1999_2010,2004.5,11,5912,6611,571,763,699,192,507,0.0102109380580848,0.0028047211833366,0.00740621687474822,EPCI
240600551,CA de la Riviera Française,2010_2015,2012.5,5,71440,71666,3300,1039,226,-2261,2487,0.000631899669022662,-0.00632179270646123,0.0069536923754839,EPCI
240600551,CA de la Riviera Française,1968_1975,1971.5,7,59119,58648,4919,3360,-471,-1559,1088,-0.0011420456298018,-0.00378014678739068,0.00263810115758888,EPCI
240600551,CA de la Riviera Française,1975_1982,1978.5,7,58648,60266,5140,3517,1618,-1623,3241,0.00389537064818324,-0.0039074082583445,0.00780277890652774,EPCI
240600551,CA de la Riviera Française,1982_1990,1986,8,60266,67293,7201,4822,7027,-2379,9406,0.0138814805582821,-0.00469959331836532,0.0185810738766474,EPCI
240600551,CA de la Riviera Française,1990_1999,1994.5,9,67293,67882,6529,2925,589,-3604,4193,0.000968767211837918,-0.00592773689552437,0.00689650410736229,EPCI
240600551,CA de la Riviera Française,1999_2010,2004.5,11,67882,71440,7506,3022,3558,-4484,8042,0.00465507707955593,-0.00586660079390915,0.0105216778734651,EPCI
240600585,CA de Sophia Antipolis,2010_2015,2012.5,5,175769,175908,8126,9737,139,1611,-1472,0.000158112126459331,0.00183250817069052,-0.00167439604423119,EPCI
240600585,CA de Sophia Antipolis,1968_1975,1971.5,7,82327,101874,7141,7148,19547,7,19540,0.0309017943266485,1.10662792390924e-05,0.0308907280474094,EPCI
240600585,CA de Sophia Antipolis,1975_1982,1978.5,7,101874,122565,8954,8710,20691,-244,20935,0.0267669310947158,-0.000315650823406827,0.0270825819181227,EPCI
240600585,CA de Sophia Antipolis,1982_1990,1986,8,122565,149858,11600,12993,27293,1393,25900,0.0254492760905047,0.00129889867709937,0.0241503774134054,EPCI
240600585,CA de Sophia Antipolis,1990_1999,1994.5,9,149858,161120,13989,16372,11262,2383,8879,0.00808374846271209,0.00171049303735064,0.00637325542536145,EPCI
240600585,CA de Sophia Antipolis,1999_2010,2004.5,11,161120,175769,17234,20628,14649,3394,11255,0.00794239333226532,0.00184015857530947,0.00610223475695584,EPCI
240600593,CC du Pays des Paillons,2010_2015,2012.5,5,25554,26518,1700,1324,964,-376,1340,0.00743346958274294,-0.00289936157999102,0.010332831162734,EPCI
240600593,CC du Pays des Paillons,1968_1975,1971.5,7,12337,13343,1483,957,1006,-526,1532,0.0112613693940973,-0.00588815139293754,0.0171495207870348,EPCI
240600593,CC du Pays des Paillons,1975_1982,1978.5,7,13343,17224,1661,934,3881,-727,4608,0.0371464277106481,-0.00695837488936903,0.0441048026000172,EPCI
240600593,CC du Pays des Paillons,1982_1990,1986,8,17224,21119,2006,1658,3895,-348,4243,0.0258111532488432,-0.00230610560477469,0.0281172588536179,EPCI
240600593,CC du Pays des Paillons,1990_1999,1994.5,9,21119,23415,2784,2077,2296,-707,3003,0.0115330804989473,-0.00355134490973682,0.0150844254086841,EPCI
240600593,CC du Pays des Paillons,1999_2010,2004.5,11,23415,25554,3860,2628,2139,-1232,3371,0.00797866282618154,-0.00459547106211111,0.0125741338882926,EPCI
240700302,CC du Pays Beaume-Drobie,2010_2015,2012.5,5,8235,8667,564,367,432,-197,629,0.0102783321797142,-0.00468710981343448,0.0149654419931487,EPCI
240700302,CC du Pays Beaume-Drobie,1968_1975,1971.5,7,6535,6161,797,385,-374,-412,38,-0.00838369417912876,-0.0092355133737996,0.000851819194670837,EPCI
240700302,CC du Pays Beaume-Drobie,1975_1982,1978.5,7,6161,6479,828,377,318,-451,769,0.0072154893010461,-0.0102332882854459,0.017448777586492,EPCI
240700302,CC du Pays Beaume-Drobie,1982_1990,1986,8,6479,6951,905,474,472,-431,903,0.00882866436240692,-0.00806176766990971,0.0168904320323166,EPCI
240700302,CC du Pays Beaume-Drobie,1990_1999,1994.5,9,6951,7057,994,515,106,-479,585,0.00168302557826894,-0.0076053703018002,0.00928839588006914,EPCI
240700302,CC du Pays Beaume-Drobie,1999_2010,2004.5,11,7057,8235,1131,738,1178,-393,1571,0.0141328772508544,-0.00471495819998794,0.0188478354508424,EPCI
240700617,CC Val de Ligne,2010_2015,2012.5,5,6115,6217,391,281,102,-110,212,0.00331402049327045,-0.00357394366921323,0.00688796416248369,EPCI
240700617,CC Val de Ligne,1968_1975,1971.5,7,6104,5729,566,638,-375,72,-447,-0.00901671746138621,0.00173120975258615,-0.0107479272139724,EPCI
240700617,CC Val de Ligne,1975_1982,1978.5,7,5729,5818,541,457,89,-84,173,0.00220465019619009,-0.00208079344359515,0.00428544363978524,EPCI
240700617,CC Val de Ligne,1982_1990,1986,8,5818,5630,585,514,-188,-71,-117,-0.00409747209947275,-0.00154744956948173,-0.00255002252999102,EPCI
240700617,CC Val de Ligne,1990_1999,1994.5,9,5630,5640,629,537,10,-92,102,0.000197199814479632,-0.00181423829321261,0.00201143810769224,EPCI
240700617,CC Val de Ligne,1999_2010,2004.5,11,5640,6115,838,605,475,-233,708,0.00737805778533507,-0.00361913150312225,0.0109971892884573,EPCI
240700716,CC du Val d'Ay,2010_2015,2012.5,5,5791,5876,331,318,85,-13,98,0.00291850457989717,-0.000446359523984274,0.00336486410388145,EPCI
240700716,CC du Val d'Ay,1968_1975,1971.5,7,5103,4919,482,491,-184,9,-193,-0.00523245480614232,0.000255935289430874,-0.00548839009557319,EPCI
240700716,CC du Val d'Ay,1975_1982,1978.5,7,4919,4939,460,397,20,-63,83,0.000579828570675067,-0.00182645999762646,0.00240628856830153,EPCI
240700716,CC du Val d'Ay,1982_1990,1986,8,4939,5126,498,449,187,-49,236,0.0046561496316655,-0.00122006059867171,0.0058762102303372,EPCI
240700716,CC du Val d'Ay,1990_1999,1994.5,9,5126,5089,509,452,-37,-57,20,-0.000804596176009476,-0.00123951302790649,0.000434916851897014,EPCI
240700716,CC du Val d'Ay,1999_2010,2004.5,11,5089,5791,760,666,702,-94,796,0.0118168777929966,-0.00158231696943259,0.0133991947624292,EPCI
240700815,CC Berg et Coiron,2010_2015,2012.5,5,6937,7542,406,389,605,-17,622,0.0168642210757994,-0.000473870674857174,0.0173380917506566,EPCI
240700815,CC Berg et Coiron,1968_1975,1971.5,7,4346,4157,469,347,-189,-122,-67,-0.00633161624156975,-0.00408707503424079,-0.00224454120732896,EPCI
240700815,CC Berg et Coiron,1975_1982,1978.5,7,4157,4720,494,267,563,-227,790,0.01831064099363,-0.00738279841128599,0.025693439404916,EPCI
240700815,CC Berg et Coiron,1982_1990,1986,8,4720,5099,570,416,379,-154,533,0.0097012099053595,-0.00394191642592444,0.0136431263312839,EPCI
240700815,CC Berg et Coiron,1990_1999,1994.5,9,5099,5733,661,487,634,-174,808,0.0131067628203072,-0.00359712418096759,0.0167038870012748,EPCI
240700815,CC Berg et Coiron,1999_2010,2004.5,11,5733,6937,707,779,1204,72,1132,0.0174810773396028,0.00104538004024203,0.0164356972993608,EPCI
240700864,CC du Rhône aux Gorges de l'Ardèche,2010_2015,2012.5,5,18722,19013,1107,1174,291,67,224,0.00308949323281227,0.000711326620613134,0.00237816661219913,EPCI
240700864,CC du Rhône aux Gorges de l'Ardèche,1968_1975,1971.5,7,13846,13445,980,1463,-401,483,-884,-0.00418964065530647,0.00504637515339907,-0.00923601580870554,EPCI
240700864,CC du Rhône aux Gorges de l'Ardèche,1975_1982,1978.5,7,13445,14937,1105,1292,1492,187,1305,0.0151470086219541,0.00189845215301971,0.0132485564689344,EPCI
240700864,CC du Rhône aux Gorges de l'Ardèche,1982_1990,1986,8,14937,16261,1167,1661,1324,494,830,0.0106725808045429,0.00398206564761647,0.00669051515692645,EPCI
240700864,CC du Rhône aux Gorges de l'Ardèche,1990_1999,1994.5,9,16261,17031,1628,1800,770,172,598,0.0051538590090785,0.00115125162280715,0.00400260738627135,EPCI
240700864,CC du Rhône aux Gorges de l'Ardèche,1999_2010,2004.5,11,17031,18722,2299,2384,1691,85,1606,0.00864296294972156,0.000434448167194756,0.0082085147825268,EPCI
240800821,"CC Ardenne, Rives de Meuse",2010_2015,2012.5,5,28690,27382,1217,869,-1308,-348,-960,-0.00928914023698435,-0.00247142263185822,-0.00681771760512613,EPCI
240800821,"CC Ardenne, Rives de Meuse",1968_1975,1971.5,7,38474,37697,2529,5386,-777,2857,-3634,-0.00291035280156926,0.0107012586281639,-0.0136116114297332,EPCI
240800821,"CC Ardenne, Rives de Meuse",1975_1982,1978.5,7,37697,35783,2457,4101,-1914,1644,-3558,-0.00741630468232102,0.00637011750142934,-0.0137864221837504,EPCI
240800821,"CC Ardenne, Rives de Meuse",1982_1990,1986,8,35783,34724,2517,4258,-1059,1741,-2800,-0.00374818666623178,0.00616203303674176,-0.00991021970297354,EPCI
240800821,"CC Ardenne, Rives de Meuse",1990_1999,1994.5,9,34724,32616,2788,3945,-2108,1157,-3265,-0.00693452500214919,0.00380609365630295,-0.0107406186584521,EPCI
240800821,"CC Ardenne, Rives de Meuse",1999_2010,2004.5,11,32616,28690,3118,3448,-3926,330,-4256,-0.0115917766556297,0.000974346993468621,-0.0125661236490983,EPCI
240800847,CC des Portes du Luxembourg,2010_2015,2012.5,5,20536,20470,1026,1144,-66,118,-184,-0.00064360157872434,0.00115068161044655,-0.00179428318917089,EPCI
240800847,CC des Portes du Luxembourg,1968_1975,1971.5,7,24257,23541,1972,2710,-716,738,-1454,-0.00427108908839713,0.00440232366932553,-0.00867341275772266,EPCI
240800847,CC des Portes du Luxembourg,1975_1982,1978.5,7,23541,22117,1887,2106,-1424,219,-1643,-0.00887425191270441,0.00136479014668698,-0.0102390420593914,EPCI
240800847,CC des Portes du Luxembourg,1982_1990,1986,8,22117,20703,1834,2199,-1414,365,-1779,-0.00822448313166813,0.00212301014360599,-0.0103474932752741,EPCI
240800847,CC des Portes du Luxembourg,1990_1999,1994.5,9,20703,20171,2060,2021,-532,-39,-493,-0.00288834157949391,-0.000211739326316283,-0.00267660225317763,EPCI
240800847,CC des Portes du Luxembourg,1999_2010,2004.5,11,20171,20536,2428,2658,365,230,135,0.00163164917054948,0.00102816249103118,0.000603486679518299,EPCI
240800862,CC des Crêtes Préardennaises,2010_2015,2012.5,5,21595,21975,948,1321,380,373,7,0.00349482012444935,0.00343044185899897,6.4378265450383e-05,EPCI
240800862,CC des Crêtes Préardennaises,1968_1975,1971.5,7,23047,21028,2247,2211,-2019,-36,-1983,-0.0130118508844622,-0.000232009228251927,-0.0127798416562103,EPCI
240800862,CC des Crêtes Préardennaises,1975_1982,1978.5,7,21028,20005,2119,1717,-1023,-402,-621,-0.00709934270705792,-0.00278977103444505,-0.00430957167261287,EPCI
240800862,CC des Crêtes Préardennaises,1982_1990,1986,8,20005,20207,1995,1988,202,-7,209,0.00125664350586585,-4.35470521834701e-05,0.00130019055804932,EPCI
240800862,CC des Crêtes Préardennaises,1990_1999,1994.5,9,20207,20243,1967,1899,36,-68,104,0.000197794641901172,-0.000373612101368881,0.000571406743270053,EPCI
240800862,CC des Crêtes Préardennaises,1999_2010,2004.5,11,20243,21595,2182,2826,1352,644,708,0.00589482940321506,0.00280789211218232,0.00308693729103274,EPCI
240800920,CC de l'Argonne Ardennaise,2010_2015,2012.5,5,18027,17486,1107,968,-541,-139,-402,-0.00607548380647294,-0.00156098382458362,-0.00451449998188932,EPCI
240800920,CC de l'Argonne Ardennaise,1968_1975,1971.5,7,22602,20886,2107,2357,-1716,250,-1966,-0.011216523265031,0.00163410886728307,-0.012850632132314,EPCI
240800920,CC de l'Argonne Ardennaise,1975_1982,1978.5,7,20886,19636,1903,1782,-1250,-121,-1129,-0.00877760162759589,-0.000849671837551282,-0.00792792979004461,EPCI
240800920,CC de l'Argonne Ardennaise,1982_1990,1986,8,19636,18878,2027,1934,-758,-93,-665,-0.00490883625035588,-0.000602271466072687,-0.00430656478428319,EPCI
240800920,CC de l'Argonne Ardennaise,1990_1999,1994.5,9,18878,18220,2045,1911,-658,-134,-524,-0.00393416648426914,-0.000801182840261497,-0.00313298364400765,EPCI
240800920,CC de l'Argonne Ardennaise,1999_2010,2004.5,11,18220,18027,2341,2202,-193,-139,-54,-0.000967645875033618,-0.000696905578392088,-0.000270740296641531,EPCI
240900431,CC du Pays de Tarascon,2010_2015,2012.5,5,8891,8633,481,315,-258,-166,-92,-0.00587218291644442,-0.00377822621755727,-0.00209395669888716,EPCI
240900431,CC du Pays de Tarascon,1968_1975,1971.5,7,8875,9134,862,777,259,-85,344,0.00411779482914754,-0.00135139984740363,0.00546919467655117,EPCI
240900431,CC du Pays de Tarascon,1975_1982,1978.5,7,9134,8947,888,663,-187,-225,38,-0.00295070013001508,-0.00355030764306628,0.000599607513051193,EPCI
240900431,CC du Pays de Tarascon,1982_1990,1986,8,8947,8574,931,695,-373,-236,-137,-0.00530884704620438,-0.00335894880135183,-0.00194989824485255,EPCI
240900431,CC du Pays de Tarascon,1990_1999,1994.5,9,8574,8406,995,711,-168,-284,116,-0.00219632139243553,-0.00371282902054578,0.00151650762811025,EPCI
240900431,CC du Pays de Tarascon,1999_2010,2004.5,11,8406,8891,1158,801,485,-357,842,0.00511245993844511,-0.00376319216087609,0.00887565209932121,EPCI
240900464,CC du Pays d'Olmes,2010_2015,2012.5,5,16017,15119,1038,563,-898,-475,-423,-0.0114733586428897,-0.00606887010620556,-0.00540448853668411,EPCI
240900464,CC du Pays d'Olmes,1968_1975,1971.5,7,17769,19224,1442,1904,1455,462,993,0.0113068926093307,0.00359022981822047,0.00771666279111024,EPCI
240900464,CC du Pays d'Olmes,1975_1982,1978.5,7,19224,19093,1543,1696,-131,153,-284,-0.000976340598038861,0.00114030619465607,-0.00211664679269493,EPCI
240900464,CC du Pays d'Olmes,1982_1990,1986,8,19093,18661,1718,1638,-432,-80,-352,-0.00285666085458902,-0.000529011269368337,-0.00232764958522068,EPCI
240900464,CC du Pays d'Olmes,1990_1999,1994.5,9,18661,16550,1904,1439,-2111,-465,-1646,-0.0132502853653876,-0.00291870331355057,-0.0103315820518371,EPCI
240900464,CC du Pays d'Olmes,1999_2010,2004.5,11,16550,16017,2163,1478,-533,-685,152,-0.0029715256734294,-0.00381894012438863,0.000847414450959228,EPCI
241000223,"CC Forêts, Lacs, Terres en Champagne",2010_2015,2012.5,5,6680,6934,262,392,254,130,124,0.00749169531666305,0.00383433224868581,0.00365736306797724,EPCI
241000223,"CC Forêts, Lacs, Terres en Champagne",1968_1975,1971.5,7,4992,4950,425,550,-42,125,-167,-0.00120627964288134,0.00359011798476588,-0.00479639762764722,EPCI
241000223,"CC Forêts, Lacs, Terres en Champagne",1975_1982,1978.5,7,4950,5259,404,431,309,27,282,0.00868799747460702,0.000759145410402555,0.00792885206420447,EPCI
241000223,"CC Forêts, Lacs, Terres en Champagne",1982_1990,1986,8,5259,5342,439,455,83,16,67,0.00195931947291528,0.000377700139357162,0.00158161933355812,EPCI
241000223,"CC Forêts, Lacs, Terres en Champagne",1990_1999,1994.5,9,5342,5552,478,558,210,80,130,0.00429342473131422,0.00163559037383399,0.00265783435748023,EPCI
241000223,"CC Forêts, Lacs, Terres en Champagne",1999_2010,2004.5,11,5552,6680,528,858,1128,330,798,0.0169566838057476,0.00496073196444742,0.0119959518413001,EPCI
241000405,CC de la Région de Bar-sur-Aube,2010_2015,2012.5,5,12081,11533,691,495,-548,-196,-352,-0.009241329856435,-0.00330529316033077,-0.00593603669610423,EPCI
241000405,CC de la Région de Bar-sur-Aube,1968_1975,1971.5,7,14413,15228,1102,1985,815,883,-68,0.00788884876672946,0.00854705946137683,-0.000658210694647367,EPCI
241000405,CC de la Région de Bar-sur-Aube,1975_1982,1978.5,7,15228,14911,1062,1502,-317,440,-757,-0.0030007235040348,0.00416504208761928,-0.00716576559165407,EPCI
241000405,CC de la Région de Bar-sur-Aube,1982_1990,1986,8,14911,14262,1188,1565,-649,377,-1026,-0.00554712481957953,0.00322228976422416,-0.0087694145838037,EPCI
241000405,CC de la Région de Bar-sur-Aube,1990_1999,1994.5,9,14262,13292,1323,1431,-970,108,-1078,-0.0077957109391148,0.000867976063324122,-0.00866368700243892,EPCI
241000405,CC de la Région de Bar-sur-Aube,1999_2010,2004.5,11,13292,12081,1509,1407,-1211,-102,-1109,-0.00864679771638421,-0.000728301706912626,-0.00791849600947159,EPCI
241000447,CC du Pays d'Othe,2010_2015,2012.5,5,7939,7922,516,387,-17,-129,112,-0.000428632819344577,-0.00325256668796767,0.00282393386862309,EPCI
241000447,CC du Pays d'Othe,1968_1975,1971.5,7,7264,6781,879,648,-483,-231,-252,-0.00978128578065718,-0.004678006242923,-0.00510327953773418,EPCI
241000447,CC du Pays d'Othe,1975_1982,1978.5,7,6781,6756,838,512,-25,-326,301,-0.000527515779765064,-0.00687880576813644,0.00635128998837137,EPCI
241000447,CC du Pays d'Othe,1982_1990,1986,8,6756,6711,900,587,-45,-313,268,-0.000835029639728591,-0.00580809504966775,0.00497306540993916,EPCI
241000447,CC du Pays d'Othe,1990_1999,1994.5,9,6711,6878,878,557,167,-321,488,0.00273483740061087,-0.00525678326704245,0.00799162066765331,EPCI
241000447,CC du Pays d'Othe,1999_2010,2004.5,11,6878,7939,977,937,1061,-40,1101,0.0131271793398662,-0.000494898372850751,0.0136220777127169,EPCI
241000488,CC de l'Orvin et de l'Ardusson,2010_2015,2012.5,5,8236,8515,404,500,279,96,183,0.00668515152267224,0.0023002671905969,0.00438488433207534,EPCI
241000488,CC de l'Orvin et de l'Ardusson,1968_1975,1971.5,7,6485,6289,534,630,-196,96,-292,-0.00437465209759635,0.00214268674167985,-0.0065173388392762,EPCI
241000488,CC de l'Orvin et de l'Ardusson,1975_1982,1978.5,7,6289,6765,514,578,476,64,412,0.0104773911859897,0.00140872486534315,0.00906866632064652,EPCI
241000488,CC de l'Orvin et de l'Ardusson,1982_1990,1986,8,6765,7301,614,700,536,86,450,0.00957669882869827,0.00153655988669413,0.00804013894200415,EPCI
241000488,CC de l'Orvin et de l'Ardusson,1990_1999,1994.5,9,7301,7435,647,693,134,46,88,0.00202284929783803,0.000694410952989173,0.00132843834484885,EPCI
241000488,CC de l'Orvin et de l'Ardusson,1999_2010,2004.5,11,7435,8236,807,983,801,176,625,0.00934486670946733,0.00205330404602528,0.00729156266344205,EPCI
241100593,CA Le Grand Narbonne,2010_2015,2012.5,5,120924,126983,6622,6407,6059,-215,6274,0.00982615677038812,-0.000348675310386771,0.0101748320807749,EPCI
241100593,CA Le Grand Narbonne,1968_1975,1971.5,7,77535,78510,7070,6802,975,-268,1243,0.0017868170147608,-0.000491145599954763,0.00227796261471556,EPCI
241100593,CA Le Grand Narbonne,1975_1982,1978.5,7,78510,83903,7405,6088,5393,-1317,6710,0.00953594649514056,-0.00232873011943262,0.0118646766145732,EPCI
241100593,CA Le Grand Narbonne,1982_1990,1986,8,83903,94545,8635,7905,10642,-730,11372,0.0150387790690047,-0.00103160202221138,0.0160703810912161,EPCI
241100593,CA Le Grand Narbonne,1990_1999,1994.5,9,94545,100566,9607,9294,6021,-313,6334,0.00688339538091021,-0.000357831382531954,0.00724122676344216,EPCI
241100593,CA Le Grand Narbonne,1999_2010,2004.5,11,100566,120924,12936,13191,20358,255,20103,0.0169001293079571,0.000211687443438897,0.0166884418645182,EPCI
241200187,CA Rodez Agglomération,2010_2015,2012.5,5,53311,55356,2283,3027,2045,744,1301,0.00755688330365345,0.00274930130949544,0.00480758199415801,EPCI
241200187,CA Rodez Agglomération,1968_1975,1971.5,7,35398,41902,2116,5042,6504,2926,3578,0.0243895672290775,0.0109723053063162,0.0134172619227613,EPCI
241200187,CA Rodez Agglomération,1975_1982,1978.5,7,41902,46618,2267,5090,4716,2823,1893,0.0153528298822345,0.00919021178065056,0.00616261810158396,EPCI
241200187,CA Rodez Agglomération,1982_1990,1986,8,46618,48813,2758,4939,2195,2181,14,0.00576781241751623,0.00573102454788287,3.67878696333609e-05,EPCI
241200187,CA Rodez Agglomération,1990_1999,1994.5,9,48813,49433,3482,5027,620,1545,-925,0.00140337787432943,0.00349712712232091,-0.00209374924799148,EPCI
241200187,CA Rodez Agglomération,1999_2010,2004.5,11,49433,53311,4607,6223,3878,1616,2262,0.00688948510502518,0.00287091488646743,0.00401857021855775,EPCI
241200542,CC du Réquistanais,2010_2015,2012.5,5,5571,5406,373,196,-165,-177,12,-0.00599498258479037,-0.00643098131822966,0.000435998733439299,EPCI
241200542,CC du Réquistanais,1968_1975,1971.5,7,8253,7588,687,656,-665,-31,-634,-0.0119295177859541,-0.000556112859194852,-0.0113734049267592,EPCI
241200542,CC du Réquistanais,1975_1982,1978.5,7,7588,7051,663,475,-537,-188,-349,-0.0104307331071022,-0.00365172779168568,-0.00677900531541651,EPCI
241200542,CC du Réquistanais,1982_1990,1986,8,7051,6274,714,511,-777,-203,-574,-0.0144884353179762,-0.00378526688487666,-0.0107031684330995,EPCI
241200542,CC du Réquistanais,1990_1999,1994.5,9,6274,5680,714,441,-594,-273,-321,-0.0109905880598593,-0.00505122986589493,-0.00593935819396437,EPCI
241200542,CC du Réquistanais,1999_2010,2004.5,11,5680,5571,820,522,-109,-298,189,-0.00175996414304724,-0.004811645088331,0.00305168094528375,EPCI
241200567,CC de Millau Grands Causses,2010_2015,2012.5,5,29241,29824,1619,1446,583,-173,756,0.00395612578363469,-0.00117394470080412,0.00513007048443881,EPCI
241200567,CC de Millau Grands Causses,1968_1975,1971.5,7,27490,26967,2464,2701,-523,237,-760,-0.00274029650249819,0.00124177872101734,-0.00398207522351553,EPCI
241200567,CC de Millau Grands Causses,1975_1982,1978.5,7,26967,27167,2237,2216,200,-21,221,0.0010561437821397,-0.000110895097124668,0.00116703887926436,EPCI
241200567,CC de Millau Grands Causses,1982_1990,1986,8,27167,27916,2653,2412,749,-241,990,0.0034054102431198,-0.00109573280185831,0.00450114304497811,EPCI
241200567,CC de Millau Grands Causses,1990_1999,1994.5,9,27916,28112,2872,2676,196,-196,392,0.000777694502101411,-0.000777694502101411,0.00155538900420282,EPCI
241200567,CC de Millau Grands Causses,1999_2010,2004.5,11,28112,29241,3578,3481,1129,-97,1226,0.00358598728419879,-0.000308096338854989,0.00389408362305378,EPCI
241200625,CC du Pays Rignacois,2010_2015,2012.5,5,5325,5482,328,276,157,-52,209,0.00582837653408586,-0.0019304177055571,0.00775879423964295,EPCI
241200625,CC du Pays Rignacois,1968_1975,1971.5,7,5696,5230,521,393,-466,-128,-338,-0.012119234156727,-0.00332888835206235,-0.00879034580466465,EPCI
241200625,CC du Pays Rignacois,1975_1982,1978.5,7,5230,4977,494,310,-253,-184,-69,-0.00705839712939638,-0.00513337973047009,-0.00192501739892628,EPCI
241200625,CC du Pays Rignacois,1982_1990,1986,8,4977,4760,536,327,-217,-209,-8,-0.00555695663200106,-0.0053520918713743,-0.000204864760626767,EPCI
241200625,CC du Pays Rignacois,1990_1999,1994.5,9,4760,4618,611,301,-142,-310,168,-0.00335945074316291,-0.00733401218577818,0.00397456144261527,EPCI
241200625,CC du Pays Rignacois,1999_2010,2004.5,11,4618,5325,684,578,707,-106,813,0.0130343065378753,-0.0019542241768243,0.0149885307146996,EPCI
241200641,CC Conques-Marcillac,2010_2015,2012.5,5,11859,11824,678,537,-35,-141,106,-0.000590967065498771,-0.00238075303529505,0.00178978596979628,EPCI
241200641,CC Conques-Marcillac,1968_1975,1971.5,7,10327,10101,1049,792,-226,-257,31,-0.00315606566983784,-0.00358897733251471,0.000432911662676872,EPCI
241200641,CC Conques-Marcillac,1975_1982,1978.5,7,10101,10382,1071,692,281,-379,660,0.00392756540019001,-0.00529732130488262,0.00922488670507263,EPCI
241200641,CC Conques-Marcillac,1982_1990,1986,8,10382,10183,1214,789,-199,-425,226,-0.00241631028810851,-0.00516046167058351,0.002744151382475,EPCI
241200641,CC Conques-Marcillac,1990_1999,1994.5,9,10183,10578,1231,910,395,-321,716,0.00423747609184955,-0.00344361981135115,0.0076810959032007,EPCI
241200641,CC Conques-Marcillac,1999_2010,2004.5,11,10578,11859,1513,1265,1281,-248,1529,0.0104460649787488,-0.00202234513249781,0.0124684101112466,EPCI
241200658,CC du Pays de Salars,2010_2015,2012.5,5,7611,7845,360,391,234,31,203,0.00607474022887033,0.000804773278183677,0.00526996695068666,EPCI
241200658,CC du Pays de Salars,1968_1975,1971.5,7,6278,6224,535,570,-54,35,-89,-0.00123333475157861,0.000799383635282431,-0.00203271838686104,EPCI
241200658,CC du Pays de Salars,1975_1982,1978.5,7,6224,6495,544,505,271,-39,310,0.00610712479932918,-0.000878885118722649,0.00698600991805183,EPCI
241200658,CC du Pays de Salars,1982_1990,1986,8,6495,6709,606,575,214,-31,245,0.00406037839732765,-0.00058818565568765,0.0046485640530153,EPCI
241200658,CC du Pays de Salars,1990_1999,1994.5,9,6709,6885,672,611,176,-61,237,0.00288139031475643,-0.000998663688637171,0.0038800540033936,EPCI
241200658,CC du Pays de Salars,1999_2010,2004.5,11,6885,7611,789,952,726,163,563,0.0091552403553159,0.00205551539657919,0.00709972495873671,EPCI
241200674,CC du Plateau de Montbazens,2010_2015,2012.5,5,6060,6206,462,301,146,-161,307,0.00477270644288685,-0.00526305299523824,0.0100357594381251,EPCI
241200674,CC du Plateau de Montbazens,1968_1975,1971.5,7,6814,6515,636,466,-299,-170,-129,-0.00638979908815618,-0.00363299613707876,-0.00275680295107741,EPCI
241200674,CC du Plateau de Montbazens,1975_1982,1978.5,7,6515,6364,606,434,-151,-172,21,-0.00334440926300728,-0.00380952578302815,0.000465116520020879,EPCI
241200674,CC du Plateau de Montbazens,1982_1990,1986,8,6364,5894,684,377,-470,-307,-163,-0.00954443820804474,-0.00623434580823348,-0.00331009239981126,EPCI
241200674,CC du Plateau de Montbazens,1990_1999,1994.5,9,5894,5594,695,416,-300,-279,-21,-0.0057876631874727,-0.00538252676434961,-0.000405136423123089,EPCI
241200674,CC du Plateau de Montbazens,1999_2010,2004.5,11,5594,6060,847,613,466,-234,700,0.00730063017348481,-0.00366598167509752,0.0109666118485823,EPCI
241200765,CC de Lévézou Pareloup,2010_2015,2012.5,5,5573,5468,289,232,-105,-57,-48,-0.00379689145484696,-0.00206116964691692,-0.00173572180793004,EPCI
241200765,CC de Lévézou Pareloup,1968_1975,1971.5,7,7610,6987,613,681,-623,68,-691,-0.0121275600189019,0.00132371441618833,-0.0134512744350902,EPCI
241200765,CC de Lévézou Pareloup,1975_1982,1978.5,7,6987,6797,597,560,-190,-37,-153,-0.00393081706269638,-0.000765474901682979,-0.0031653421610134,EPCI
241200765,CC de Lévézou Pareloup,1982_1990,1986,8,6797,5951,596,471,-846,-125,-721,-0.0164779861318483,-0.002434690622318,-0.0140432955095303,EPCI
241200765,CC de Lévézou Pareloup,1990_1999,1994.5,9,5951,5538,698,449,-413,-249,-164,-0.00795991165861054,-0.00479907506778214,-0.0031608365908284,EPCI
241200765,CC de Lévézou Pareloup,1999_2010,2004.5,11,5538,5573,717,562,35,-155,190,0.000572898938366873,-0.00253712386991044,0.00311002280827731,EPCI
241200807,CC Aveyron Bas Ségala Viaur,2010_2015,2012.5,5,5917,5644,415,210,-273,-205,-68,-0.00940282034592299,-0.00706072590078466,-0.00234209444513833,EPCI
241200807,CC Aveyron Bas Ségala Viaur,1968_1975,1971.5,7,8200,7651,652,567,-549,-85,-464,-0.00985084456445651,-0.00152517629868634,-0.00832566826577016,EPCI
241200807,CC Aveyron Bas Ségala Viaur,1975_1982,1978.5,7,7651,7358,648,471,-293,-177,-116,-0.00556278460352522,-0.00336045349769271,-0.00220233110583251,EPCI
241200807,CC Aveyron Bas Ségala Viaur,1982_1990,1986,8,7358,6615,679,391,-743,-288,-455,-0.0132179108125511,-0.00512349705789329,-0.0080944137546578,EPCI
241200807,CC Aveyron Bas Ségala Viaur,1990_1999,1994.5,9,6615,6037,763,456,-578,-307,-271,-0.0101077473940131,-0.00536864783730454,-0.00473909955670856,EPCI
241200807,CC Aveyron Bas Ségala Viaur,1999_2010,2004.5,11,6037,5917,844,498,-120,-346,226,-0.00182357491036544,-0.00525797432488703,0.00343439941452159,EPCI
241200906,CC Larzac et Vallées,2010_2015,2012.5,5,5323,5356,436,224,33,-212,245,0.00123683898288696,-0.00794575346581924,0.00918259244870619,EPCI
241200906,CC Larzac et Vallées,1968_1975,1971.5,7,5316,5069,576,283,-247,-293,46,-0.00677375135275538,-0.00803525970185152,0.00126150834909614,EPCI
241200906,CC Larzac et Vallées,1975_1982,1978.5,7,5069,5092,580,300,23,-280,303,0.000646940776679594,-0.00787580075957767,0.00852274153625726,EPCI
241200906,CC Larzac et Vallées,1982_1990,1986,8,5092,4531,587,342,-561,-245,-316,-0.0144850690562421,-0.00632592142384906,-0.00815914763239308,EPCI
241200906,CC Larzac et Vallées,1990_1999,1994.5,9,4531,4561,686,350,30,-336,366,0.000733516896987307,-0.00821538924625784,0.00894890614324515,EPCI
241200906,CC Larzac et Vallées,1999_2010,2004.5,11,4561,5323,817,499,762,-318,1080,0.0141441088208489,-0.00590265958665349,0.0200467684075024,EPCI
241200914,CC de la Muse et des Raspes du Tarn,2010_2015,2012.5,5,5448,5423,358,229,-25,-129,104,-0.000919457237569254,-0.00474439934585735,0.0038249421082881,EPCI
241200914,CC de la Muse et des Raspes du Tarn,1968_1975,1971.5,7,6666,5825,636,407,-841,-229,-612,-0.0190814538854165,-0.00519578233027393,-0.0138856715551426,EPCI
241200914,CC de la Muse et des Raspes du Tarn,1975_1982,1978.5,7,5825,5592,602,352,-233,-250,17,-0.00581474206857779,-0.00623899363581308,0.00042425156723529,EPCI
241200914,CC de la Muse et des Raspes du Tarn,1982_1990,1986,8,5592,5234,687,362,-358,-325,-33,-0.00823604649033694,-0.00747685784737292,-0.000759188642964019,EPCI
241200914,CC de la Muse et des Raspes du Tarn,1990_1999,1994.5,9,5234,5170,708,410,-64,-298,234,-0.0013660789066281,-0.00636080490898709,0.00499472600235899,EPCI
241200914,CC de la Muse et des Raspes du Tarn,1999_2010,2004.5,11,5170,5448,725,466,278,-259,537,0.00477279735179792,-0.00444659897163907,0.00921939632343699,EPCI
241300375,CC Vallée des Baux-Alpilles (Cc Vba),2010_2015,2012.5,5,27809,27744,1624,1327,-65,-297,232,-0.000467912237476886,-0.002137998992779,0.00167008675530212,EPCI
241300375,CC Vallée des Baux-Alpilles (Cc Vba),1968_1975,1971.5,7,17495,18562,1614,1456,1067,-158,1225,0.00849320063936765,-0.0012576623252297,0.00975086296459735,EPCI
241300375,CC Vallée des Baux-Alpilles (Cc Vba),1975_1982,1978.5,7,18562,20926,1766,1419,2364,-347,2711,0.0172726078314607,-0.00253536164023556,0.0198079694716962,EPCI
241300375,CC Vallée des Baux-Alpilles (Cc Vba),1982_1990,1986,8,20926,23781,2091,1964,2855,-127,2982,0.0161152900686172,-0.000716862290267737,0.016832152358885,EPCI
241300375,CC Vallée des Baux-Alpilles (Cc Vba),1990_1999,1994.5,9,23781,25267,2319,2416,1486,97,1389,0.00675742394028545,0.000441096986680813,0.00631632695360463,EPCI
241300375,CC Vallée des Baux-Alpilles (Cc Vba),1999_2010,2004.5,11,25267,27809,3248,2894,2542,-354,2896,0.00875267467513763,-0.00121890119394127,0.0099715758690789,EPCI
241300417,CA d'Arles-Crau-Camargue-Montagnette,2010_2015,2012.5,5,81211,85992,3872,5314,4781,1442,3339,0.0115064077857017,0.00347045388558498,0.00803595390011668,EPCI
241300417,CA d'Arles-Crau-Camargue-Montagnette,1968_1975,1971.5,7,62998,69113,4967,6651,6115,1684,4431,0.0133222271324829,0.0036687866706625,0.00965344046182038,EPCI
241300417,CA d'Arles-Crau-Camargue-Montagnette,1975_1982,1978.5,7,69113,74692,5106,6428,5579,1322,4257,0.0111517429698282,0.00264251733395105,0.00850922563587718,EPCI
241300417,CA d'Arles-Crau-Camargue-Montagnette,1982_1990,1986,8,74692,77702,5740,7686,3010,1946,1064,0.00495071520737289,0.00320069494802247,0.00175002025935042,EPCI
241300417,CA d'Arles-Crau-Camargue-Montagnette,1990_1999,1994.5,9,77702,78417,6551,8260,715,1709,-994,0.00101826736224231,0.00243387261828267,-0.00141560525604036,EPCI
241300417,CA d'Arles-Crau-Camargue-Montagnette,1999_2010,2004.5,11,78417,81211,7985,10624,2794,2639,155,0.00318779437021277,0.00301094822583805,0.000176846144374724,EPCI
241400415,CC Coeur Côte Fleurie,2010_2015,2012.5,5,22128,21195,1563,841,-933,-722,-211,-0.00857868529337136,-0.00663859676507408,-0.00194008852829727,EPCI
241400415,CC Coeur Côte Fleurie,1968_1975,1971.5,7,19144,19957,1723,2141,813,418,395,0.00595920129543504,0.0030638943929789,0.00289530690245614,EPCI
241400415,CC Coeur Côte Fleurie,1975_1982,1978.5,7,19957,19574,1738,1837,-383,99,-482,-0.00276442961956314,0.000714565358581594,-0.00347899497814473,EPCI
241400415,CC Coeur Côte Fleurie,1982_1990,1986,8,19574,20211,2035,2084,637,49,588,0.00401113009027365,0.000308548468482589,0.00370258162179106,EPCI
241400415,CC Coeur Côte Fleurie,1990_1999,1994.5,9,20211,21435,2337,2448,1224,111,1113,0.00655450843019634,0.000594403950777609,0.00596010447941873,EPCI
241400415,CC Coeur Côte Fleurie,1999_2010,2004.5,11,21435,22128,3226,2537,693,-689,1382,0.00289679443039903,-0.00288007411622645,0.00577686854662548,EPCI
241400514,CC du Pays de Falaise,2010_2015,2012.5,5,27428,28279,1268,1730,851,462,389,0.00612972842500059,0.00332777265846096,0.00280195576653964,EPCI
241400514,CC du Pays de Falaise,1968_1975,1971.5,7,25394,25209,2006,3165,-185,1159,-1344,-0.0010440049377316,0.00654054985314014,-0.00758455479087175,EPCI
241400514,CC du Pays de Falaise,1975_1982,1978.5,7,25209,25414,1874,2802,205,928,-723,0.0011576881281774,0.00524065650218844,-0.00408296837401104,EPCI
241400514,CC du Pays de Falaise,1982_1990,1986,8,25414,24981,1984,2796,-433,812,-1245,-0.0021457779399624,0.00402395308833596,-0.00616973102829836,EPCI
241400514,CC du Pays de Falaise,1990_1999,1994.5,9,24981,25389,2080,2821,408,741,-333,0.00180167367102069,0.0032721573289861,-0.00147048365796541,EPCI
241400514,CC du Pays de Falaise,1999_2010,2004.5,11,25389,27428,2587,3976,2039,1389,650,0.00704729614411837,0.00480073288091241,0.00224656326320595,EPCI
241400555,CC de Bayeux Intercom,2010_2015,2012.5,5,29070,30169,1554,1557,1099,3,1096,0.00744924712561979,2.03346145376336e-05,0.00742891251108215,EPCI
241400555,CC de Bayeux Intercom,1968_1975,1971.5,7,22350,24984,2048,3426,2634,1378,1256,0.0160429421223822,0.00839300464868743,0.00764993747369479,EPCI
241400555,CC de Bayeux Intercom,1975_1982,1978.5,7,24984,27633,2032,3340,2649,1308,1341,0.014500569382097,0.00715996404370814,0.00734060533838885,EPCI
241400555,CC de Bayeux Intercom,1982_1990,1986,8,27633,28903,2377,3622,1270,1245,25,0.00563263965768113,0.00552176092426221,0.00011087873341892,EPCI
241400555,CC de Bayeux Intercom,1990_1999,1994.5,9,28903,29142,2433,3451,239,1018,-779,0.000915422814198319,0.00389916495754765,-0.00298374214334933,EPCI
241400555,CC de Bayeux Intercom,1999_2010,2004.5,11,29142,29070,3200,3671,-72,471,-543,-0.000224858172054421,0.001470947208856,-0.00169580538091042,EPCI
241400860,CC Coeur de Nacre,2010_2015,2012.5,5,23383,23920,1227,1156,537,-71,608,0.00455145986556138,-0.000601775885390797,0.00515323575095218,EPCI
241400860,CC Coeur de Nacre,1968_1975,1971.5,7,10649,12771,853,1216,2122,363,1759,0.0262985738536541,0.00449876640380605,0.021799807449848,EPCI
241400860,CC Coeur de Nacre,1975_1982,1978.5,7,12771,15979,979,1411,3208,432,2776,0.0325320173879988,0.00438087017194997,0.0281511472160489,EPCI
241400860,CC Coeur de Nacre,1982_1990,1986,8,15979,18167,1221,1719,2188,498,1690,0.0161707795737998,0.00368055220646813,0.0124902273673316,EPCI
241400860,CC Coeur de Nacre,1990_1999,1994.5,9,18167,21404,1600,2225,3237,625,2612,0.0183859851746944,0.00354996624472783,0.0148360189299665,EPCI
241400860,CC Coeur de Nacre,1999_2010,2004.5,11,21404,23383,2133,2927,1979,794,1185,0.00807162332896638,0.0032384380612427,0.00483318526772368,EPCI
241400878,CC Blangy-Pont-l'Evêque Intercom,2010_2015,2012.5,5,19031,19307,936,1029,276,93,183,0.00288384950038401,0.000971731896868524,0.00191211760351548,EPCI
241400878,CC Blangy-Pont-l'Evêque Intercom,1968_1975,1971.5,7,13661,13472,1246,1482,-189,236,-425,-0.00198824943757381,0.00248268183739375,-0.00447093127496756,EPCI
241400878,CC Blangy-Pont-l'Evêque Intercom,1975_1982,1978.5,7,13472,14413,1290,1243,941,-47,988,0.00969196864793398,-0.000484083450003079,0.0101760520979371,EPCI
241400878,CC Blangy-Pont-l'Evêque Intercom,1982_1990,1986,8,14413,15816,1473,1675,1403,202,1201,0.011679113027909,0.00168152589567899,0.00999758713223004,EPCI
241400878,CC Blangy-Pont-l'Evêque Intercom,1990_1999,1994.5,9,15816,17147,1475,1788,1331,313,1018,0.00901832730444707,0.00212076367114345,0.00689756363330362,EPCI
241400878,CC Blangy-Pont-l'Evêque Intercom,1999_2010,2004.5,11,17147,19031,1935,2359,1884,424,1460,0.00952195694269431,0.00214294572383354,0.00737901121886077,EPCI
241500230,CA du Bassin d'Aurillac,2010_2015,2012.5,5,54038,53295,2986,2566,-743,-420,-323,-0.0027651667927362,-0.0015630821708603,-0.0012020846218759,EPCI
241500230,CA du Bassin d'Aurillac,1968_1975,1971.5,7,43748,49290,3102,6247,5542,3145,2397,0.0171853293620223,0.00975241083427647,0.00743291852774585,EPCI
241500230,CA du Bassin d'Aurillac,1975_1982,1978.5,7,49290,52025,3289,5322,2735,2033,702,0.00774457118712024,0.0057567507215413,0.00198782046557894,EPCI
241500230,CA du Bassin d'Aurillac,1982_1990,1986,8,52025,54019,3876,5374,1994,1498,496,0.00471250210770147,0.0035402849334688,0.00117221717423266,EPCI
241500230,CA du Bassin d'Aurillac,1990_1999,1994.5,9,54019,53954,4396,5083,-65,687,-752,-0.000133769368782954,0.00141383932852138,-0.00154760869730433,EPCI
241500230,CA du Bassin d'Aurillac,1999_2010,2004.5,11,53954,54038,5766,6082,84,316,-232,0.0001414346467703,0.000532063671183509,-0.000390629024413209,EPCI
241500255,CC du Pays Gentiane,2010_2015,2012.5,5,5740,5513,459,191,-227,-268,41,-0.00803757867615063,-0.00948929993483862,0.001451721258688,EPCI
241500255,CC du Pays Gentiane,1968_1975,1971.5,7,10178,9066,917,951,-1112,34,-1146,-0.0163923553140842,0.000501205108524158,-0.0168935604226084,EPCI
241500255,CC du Pays Gentiane,1975_1982,1978.5,7,9066,8200,871,596,-866,-275,-591,-0.0142400656568685,-0.00452196080327811,-0.00971810485359041,EPCI
241500255,CC du Pays Gentiane,1982_1990,1986,8,8200,7247,920,567,-953,-353,-600,-0.0153246839429356,-0.00567640444056272,-0.0096482795023729,EPCI
241500255,CC du Pays Gentiane,1990_1999,1994.5,9,7247,6362,901,458,-885,-443,-442,-0.0143674331544339,-0.00719183377108951,-0.00717559938334439,EPCI
241500255,CC du Pays Gentiane,1999_2010,2004.5,11,6362,5740,1131,508,-622,-623,1,-0.00930944924800603,-0.00932441620821183,1.49669602057985e-05,EPCI
241500271,CC du Pays de Mauriac,2010_2015,2012.5,5,6973,6787,532,239,-186,-293,107,-0.00539271293888644,-0.00849497253276197,0.00310225959387553,EPCI
241500271,CC du Pays de Mauriac,1968_1975,1971.5,7,8578,8088,794,808,-490,14,-504,-0.00836755327297523,0.000239072950656435,-0.00860662622363166,EPCI
241500271,CC du Pays de Mauriac,1975_1982,1978.5,7,8088,8048,763,655,-40,-108,68,-0.000708016146882429,-0.00191164359658256,0.00120362744970013,EPCI
241500271,CC du Pays de Mauriac,1982_1990,1986,8,8048,7700,871,655,-348,-216,-132,-0.00551017355776318,-0.00342010772550818,-0.002090065832255,EPCI
241500271,CC du Pays de Mauriac,1990_1999,1994.5,9,7700,7342,959,569,-358,-390,32,-0.00527592690449386,-0.00574751813618046,0.000471591231686603,EPCI
241500271,CC du Pays de Mauriac,1999_2010,2004.5,11,7342,6973,1057,614,-369,-443,74,-0.00467682369956335,-0.00561472330326982,0.00093789960370647,EPCI
241501055,CC Sumène - Artense,2010_2015,2012.5,5,8639,8520,710,308,-119,-402,283,-0.00277025465033576,-0.00935833923894936,0.00658808458861361,EPCI
241501055,CC Sumène - Artense,1968_1975,1971.5,7,10529,9843,1041,883,-686,-158,-528,-0.00957851839638113,-0.00220613105922481,-0.00737238733715632,EPCI
241501055,CC Sumène - Artense,1975_1982,1978.5,7,9843,9663,1107,725,-180,-382,202,-0.00263315338676695,-0.00558813663191653,0.00295498324514958,EPCI
241501055,CC Sumène - Artense,1982_1990,1986,8,9663,9492,1140,670,-171,-470,299,-0.00222936382437999,-0.00612749121320817,0.00389812738882817,EPCI
241501055,CC Sumène - Artense,1990_1999,1994.5,9,9492,9023,1113,632,-469,-481,12,-0.00561445366363278,-0.00575810706227584,0.000143653398643057,EPCI
241501055,CC Sumène - Artense,1999_2010,2004.5,11,9023,8639,1471,763,-384,-708,324,-0.00394583444117524,-0.00727513225091686,0.00332929780974161,EPCI
241501089,CC Cère et Goul en Carladès,2010_2015,2012.5,5,5042,4968,307,217,-74,-90,16,-0.00295272892258769,-0.00359115679774178,0.000638427875154095,EPCI
241501089,CC Cère et Goul en Carladès,1968_1975,1971.5,7,6131,5803,518,564,-328,46,-374,-0.00782392445521107,0.00109725769798692,-0.00892118215319799,EPCI
241501089,CC Cère et Goul en Carladès,1975_1982,1978.5,7,5803,5688,551,443,-115,-108,-7,-0.00285539169330595,-0.00268158524240907,-0.000173806450896884,EPCI
241501089,CC Cère et Goul en Carladès,1982_1990,1986,8,5688,5340,607,416,-348,-191,-157,-0.00786057278044594,-0.00431427988811832,-0.00354629289232762,EPCI
241501089,CC Cère et Goul en Carladès,1990_1999,1994.5,9,5340,5060,636,356,-280,-280,0,-0.00596648161601487,-0.00596648161601487,0,EPCI
241501089,CC Cère et Goul en Carladès,1999_2010,2004.5,11,5060,5042,721,486,-18,-235,217,-0.000323916121809487,-0.00422890492362385,0.00390498880181437,EPCI
241501139,CC du Pays de Salers,2010_2015,2012.5,5,9019,8699,739,293,-320,-446,126,-0.00719903920730169,-0.0100336608951767,0.00283462168787504,EPCI
241501139,CC du Pays de Salers,1968_1975,1971.5,7,15446,13398,1526,1162,-2048,-364,-1684,-0.0201155879402161,-0.00357523145031184,-0.0165403564899042,EPCI
241501139,CC du Pays de Salers,1975_1982,1978.5,7,13398,11698,1433,766,-1700,-667,-1033,-0.0191972759592749,-0.00753210768519786,-0.011665168274077,EPCI
241501139,CC du Pays de Salers,1982_1990,1986,8,11698,10798,1414,753,-900,-661,-239,-0.00995721478958922,-0.00731302108435386,-0.00264419370523536,EPCI
241501139,CC du Pays de Salers,1990_1999,1994.5,9,10798,9676,1456,596,-1122,-860,-262,-0.0121162596752925,-0.00928697265664132,-0.00282928701865119,EPCI
241501139,CC du Pays de Salers,1999_2010,2004.5,11,9676,9019,1549,769,-657,-780,123,-0.00637189731859955,-0.00756480960199033,0.00119291228339078,EPCI
241600303,CC du Rouillacais,2010_2015,2012.5,5,9852,10147,559,557,295,-2,297,0.00591816656673005,-4.01231631642716e-05,0.00595828972989433,EPCI
241600303,CC du Rouillacais,1968_1975,1971.5,7,8714,8742,858,791,28,-67,95,0.000458400568568163,-0.0010968870747881,0.00155528764335627,EPCI
241600303,CC du Rouillacais,1975_1982,1978.5,7,8742,8739,800,598,-3,-202,199,-4.90316258698886e-05,-0.0033014628085725,0.00325243118270261,EPCI
241600303,CC du Rouillacais,1982_1990,1986,8,8739,8963,948,764,224,-184,408,0.00316866284858364,-0.00260283019705084,0.00577149304563448,EPCI
241600303,CC du Rouillacais,1990_1999,1994.5,9,8963,8980,1063,795,17,-268,285,0.000210565492344328,-0.00331950305578117,0.0035300685481255,EPCI
241600303,CC du Rouillacais,1999_2010,2004.5,11,8980,9852,1300,1056,872,-244,1116,0.00846055333164175,-0.00236740253775297,0.0108279558693947,EPCI
241700434,CA de la Rochelle,2010_2015,2012.5,5,161935,167675,7874,7886,5740,12,5728,0.00699083496318842,1.46149859857598e-05,0.00697621997720266,EPCI
241700434,CA de la Rochelle,1968_1975,1971.5,7,111169,125038,7308,15233,13869,7925,5944,0.0169369923608083,0.00967810689014388,0.00725888547066438,EPCI
241700434,CA de la Rochelle,1975_1982,1978.5,7,125038,133128,7630,13203,8090,5573,2517,0.00899642392541278,0.00619741292167187,0.00279901100374091,EPCI
241700434,CA de la Rochelle,1982_1990,1986,8,133128,136228,9091,13769,3100,4678,-1578,0.00288150372332874,0.00434828207023608,-0.00146677834690734,EPCI
241700434,CA de la Rochelle,1990_1999,1994.5,9,136228,151364,11067,14470,15136,3403,11733,0.0117751857427122,0.00264739409899905,0.00912779164371314,EPCI
241700434,CA de la Rochelle,1999_2010,2004.5,11,151364,161935,15451,18206,10571,2755,7816,0.00615591461528053,0.00160434630262963,0.0045515683126509,EPCI
241700459,CC de l'Ile de Ré,2010_2015,2012.5,5,17926,17602,1075,619,-324,-456,132,-0.00364128259000052,-0.00512476808963036,0.00148348549962984,EPCI
241700459,CC de l'Ile de Ré,1968_1975,1971.5,7,9805,10274,906,875,469,-31,500,0.00669717967983829,-0.000442670725106582,0.00713985040494488,EPCI
241700459,CC de l'Ile de Ré,1975_1982,1978.5,7,10274,11396,963,746,1122,-217,1339,0.0149167295004167,-0.00288496461817328,0.0178016941185899,EPCI
241700459,CC de l'Ile de Ré,1982_1990,1986,8,11396,13969,1178,1003,2573,-175,2748,0.0257738173437883,-0.00175298019244576,0.027526797536234,EPCI
241700459,CC de l'Ile de Ré,1990_1999,1994.5,9,13969,16499,1538,1294,2530,-244,2774,0.0186675654183741,-0.00180035018264161,0.0204679156010157,EPCI
241700459,CC de l'Ile de Ré,1999_2010,2004.5,11,16499,17926,2235,1602,1427,-633,2060,0.00756963317672232,-0.00335779803844795,0.0109274312151703,EPCI
241700517,CC Charente-Arnoult-Coeur de Saintonge,2010_2015,2012.5,5,15987,17168,628,947,1181,319,862,0.0143563351588527,0.00387779078380526,0.0104785443750474,EPCI
241700517,CC Charente-Arnoult-Coeur de Saintonge,1968_1975,1971.5,7,10701,10316,897,983,-385,86,-471,-0.00522076803174909,0.00116619753436473,-0.00638696556611382,EPCI
241700517,CC Charente-Arnoult-Coeur de Saintonge,1975_1982,1978.5,7,10316,11116,891,866,800,-25,825,0.0107270442640666,-0.00033522013325208,0.0110622643973186,EPCI
241700517,CC Charente-Arnoult-Coeur de Saintonge,1982_1990,1986,8,11116,12117,1076,1095,1001,19,982,0.010836280930848,0.00020568365403208,0.0106305972768159,EPCI
241700517,CC Charente-Arnoult-Coeur de Saintonge,1990_1999,1994.5,9,12117,13107,1066,1105,990,39,951,0.00876452027278885,0.000345268980443197,0.00841925129234565,EPCI
241700517,CC Charente-Arnoult-Coeur de Saintonge,1999_2010,2004.5,11,13107,15987,1350,1910,2880,560,2320,0.0182212404287636,0.00354301897225959,0.014678221456504,EPCI
241700624,CC de l'Ile d'Oléron,2010_2015,2012.5,5,21869,22208,1597,785,339,-812,1151,0.00308123235145596,-0.00738041495392992,0.0104616473053859,EPCI
241700624,CC de l'Ile d'Oléron,1968_1975,1971.5,7,15751,16360,1556,1517,609,-39,648,0.00543406495396837,-0.000347994307396989,0.00578205926136535,EPCI
241700624,CC de l'Ile d'Oléron,1975_1982,1978.5,7,16360,16841,1574,1180,481,-394,875,0.00414815965229609,-0.00339786882121551,0.0075460284735116,EPCI
241700624,CC de l'Ile d'Oléron,1982_1990,1986,8,16841,18452,1828,1424,1611,-404,2015,0.011484998961405,-0.0028801611299861,0.0143651600913911,EPCI
241700624,CC de l'Ile d'Oléron,1990_1999,1994.5,9,18452,20009,2263,1635,1557,-628,2185,0.00904167640560183,-0.00364686755473214,0.012688543960334,EPCI
241700624,CC de l'Ile d'Oléron,1999_2010,2004.5,11,20009,21869,3260,1912,1860,-1348,3208,0.00811345865708346,-0.0058800764891121,0.0139935351461956,EPCI
241700632,CC de Gémozac et de la Saintonge Viticole,2010_2015,2012.5,5,13371,14008,672,737,637,65,572,0.00935153739252725,0.000954238509441556,0.0083972988830857,EPCI
241700632,CC de Gémozac et de la Saintonge Viticole,1968_1975,1971.5,7,9937,9726,915,942,-211,27,-238,-0.00306136903377208,0.000391739165458986,-0.00345310819923106,EPCI
241700632,CC de Gémozac et de la Saintonge Viticole,1975_1982,1978.5,7,9726,9908,866,781,182,-85,267,0.00265205329454354,-0.00123859631888023,0.00389064961342377,EPCI
241700632,CC de Gémozac et de la Saintonge Viticole,1982_1990,1986,8,9908,10173,1034,847,265,-187,452,0.00330477880315616,-0.00233205145732152,0.00563683026047768,EPCI
241700632,CC de Gémozac et de la Saintonge Viticole,1990_1999,1994.5,9,10173,10739,1209,950,566,-259,825,0.00603422447485569,-0.00276124406181559,0.00879546853667128,EPCI
241700632,CC de Gémozac et de la Saintonge Viticole,1999_2010,2004.5,11,10739,13371,1353,1428,2632,75,2557,0.0201277219638922,0.00057354830824161,0.0195541736556506,EPCI
241700640,CA Royan Atlantique,2010_2015,2012.5,5,78880,82088,5747,2841,3208,-2906,6114,0.00800469406928972,-0.00725113496426307,0.0152558290335528,EPCI
241700640,CA Royan Atlantique,1968_1975,1971.5,7,55905,58781,5309,5698,2876,389,2487,0.00719214755409037,0.00097279047237175,0.00621935708171862,EPCI
241700640,CA Royan Atlantique,1975_1982,1978.5,7,58781,60815,5625,4475,2034,-1150,3184,0.00487151251172735,-0.00275429665117328,0.00762580916290063,EPCI
241700640,CA Royan Atlantique,1982_1990,1986,8,60815,64174,6722,4962,3359,-1760,5119,0.00674284067108633,-0.00353301565379933,0.0102758563248857,EPCI
241700640,CA Royan Atlantique,1990_1999,1994.5,9,64174,68821,8292,5464,4647,-2828,7475,0.00779811332181635,-0.00474565622425148,0.0125437695460678,EPCI
241700640,CA Royan Atlantique,1999_2010,2004.5,11,68821,78880,11534,6786,10059,-4748,14807,0.0124789272764854,-0.00589024224164952,0.0183691695181349,EPCI
241700699,CC du Bassin de Marennes,2010_2015,2012.5,5,14990,15384,997,679,394,-318,712,0.0052024250952647,-0.00419891162511212,0.00940133672037681,EPCI
241700699,CC du Bassin de Marennes,1968_1975,1971.5,7,11575,11097,1072,1178,-478,106,-584,-0.00600657346710432,0.00133200164751686,-0.00733857511462117,EPCI
241700699,CC du Bassin de Marennes,1975_1982,1978.5,7,11097,11448,1057,819,351,-238,589,0.00445851555564469,-0.00302315299784455,0.00748166855348924,EPCI
241700699,CC du Bassin de Marennes,1982_1990,1986,8,11448,11932,1273,975,484,-298,782,0.00518952221418734,-0.00319520169385915,0.00838472390804648,EPCI
241700699,CC du Bassin de Marennes,1990_1999,1994.5,9,11932,12470,1470,1120,538,-350,888,0.0049122360031324,-0.00319569256709357,0.00810792857022596,EPCI
241700699,CC du Bassin de Marennes,1999_2010,2004.5,11,12470,14990,2078,1482,2520,-596,3116,0.0168732771859266,-0.00399066396936994,0.0208639411552965,EPCI
241800325,CC Les Villages de la Forêt,2010_2015,2012.5,5,5226,5305,290,258,79,-32,111,0.00300522766337119,-0.00121730740794782,0.00422253507131901,EPCI
241800325,CC Les Villages de la Forêt,1968_1975,1971.5,7,3650,3526,404,274,-124,-130,6,-0.00492541354739851,-0.0051637400093694,0.000238326461970895,EPCI
241800325,CC Les Villages de la Forêt,1975_1982,1978.5,7,3526,4117,362,285,591,-77,668,0.0223840837401494,-0.00291636962435111,0.0253004533645006,EPCI
241800325,CC Les Villages de la Forêt,1982_1990,1986,8,4117,4644,425,398,527,-27,554,0.0151703339676372,-0.000777227736482363,0.0159475617041196,EPCI
241800325,CC Les Villages de la Forêt,1990_1999,1994.5,9,4644,4582,427,412,-62,-15,-47,-0.00149227209797675,-0.00036103357209115,-0.0011312385258856,EPCI
241800325,CC Les Villages de la Forêt,1999_2010,2004.5,11,4582,5226,588,499,644,-89,733,0.0120272602936671,-0.00166215243188877,0.0136894127255558,EPCI
241800374,CC La Septaine,2010_2015,2012.5,5,10609,10829,428,645,220,217,3,0.00411344170613348,0.00405734931923166,5.60923869018203e-05,EPCI
241800374,CC La Septaine,1968_1975,1971.5,7,8690,8426,662,1015,-264,353,-617,-0.00439755598383695,0.00588006538747896,-0.0102776213713159,EPCI
241800374,CC La Septaine,1975_1982,1978.5,7,8426,8559,637,720,133,83,50,0.00223981856040067,0.00139778150761847,0.000842037052782209,EPCI
241800374,CC La Septaine,1982_1990,1986,8,8559,8688,675,956,129,281,-152,0.00187167468704819,0.00407705881442279,-0.00220538412737461,EPCI
241800374,CC La Septaine,1990_1999,1994.5,9,8688,9189,776,1076,501,300,201,0.00624881548472667,0.00374180567947705,0.00250700980524962,EPCI
241800374,CC La Septaine,1999_2010,2004.5,11,9189,10609,853,1441,1420,588,832,0.0131489314346824,0.00544476879126287,0.00770416264341957,EPCI
241800424,CC Le Dunois,2010_2015,2012.5,5,8244,7805,508,414,-439,-94,-345,-0.0108845516960062,-0.00233063293718584,-0.00855391875882038,EPCI
241800424,CC Le Dunois,1968_1975,1971.5,7,8495,8177,788,731,-318,-57,-261,-0.00543551952031063,-0.00097429123477266,-0.00446122828553797,EPCI
241800424,CC Le Dunois,1975_1982,1978.5,7,8177,7958,882,488,-219,-394,175,-0.00387072125334886,-0.00696376335077375,0.00309304209742489,EPCI
241800424,CC Le Dunois,1982_1990,1986,8,7958,7962,945,569,4,-376,380,6.28160445186321e-05,-0.00590470818475142,0.00596752422927005,EPCI
241800424,CC Le Dunois,1990_1999,1994.5,9,7962,7547,998,634,-415,-364,-51,-0.00593013484517502,-0.00520137128588845,-0.000728763559286568,EPCI
241800424,CC Le Dunois,1999_2010,2004.5,11,7547,8244,1188,955,697,-233,930,0.00806283367585192,-0.00269532316567216,0.0107581568415241,EPCI
241800432,CC Les Trois Provinces,2010_2015,2012.5,5,5649,5274,448,247,-375,-201,-174,-0.0136439559148681,-0.00731316037036931,-0.0063307955444988,EPCI
241800432,CC Les Trois Provinces,1968_1975,1971.5,7,6544,6253,778,572,-291,-206,-85,-0.00647711116874583,-0.00458517148028055,-0.00189193968846528,EPCI
241800432,CC Les Trois Provinces,1975_1982,1978.5,7,6253,6171,689,480,-82,-209,127,-0.00188400150070189,-0.00480190626398409,0.0029179047632822,EPCI
241800432,CC Les Trois Provinces,1982_1990,1986,8,6171,5878,786,505,-293,-281,-12,-0.00606209233821309,-0.00581381551890061,-0.000248276819312481,EPCI
241800432,CC Les Trois Provinces,1990_1999,1994.5,9,5878,5744,852,480,-134,-372,238,-0.00255902412886555,-0.00710415653685063,0.00454513240798508,EPCI
241800432,CC Les Trois Provinces,1999_2010,2004.5,11,5744,5649,975,572,-95,-403,308,-0.00151496885641889,-0.00642665735933485,0.00491168850291597,EPCI
241800457,CC Fercher Pays Florentais,2010_2015,2012.5,5,11531,11802,576,613,271,37,234,0.00465679891228676,0.000635799113485647,0.00402099979880112,EPCI
241800457,CC Fercher Pays Florentais,1968_1975,1971.5,7,11965,11960,974,1266,-5,292,-297,-5.97086227764887e-05,0.00348698357014694,-0.00354669219292343,EPCI
241800457,CC Fercher Pays Florentais,1975_1982,1978.5,7,11960,12523,994,1040,563,46,517,0.00659295347070787,0.000538678258707926,0.00605427521199995,EPCI
241800457,CC Fercher Pays Florentais,1982_1990,1986,8,12523,12283,1097,1139,-240,42,-282,-0.00241592207951602,0.000422786363915303,-0.00283870844343132,EPCI
241800457,CC Fercher Pays Florentais,1990_1999,1994.5,9,12283,11757,1196,1053,-526,-143,-383,-0.0048512372934616,-0.00131887249613119,-0.0035323647973304,EPCI
241800457,CC Fercher Pays Florentais,1999_2010,2004.5,11,11757,11531,1424,1394,-226,-30,-196,-0.0017629666088157,-0.000234022116214473,-0.00152894449260122,EPCI
241800507,CA Bourges Plus,2010_2015,2012.5,5,96416,97100,4583,5274,684,691,-7,0.00141484241634249,0.00142932179779629,-1.44793814537973e-05,EPCI
241800507,CA Bourges Plus,1968_1975,1971.5,7,84733,97640,6044,12212,12907,6168,6739,0.0204611031418893,0.00977795647161798,0.0106831466702713,EPCI
241800507,CA Bourges Plus,1975_1982,1978.5,7,97640,100991,6143,10081,3351,3938,-587,0.004832231818509,0.00567870155216009,-0.000846469733651085,EPCI
241800507,CA Bourges Plus,1982_1990,1986,8,100991,102916,7070,11236,1925,4166,-2241,0.00236300219435037,0.00511390500865644,-0.00275090281430607,EPCI
241800507,CA Bourges Plus,1990_1999,1994.5,9,102916,100463,7845,11290,-2453,3445,-5898,-0.00267681326380631,0.00375932396812586,-0.00643613723193217,EPCI
241800507,CA Bourges Plus,1999_2010,2004.5,11,100463,96416,10262,12077,-4047,1815,-5862,-0.00373096237769943,0.00167326333469841,-0.00540422571239784,EPCI
241900133,CC de Ventadour - Egletons - Monédières,2010_2015,2012.5,5,10432,10257,698,442,-175,-256,81,-0.00337780351446737,-0.00494124399830655,0.00156344048383918,EPCI
241900133,CC de Ventadour - Egletons - Monédières,1968_1975,1971.5,7,10668,10894,1205,789,226,-416,642,0.00299928497346569,-0.0055208077387687,0.00852009271223439,EPCI
241900133,CC de Ventadour - Egletons - Monédières,1975_1982,1978.5,7,10894,10645,1210,708,-249,-502,253,-0.00329767648383783,-0.00664832769030759,0.00335065120646976,EPCI
241900133,CC de Ventadour - Egletons - Monédières,1982_1990,1986,8,10645,10450,1230,827,-195,-403,208,-0.00230837159489239,-0.00477063462944427,0.00246226303455188,EPCI
241900133,CC de Ventadour - Egletons - Monédières,1990_1999,1994.5,9,10450,9979,1252,809,-471,-443,-28,-0.00511123667178881,-0.00480738396093937,-0.00030385271084944,EPCI
241900133,CC de Ventadour - Egletons - Monédières,1999_2010,2004.5,11,9979,10432,1455,1021,453,-434,887,0.00404407531855311,-0.00387445626545706,0.00791853158401017,EPCI
241927201,CA Tulle Agglo,2010_2015,2012.5,5,44352,44304,2804,1890,-48,-914,866,-0.00021654397873383,-0.00412335826172334,0.00390681428298951,EPCI
241927201,CA Tulle Agglo,1968_1975,1971.5,7,47452,46454,4681,4045,-998,-636,-362,-0.00303197968686164,-0.00193220348781964,-0.001099776199042,EPCI
241927201,CA Tulle Agglo,1975_1982,1978.5,7,46454,46139,4602,3378,-315,-1224,909,-0.000971527234572833,-0.00377507725434015,0.00280355001976732,EPCI
241927201,CA Tulle Agglo,1982_1990,1986,8,46139,45003,4984,3525,-1136,-1459,323,-0.00311132789718716,-0.00399597482570076,0.000884646928513601,EPCI
241927201,CA Tulle Agglo,1990_1999,1994.5,9,45003,42882,5011,3219,-2121,-1792,-329,-0.0053497495975614,-0.00451992045206508,-0.000829829145496323,EPCI
241927201,CA Tulle Agglo,1999_2010,2004.5,11,42882,44352,5998,4273,1470,-1725,3195,0.00306884895068538,-0.00360120029927366,0.00667004924995903,EPCI
241927243,CC du Pays d'Uzerche,2010_2015,2012.5,5,9945,9738,736,388,-207,-348,141,-0.00419799459124415,-0.00705749815339596,0.00285950356215181,EPCI
241927243,CC du Pays d'Uzerche,1968_1975,1971.5,7,11830,10717,1378,666,-1113,-712,-401,-0.0140161902128594,-0.00896633192412927,-0.00504985828873011,EPCI
241927243,CC du Pays d'Uzerche,1975_1982,1978.5,7,10717,10237,1426,558,-480,-868,388,-0.00652471497240592,-0.0117988595751007,0.00527414460269479,EPCI
241927243,CC du Pays d'Uzerche,1982_1990,1986,8,10237,9481,1520,560,-756,-960,204,-0.00954401551145412,-0.0121193847764497,0.00257536926499556,EPCI
241927243,CC du Pays d'Uzerche,1990_1999,1994.5,9,9481,9471,1601,558,-10,-1043,1033,-0.000117248424961414,-0.0122290107234754,0.012111762298514,EPCI
241927243,CC du Pays d'Uzerche,1999_2010,2004.5,11,9471,9945,1643,838,474,-805,1279,0.0044494526457346,-0.00755655987303028,0.0120060125187649,EPCI
242000354,CA de Bastia,2010_2015,2012.5,5,56428,58098,2591,2507,1670,-84,1754,0.005850196076993,-0.000294261359561324,0.00614445743655432,EPCI
242000354,CA de Bastia,1968_1975,1971.5,7,43358,48825,2773,4893,5467,2120,3347,0.0171091774234133,0.00663461791432893,0.0104745595090844,EPCI
242000354,CA de Bastia,1975_1982,1978.5,7,48825,51919,3002,4632,3094,1630,1464,0.00881611143811445,0.00464455773889029,0.00417155369922416,EPCI
242000354,CA de Bastia,1982_1990,1986,8,51919,48373,3636,4875,-3546,1239,-4785,-0.00880389239090629,0.0030761485257566,-0.0118800409166629,EPCI
242000354,CA de Bastia,1990_1999,1994.5,9,48373,49057,4104,4942,684,838,-154,0.00156133767841427,0.00191286692179993,-0.000351529243385668,EPCI
242000354,CA de Bastia,1999_2010,2004.5,11,49057,56428,5147,5597,7371,450,6921,0.0128070072540289,0.000781868574727042,0.0120251386793019,EPCI
242000495,CC de l'Alta Rocca,2010_2015,2012.5,5,8085,8479,397,345,394,-52,446,0.00956183002094857,-0.0012619674139323,0.0108237974348809,EPCI
242000495,CC de l'Alta Rocca,1968_1975,1971.5,7,5841,6090,649,433,249,-216,465,0.00598154221366332,-0.00518880770341878,0.0111703499170821,EPCI
242000495,CC de l'Alta Rocca,1975_1982,1978.5,7,6090,6214,625,454,124,-171,295,0.00288368258653393,-0.00397669130884921,0.00686037389538314,EPCI
242000495,CC de l'Alta Rocca,1982_1990,1986,8,6214,6348,729,537,134,-192,326,0.00267043323336669,-0.00382629239407764,0.00649672562744433,EPCI
242000495,CC de l'Alta Rocca,1990_1999,1994.5,9,6348,6469,757,524,121,-233,354,0.00210017276855412,-0.00404413433944719,0.00614430710800131,EPCI
242000495,CC de l'Alta Rocca,1999_2010,2004.5,11,6469,8085,798,675,1616,-123,1739,0.020478590136616,-0.00155870457104194,0.022037294707658,EPCI
242000503,CC Celavu-Prunelli,2010_2015,2012.5,5,7654,8467,355,364,813,9,804,0.0203947615306677,0.00022577226786717,0.0201689892628005,EPCI
242000503,CC Celavu-Prunelli,1968_1975,1971.5,7,4008,3748,503,194,-260,-309,49,-0.00953567285209178,-0.0113327804280629,0.00179710757597114,EPCI
242000503,CC Celavu-Prunelli,1975_1982,1978.5,7,3748,4441,469,240,693,-229,922,0.0245328417602315,-0.00810681206795529,0.0326396538281868,EPCI
242000503,CC Celavu-Prunelli,1982_1990,1986,8,4441,4786,558,417,345,-141,486,0.00939579254996725,-0.00384001956389966,0.0132358121138669,EPCI
242000503,CC Celavu-Prunelli,1990_1999,1994.5,9,4786,6078,563,495,1292,-68,1360,0.026909094724147,-0.00141626814337616,0.0283253628675232,EPCI
242000503,CC Celavu-Prunelli,1999_2010,2004.5,11,6078,7654,629,666,1576,37,1539,0.0211805251842419,0.00049725852272649,0.0206832666615154,EPCI
242010056,CA du Pays Ajaccien,2010_2015,2012.5,5,79502,83997,3547,3643,4495,96,4399,0.0110605010918603,0.00023621982309646,0.0108242812687638,EPCI
242010056,CA du Pays Ajaccien,1968_1975,1971.5,7,46471,52263,3317,5787,5792,2470,3322,0.0169216042549345,0.00721622280899313,0.00970538144594137,EPCI
242010056,CA du Pays Ajaccien,1975_1982,1978.5,7,52263,59496,3817,5256,7233,1439,5794,0.0186897093450693,0.00371830385006978,0.0149714054949995,EPCI
242010056,CA du Pays Ajaccien,1982_1990,1986,8,59496,67686,4860,6797,8190,1937,6253,0.0162519341048026,0.00384371139938983,0.0124082227054128,EPCI
242010056,CA du Pays Ajaccien,1990_1999,1994.5,9,67686,63707,5632,6952,-3979,1320,-5299,-0.00670905061621119,0.00222567147861241,-0.0089347220948236,EPCI
242010056,CA du Pays Ajaccien,1999_2010,2004.5,11,63707,79502,6837,7878,15795,1041,14754,0.0203393299129551,0.00134050284516532,0.0189988270677897,EPCI
242010130,CC du Sartenais Valinco,2010_2015,2012.5,5,10888,11485,681,506,597,-175,772,0.0107333072171414,-0.00314627933500794,0.0138795865521493,EPCI
242010130,CC du Sartenais Valinco,1968_1975,1971.5,7,8251,10002,968,658,1751,-310,2061,0.0278743711920884,-0.00493492579642912,0.0328092969885175,EPCI
242010130,CC du Sartenais Valinco,1975_1982,1978.5,7,10002,9298,950,634,-704,-316,-388,-0.0103723677770156,-0.00465577871809221,-0.00571658905892335,EPCI
242010130,CC du Sartenais Valinco,1982_1990,1986,8,9298,10250,994,942,952,-52,1004,0.0122593348701892,-0.000669627534926298,0.0129289624051155,EPCI
242010130,CC du Sartenais Valinco,1990_1999,1994.5,9,10250,10293,1235,985,43,-250,293,0.000465257861102408,-0.00270498756454889,0.00317024542565129,EPCI
242010130,CC du Sartenais Valinco,1999_2010,2004.5,11,10293,10888,1586,1153,595,-433,1028,0.00512190989019068,-0.00372737307975221,0.00884928296994289,EPCI
242020071,CC du Centre Corse,2010_2015,2012.5,5,9344,9693,465,326,349,-139,488,0.00736086886663601,-0.00293169275777193,0.0102925616244079,EPCI
242020071,CC du Centre Corse,1968_1975,1971.5,7,7327,7429,736,627,102,-109,211,0.00197696662557667,-0.0021126408057633,0.00408960743133998,EPCI
242020071,CC du Centre Corse,1975_1982,1978.5,7,7429,7294,741,484,-135,-257,122,-0.00261645221844742,-0.00498094977882212,0.0023644975603747,EPCI
242020071,CC du Centre Corse,1982_1990,1986,8,7294,7546,808,584,252,-224,476,0.00425471686004708,-0.00378197054226407,0.00803668740231115,EPCI
242020071,CC du Centre Corse,1990_1999,1994.5,9,7546,8451,896,568,905,-328,1233,0.0126647669587763,-0.00459010338395428,0.0172548703427306,EPCI
242020071,CC du Centre Corse,1999_2010,2004.5,11,8451,9344,829,745,893,-84,977,0.00917360819543145,-0.00086291499262737,0.0100365231880588,EPCI
242020105,CC de Calvi Balagne,2010_2015,2012.5,5,11631,11785,559,769,154,210,-56,0.00263418118071423,0.0035920652464285,-0.000957884065714267,EPCI
242020105,CC de Calvi Balagne,1968_1975,1971.5,7,6464,7963,621,675,1499,54,1445,0.0302422074243716,0.00108944576445368,0.0291527616599179,EPCI
242020105,CC de Calvi Balagne,1975_1982,1978.5,7,7963,8440,646,652,477,6,471,0.00834555953982741,0.000104975591695942,0.00824058394813147,EPCI
242020105,CC de Calvi Balagne,1982_1990,1986,8,8440,9590,821,987,1150,166,984,0.0160954814400058,0.0023233477556878,0.013772133684318,EPCI
242020105,CC de Calvi Balagne,1990_1999,1994.5,9,9590,10355,909,1216,765,307,458,0.00856408663560981,0.00343682953873492,0.0051272570968749,EPCI
242020105,CC de Calvi Balagne,1999_2010,2004.5,11,10355,11631,1189,1522,1276,333,943,0.0106200376291603,0.00277153019632475,0.00784850743283556,EPCI
242100154,CC des Vallées de la Tille et de l'Ignon,2010_2015,2012.5,5,12907,13459,482,782,552,300,252,0.00841081933096266,0.00457109746247971,0.00383972186848295,EPCI
242100154,CC des Vallées de la Tille et de l'Ignon,1968_1975,1971.5,7,8954,9742,714,1261,788,547,241,0.0121223263158023,0.00841486357201,0.00370746274379234,EPCI
242100154,CC des Vallées de la Tille et de l'Ignon,1975_1982,1978.5,7,9742,10809,748,1077,1067,329,738,0.0149582985077326,0.00461225886508342,0.0103460396426491,EPCI
242100154,CC des Vallées de la Tille et de l'Ignon,1982_1990,1986,8,10809,11111,769,1160,302,391,-89,0.00345050033877903,0.00446736964391589,-0.00101686930513687,EPCI
242100154,CC des Vallées de la Tille et de l'Ignon,1990_1999,1994.5,9,11111,11417,865,1228,306,363,-57,0.0030232122823679,0.00358635966829918,-0.000563147385931277,EPCI
242100154,CC des Vallées de la Tille et de l'Ignon,1999_2010,2004.5,11,11417,12907,1033,1739,1490,706,784,0.0112138938587822,0.00531342890221494,0.0059004649565673,EPCI
242100410,Dijon Métropole,2010_2015,2012.5,5,244652,251650,9324,14402,6998,5078,1920,0.00565642561947133,0.00410450547237431,0.00155192014709702,EPCI
242100410,Dijon Métropole,1968_1975,1971.5,7,192337,221542,11227,28616,29205,17389,11816,0.0204000284227224,0.0121464165123342,0.00825361191038821,EPCI
242100410,Dijon Métropole,1975_1982,1978.5,7,221542,224605,11421,25758,3063,14337,-11274,0.00196351318552823,0.00919062636007779,-0.00722711317454955,EPCI
242100410,Dijon Métropole,1982_1990,1986,8,224605,237246,12940,27567,12641,14627,-1986,0.00686775984557952,0.00794673864894326,-0.00107897880336373,EPCI
242100410,Dijon Métropole,1990_1999,1994.5,9,237246,244027,15219,28005,6781,12786,-6005,0.00313616276882844,0.00591343122876279,-0.00277726845993435,EPCI
242100410,Dijon Métropole,1999_2010,2004.5,11,244027,244652,19283,31763,625,12480,-11855,0.00023256501509672,0.0046438582214513,-0.00441129320635458,EPCI
242101434,CC du Pays Châtillonnais,2010_2015,2012.5,5,21037,20346,1323,923,-691,-400,-291,-0.00665743240364702,-0.00385379589212563,-0.00280363651152139,EPCI
242101434,CC du Pays Châtillonnais,1968_1975,1971.5,7,27654,26429,2477,3146,-1225,669,-1894,-0.00645173912919117,0.00352343957341134,-0.00997517870260251,EPCI
242101434,CC du Pays Châtillonnais,1975_1982,1978.5,7,26429,25530,2271,2343,-899,72,-971,-0.00493175033783755,0.000394978892463074,-0.00532672923030062,EPCI
242101434,CC du Pays Châtillonnais,1982_1990,1986,8,25530,23891,2502,2401,-1639,-101,-1538,-0.00825975078499786,-0.000508990133791814,-0.00775076065120604,EPCI
242101434,CC du Pays Châtillonnais,1990_1999,1994.5,9,23891,22625,2680,2242,-1266,-438,-828,-0.00603133021657398,-0.00208666874791422,-0.00394466146865976,EPCI
242101434,CC du Pays Châtillonnais,1999_2010,2004.5,11,22625,21037,3114,2321,-1588,-793,-795,-0.00659386420407848,-0.00329277979460594,-0.00330108440947254,EPCI
242101442,CC de Saulieu,2010_2015,2012.5,5,5741,5510,460,217,-231,-243,12,-0.00818011686577902,-0.00860505800166364,0.000424941135884625,EPCI
242101442,CC de Saulieu,1968_1975,1971.5,7,7140,6344,721,625,-796,-96,-700,-0.0167444120798981,-0.00201942658250027,-0.0147249854973978,EPCI
242101442,CC de Saulieu,1975_1982,1978.5,7,6344,6382,666,526,38,-140,178,0.000853513109976278,-0.00314452198412313,0.00399803509409941,EPCI
242101442,CC de Saulieu,1982_1990,1986,8,6382,5973,701,599,-409,-102,-307,-0.00824485000296815,-0.00205617286137592,-0.00618867714159223,EPCI
242101442,CC de Saulieu,1990_1999,1994.5,9,5973,5880,757,557,-93,-200,107,-0.00174209765427946,-0.00374644656834293,0.00200434891406347,EPCI
242101442,CC de Saulieu,1999_2010,2004.5,11,5880,5741,1000,564,-139,-436,297,-0.00217248679307291,-0.00681441900561,0.00464193221253709,EPCI
242101459,CC du Pays d'Alésia et de la Seine,2010_2015,2012.5,5,7717,7666,450,357,-51,-93,42,-0.00132526516290588,-0.00241666000294601,0.00109139484004013,EPCI
242101459,CC du Pays d'Alésia et de la Seine,1968_1975,1971.5,7,9381,8676,743,942,-705,199,-904,-0.0110987739378292,0.00313284540940144,-0.0142316193472306,EPCI
242101459,CC du Pays d'Alésia et de la Seine,1975_1982,1978.5,7,8676,8613,752,706,-63,-46,-17,-0.00104058723573186,-0.000759793854661358,-0.000280793381070502,EPCI
242101459,CC du Pays d'Alésia et de la Seine,1982_1990,1986,8,8613,8580,866,994,-33,128,-161,-0.000479731930217775,0.00186077839599622,-0.00234051032621399,EPCI
242101459,CC du Pays d'Alésia et de la Seine,1990_1999,1994.5,9,8580,8072,900,848,-508,-52,-456,-0.00675846155580617,-0.000691811025397482,-0.00606665053040869,EPCI
242101459,CC du Pays d'Alésia et de la Seine,1999_2010,2004.5,11,8072,7717,1196,870,-355,-326,-29,-0.00408034319226802,-0.00374701938219542,-0.000333323810072599,EPCI
242101491,CC du Montbardois,2010_2015,2012.5,5,11275,10997,633,504,-278,-129,-149,-0.00498063073197796,-0.00231115598714085,-0.00266947474483711,EPCI
242101491,CC du Montbardois,1968_1975,1971.5,7,13185,13239,1034,1486,54,452,-398,0.000584056087269858,0.00488876576751807,-0.00430470968024821,EPCI
242101491,CC du Montbardois,1975_1982,1978.5,7,13239,13630,977,1349,391,372,19,0.00416668900396355,0.00396421562525433,0.000202473378709226,EPCI
242101491,CC du Montbardois,1982_1990,1986,8,13630,13121,1075,1448,-509,373,-882,-0.00474610716795121,0.00347799208967741,-0.00822409925762861,EPCI
242101491,CC du Montbardois,1990_1999,1994.5,9,13121,12144,1215,1212,-977,-3,-974,-0.00856078813286765,-2.62869645840358e-05,-0.00853450116828361,EPCI
242101491,CC du Montbardois,1999_2010,2004.5,11,12144,11275,1440,1391,-869,-49,-820,-0.00672702930239577,-0.000379314655716217,-0.00634771464667955,EPCI
242101509,CC Rives de Saône,2010_2015,2012.5,5,20251,20798,1090,1199,547,109,438,0.00534476319397381,0.00106504421964012,0.00427971897433369,EPCI
242101509,CC Rives de Saône,1968_1975,1971.5,7,16743,16945,1629,1798,202,169,33,0.00171468905589545,0.00143456658636797,0.000280122469527474,EPCI
242101509,CC Rives de Saône,1975_1982,1978.5,7,16945,17746,1571,1639,801,68,733,0.0066200064936397,0.000561998054391385,0.00605800843924831,EPCI
242101509,CC Rives de Saône,1982_1990,1986,8,17746,18369,1604,1873,623,269,354,0.00432235488887311,0.00186631374816512,0.002456041140708,EPCI
242101509,CC Rives de Saône,1990_1999,1994.5,9,18369,18366,1713,1887,-3,174,-177,-1.81478322812678e-05,0.00105257427231353,-0.0010707221045948,EPCI
242101509,CC Rives de Saône,1999_2010,2004.5,11,18366,20251,2216,2589,1885,373,1512,0.00892165793140998,0.00176539968616229,0.00715625824524768,EPCI
242200715,CC du Kreiz-Breizh (Cckb),2010_2015,2012.5,5,19197,18653,1565,766,-544,-799,255,-0.00573290895238443,-0.00842021002381463,0.0026873010714302,EPCI
242200715,CC du Kreiz-Breizh (Cckb),1968_1975,1971.5,7,26082,24698,2500,1839,-1384,-661,-723,-0.00775876596645275,-0.00370559559524947,-0.00405317037120328,EPCI
242200715,CC du Kreiz-Breizh (Cckb),1975_1982,1978.5,7,24698,23431,2660,1382,-1267,-1278,11,-0.00749496259838334,-0.00756003330760371,6.50707092203755e-05,EPCI
242200715,CC du Kreiz-Breizh (Cckb),1982_1990,1986,8,23431,21599,3011,1735,-1832,-1276,-556,-0.0101250077951042,-0.00705213425030181,-0.00307287354480236,EPCI
242200715,CC du Kreiz-Breizh (Cckb),1990_1999,1994.5,9,21599,20142,3139,1732,-1457,-1407,-50,-0.00772995019829725,-0.00746468080233647,-0.000265269395960784,EPCI
242200715,CC du Kreiz-Breizh (Cckb),1999_2010,2004.5,11,20142,19197,3548,1938,-945,-1610,665,-0.00435894215032562,-0.00742634588573994,0.00306740373541432,EPCI
242400752,CC Périgord-Limousin,2010_2015,2012.5,5,14722,14301,1130,485,-421,-645,224,-0.0057858985922945,-0.00886438145375286,0.00307848286145836,EPCI
242400752,CC Périgord-Limousin,1968_1975,1971.5,7,17538,17014,1816,1224,-524,-592,68,-0.00432397043319654,-0.00488509636727549,0.000561125934078941,EPCI
242400752,CC Périgord-Limousin,1975_1982,1978.5,7,17014,16078,1822,1003,-936,-819,-117,-0.00805093856768613,-0.00704457124672536,-0.00100636732096077,EPCI
242400752,CC Périgord-Limousin,1982_1990,1986,8,16078,15439,1933,1082,-639,-851,212,-0.00505656011979483,-0.00673416692010235,0.00167760680030752,EPCI
242400752,CC Périgord-Limousin,1990_1999,1994.5,9,15439,14687,2092,1073,-752,-1019,267,-0.00553286223384419,-0.00749732262804153,0.00196446039419734,EPCI
242400752,CC Périgord-Limousin,1999_2010,2004.5,11,14687,14722,2576,1199,35,-1377,1412,0.000216407491340664,-0.00851408901645985,0.00873049650780052,EPCI
242400935,CC du Pays de Saint-Aulaye,2010_2015,2012.5,5,6575,6651,616,242,76,-374,450,0.00230117188885037,-0.0113241879793426,0.013625359868193,EPCI
242400935,CC du Pays de Saint-Aulaye,1968_1975,1971.5,7,7001,7004,740,680,3,-60,63,6.12045055685684e-05,-0.00122409011137137,0.00128529461693994,EPCI
242400935,CC du Pays de Saint-Aulaye,1975_1982,1978.5,7,7004,7019,779,477,15,-302,317,0.000305667181649483,-0.00615409925720959,0.00645976643885907,EPCI
242400935,CC du Pays de Saint-Aulaye,1982_1990,1986,8,7019,6813,858,522,-206,-336,130,-0.00371660201883173,-0.00606203047731777,0.00234542845848604,EPCI
242400935,CC du Pays de Saint-Aulaye,1990_1999,1994.5,9,6813,6576,919,483,-237,-436,199,-0.00392626023199083,-0.0072229935069536,0.00329673327496276,EPCI
242400935,CC du Pays de Saint-Aulaye,1999_2010,2004.5,11,6576,6575,1185,599,-1,-586,585,-1.38253307974123e-05,-0.00810164384728362,0.00808781851648621,EPCI
242401024,CC Isle-Loue-Auvézère en Périgord,2010_2015,2012.5,5,14071,13861,1017,427,-210,-590,380,-0.00300284253734562,-0.0084365576049234,0.00543371506757779,EPCI
242401024,CC Isle-Loue-Auvézère en Périgord,1968_1975,1971.5,7,17008,15987,1890,1140,-1021,-750,-271,-0.00880499690221581,-0.00646792132875794,-0.00233707557345787,EPCI
242401024,CC Isle-Loue-Auvézère en Périgord,1975_1982,1978.5,7,15987,14918,1789,883,-1069,-906,-163,-0.00983805153254746,-0.00833795574227129,-0.00150009579027618,EPCI
242401024,CC Isle-Loue-Auvézère en Périgord,1982_1990,1986,8,14918,14320,1955,936,-598,-1019,421,-0.00510086816252964,-0.00869194758798946,0.00359107942545983,EPCI
242401024,CC Isle-Loue-Auvézère en Périgord,1990_1999,1994.5,9,14320,13722,2098,929,-598,-1169,571,-0.00472842753981861,-0.00924336420409358,0.00451493666427496,EPCI
242401024,CC Isle-Loue-Auvézère en Périgord,1999_2010,2004.5,11,13722,14071,2252,1158,349,-1094,1443,0.0022858410636728,-0.00716535852051015,0.00945119958418295,EPCI
242500320,CC de Montbenoît,2010_2015,2012.5,5,6767,7476,200,554,709,354,355,0.020127894773418,0.0100497528205783,0.0100781419528398,EPCI
242500320,CC de Montbenoît,1968_1975,1971.5,7,4826,4637,368,544,-189,176,-365,-0.00569093944552868,0.0052994991662066,-0.0109904386117353,EPCI
242500320,CC de Montbenoît,1975_1982,1978.5,7,4637,4805,313,527,168,214,-46,0.00509715179085912,0.00649280049549912,-0.00139564870464,EPCI
242500320,CC de Montbenoît,1982_1990,1986,8,4805,5080,327,569,275,242,33,0.00698103198385325,0.00614330814579086,0.00083772383806239,EPCI
242500320,CC de Montbenoît,1990_1999,1994.5,9,5080,5574,352,702,494,350,144,0.0103646409950964,0.00734336912608043,0.00302127186901595,EPCI
242500320,CC de Montbenoît,1999_2010,2004.5,11,5574,6767,425,1059,1193,634,559,0.0177877070203085,0.00945298093116144,0.00833472608914708,EPCI
242500338,CC du Grand Pontarlier,2010_2015,2012.5,5,27017,26646,1234,1882,-371,648,-1019,-0.00276163005699748,0.00482354791626514,-0.00758517797326261,EPCI
242500338,CC du Grand Pontarlier,1968_1975,1971.5,7,19903,22302,1393,2942,2399,1549,850,0.016390863934945,0.0105833464923843,0.00580751744256077,EPCI
242500338,CC du Grand Pontarlier,1975_1982,1978.5,7,22302,22875,1350,2706,573,1356,-783,0.00363061056036673,0.00859181137845949,-0.00496120081809276,EPCI
242500338,CC du Grand Pontarlier,1982_1990,1986,8,22875,24227,1594,2937,1352,1343,9,0.00720371060250824,0.00715575690766906,4.79536948391826e-05,EPCI
242500338,CC du Grand Pontarlier,1990_1999,1994.5,9,24227,25492,1790,3425,1265,1635,-370,0.00567123912652012,0.00733002053111494,-0.00165878140459482,EPCI
242500338,CC du Grand Pontarlier,1999_2010,2004.5,11,25492,27017,2396,3867,1525,1471,54,0.00529593963135988,0.00510841127720025,0.000187528354159628,EPCI
242500361,CA du Grand Besançon,2010_2015,2012.5,5,189980,192816,6902,11635,2836,4733,-1897,0.0029679081089713,0.00495314142445738,-0.00198523331548609,EPCI
242500361,CA du Grand Besançon,1968_1975,1971.5,7,140997,160107,8199,22241,19110,14042,5068,0.0183235283545418,0.0134641017872567,0.00485942656728507,EPCI
242500361,CA du Grand Besançon,1975_1982,1978.5,7,160107,162384,8219,19135,2277,10916,-8639,0.00201940182044513,0.00968106731312212,-0.00766166549267699,EPCI
242500361,CA du Grand Besançon,1982_1990,1986,8,162384,171606,9527,20450,9222,10923,-1701,0.00692854844327018,0.00820652078137499,-0.00127797233810481,EPCI
242500361,CA du Grand Besançon,1990_1999,1994.5,9,171606,181898,11027,20751,10292,9724,568,0.00649264632028723,0.00613432693533551,0.000358319384951724,EPCI
242500361,CA du Grand Besançon,1999_2010,2004.5,11,181898,189980,14355,26105,8082,11750,-3668,0.0039598845289015,0.00575707042991743,-0.00179718590101593,EPCI
242504116,CC du Val de Morteau,2010_2015,2012.5,5,19151,20197,727,1310,1046,583,463,0.0106925904741677,0.00595963694688315,0.00473295352728456,EPCI
242504116,CC du Val de Morteau,1968_1975,1971.5,7,15600,17120,959,2100,1520,1141,379,0.0133709531931654,0.0100370115746064,0.003333941618559,EPCI
242504116,CC du Val de Morteau,1975_1982,1978.5,7,17120,16726,875,2143,-394,1268,-1662,-0.00332061391969662,0.0106866458126277,-0.0140072597323243,EPCI
242504116,CC du Val de Morteau,1982_1990,1986,8,16726,17348,1058,2006,622,948,-326,0.00457453526276064,0.00697212126864483,-0.00239758600588419,EPCI
242504116,CC du Val de Morteau,1990_1999,1994.5,9,17348,17662,1192,2249,314,1057,-743,0.00199512239938859,0.00671606489220937,-0.00472094249282078,EPCI
242504116,CC du Val de Morteau,1999_2010,2004.5,11,17662,19151,1525,2571,1489,1046,443,0.00738527346867923,0.00518804301426358,0.00219723045441565,EPCI
242504181,CC des Portes du Haut-Doubs,2010_2015,2012.5,5,23758,25478,879,1812,1720,933,787,0.0140773697269521,0.00763615462514318,0.00644121510180888,EPCI
242504181,CC des Portes du Haut-Doubs,1968_1975,1971.5,7,16293,16575,1069,2294,282,1225,-943,0.00245443124689793,0.0106619797072694,-0.00820754846037143,EPCI
242504181,CC des Portes du Haut-Doubs,1975_1982,1978.5,7,16575,17683,979,1985,1108,1006,102,0.00928688512020615,0.00843195526256984,0.000854929857636305,EPCI
242504181,CC des Portes du Haut-Doubs,1982_1990,1986,8,17683,18276,1187,2230,593,1043,-450,0.00413163647653003,0.00726694240307053,-0.0031353059265405,EPCI
242504181,CC des Portes du Haut-Doubs,1990_1999,1994.5,9,18276,19536,1369,2343,1260,974,286,0.00743530491833799,0.00574760872258826,0.00168769619574973,EPCI
242504181,CC des Portes du Haut-Doubs,1999_2010,2004.5,11,19536,23758,1739,3668,4222,1929,2293,0.0179464452697411,0.00819959567156101,0.00974684959818009,EPCI
242504355,CC du Plateau de Russey,2010_2015,2012.5,5,5926,6425,158,444,499,286,213,0.0163008691039497,0.0093427826928449,0.00695808641110477,EPCI
242504355,CC du Plateau de Russey,1968_1975,1971.5,7,4261,4229,263,534,-32,271,-303,-0.00107632263845581,0.00911510734442261,-0.0101914299828784,EPCI
242504355,CC du Plateau de Russey,1975_1982,1978.5,7,4229,4297,246,455,68,209,-141,0.00228139074954759,0.00701192156846243,-0.00473053081891485,EPCI
242504355,CC du Plateau de Russey,1982_1990,1986,8,4297,4497,272,503,200,231,-31,0.00570287520604151,0.00658682086297795,-0.000883945656936435,EPCI
242504355,CC du Plateau de Russey,1990_1999,1994.5,9,4497,4904,355,643,407,288,119,0.00967322957208494,0.00684493886181932,0.00282829071026562,EPCI
242504355,CC du Plateau de Russey,1999_2010,2004.5,11,4904,5926,400,784,1022,384,638,0.0173578585966647,0.00652193512829673,0.010835923468368,EPCI
242504371,CC du Pays de Sancey-Belleherbe,2010_2015,2012.5,5,5170,5440,243,280,270,37,233,0.0102332799887233,0.00140233836882504,0.00883094161989821,EPCI
242504371,CC du Pays de Sancey-Belleherbe,1968_1975,1971.5,7,5359,5132,411,647,-227,236,-463,-0.00616405858188218,0.00640844856971011,-0.0125725071515923,EPCI
242504371,CC du Pays de Sancey-Belleherbe,1975_1982,1978.5,7,5132,5321,352,528,189,176,13,0.00517991372703119,0.00482362336485444,0.000356290362176749,EPCI
242504371,CC du Pays de Sancey-Belleherbe,1982_1990,1986,8,5321,5176,386,558,-145,172,-317,-0.00344763052871322,0.00408960310992189,-0.00753723363863511,EPCI
242504371,CC du Pays de Sancey-Belleherbe,1990_1999,1994.5,9,5176,5127,446,524,-49,78,-127,-0.00105631552745478,0.00168148186003005,-0.00273779738748483,EPCI
242504371,CC du Pays de Sancey-Belleherbe,1999_2010,2004.5,11,5127,5170,557,665,43,108,-65,0.000759560658278646,0.00190773374637427,-0.00114817308809563,EPCI
242504447,CC du Doubs Baumois,2010_2015,2012.5,5,15865,16220,729,994,355,265,90,0.0044357336010501,0.00331118142050218,0.00112455218054791,EPCI
242504447,CC du Doubs Baumois,1968_1975,1971.5,7,11483,12121,980,1448,638,468,170,0.00775445478144121,0.00568822074876879,0.00206623403267242,EPCI
242504447,CC du Doubs Baumois,1975_1982,1978.5,7,12121,12893,1021,1302,772,281,491,0.00885973760994308,0.00322485267926684,0.00563488493067623,EPCI
242504447,CC du Doubs Baumois,1982_1990,1986,8,12893,13494,1085,1562,601,477,124,0.00571132450097367,0.00453294806483268,0.00117837643614099,EPCI
242504447,CC du Doubs Baumois,1990_1999,1994.5,9,13494,14328,1161,1640,834,479,355,0.00668564117945802,0.00383983468220671,0.00284580649725132,EPCI
242504447,CC du Doubs Baumois,1999_2010,2004.5,11,14328,15865,1509,2201,1537,692,845,0.00930665464763858,0.00419011386868308,0.0051165407789555,EPCI
242504488,CC Altitude 800,2010_2015,2012.5,5,5895,6236,269,445,341,176,165,0.0113103674105146,0.00583760898607206,0.00547275842444255,EPCI
242504488,CC Altitude 800,1968_1975,1971.5,7,4746,4603,325,516,-143,191,-334,-0.00436101918677223,0.00582485779491955,-0.0101858769816918,EPCI
242504488,CC Altitude 800,1975_1982,1978.5,7,4603,4877,329,509,274,180,94,0.00829449771810786,0.00544894010678619,0.00284555761132168,EPCI
242504488,CC Altitude 800,1982_1990,1986,8,4877,5115,384,529,238,145,93,0.00597366191363813,0.00363941587175432,0.00233424604188381,EPCI
242504488,CC Altitude 800,1990_1999,1994.5,9,5115,5102,425,539,-13,114,-127,-0.000282713327272477,0.00247917840838941,-0.00276189173566189,EPCI
242504488,CC Altitude 800,1999_2010,2004.5,11,5102,5895,583,797,793,214,579,0.0132204377093037,0.00356768432508322,0.00965275338422048,EPCI
242504496,CC du Plateau de Frasne et du Val de Drugeon (Cfd),2010_2015,2012.5,5,5522,5907,200,375,385,175,210,0.0135708542888457,0.00616857013129352,0.00740228415755223,EPCI
242504496,CC du Plateau de Frasne et du Val de Drugeon (Cfd),1968_1975,1971.5,7,4151,3858,302,378,-293,76,-369,-0.0104027071545892,0.00269831311859653,-0.0131010202731858,EPCI
242504496,CC du Plateau de Frasne et du Val de Drugeon (Cfd),1975_1982,1978.5,7,3858,4051,262,358,193,96,97,0.0069979217817322,0.00348083155982534,0.00351709022190686,EPCI
242504496,CC du Plateau de Frasne et du Val de Drugeon (Cfd),1982_1990,1986,8,4051,4517,292,479,466,187,279,0.013703581560758,0.00549907672073337,0.00820450484002465,EPCI
242504496,CC du Plateau de Frasne et du Val de Drugeon (Cfd),1990_1999,1994.5,9,4517,4791,345,592,274,247,27,0.00656491086972699,0.00591800359424295,0.000646907275484047,EPCI
242504496,CC du Plateau de Frasne et du Val de Drugeon (Cfd),1999_2010,2004.5,11,4791,5522,418,769,731,351,380,0.0129928609237693,0.00623870613439537,0.00675415478937391,EPCI
242600252,CC du Val de Drôme,2010_2015,2012.5,5,29114,30415,1124,1768,1301,644,657,0.00878168465319762,0.00434696765308168,0.00443471700011594,EPCI
242600252,CC du Val de Drôme,1968_1975,1971.5,7,18086,17683,1566,1652,-403,86,-489,-0.00321402852312358,0.000685872091783196,-0.00389990061490678,EPCI
242600252,CC du Val de Drôme,1975_1982,1978.5,7,17683,21193,1455,1820,3510,365,3145,0.0262041921413354,0.00272493735942662,0.0234792547819088,EPCI
242600252,CC du Val de Drôme,1982_1990,1986,8,21193,23905,1731,2523,2712,792,1920,0.0151659411518368,0.00442899166381074,0.010736949488026,EPCI
242600252,CC du Val de Drôme,1990_1999,1994.5,9,23905,25939,1920,2643,2034,723,1311,0.00911461918099832,0.00323985726050235,0.00587476192049597,EPCI
242600252,CC du Val de Drôme,1999_2010,2004.5,11,25939,29114,2369,3700,3175,1331,1844,0.0105527029932984,0.00442382604222996,0.0061288769510684,EPCI
242600492,CC Dieulefit-Bourdeaux,2010_2015,2012.5,5,8925,9361,590,394,436,-196,632,0.00958480173730947,-0.00430876408374462,0.0138935658210541,EPCI
242600492,CC Dieulefit-Bourdeaux,1968_1975,1971.5,7,6673,6546,706,527,-127,-179,52,-0.00274128691262965,-0.00386370360126541,0.00112241668863576,EPCI
242600492,CC Dieulefit-Bourdeaux,1975_1982,1978.5,7,6546,6966,742,468,420,-274,694,0.00892343512236393,-0.00582147910363742,0.0147449142260014,EPCI
242600492,CC Dieulefit-Bourdeaux,1982_1990,1986,8,6966,7503,774,691,537,-83,620,0.00932593915638802,-0.001441439385438,0.010767378541826,EPCI
242600492,CC Dieulefit-Bourdeaux,1990_1999,1994.5,9,7503,8178,938,702,675,-236,911,0.00961758582987593,-0.0033625929716307,0.0129801788015066,EPCI
242600492,CC Dieulefit-Bourdeaux,1999_2010,2004.5,11,8178,8925,1166,923,747,-243,990,0.00797790117851416,-0.00259522086529979,0.0105731220438139,EPCI
242600534,CC du Diois,2010_2015,2012.5,5,10975,11404,680,506,429,-174,603,0.00769832330308806,-0.00312239686418956,0.0108207201672776,EPCI
242600534,CC du Diois,1968_1975,1971.5,7,10455,9717,1135,790,-738,-345,-393,-0.0104031382564298,-0.00486325568898141,-0.00553988256744839,EPCI
242600534,CC du Diois,1975_1982,1978.5,7,9717,9615,1064,753,-102,-311,209,-0.00150637139857057,-0.00459295593093576,0.00308658453236519,EPCI
242600534,CC du Diois,1982_1990,1986,8,9615,9860,1125,974,245,-151,396,0.00315017510250848,-0.00194153649175012,0.0050917115942586,EPCI
242600534,CC du Diois,1990_1999,1994.5,9,9860,10292,1132,961,432,-171,603,0.0047758934869373,-0.00189045783857935,0.00666635132551665,EPCI
242600534,CC du Diois,1999_2010,2004.5,11,10292,10975,1494,1112,683,-382,1065,0.00585828068733907,-0.00327652009160106,0.00913480077894013,EPCI
242700276,CC du Pays de Conches,2010_2015,2012.5,5,18533,18785,741,1116,252,375,-123,0.00270480183592192,0.00402500273202667,-0.00132020089610475,EPCI
242700276,CC du Pays de Conches,1968_1975,1971.5,7,10237,11045,877,1128,808,251,557,0.0109118516717928,0.00338969649705443,0.00752215517473833,EPCI
242700276,CC du Pays de Conches,1975_1982,1978.5,7,11045,12525,895,1061,1480,166,1314,0.0181264410085495,0.0020331008158238,0.0160933401927257,EPCI
242700276,CC du Pays de Conches,1982_1990,1986,8,12525,14850,1054,1673,2325,619,1706,0.0215122754486372,0.00572735419471244,0.0157849212539248,EPCI
242700276,CC du Pays de Conches,1990_1999,1994.5,9,14850,16045,1281,1853,1195,572,623,0.00863679589736832,0.00413409811991187,0.00450269777745646,EPCI
242700276,CC du Pays de Conches,1999_2010,2004.5,11,16045,18533,1473,2508,2488,1035,1453,0.0131913069336538,0.00548754126862205,0.00770376566503173,EPCI
242700607,CC du Pays du Neubourg,2010_2015,2012.5,5,17968,18838,856,1065,870,209,661,0.00950159794906358,0.00228256778316585,0.00721903016589773,EPCI
242700607,CC du Pays du Neubourg,1968_1975,1971.5,7,10623,11639,980,1352,1016,372,644,0.0131340851099755,0.00480893667412488,0.00832514843585061,EPCI
242700607,CC du Pays du Neubourg,1975_1982,1978.5,7,11639,12850,973,1224,1211,251,960,0.0142407735039622,0.00295163843888895,0.0112891350650733,EPCI
242700607,CC du Pays du Neubourg,1982_1990,1986,8,12850,14392,1116,1576,1542,460,1082,0.0142669001412203,0.00425601430931346,0.0100108858319069,EPCI
242700607,CC du Pays du Neubourg,1990_1999,1994.5,9,14392,15183,1351,1750,791,399,392,0.00596258187243515,0.00300767404184782,0.00295490783058733,EPCI
242700607,CC du Pays du Neubourg,1999_2010,2004.5,11,15183,17968,1834,2451,2785,617,2168,0.0154283538949962,0.00341805901372088,0.0120102948812753,EPCI
242700623,CC Eure-Madrie-Seine,2010_2015,2012.5,5,26364,27130,997,1780,766,783,-17,0.00574457384082816,0.00587206438298753,-0.000127490542159371,EPCI
242700623,CC Eure-Madrie-Seine,1968_1975,1971.5,7,12509,14479,910,1614,1970,704,1266,0.0211127777623024,0.00754487083485323,0.0135679069274491,EPCI
242700623,CC Eure-Madrie-Seine,1975_1982,1978.5,7,14479,18080,929,1825,3601,896,2705,0.0322383254182506,0.00802153278943418,0.0242167926288164,EPCI
242700623,CC Eure-Madrie-Seine,1982_1990,1986,8,18080,21630,1178,2546,3550,1368,2182,0.0226623364885841,0.00873297924405155,0.0139293572445325,EPCI
242700623,CC Eure-Madrie-Seine,1990_1999,1994.5,9,21630,22902,1570,2664,1272,1094,178,0.00636942159878551,0.00547810316750892,0.000891318431276589,EPCI
242700623,CC Eure-Madrie-Seine,1999_2010,2004.5,11,22902,26364,2045,3749,3462,1704,1758,0.0128799870784928,0.00633954303343493,0.00654044404505787,EPCI
242852465,CC du Bonnevalais,2010_2015,2012.5,5,12014,12508,663,724,494,61,433,0.0080917230851465,0.000999180380959385,0.00709254270418711,EPCI
242852465,CC du Bonnevalais,1968_1975,1971.5,7,12004,11374,957,910,-630,-47,-583,-0.00767183135869609,-0.000572342974378915,-0.00709948838431718,EPCI
242852465,CC du Bonnevalais,1975_1982,1978.5,7,11374,11002,972,697,-372,-275,-97,-0.00473915949588333,-0.00350341091765569,-0.00123574857822764,EPCI
242852465,CC du Bonnevalais,1982_1990,1986,8,11002,10578,1043,776,-424,-267,-157,-0.00490054070252799,-0.00308595369711079,-0.0018145870054172,EPCI
242852465,CC du Bonnevalais,1990_1999,1994.5,9,10578,10577,1231,917,-1,-314,313,-1.0504422369495e-05,-0.00329838862402143,0.00328788420165194,EPCI
242852465,CC du Bonnevalais,1999_2010,2004.5,11,10577,12014,1408,1418,1437,10,1427,0.0116483013866604,8.10598565529603e-05,0.0115672415301074,EPCI
242900074,CC du Pays d'Iroise,2010_2015,2012.5,5,45662,47801,2091,2591,2139,500,1639,0.00919806813057256,0.00215008605202725,0.00704798207854531,EPCI
242900074,CC du Pays d'Iroise,1968_1975,1971.5,7,26325,27814,2242,2780,1489,538,951,0.00789103324105223,0.00285115908911088,0.00503987415194135,EPCI
242900074,CC du Pays d'Iroise,1975_1982,1978.5,7,27814,32085,2326,2712,4271,386,3885,0.0206166669149062,0.00186327169963797,0.0187533952152682,EPCI
242900074,CC du Pays d'Iroise,1982_1990,1986,8,32085,36031,2948,3548,3946,600,3346,0.0146044995856613,0.00222065376365859,0.0123838458220028,EPCI
242900074,CC du Pays d'Iroise,1990_1999,1994.5,9,36031,38923,3425,3860,2892,435,2457,0.00861530624549167,0.00129587075269325,0.00731943549279842,EPCI
242900074,CC du Pays d'Iroise,1999_2010,2004.5,11,38923,45662,4412,5763,6739,1351,5388,0.0146223397975527,0.00293141134686061,0.0116909284506921,EPCI
242900314,Brest Métropole,2010_2015,2012.5,5,207267,208497,9237,12064,1230,2827,-1597,0.00118406754645228,0.00272143004375659,-0.00153736249730431,EPCI
242900314,Brest Métropole,1968_1975,1971.5,7,183595,206668,12597,29565,23073,16968,6105,0.0170554391686695,0.0125426555633851,0.00451278360528441,EPCI
242900314,Brest Métropole,1975_1982,1978.5,7,206668,207831,12786,25719,1163,12933,-11770,0.000801979768394245,0.00891831843907375,-0.00811633867067951,EPCI
242900314,Brest Métropole,1982_1990,1986,8,207831,208265,14190,26307,434,12117,-11683,0.000260791227650437,0.00728112282359525,-0.00702033159594482,EPCI
242900314,Brest Métropole,1990_1999,1994.5,9,208265,213545,16541,26176,5280,9635,-4355,0.0027856812670346,0.00508334072118909,-0.00229765945415449,EPCI
242900314,Brest Métropole,1999_2010,2004.5,11,213545,207267,20201,28438,-6278,8237,-14515,-0.00270902994724076,0.00355436120984743,-0.00626339115708819,EPCI
242900553,CC du Pays des Abers,2010_2015,2012.5,5,39498,40451,1824,2393,953,569,384,0.00477965174099682,0.00285374799646085,0.00192590374453597,EPCI
242900553,CC du Pays des Abers,1968_1975,1971.5,7,25227,26617,2090,2585,1390,495,895,0.00769160960048354,0.00273909838290601,0.00495251121757753,EPCI
242900553,CC du Pays des Abers,1975_1982,1978.5,7,26617,30287,2407,2635,3670,228,3442,0.0186239402728745,0.00115701863275624,0.0174669216401183,EPCI
242900553,CC du Pays des Abers,1982_1990,1986,8,30287,32083,2851,3053,1796,202,1594,0.007226953952433,0.000812831123825984,0.00641412282860702,EPCI
242900553,CC du Pays des Abers,1990_1999,1994.5,9,32083,33814,3001,3579,1731,578,1153,0.00585581453919404,0.00195532108818842,0.00390049345100562,EPCI
242900553,CC du Pays des Abers,1999_2010,2004.5,11,33814,39498,3785,5513,5684,1728,3956,0.0142252402145784,0.00432463319683171,0.00990060701774667,EPCI
242900561,CC de Haute-Cornouaille,2010_2015,2012.5,5,15011,14986,1141,685,-25,-456,431,-0.000333311186664131,-0.00607959604475376,0.00574628485808963,EPCI
242900561,CC de Haute-Cornouaille,1968_1975,1971.5,7,18238,16891,1828,1289,-1347,-539,-808,-0.010901061467479,-0.00436204315588063,-0.00653901831159842,EPCI
242900561,CC de Haute-Cornouaille,1975_1982,1978.5,7,16891,16342,1858,1070,-549,-788,239,-0.00470922733018708,-0.00675932811691698,0.0020501007867299,EPCI
242900561,CC de Haute-Cornouaille,1982_1990,1986,8,16342,15258,2103,1188,-1084,-915,-169,-0.00854261835411363,-0.00721078947787267,-0.00133182887624096,EPCI
242900561,CC de Haute-Cornouaille,1990_1999,1994.5,9,15258,14732,2172,1275,-526,-897,371,-0.00389040790992734,-0.00663440284259472,0.00274399493266738,EPCI
242900561,CC de Haute-Cornouaille,1999_2010,2004.5,11,14732,15011,2476,1665,279,-811,1090,0.00170702504725195,-0.00496199753878614,0.0066690225860381,EPCI
242900629,CC Cap Sizun - Pointe du Raz,2010_2015,2012.5,5,16119,15495,1453,455,-624,-998,374,-0.00786516825437578,-0.0125792274324792,0.00471405917810343,EPCI
242900629,CC Cap Sizun - Pointe du Raz,1968_1975,1971.5,7,22760,21082,2518,1819,-1678,-699,-979,-0.0108810842383331,-0.00453270434004461,-0.00634837989828851,EPCI
242900629,CC Cap Sizun - Pointe du Raz,1975_1982,1978.5,7,21082,19588,2419,1237,-1494,-1182,-312,-0.0104454154716459,-0.00826404356592065,-0.00218137190572525,EPCI
242900629,CC Cap Sizun - Pointe du Raz,1982_1990,1986,8,19588,18150,2676,1173,-1438,-1503,65,-0.00948554730860174,-0.00991430987818388,0.000428762569582138,EPCI
242900629,CC Cap Sizun - Pointe du Raz,1990_1999,1994.5,9,18150,16256,2767,1089,-1894,-1678,-216,-0.01217071803875,-0.010782716403919,-0.00138800163483105,EPCI
242900629,CC Cap Sizun - Pointe du Raz,1999_2010,2004.5,11,16256,16119,3300,1284,-137,-2016,1879,-0.000769101451679743,-0.0113175804860318,0.0105484790343521,EPCI
242900645,CC Douarnenez Communauté,2010_2015,2012.5,5,19233,18504,1361,710,-729,-651,-78,-0.00769834056230068,-0.00687464980254834,-0.000823690759752336,EPCI
242900645,CC Douarnenez Communauté,1968_1975,1971.5,7,23163,22732,2510,2229,-431,-281,-150,-0.00267962545718747,-0.00174704119134497,-0.000932584265842508,EPCI
242900645,CC Douarnenez Communauté,1975_1982,1978.5,7,22732,21908,2499,1778,-824,-721,-103,-0.00526065070106319,-0.00460306936343029,-0.000657581337632898,EPCI
242900645,CC Douarnenez Communauté,1982_1990,1986,8,21908,20875,2610,1957,-1033,-653,-380,-0.0060192607477112,-0.00380501187633631,-0.00221424887137488,EPCI
242900645,CC Douarnenez Communauté,1990_1999,1994.5,9,20875,20145,2663,1875,-730,-788,58,-0.00394731679312632,-0.00426093922326512,0.000313622430138803,EPCI
242900645,CC Douarnenez Communauté,1999_2010,2004.5,11,20145,19233,3153,1837,-912,-1316,404,-0.00420283100608176,-0.00606461140789869,0.00186178040181692,EPCI
242900660,CC du Pays Fouesnantais,2010_2015,2012.5,5,26741,27487,1361,1090,746,-271,1017,0.00551820903461975,-0.00200460408630288,0.00752281312092263,EPCI
242900660,CC du Pays Fouesnantais,1968_1975,1971.5,7,11552,13984,1052,1155,2432,103,2329,0.0276694876318906,0.00117185741204142,0.0264976302198492,EPCI
242900660,CC du Pays Fouesnantais,1975_1982,1978.5,7,13984,16447,1166,1250,2463,84,2379,0.0234462512870277,0.000799628545720799,0.0226466227413069,EPCI
242900660,CC du Pays Fouesnantais,1982_1990,1986,8,16447,19336,1514,1666,2889,152,2737,0.0204341706250308,0.00107511039633253,0.0193590602286983,EPCI
242900660,CC du Pays Fouesnantais,1990_1999,1994.5,9,19336,22424,1713,1944,3088,231,2857,0.0165988293502291,0.001241687040124,0.0153571423101051,EPCI
242900660,CC du Pays Fouesnantais,1999_2010,2004.5,11,22424,26741,2509,2733,4317,224,4093,0.0161347964473142,0.000837200464257211,0.015297595983057,EPCI
242900694,CA Quimperlé Communauté,2010_2015,2012.5,5,53890,55389,3188,2715,1499,-473,1972,0.00550229957780379,-0.00173621594416357,0.00723851552196736,EPCI
242900694,CA Quimperlé Communauté,1968_1975,1971.5,7,48276,48012,4523,4640,-264,117,-381,-0.00078305940491652,0.000347037690815276,-0.0011300970957318,EPCI
242900694,CA Quimperlé Communauté,1975_1982,1978.5,7,48012,48826,4474,3742,814,-732,1546,0.00240459759012435,-0.0021623654004558,0.00456696299058015,EPCI
242900694,CA Quimperlé Communauté,1982_1990,1986,8,48826,49112,5078,4191,286,-887,1173,0.000730322338259315,-0.0022650206784476,0.00299534301670691,EPCI
242900694,CA Quimperlé Communauté,1990_1999,1994.5,9,49112,49266,5441,4447,154,-994,1148,0.000347925381946057,-0.00224570019256091,0.00259362557450697,EPCI
242900694,CA Quimperlé Communauté,1999_2010,2004.5,11,49266,53890,6565,5889,4624,-676,5300,0.00818886904404437,-0.00119716165090268,0.00938603069494705,EPCI
242900702,CC du Pays Bigouden Sud,2010_2015,2012.5,5,37369,37412,2531,1360,43,-1171,1214,0.000230031426302402,-0.00626434419070029,0.00649437561700269,EPCI
242900702,CC du Pays Bigouden Sud,1968_1975,1971.5,7,34239,34229,3471,3000,-10,-471,461,-4.17287384553156e-05,-0.00196542358124536,0.00192369484279005,EPCI
242900702,CC du Pays Bigouden Sud,1975_1982,1978.5,7,34229,34112,3645,2594,-117,-1051,934,-0.0004890245930953,-0.00439286194310393,0.00390383735000863,EPCI
242900702,CC du Pays Bigouden Sud,1982_1990,1986,8,34112,34210,3959,3018,98,-941,1039,0.000358660609108163,-0.00344387380786512,0.00380253441697328,EPCI
242900702,CC du Pays Bigouden Sud,1990_1999,1994.5,9,34210,34601,4308,3053,391,-1255,1646,0.00126352918017858,-0.00405557319980593,0.00531910237998451,EPCI
242900702,CC du Pays Bigouden Sud,1999_2010,2004.5,11,34601,37369,5456,3591,2768,-1865,4633,0.00702079469383277,-0.00473041260982591,0.0117512073036587,EPCI
242900710,CC du Haut Pays Bigouden,2010_2015,2012.5,5,17352,17999,1044,883,647,-161,808,0.00734855452910899,-0.00182862021512604,0.00917717474423502,EPCI
242900710,CC du Haut Pays Bigouden,1968_1975,1971.5,7,15928,15588,1596,1166,-340,-430,90,-0.00307770829931209,-0.00389239579030646,0.000814687490994376,EPCI
242900710,CC du Haut Pays Bigouden,1975_1982,1978.5,7,15588,15603,1643,968,15,-675,690,0.000137411723352132,-0.00618352755084595,0.00632093927419808,EPCI
242900710,CC du Haut Pays Bigouden,1982_1990,1986,8,15603,15312,1843,1178,-291,-665,374,-0.00235052926311985,-0.00537148439853849,0.00302095513541864,EPCI
242900710,CC du Haut Pays Bigouden,1990_1999,1994.5,9,15312,15123,2070,1241,-189,-829,640,-0.00137905610943456,-0.00604887573926588,0.00466981962983132,EPCI
242900710,CC du Haut Pays Bigouden,1999_2010,2004.5,11,15123,17352,2171,1939,2229,-232,2461,0.0125776239657562,-0.00130911115300828,0.0138867351187645,EPCI
242900744,CC Poher Communauté,2010_2015,2012.5,5,15869,15487,1068,707,-382,-361,-21,-0.00486145633215462,-0.00459420349714089,-0.000267252835013735,EPCI
242900744,CC Poher Communauté,1968_1975,1971.5,7,15138,15644,1509,1430,506,-79,585,0.00470809383887416,-0.000735058128994187,0.00544315196786835,EPCI
242900744,CC Poher Communauté,1975_1982,1978.5,7,15644,16299,1478,1360,655,-118,773,0.00587667161549188,-0.0010586980925619,0.00693536970805378,EPCI
242900744,CC Poher Communauté,1982_1990,1986,8,16299,16155,1745,1492,-144,-253,109,-0.00110865460801002,-0.00194784455435093,0.000839189946340916,EPCI
242900744,CC Poher Communauté,1990_1999,1994.5,9,16155,15418,1858,1467,-737,-391,-346,-0.00517478014777084,-0.00274537182873596,-0.00242940831903489,EPCI
242900744,CC Poher Communauté,1999_2010,2004.5,11,15418,15869,2262,1697,451,-565,1016,0.00262451644220652,-0.00328791971141171,0.00591243615361822,EPCI
242900751,CC du Pays de Landivisiau,2010_2015,2012.5,5,32063,33007,1502,2290,944,788,156,0.00582026084899479,0.00485843808157616,0.00096182276741863,EPCI
242900751,CC du Pays de Landivisiau,1968_1975,1971.5,7,25709,26608,2397,2977,899,580,319,0.00492218826342916,0.00317560533124462,0.00174658293218454,EPCI
242900751,CC du Pays de Landivisiau,1975_1982,1978.5,7,26608,27598,2477,2703,990,226,764,0.00523241062141633,0.00119446949539403,0.0040379411260223,EPCI
242900751,CC du Pays de Landivisiau,1982_1990,1986,8,27598,27872,2716,2829,274,113,161,0.00123567461013074,0.000509603032645161,0.000726071577485583,EPCI
242900751,CC du Pays de Landivisiau,1990_1999,1994.5,9,27872,28502,2900,3234,630,334,296,0.00248660421595925,0.0013182949335403,0.00116830928241895,EPCI
242900751,CC du Pays de Landivisiau,1999_2010,2004.5,11,28502,32063,3321,4770,3561,1449,2112,0.0107600645632888,0.00437835820056318,0.00638170636272563,EPCI
242900769,CA Concarneau Cornouaille Agglomération,2010_2015,2012.5,5,49053,49968,3190,2252,915,-938,1853,0.00370313057169502,-0.003796214728142,0.00749934529983703,EPCI
242900769,CA Concarneau Cornouaille Agglomération,1968_1975,1971.5,7,42960,44547,3747,4547,1587,800,787,0.00519564527773131,0.00261910284951799,0.00257654242821332,EPCI
242900769,CA Concarneau Cornouaille Agglomération,1975_1982,1978.5,7,44547,44962,3936,3643,415,-293,708,0.00132557451250981,-0.000935887547386443,0.00226146205989625,EPCI
242900769,CA Concarneau Cornouaille Agglomération,1982_1990,1986,8,44962,45634,4379,4021,672,-358,1030,0.00185614101876985,-0.000988837030832749,0.0028449780496026,EPCI
242900769,CA Concarneau Cornouaille Agglomération,1990_1999,1994.5,9,45634,46564,5122,4311,930,-811,1741,0.00224414295701392,-0.00195698918079386,0.00420113213780777,EPCI
242900769,CA Concarneau Cornouaille Agglomération,1999_2010,2004.5,11,46564,49053,6676,5433,2489,-1243,3732,0.00474518981798977,-0.00236973521243925,0.00711492503042902,EPCI
242900793,CC Communauté Lesneven Côte des Légendes,2010_2015,2012.5,5,27135,27456,1409,1463,321,54,267,0.00235483142854331,0.000396139866483922,0.00195869156205939,EPCI
242900793,CC Communauté Lesneven Côte des Légendes,1968_1975,1971.5,7,22589,23318,1842,2640,729,798,-69,0.00454781468877075,0.00497826628482724,-0.000430451596056491,EPCI
242900793,CC Communauté Lesneven Côte des Légendes,1975_1982,1978.5,7,23318,24218,1972,2167,900,195,705,0.00542474145860639,0.00117536064936472,0.00424938080924167,EPCI
242900793,CC Communauté Lesneven Côte des Légendes,1982_1990,1986,8,24218,24844,2283,2461,626,178,448,0.00319510805669565,0.000908513153501319,0.00228659490319433,EPCI
242900793,CC Communauté Lesneven Côte des Légendes,1990_1999,1994.5,9,24844,24682,2443,2354,-162,-89,-73,-0.000726629395358391,-0.000399197630783314,-0.000327431764575078,EPCI
242900793,CC Communauté Lesneven Côte des Légendes,1999_2010,2004.5,11,24682,27135,2892,3397,2453,505,1948,0.00865085647294728,0.00178095496079836,0.00686990151214892,EPCI
242900801,CC du Pays de Landerneau-Daoulas,2010_2015,2012.5,5,46561,47977,1910,2882,1416,972,444,0.0060096757868604,0.00412528592148892,0.00188438986537148,EPCI
242900801,CC du Pays de Landerneau-Daoulas,1968_1975,1971.5,7,29823,32329,2644,3628,2506,984,1522,0.0115930780265909,0.00455211044619532,0.00704096758039561,EPCI
242900801,CC du Pays de Landerneau-Daoulas,1975_1982,1978.5,7,32329,36732,2852,3403,4403,551,3852,0.0184078957860054,0.00230359994960004,0.0161042958364054,EPCI
242900801,CC du Pays de Landerneau-Daoulas,1982_1990,1986,8,36732,39485,3285,4176,2753,891,1862,0.00907499825421176,0.00293709533036785,0.00613790292384392,EPCI
242900801,CC du Pays de Landerneau-Daoulas,1990_1999,1994.5,9,39485,41355,3355,4457,1870,1102,768,0.00515462629705543,0.00303764608521662,0.00211698021183881,EPCI
242900801,CC du Pays de Landerneau-Daoulas,1999_2010,2004.5,11,41355,46561,3910,6553,5206,2643,2563,0.0108373898031746,0.00550196335954485,0.00533542644362976,EPCI
242900835,CA Morlaix Communauté,2010_2015,2012.5,5,64794,64304,4167,3289,-490,-878,388,-0.001517081820542,-0.00271836293558342,0.00120128111504142,EPCI
242900835,CA Morlaix Communauté,1968_1975,1971.5,7,58426,61031,5779,5937,2605,158,2447,0.00625101880174084,0.00037914048778313,0.00587187831395771,EPCI
242900835,CA Morlaix Communauté,1975_1982,1978.5,7,61031,64076,5813,5793,3045,-20,3065,0.00697966612444234,-4.58434556613619e-05,0.0070255095801037,EPCI
242900835,CA Morlaix Communauté,1982_1990,1986,8,64076,63309,6640,6329,-767,-311,-456,-0.00150416507066031,-0.000609902655769697,-0.000894262414890616,EPCI
242900835,CA Morlaix Communauté,1990_1999,1994.5,9,63309,62179,7123,5811,-1130,-1312,182,-0.00199912984813688,-0.00232111359358902,0.000321983745452135,EPCI
242900835,CA Morlaix Communauté,1999_2010,2004.5,11,62179,64794,8944,7648,2615,-1296,3911,0.0037520837188898,-0.00185954130006928,0.00561162501895908,EPCI
243000270,CC du Pays Viganais,2010_2015,2012.5,5,10118,10165,643,423,47,-220,267,0.000927315933914263,-0.00434062777576889,0.00526794370968316,EPCI
243000270,CC du Pays Viganais,1968_1975,1971.5,7,9452,9225,1019,722,-227,-297,70,-0.0034667155032424,-0.00453574671569601,0.0010690312124536,EPCI
243000270,CC du Pays Viganais,1975_1982,1978.5,7,9225,9593,965,610,368,-355,723,0.00560371036225726,-0.005405753202721,0.0110094635649783,EPCI
243000270,CC du Pays Viganais,1982_1990,1986,8,9593,9728,1192,860,135,-332,467,0.0017483590240337,-0.00429966811836435,0.00604802714239805,EPCI
243000270,CC du Pays Viganais,1990_1999,1994.5,9,9728,10111,1137,918,383,-219,602,0.00429984178159115,-0.00245865626675839,0.00675849804834954,EPCI
243000270,CC du Pays Viganais,1999_2010,2004.5,11,10111,10118,1406,1038,7,-368,375,6.29179574773708e-05,-0.00330768690738178,0.00337060486485915,EPCI
243000296,CC du Pays de Sommières,2010_2015,2012.5,5,21189,22594,901,1265,1405,364,1041,0.0129232334893845,0.00334808326700069,0.00957515022238383,EPCI
243000296,CC du Pays de Sommières,1968_1975,1971.5,7,9723,9671,988,887,-52,-101,49,-0.000765777513011212,-0.00148737555411793,0.000721598041106719,EPCI
243000296,CC du Pays de Sommières,1975_1982,1978.5,7,9671,10913,1155,773,1242,-382,1624,0.017410253779558,-0.00535484456021831,0.0227650983397763,EPCI
243000296,CC du Pays de Sommières,1982_1990,1986,8,10913,13032,1312,1162,2119,-150,2269,0.0224294832511773,-0.00158774067375016,0.0240172239249275,EPCI
243000296,CC du Pays de Sommières,1990_1999,1994.5,9,13032,15743,1441,1567,2711,126,2585,0.0212206844187302,0.000986280426691258,0.0202344039920389,EPCI
243000296,CC du Pays de Sommières,1999_2010,2004.5,11,15743,21189,1829,2598,5446,769,4677,0.0273758682920087,0.00386559726708679,0.0235102710249219,EPCI
243000569,"CC Rhony, Vistre, Vidourle",2010_2015,2012.5,5,24505,26152,986,1451,1647,465,1182,0.0130946925193507,0.0036970443360644,0.00939764818328629,EPCI
243000569,"CC Rhony, Vistre, Vidourle",1968_1975,1971.5,7,9381,10670,870,890,1289,20,1269,0.0185630036489211,0.00028802177888163,0.0182749818700394,EPCI
243000569,"CC Rhony, Vistre, Vidourle",1975_1982,1978.5,7,10670,13244,926,923,2574,-3,2577,0.0313541532156321,-3.65433021161213e-05,0.0313906965177482,EPCI
243000569,"CC Rhony, Vistre, Vidourle",1982_1990,1986,8,13244,16501,1203,1421,3257,218,3039,0.0278657300193259,0.00186513022542617,0.0260005997938997,EPCI
243000569,"CC Rhony, Vistre, Vidourle",1990_1999,1994.5,9,16501,19646,1502,1912,3145,410,2735,0.0195727236227552,0.00255161102872166,0.0170211125940335,EPCI
243000569,"CC Rhony, Vistre, Vidourle",1999_2010,2004.5,11,19646,24505,2006,2895,4859,889,3970,0.0202944073260718,0.00371305373798679,0.016581353588085,EPCI
243000585,CC Beaucaire Terre d'Argence,2010_2015,2012.5,5,29589,30887,1144,2179,1298,1035,263,0.008623512648952,0.00687622156522752,0.00174729108372448,EPCI
243000585,CC Beaucaire Terre d'Argence,1968_1975,1971.5,7,19811,20023,1662,2098,212,436,-224,0.00152176725991993,0.00312967228926928,-0.00160790502934936,EPCI
243000585,CC Beaucaire Terre d'Argence,1975_1982,1978.5,7,20023,21596,1601,1936,1573,335,1238,0.0108623572832907,0.00231334373166076,0.0085490135516299,EPCI
243000585,CC Beaucaire Terre d'Argence,1982_1990,1986,8,21596,23435,1859,2444,1839,585,1254,0.0102676693268835,0.0032662243372631,0.0070014449896204,EPCI
243000585,CC Beaucaire Terre d'Argence,1990_1999,1994.5,9,23435,25147,2056,2883,1712,827,885,0.00786498709767747,0.00379926654776826,0.00406572054990921,EPCI
243000585,CC Beaucaire Terre d'Argence,1999_2010,2004.5,11,25147,29589,2617,4089,4442,1472,2970,0.0148975204458868,0.00493677399737626,0.00996074644851051,EPCI
243000593,CC de Petite Camargue,2010_2015,2012.5,5,23808,26390,942,1647,2582,705,1877,0.0208061909303972,0.00568100875520139,0.0151251821751958,EPCI
243000593,CC de Petite Camargue,1968_1975,1971.5,7,11627,12897,958,1281,1270,323,947,0.0149194497571281,0.0037944742295688,0.0111249755275593,EPCI
243000593,CC de Petite Camargue,1975_1982,1978.5,7,12897,15754,970,1368,2857,398,2459,0.0289981444405902,0.00403964350274936,0.0249585009378409,EPCI
243000593,CC de Petite Camargue,1982_1990,1986,8,15754,19526,1302,1970,3772,668,3104,0.0271947841348152,0.00481604342578382,0.0223787407090314,EPCI
243000593,CC de Petite Camargue,1990_1999,1994.5,9,19526,21057,1532,2252,1531,720,811,0.00842262075290789,0.003960997349506,0.0044616234034019,EPCI
243000593,CC de Petite Camargue,1999_2010,2004.5,11,21057,23808,1944,3070,2751,1126,1625,0.0112251354092021,0.00459451198500966,0.00663062342419245,EPCI
243000643,CA de Nîmes Métropole,2010_2015,2012.5,5,243601,256592,10320,16157,12991,5837,7154,0.0104453020122071,0.00469318973483586,0.0057521122773712,EPCI
243000643,CA de Nîmes Métropole,1968_1975,1971.5,7,157991,170501,11868,17602,12510,5734,6776,0.0109456258615552,0.00501696392407336,0.00592866193748187,EPCI
243000643,CA de Nîmes Métropole,1975_1982,1978.5,7,170501,182352,12407,16214,11851,3807,8044,0.00964589943103467,0.00309863632891309,0.00654726310212158,EPCI
243000643,CA de Nîmes Métropole,1982_1990,1986,8,182352,203337,14689,21176,20985,6487,14498,0.0137088431468779,0.00423775389534416,0.00947108925153377,EPCI
243000643,CA de Nîmes Métropole,1990_1999,1994.5,9,203337,217970,17093,24630,14633,7537,7096,0.00775130228040633,0.00399245303679508,0.00375884924361124,EPCI
243000643,CA de Nîmes Métropole,1999_2010,2004.5,11,217970,243601,21559,33493,25631,11934,13697,0.0101579913122485,0.00472964255473346,0.00542834875751502,EPCI
243000650,CC Terre de Camargue,2010_2015,2012.5,5,19797,20277,1093,1003,480,-90,570,0.00480286248996231,-0.000900536716867934,0.00570339920683025,EPCI
243000650,CC Terre de Camargue,1968_1975,1971.5,7,9413,10222,747,1035,809,288,521,0.0118482911360098,0.00421793306201586,0.00763035807399397,EPCI
243000650,CC Terre de Camargue,1975_1982,1978.5,7,10222,10354,879,842,132,-37,169,0.00183463204376144,-0.000514252921357374,0.00234888496511882,EPCI
243000650,CC Terre de Camargue,1982_1990,1986,8,10354,12575,1028,1222,2221,194,2027,0.0245896845484903,0.00214786078451469,0.0224418237639756,EPCI
243000650,CC Terre de Camargue,1990_1999,1994.5,9,12575,14625,1313,1491,2050,178,1872,0.0169217644687736,0.00146930442704473,0.0154524600417289,EPCI
243000650,CC Terre de Camargue,1999_2010,2004.5,11,14625,19797,1958,2138,5172,180,4992,0.0279094634093364,0.000971327032807532,0.0269381363765289,EPCI
243000684,CC du Pont du Gard,2010_2015,2012.5,5,23933,25775,938,1534,1842,596,1246,0.0149398544496078,0.00483395942017711,0.0101058950294307,EPCI
243000684,CC du Pont du Gard,1968_1975,1971.5,7,12113,12979,985,1218,866,233,633,0.00991359021739657,0.0026672823564127,0.00724630786098387,EPCI
243000684,CC du Pont du Gard,1975_1982,1978.5,7,12979,15624,1111,1349,2645,238,2407,0.0268506572195633,0.00241605157590021,0.0244346056436631,EPCI
243000684,CC du Pont du Gard,1982_1990,1986,8,15624,17844,1284,1804,2220,520,1700,0.0167460597518854,0.0039225004824236,0.0128235592694618,EPCI
243000684,CC du Pont du Gard,1990_1999,1994.5,9,17844,20326,1503,2104,2482,601,1881,0.0145755960177276,0.0035293848536077,0.0110462111641199,EPCI
243000684,CC du Pont du Gard,1999_2010,2004.5,11,20326,23933,1962,3120,3607,1158,2449,0.0149614923285846,0.00480327366689796,0.0101582186616866,EPCI
243100518,Toulouse Métropole,2010_2015,2012.5,5,704395,755882,21322,48992,51487,27670,23817,0.0142092047363536,0.00763627119573685,0.00657293354061672,EPCI
243100518,Toulouse Métropole,1968_1975,1971.5,7,436821,489266,28228,53969,52445,25741,26704,0.0163294354548227,0.00801479641610431,0.00831463903871837,EPCI
243100518,Toulouse Métropole,1975_1982,1978.5,7,489266,496256,27894,47142,6990,19248,-12258,0.00202857102182263,0.00558597067640087,-0.00355739965457823,EPCI
243100518,Toulouse Métropole,1982_1990,1986,8,496256,547254,31008,55216,50998,24208,26790,0.0123027036115464,0.00583991233045051,0.00646279128109589,EPCI
243100518,Toulouse Métropole,1990_1999,1994.5,9,547254,614970,35900,69806,67716,33906,33810,0.0130466455683691,0.00653257080514388,0.00651407476322522,EPCI
243100518,Toulouse Métropole,1999_2010,2004.5,11,614970,704395,45636,95554,89425,49918,39507,0.0124188258129638,0.00693232258240457,0.00548650323055926,EPCI
243100567,CC Lauragais Revel Sorezois,2010_2015,2012.5,5,20643,21360,1159,966,717,-193,910,0.00685211609728897,-0.00184443292437486,0.00869654902166383,EPCI
243100567,CC Lauragais Revel Sorezois,1968_1975,1971.5,7,14807,14689,1406,1218,-118,-188,70,-0.00114236522881672,-0.00182003951709783,0.000677674288281106,EPCI
243100567,CC Lauragais Revel Sorezois,1975_1982,1978.5,7,14689,15246,1466,1061,557,-405,962,0.00533105393985989,-0.00387626004603816,0.00920731398589805,EPCI
243100567,CC Lauragais Revel Sorezois,1982_1990,1986,8,15246,15872,1712,1213,626,-499,1125,0.0050425934166316,-0.0040195752634172,0.0090621686800488,EPCI
243100567,CC Lauragais Revel Sorezois,1990_1999,1994.5,9,15872,17085,1849,1542,1213,-307,1520,0.00821627371462963,-0.00207946910996809,0.0102957428245977,EPCI
243100567,CC Lauragais Revel Sorezois,1999_2010,2004.5,11,17085,20643,2348,2038,3558,-310,3868,0.017346495957018,-0.0015113585572444,0.0188578545142624,EPCI
243100633,CA du Sicoval,2010_2015,2012.5,5,68206,75439,2123,3736,7233,1613,5620,0.0203629211179082,0.0045410468357785,0.0158218742821297,EPCI
243100633,CA du Sicoval,1968_1975,1971.5,7,14952,28587,1161,2351,13635,1190,12445,0.0970082635486502,0.00846643444245646,0.0885418291061938,EPCI
243100633,CA du Sicoval,1975_1982,1978.5,7,28587,38258,1551,3018,9671,1467,8204,0.0425072821650252,0.00644795604757439,0.0360593261174508,EPCI
243100633,CA du Sicoval,1982_1990,1986,8,38258,48367,2046,4106,10109,2060,8049,0.029741844360057,0.00606075767946557,0.0236810866805914,EPCI
243100633,CA du Sicoval,1990_1999,1994.5,9,48367,57848,3086,5704,9481,2618,6863,0.0200881173231202,0.00554695613879641,0.0145411611843238,EPCI
243100633,CA du Sicoval,1999_2010,2004.5,11,57848,68206,4027,7470,10358,3443,6915,0.0150866403342891,0.00501480041233417,0.0100718399219549,EPCI
243100732,CC des Coteaux du Girou,2010_2015,2012.5,5,19873,20894,496,1070,1021,574,447,0.0100703702832321,0.00566150102113146,0.00440886926210064,EPCI
243100732,CC des Coteaux du Girou,1968_1975,1971.5,7,7452,8749,594,662,1297,68,1229,0.0231871598571325,0.00121567222072861,0.0219714876364039,EPCI
243100732,CC des Coteaux du Girou,1975_1982,1978.5,7,8749,10976,663,766,2227,103,2124,0.0329264134567626,0.00152286510374789,0.0314035483530147,EPCI
243100732,CC des Coteaux du Girou,1982_1990,1986,8,10976,12978,748,1050,2002,302,1700,0.0211639132338191,0.00319255833996671,0.0179713548938523,EPCI
243100732,CC des Coteaux du Girou,1990_1999,1994.5,9,12978,15904,824,1554,2926,730,2196,0.0228476583400703,0.00570020184150763,0.0171474564985627,EPCI
243100732,CC des Coteaux du Girou,1999_2010,2004.5,11,15904,19873,1011,2372,3969,1361,2608,0.0204602607120017,0.00701597753314041,0.0134442831788613,EPCI
243100773,CC Val'Aïgo,2010_2015,2012.5,5,12859,14346,830,921,1487,91,1396,0.0221266834240732,0.00135408755318807,0.0207725958708851,EPCI
243100773,CC Val'Aïgo,1968_1975,1971.5,7,8264,8399,751,767,135,16,119,0.00231752694169041,0.0002746698597559,0.00204285708193451,EPCI
243100773,CC Val'Aïgo,1975_1982,1978.5,7,8399,8707,764,607,308,-157,465,0.0051582077964758,-0.00262934618196981,0.00778755397844561,EPCI
243100773,CC Val'Aïgo,1982_1990,1986,8,8707,9566,900,803,859,-97,956,0.0118304129398743,-0.0013359139175411,0.0131663268574154,EPCI
243100773,CC Val'Aïgo,1990_1999,1994.5,9,9566,10003,1317,910,437,-407,844,0.00497566021600071,-0.00463408171146977,0.00960974192747048,EPCI
243100773,CC Val'Aïgo,1999_2010,2004.5,11,10003,12859,1642,1522,2856,-120,2976,0.0230952876452641,-0.000970390237195972,0.0240656778824601,EPCI
243100781,CC de la Save au Touch,2010_2015,2012.5,5,35406,39112,982,2438,3706,1456,2250,0.0201091237012712,0.0079004004611578,0.0122087232401134,EPCI
243100781,CC de la Save au Touch,1968_1975,1971.5,7,6193,9828,483,808,3635,325,3310,0.0681986129032619,0.00609753760483084,0.0621010752984311,EPCI
243100781,CC de la Save au Touch,1975_1982,1978.5,7,9828,12975,677,898,3147,221,2926,0.0404820747819277,0.00284287846419003,0.0376391963177376,EPCI
243100781,CC de la Save au Touch,1982_1990,1986,8,12975,21189,888,1794,8214,906,7308,0.0632255068338181,0.00697374107516913,0.056251765758649,EPCI
243100781,CC de la Save au Touch,1990_1999,1994.5,9,21189,29284,1257,3044,8095,1787,6308,0.0366050645783205,0.00808069801129817,0.0285243665670223,EPCI
243100781,CC de la Save au Touch,1999_2010,2004.5,11,29284,35406,1822,4283,6122,2461,3661,0.0174079651676249,0.00699787688296714,0.0104100882846577,EPCI
243100815,CC des Coteaux Bellevue,2010_2015,2012.5,5,17955,19797,684,927,1842,243,1599,0.0197243612199414,0.00260207371142549,0.0171222875085159,EPCI
243100815,CC des Coteaux Bellevue,1968_1975,1971.5,7,4022,6512,341,518,2490,177,2313,0.0712628552058061,0.0050656728399308,0.0661971823658753,EPCI
243100815,CC des Coteaux Bellevue,1975_1982,1978.5,7,6512,8164,379,476,1652,97,1555,0.0328254798437049,0.00192740408283255,0.0308980757608723,EPCI
243100815,CC des Coteaux Bellevue,1982_1990,1986,8,8164,11291,484,833,3127,349,2778,0.0413666769408503,0.00461687568031876,0.0367498012605315,EPCI
243100815,CC des Coteaux Bellevue,1990_1999,1994.5,9,11291,14856,822,1326,3565,504,3061,0.030958191568307,0.00437669805061059,0.0265814935176965,EPCI
243100815,CC des Coteaux Bellevue,1999_2010,2004.5,11,14856,17955,1291,1962,3099,671,2428,0.0173732627237839,0.00376168418446564,0.0136115785393183,EPCI
243200391,CC de la Lomagne Gersoise,2010_2015,2012.5,5,19436,19458,1244,792,22,-452,474,0.000226281599735589,-0.00464905832184029,0.00487533992157588,EPCI
243200391,CC de la Lomagne Gersoise,1968_1975,1971.5,7,19182,18595,1863,1638,-587,-225,-362,-0.00443010257873311,-0.00169808020479548,-0.00273202237393762,EPCI
243200391,CC de la Lomagne Gersoise,1975_1982,1978.5,7,18595,18531,1711,1392,-64,-319,255,-0.000492410439761226,-0.00245435828568486,0.00196194784592364,EPCI
243200391,CC de la Lomagne Gersoise,1982_1990,1986,8,18531,18970,1948,1526,439,-422,861,0.00293100935370072,-0.00281750785253236,0.00574851720623308,EPCI
243200391,CC de la Lomagne Gersoise,1990_1999,1994.5,9,18970,18620,2111,1599,-350,-512,162,-0.00206702875850573,-0.00302376778387124,0.000956739025365509,EPCI
243200391,CC de la Lomagne Gersoise,1999_2010,2004.5,11,18620,19436,2586,1958,816,-628,1444,0.00390677021728103,-0.00300668100055452,0.00691345121783555,EPCI
243200409,CC du Bas Armagnac,2010_2015,2012.5,5,8329,8523,523,340,194,-183,377,0.0046156174155807,-0.0043539071497488,0.0089695245653295,EPCI
243200409,CC du Bas Armagnac,1968_1975,1971.5,7,9195,8580,823,711,-615,-112,-503,-0.00984068113137038,-0.00179212404343656,-0.00804855708793382,EPCI
243200409,CC du Bas Armagnac,1975_1982,1978.5,7,8580,8228,796,485,-352,-311,-41,-0.00596654926825091,-0.00527158188189214,-0.00069496738635877,EPCI
243200409,CC du Bas Armagnac,1982_1990,1986,8,8228,8102,982,609,-126,-373,247,-0.00192714404500793,-0.0057049581649838,0.00377781411997587,EPCI
243200409,CC du Bas Armagnac,1990_1999,1994.5,9,8102,7809,960,599,-293,-361,68,-0.00408430645085123,-0.00503220009814776,0.00094789364729653,EPCI
243200409,CC du Bas Armagnac,1999_2010,2004.5,11,7809,8329,1178,696,520,-482,1002,0.00587779651441878,-0.00544826523067279,0.0113260617450916,EPCI
243200417,CC de la Tenarèze,2010_2015,2012.5,5,15140,14856,963,605,-284,-358,74,-0.00378012207400302,-0.00476508345948268,0.000984961385479661,EPCI
243200417,CC de la Tenarèze,1968_1975,1971.5,7,16927,16295,1420,1397,-632,-23,-609,-0.0054212045048615,-0.000197290670271858,-0.00522391383458964,EPCI
243200417,CC de la Tenarèze,1975_1982,1978.5,7,16295,15664,1390,1031,-631,-359,-272,-0.00562600393054635,-0.00320084851199071,-0.00242515541855564,EPCI
243200417,CC de la Tenarèze,1982_1990,1986,8,15664,15593,1541,1230,-71,-311,240,-0.000567712563381728,-0.00248674094664391,0.00191902838326218,EPCI
243200417,CC de la Tenarèze,1990_1999,1994.5,9,15593,14980,1658,1198,-613,-460,-153,-0.00444632099512654,-0.00333655409095956,-0.00110976690416698,EPCI
243200417,CC de la Tenarèze,1999_2010,2004.5,11,14980,15140,2108,1341,160,-767,927,0.000966309296301704,-0.00463224518914629,0.005598554485448,EPCI
243200425,CC Coeur d'Astarac en Gascogne,2010_2015,2012.5,5,8128,7818,512,302,-310,-210,-100,-0.00774706033010641,-0.00524800861071725,-0.00249905171938917,EPCI
243200425,CC Coeur d'Astarac en Gascogne,1968_1975,1971.5,7,9083,8507,753,881,-576,128,-704,-0.00931564946954944,0.00207014432656654,-0.011385793796116,EPCI
243200425,CC Coeur d'Astarac en Gascogne,1975_1982,1978.5,7,8507,8419,721,605,-88,-116,28,-0.0014843683251029,-0.00195666733763564,0.000472299012532742,EPCI
243200425,CC Coeur d'Astarac en Gascogne,1982_1990,1986,8,8419,7996,852,609,-423,-243,-180,-0.00642298881796466,-0.00368980208691587,-0.00273318673104879,EPCI
243200425,CC Coeur d'Astarac en Gascogne,1990_1999,1994.5,9,7996,7829,914,673,-167,-241,74,-0.00234243317959548,-0.00338039758253001,0.00103796440293453,EPCI
243200425,CC Coeur d'Astarac en Gascogne,1999_2010,2004.5,11,7829,8128,1073,777,299,-296,595,0.00341309346682173,-0.00337884838187034,0.00679194184869206,EPCI
243200458,CC du Grand Armagnac,2010_2015,2012.5,5,13388,13185,862,481,-203,-381,178,-0.00305112852636102,-0.00572650230809631,0.00267537378173528,EPCI
243200458,CC du Grand Armagnac,1968_1975,1971.5,7,15200,14684,1455,1159,-516,-296,-220,-0.00492170029155936,-0.0028233009424449,-0.00209839934911446,EPCI
243200458,CC du Grand Armagnac,1975_1982,1978.5,7,14684,13968,1359,864,-716,-495,-221,-0.00711591349768104,-0.00491952120300574,-0.00219639229467529,EPCI
243200458,CC du Grand Armagnac,1982_1990,1986,8,13968,13416,1488,940,-552,-548,-4,-0.00502744172008252,-0.00499101098298047,-3.64307371020474e-05,EPCI
243200458,CC du Grand Armagnac,1990_1999,1994.5,9,13416,12786,1614,896,-630,-718,88,-0.0053298790972337,-0.00607437014573619,0.000744491048502485,EPCI
243200458,CC du Grand Armagnac,1999_2010,2004.5,11,12786,13388,1959,1065,602,-894,1496,0.00419130094533715,-0.00622429077264354,0.0104155917179807,EPCI
243200508,CC Bastides et Vallons du Gers,2010_2015,2012.5,5,7330,7279,531,186,-51,-345,294,-0.00139543063247394,-0.00943967780791193,0.00804424717543799,EPCI
243200508,CC Bastides et Vallons du Gers,1968_1975,1971.5,7,7687,7397,773,563,-290,-210,-80,-0.0054786624815707,-0.00396730731424085,-0.00151135516732985,EPCI
243200508,CC Bastides et Vallons du Gers,1975_1982,1978.5,7,7397,7339,827,462,-58,-365,307,-0.00112392778277448,-0.00707299380539113,0.00594906602261665,EPCI
243200508,CC Bastides et Vallons du Gers,1982_1990,1986,8,7339,7315,854,494,-24,-360,336,-0.00040936107523637,-0.00614041612854555,0.00573105505330918,EPCI
243200508,CC Bastides et Vallons du Gers,1990_1999,1994.5,9,7315,7084,927,520,-231,-407,176,-0.00355901990501184,-0.00627065411835419,0.00271163421334235,EPCI
243200508,CC Bastides et Vallons du Gers,1999_2010,2004.5,11,7084,7330,1112,566,246,-546,792,0.00310816544940118,-0.00689861111940262,0.0100067765688038,EPCI
243200599,CC du Saves,2010_2015,2012.5,5,9172,9518,535,421,346,-114,460,0.00743336686077467,-0.0024491439945905,0.00988251085536517,EPCI
243200599,CC du Saves,1968_1975,1971.5,7,8182,7540,816,520,-642,-296,-346,-0.0116056202260169,-0.00535087786121649,-0.00625474236480036,EPCI
243200599,CC du Saves,1975_1982,1978.5,7,7540,7347,798,373,-193,-425,232,-0.00369744973381425,-0.00814205252264796,0.00444460278883371,EPCI
243200599,CC du Saves,1982_1990,1986,8,7347,7116,882,440,-231,-442,211,-0.003985324535837,-0.00762559932831149,0.00364027479247449,EPCI
243200599,CC du Saves,1990_1999,1994.5,9,7116,7232,952,563,116,-389,505,0.0017982653084283,-0.00603038969809147,0.00782865500651977,EPCI
243200599,CC du Saves,1999_2010,2004.5,11,7232,9172,1091,837,1940,-254,2194,0.0218386605200147,-0.0028592885423112,0.0246979490623259,EPCI
243200607,CC Artagnan de Fezensac,2010_2015,2012.5,5,7237,7124,522,270,-113,-252,139,-0.00314252997487152,-0.00700811994396127,0.00386558996908975,EPCI
243200607,CC Artagnan de Fezensac,1968_1975,1971.5,7,8555,8058,745,754,-497,9,-506,-0.00851362643349696,0.000154170297588476,-0.00866779673108543,EPCI
243200607,CC Artagnan de Fezensac,1975_1982,1978.5,7,8058,7803,726,480,-255,-246,-9,-0.00458333739505124,-0.00442157254581413,-0.000161764849237103,EPCI
243200607,CC Artagnan de Fezensac,1982_1990,1986,8,7803,7307,870,517,-496,-353,-143,-0.00817582990010091,-0.00581868539261214,-0.00235714450748877,EPCI
243200607,CC Artagnan de Fezensac,1990_1999,1994.5,9,7307,7043,917,512,-264,-405,141,-0.00408038330390015,-0.00625967893211955,0.0021792956282194,EPCI
243200607,CC Artagnan de Fezensac,1999_2010,2004.5,11,7043,7237,1065,649,194,-416,610,0.00247328445425832,-0.00530353779882196,0.00777682225308028,EPCI
243300316,Bordeaux Métropole,2010_2015,2012.5,5,721436,773542,26901,44666,52106,17765,34341,0.0140449761858026,0.00478848888689945,0.00925648729890313,EPCI
243300316,Bordeaux Métropole,1968_1975,1971.5,7,554930,586900,41515,66835,31970,25320,6650,0.00803388094041191,0.00636277339415795,0.00167110754625396,EPCI
243300316,Bordeaux Métropole,1975_1982,1978.5,7,586900,592473,40293,60842,5573,20549,-14976,0.00135103393751668,0.00498158915880678,-0.0036305552212901,EPCI
243300316,Bordeaux Métropole,1982_1990,1986,8,592473,630018,43595,65487,37545,21892,15653,0.0077099558255822,0.00449557472189761,0.0032143811036846,EPCI
243300316,Bordeaux Métropole,1990_1999,1994.5,9,630018,665572,48445,73215,35554,24770,10784,0.00611846747769307,0.00426265509991723,0.00185581237777584,EPCI
243300316,Bordeaux Métropole,1999_2010,2004.5,11,665572,721436,57484,93376,55864,35892,19972,0.00735389430346101,0.00472479547364712,0.00262909882981389,EPCI
243300563,CA Bassin d'Arcachon Sud-Pôle Atlantique (Cobas),2010_2015,2012.5,5,61457,65500,3780,2620,4043,-1160,5203,0.0128240112055684,-0.00367940959645297,0.0165034208020214,EPCI
243300563,CA Bassin d'Arcachon Sud-Pôle Atlantique (Cobas),1968_1975,1971.5,7,38417,39512,3425,3752,1095,327,768,0.00402297814987507,0.00120138251599009,0.00282159563388498,EPCI
243300563,CA Bassin d'Arcachon Sud-Pôle Atlantique (Cobas),1975_1982,1978.5,7,39512,42877,3681,3246,3365,-435,3800,0.0117443045823482,-0.00151820876473149,0.0132625133470797,EPCI
243300563,CA Bassin d'Arcachon Sud-Pôle Atlantique (Cobas),1982_1990,1986,8,42877,47141,4372,3873,4264,-499,4763,0.01192144555458,-0.0013951222635402,0.0133165678181202,EPCI
243300563,CA Bassin d'Arcachon Sud-Pôle Atlantique (Cobas),1990_1999,1994.5,9,47141,54204,5560,4765,7063,-795,7858,0.0156333413563892,-0.001759663935768,0.0173930052921572,EPCI
243300563,CA Bassin d'Arcachon Sud-Pôle Atlantique (Cobas),1999_2010,2004.5,11,54204,61457,7377,6162,7253,-1215,8468,0.0114820582578838,-0.00192343868514117,0.013405496943025,EPCI
243300811,CC de l'Estuaire - Canton de Saint-Ciers-sur-Gironde,2010_2015,2012.5,5,15263,15645,799,864,382,65,317,0.00495619715176532,0.000843331976085722,0.0041128651756796,EPCI
243300811,CC de l'Estuaire - Canton de Saint-Ciers-sur-Gironde,1968_1975,1971.5,7,11442,10661,1149,954,-781,-195,-586,-0.0100489644583001,-0.00250902441660501,-0.00753994004169505,EPCI
243300811,CC de l'Estuaire - Canton de Saint-Ciers-sur-Gironde,1975_1982,1978.5,7,10661,14224,1124,1087,3563,-37,3600,0.0420513350201122,-0.000436682401275372,0.0424880174213875,EPCI
243300811,CC de l'Estuaire - Canton de Saint-Ciers-sur-Gironde,1982_1990,1986,8,14224,13297,1276,1475,-927,199,-1126,-0.00838864640357873,0.00180079895826555,-0.0101894453618443,EPCI
243300811,CC de l'Estuaire - Canton de Saint-Ciers-sur-Gironde,1990_1999,1994.5,9,13297,13636,1425,1349,339,-76,415,0.00280112789247755,-0.000627981474419746,0.0034291093668973,EPCI
243300811,CC de l'Estuaire - Canton de Saint-Ciers-sur-Gironde,1999_2010,2004.5,11,13636,15263,1659,1747,1627,88,1539,0.0102997946051384,0.000557087845883331,0.00974270675925508,EPCI
243301165,CC Jalle-Eau-Bourde,2010_2015,2012.5,5,28428,29600,919,1062,1172,143,1029,0.00811268822334443,0.000989858716670865,0.00712282950667357,EPCI
243301165,CC Jalle-Eau-Bourde,1968_1975,1971.5,7,5158,11200,415,725,6042,310,5732,0.11713392519508,0.00600985051480881,0.111124074680271,EPCI
243301165,CC Jalle-Eau-Bourde,1975_1982,1978.5,7,11200,19648,562,1449,8448,887,7561,0.0836061850612591,0.00877825356881354,0.0748279314924455,EPCI
243301165,CC Jalle-Eau-Bourde,1982_1990,1986,8,19648,25623,983,1937,5975,954,5021,0.0337462649156846,0.00538810656561725,0.0283581583500673,EPCI
243301165,CC Jalle-Eau-Bourde,1990_1999,1994.5,9,25623,27254,1379,2155,1631,776,855,0.00688021776882786,0.00327348190595366,0.0036067358628742,EPCI
243301165,CC Jalle-Eau-Bourde,1999_2010,2004.5,11,27254,28428,2007,2519,1174,512,662,0.00384138433419401,0.00167528856823453,0.00216609576595948,EPCI
243301181,CC Latitude Nord Gironde,2010_2015,2012.5,5,17595,19277,735,1295,1682,560,1122,0.0184273063864771,0.00613513173390437,0.0122921746525727,EPCI
243301181,CC Latitude Nord Gironde,1968_1975,1971.5,7,9976,10091,909,893,115,-16,131,0.00163873112684287,-0.000227997374169443,0.00186672850101232,EPCI
243301181,CC Latitude Nord Gironde,1975_1982,1978.5,7,10091,11659,850,952,1568,102,1466,0.0208478389019595,0.00135617319387747,0.019491665708082,EPCI
243301181,CC Latitude Nord Gironde,1982_1990,1986,8,11659,12517,1013,1170,858,157,701,0.00891567324920306,0.00163142272741828,0.00728425052178478,EPCI
243301181,CC Latitude Nord Gironde,1990_1999,1994.5,9,12517,13383,1045,1400,866,355,511,0.00746075202581498,0.00305839141935833,0.00440236060645664,EPCI
243301181,CC Latitude Nord Gironde,1999_2010,2004.5,11,13383,17595,1416,2264,4212,848,3364,0.0251873859584348,0.00507096469438574,0.0201164212640491,EPCI
243301215,CC du Créonnais,2010_2015,2012.5,5,15130,16712,479,1042,1582,563,1019,0.0200886132834632,0.00714910826712377,0.0129395050163395,EPCI
243301215,CC du Créonnais,1968_1975,1971.5,7,6700,7032,517,717,332,200,132,0.00693301339893315,0.00417651409574286,0.00275649930319029,EPCI
243301215,CC du Créonnais,1975_1982,1978.5,7,7032,9471,610,701,2439,91,2348,0.043455310105246,0.00162133383336506,0.0418339762718809,EPCI
243301215,CC du Créonnais,1982_1990,1986,8,9471,11012,710,1002,1541,292,1249,0.0190225526444174,0.0036045330124399,0.0154180196319775,EPCI
243301215,CC du Créonnais,1990_1999,1994.5,9,11012,11958,805,1142,946,337,609,0.00919926924027825,0.00327711811202301,0.00592215112825524,EPCI
243301215,CC du Créonnais,1999_2010,2004.5,11,11958,15130,999,1844,3172,845,2327,0.0216193859023943,0.00575926263793291,0.0158601232644614,EPCI
243301223,CC Grand Cubzaguais,2010_2015,2012.5,5,30608,33880,1289,2112,3272,823,2449,0.0205203981103517,0.00516145710416241,0.0153589410061893,EPCI
243301223,CC Grand Cubzaguais,1968_1975,1971.5,7,17064,18179,1628,1941,1115,313,802,0.00908330517663258,0.00254984261909058,0.006533462557542,EPCI
243301223,CC Grand Cubzaguais,1975_1982,1978.5,7,18179,21153,1608,1836,2974,228,2746,0.0218809023589761,0.00167748679819992,0.0202034155607762,EPCI
243301223,CC Grand Cubzaguais,1982_1990,1986,8,21153,24185,1972,2299,3032,327,2705,0.0168848224168434,0.00182102141500917,0.0150638010018342,EPCI
243301223,CC Grand Cubzaguais,1990_1999,1994.5,9,24185,25461,2047,2494,1276,447,829,0.00572915624290049,0.00200700065875903,0.00372215558414146,EPCI
243301223,CC Grand Cubzaguais,1999_2010,2004.5,11,25461,30608,2569,3807,5147,1238,3909,0.0168784531413662,0.00405974839498957,0.0128187047463766,EPCI
243301249,CC du Secteur de Saint-Loubès,2010_2015,2012.5,5,24270,26282,825,1454,2012,629,1383,0.0160561921860027,0.0050195551118269,0.0110366370741758,EPCI
243301249,CC du Secteur de Saint-Loubès,1968_1975,1971.5,7,9604,12456,732,1349,2852,617,2235,0.0378446471922895,0.00818728868080036,0.0296573585114892,EPCI
243301249,CC du Secteur de Saint-Loubès,1975_1982,1978.5,7,12456,16933,789,1331,4477,542,3935,0.0448423285967232,0.00542875633223676,0.0394135722644865,EPCI
243301249,CC du Secteur de Saint-Loubès,1982_1990,1986,8,16933,19356,997,1634,2423,637,1786,0.0168577738154629,0.00443186212152286,0.0124259116939401,EPCI
243301249,CC du Secteur de Saint-Loubès,1990_1999,1994.5,9,19356,21366,1345,2005,2010,660,1350,0.0110380777008652,0.00362444342416469,0.00741363427670049,EPCI
243301249,CC du Secteur de Saint-Loubès,1999_2010,2004.5,11,21366,24270,1703,2851,2904,1148,1756,0.0116528392954558,0.00460656319255622,0.00704627610289958,EPCI
243301264,CC de Montesquieu,2010_2015,2012.5,5,36841,41644,1217,2293,4803,1076,3727,0.0248120080995056,0.0055585510545634,0.0192534570449422,EPCI
243301264,CC de Montesquieu,1968_1975,1971.5,7,14335,18101,1183,1682,3766,499,3267,0.0338847380878342,0.00448977278434128,0.0293949653034929,EPCI
243301264,CC de Montesquieu,1975_1982,1978.5,7,18101,23047,1253,1712,4946,459,4487,0.0351121463651138,0.0032584866925975,0.0318536596725163,EPCI
243301264,CC de Montesquieu,1982_1990,1986,8,23047,27872,1529,2440,4825,911,3914,0.0240454126681686,0.00453997325195888,0.0195054394162097,EPCI
243301264,CC de Montesquieu,1990_1999,1994.5,9,27872,30883,2042,2816,3011,774,2237,0.0114633474326238,0.00294673892821349,0.0085166085044103,EPCI
243301264,CC de Montesquieu,1999_2010,2004.5,11,30883,36841,2599,4122,5958,1523,4435,0.0161661428842688,0.00413243296622043,0.0120337099180483,EPCI
243301355,CC des Coteaux Bordelais,2010_2015,2012.5,5,17668,18847,800,876,1179,76,1103,0.0130035515776372,0.000838227243342179,0.012165324334295,EPCI
243301355,CC des Coteaux Bordelais,1968_1975,1971.5,7,5854,8381,558,714,2527,156,2371,0.0525998486187305,0.0032471612127115,0.049352687406019,EPCI
243301355,CC des Coteaux Bordelais,1975_1982,1978.5,7,8381,11473,698,755,3092,57,3035,0.0458828022961753,0.000845834324347345,0.0450369679718279,EPCI
243301355,CC des Coteaux Bordelais,1982_1990,1986,8,11473,14107,957,1030,2634,73,2561,0.0261709336903933,0.000725314411313101,0.0254456192790802,EPCI
243301355,CC des Coteaux Bordelais,1990_1999,1994.5,9,14107,15278,1274,1167,1171,-107,1278,0.00889967503751388,-0.000813206856544821,0.0097128818940587,EPCI
243301355,CC des Coteaux Bordelais,1999_2010,2004.5,11,15278,17668,1672,1809,2390,137,2253,0.0133005124002965,0.000762414309138335,0.0125380980911582,EPCI
243301371,CC du Pays Foyen,2010_2015,2012.5,5,16547,16517,1246,871,-30,-375,345,-0.000362866742083745,-0.00453583427604681,0.00417296753396307,EPCI
243301371,CC du Pays Foyen,1968_1975,1971.5,7,14961,15089,1559,1424,128,-135,263,0.00121776749161784,-0.00128436415131569,0.00250213164293353,EPCI
243301371,CC du Pays Foyen,1975_1982,1978.5,7,15089,14978,1748,1205,-111,-543,432,-0.00105423586026521,-0.00515720785697304,0.00410297199670783,EPCI
243301371,CC du Pays Foyen,1982_1990,1986,8,14978,15163,1879,1263,185,-616,801,0.00153565190659255,-0.00511330580789736,0.00664895771448991,EPCI
243301371,CC du Pays Foyen,1990_1999,1994.5,9,15163,15507,2056,1311,344,-745,1089,0.00249569630747271,-0.00540492368914874,0.00790061999662144,EPCI
243301371,CC du Pays Foyen,1999_2010,2004.5,11,15507,16547,2532,1822,1040,-710,1750,0.00591865384665358,-0.00404061945300388,0.00995927329965746,EPCI
243301389,CC Médullienne,2010_2015,2012.5,5,17660,20191,644,1431,2531,787,1744,0.0271489485297847,0.00844181054640084,0.0187071379833838,EPCI
243301389,CC Médullienne,1968_1975,1971.5,7,8185,8957,844,900,772,56,716,0.0129592726912482,0.000940050868795206,0.012019221822453,EPCI
243301389,CC Médullienne,1975_1982,1978.5,7,8957,10981,874,911,2024,37,1987,0.0295321245371802,0.00053986591298205,0.0289922586241982,EPCI
243301389,CC Médullienne,1982_1990,1986,8,10981,11904,923,1086,923,163,760,0.0101395568777958,0.00179062597083501,0.00834893090696077,EPCI
243301389,CC Médullienne,1990_1999,1994.5,9,11904,13064,1157,1236,1160,79,1081,0.0103853211378118,0.000707276180937181,0.00967804495687458,EPCI
243301389,CC Médullienne,1999_2010,2004.5,11,13064,17660,1315,2406,4596,1091,3505,0.0277827413433505,0.00659507632845852,0.0211876650148919,EPCI
243301397,CC du Fronsadais,2010_2015,2012.5,5,15938,16795,547,938,857,391,466,0.0105300605547562,0.00480426333361691,0.00572579722113934,EPCI
243301397,CC du Fronsadais,1968_1975,1971.5,7,8999,9652,802,918,653,116,537,0.0100576252804327,0.00178665318917335,0.0082709720912594,EPCI
243301397,CC du Fronsadais,1975_1982,1978.5,7,9652,12259,756,962,2607,206,2401,0.0347464895165253,0.00274559909489996,0.0320008904216253,EPCI
243301397,CC du Fronsadais,1982_1990,1986,8,12259,13889,889,1284,1630,395,1235,0.0157269873951218,0.00381114111722277,0.011915846277899,EPCI
243301397,CC du Fronsadais,1990_1999,1994.5,9,13889,13960,1029,1334,71,305,-234,0.000566709118986708,0.00243445466606966,-0.00186774554708295,EPCI
243301397,CC du Fronsadais,1999_2010,2004.5,11,13960,15938,1264,1809,1978,545,1433,0.0121192222894986,0.00333921948825921,0.00878000280123936,EPCI
243301405,CC du Val de l'Eyre,2010_2015,2012.5,5,16924,19274,615,1104,2350,489,1861,0.0263459374409145,0.005482197195152,0.0208637402457625,EPCI
243301405,CC du Val de l'Eyre,1968_1975,1971.5,7,7602,7736,748,647,134,-101,235,0.00249931632299183,-0.00188381304941921,0.00438312937241104,EPCI
243301405,CC du Val de l'Eyre,1975_1982,1978.5,7,7736,9491,740,630,1755,-110,1865,0.0296392111356525,-0.00185772833328876,0.0314969394689413,EPCI
243301405,CC du Val de l'Eyre,1982_1990,1986,8,9491,10442,803,871,951,68,883,0.0120080437770711,0.000858619323702245,0.0111494244533689,EPCI
243301405,CC du Val de l'Eyre,1990_1999,1994.5,9,10442,11858,908,1122,1416,214,1202,0.0142299183144319,0.0021505667509099,0.012079351563522,EPCI
243301405,CC du Val de l'Eyre,1999_2010,2004.5,11,11858,16924,1187,2151,5066,964,4102,0.0328676808052593,0.00625433168106394,0.0266133491241953,EPCI
243301439,CC des Portes de l'Entre-deux-Mers,2010_2015,2012.5,5,19394,20401,822,1045,1007,223,784,0.010175457310363,0.00225335350567124,0.00792210380469172,EPCI
243301439,CC des Portes de l'Entre-deux-Mers,1968_1975,1971.5,7,11556,13258,1096,1312,1702,216,1486,0.0198219483343118,0.00251559391316766,0.0173063544211442,EPCI
243301439,CC des Portes de l'Entre-deux-Mers,1975_1982,1978.5,7,13258,16183,1140,1234,2925,94,2831,0.0288894570506721,0.000928413320602797,0.0279610437300693,EPCI
243301439,CC des Portes de l'Entre-deux-Mers,1982_1990,1986,8,16183,16962,1350,1327,779,-23,802,0.00589408207377562,-0.000174022962383619,0.00606810503615924,EPCI
243301439,CC des Portes de l'Entre-deux-Mers,1990_1999,1994.5,9,16962,17570,1548,1676,608,128,480,0.00392070529646404,0.000825411641360851,0.00309529365510319,EPCI
243301439,CC des Portes de l'Entre-deux-Mers,1999_2010,2004.5,11,17570,19394,1944,2239,1824,295,1529,0.00901960071224472,0.0014587621765966,0.00756083853564813,EPCI
243301447,CC Médoc Estuaire,2010_2015,2012.5,5,24971,27374,862,1820,2403,958,1445,0.0185455733576008,0.00739353278259739,0.0111520405750034,EPCI
243301447,CC Médoc Estuaire,1968_1975,1971.5,7,10999,12444,970,1263,1445,293,1152,0.0177898472415146,0.00360721470018254,0.014182632541332,EPCI
243301447,CC Médoc Estuaire,1975_1982,1978.5,7,12444,16559,997,1445,4115,448,3667,0.0416573244441507,0.00453523240607036,0.0371220920380804,EPCI
243301447,CC Médoc Estuaire,1982_1990,1986,8,16559,20438,1200,1882,3879,682,3197,0.0266573864107476,0.00468686195723894,0.0219705244535086,EPCI
243301447,CC Médoc Estuaire,1990_1999,1994.5,9,20438,21515,1443,2162,1077,719,358,0.00572236085788513,0.00382022047986946,0.00190214037801567,EPCI
243301447,CC Médoc Estuaire,1999_2010,2004.5,11,21515,24971,1727,3180,3456,1453,2003,0.0136343648461679,0.00573227202589176,0.00790209282027611,EPCI
243301454,CC Castillon/Pujols,2010_2015,2012.5,5,18707,19112,1072,1014,405,-58,463,0.00429291319630698,-0.000614787568853839,0.00490770076516082,EPCI
243301454,CC Castillon/Pujols,1968_1975,1971.5,7,16385,15538,1710,1428,-847,-282,-565,-0.00755384601385711,-0.00251497588654983,-0.00503887012730728,EPCI
243301454,CC Castillon/Pujols,1975_1982,1978.5,7,15538,16006,1635,1209,468,-426,894,0.00424828640892061,-0.00386702993632517,0.00811531634524578,EPCI
243301454,CC Castillon/Pujols,1982_1990,1986,8,16006,16589,1739,1351,583,-388,971,0.00448203605711672,-0.00298289878243789,0.00746493483955461,EPCI
243301454,CC Castillon/Pujols,1990_1999,1994.5,9,16589,17196,1826,1588,607,-238,845,0.00400097969230595,-0.001568753157774,0.00556973285007995,EPCI
243301454,CC Castillon/Pujols,1999_2010,2004.5,11,17196,18707,2350,2245,1511,-105,1616,0.00768583892679287,-0.000534092049843316,0.00821993097663618,EPCI
243301504,CA du Bassin Nord,2010_2015,2012.5,5,57857,64092,3071,2903,6235,-168,6403,0.0206799475445121,-0.000557214304326869,0.0212371618488389,EPCI
243301504,CA du Bassin Nord,1968_1975,1971.5,7,23067,24408,2031,2122,1341,91,1250,0.00810523135437835,0.000550019428224034,0.00755521192615432,EPCI
243301504,CA du Bassin Nord,1975_1982,1978.5,7,24408,28166,2326,1901,3758,-425,4183,0.0206684994050554,-0.00233744338668136,0.0230059427917368,EPCI
243301504,CA du Bassin Nord,1982_1990,1986,8,28166,35480,2984,2702,7314,-282,7596,0.0292770860122309,-0.00112881299636985,0.0304058990086007,EPCI
243301504,CA du Bassin Nord,1990_1999,1994.5,9,35480,44207,3957,3632,8727,-325,9052,0.0247358661218362,-0.000921182134708006,0.0256570482565442,EPCI
243301504,CA du Bassin Nord,1999_2010,2004.5,11,44207,57857,5535,5764,13650,229,13421,0.0247645158637444,0.000415463306432049,0.0243490525573124,EPCI
243400017,Montpellier Méditerranée Métropole,2010_2015,2012.5,5,417647,457839,13894,28687,40192,14793,25399,0.01854608457789,0.00682604073349737,0.0117200438443926,EPCI
243400017,Montpellier Méditerranée Métropole,1968_1975,1971.5,7,201068,249655,13216,25518,48587,12302,36285,0.0314025176562014,0.00795096985215365,0.0234515478040477,EPCI
243400017,Montpellier Méditerranée Métropole,1975_1982,1978.5,7,249655,277529,14850,25857,27874,11007,16867,0.0152356784559418,0.00601632750106016,0.0092193509548816,EPCI
243400017,Montpellier Méditerranée Métropole,1982_1990,1986,8,277529,316259,18384,32561,38730,14177,24553,0.0164635633482997,0.00602643784117853,0.0104371255071211,EPCI
243400017,Montpellier Méditerranée Métropole,1990_1999,1994.5,9,316259,366895,22588,40487,50636,17899,32737,0.0166384814291309,0.00588143176988733,0.0107570496592436,EPCI
243400017,Montpellier Méditerranée Métropole,1999_2010,2004.5,11,366895,417647,28645,55828,50752,27183,23569,0.0118478981745176,0.00634578767492733,0.00550211049959026,EPCI
243400355,CC du Clermontais,2010_2015,2012.5,5,25023,27305,1257,1548,2282,291,1991,0.0176081134910466,0.00224538169408176,0.0153627317969649,EPCI
243400355,CC du Clermontais,1968_1975,1971.5,7,15967,14516,1514,1172,-1451,-342,-1109,-0.0135181695237404,-0.00318622603523034,-0.0103319434885101,EPCI
243400355,CC du Clermontais,1975_1982,1978.5,7,14516,15454,1418,1049,938,-369,1307,0.00898532500319083,-0.00353473872726803,0.0125200637304589,EPCI
243400355,CC du Clermontais,1982_1990,1986,8,15454,16652,1740,1452,1198,-288,1486,0.00937649392534556,-0.00225411540108474,0.0116306093264303,EPCI
243400355,CC du Clermontais,1990_1999,1994.5,9,16652,18010,1926,1606,1358,-320,1678,0.00874880793134492,-0.00206157477027273,0.0108103827016176,EPCI
243400355,CC du Clermontais,1999_2010,2004.5,11,18010,25023,2568,2656,7013,88,6925,0.0303485190073742,0.000380817007364742,0.0299677020000095,EPCI
243400470,CA du Pays de l'Or,2010_2015,2012.5,5,42443,44658,1931,2244,2215,313,1902,0.0102262267627222,0.00144506048610928,0.00878116627661294,EPCI
243400470,CA du Pays de l'Or,1968_1975,1971.5,7,10135,14465,736,1233,4330,497,3833,0.0521330651216898,0.00598386451858657,0.0461492006031032,EPCI
243400470,CA du Pays de l'Or,1975_1982,1978.5,7,14465,22977,978,1761,8512,783,7729,0.068342973594959,0.0062867185532017,0.0620562550417573,EPCI
243400470,CA du Pays de l'Or,1982_1990,1986,8,22977,28876,1589,2671,5899,1082,4817,0.0289765171844751,0.00531489940559453,0.0236616177788806,EPCI
243400470,CA du Pays de l'Or,1990_1999,1994.5,9,28876,37187,2266,3903,8311,1637,6674,0.028504064475759,0.00561438497735742,0.0228896794984016,EPCI
243400470,CA du Pays de l'Or,1999_2010,2004.5,11,37187,42443,3432,5071,5256,1639,3617,0.0120909444230179,0.00377036870420974,0.0083205757188082,EPCI
243400488,CC La Domitienne,2010_2015,2012.5,5,25376,27263,1403,1451,1887,48,1839,0.0144487131879192,0.00036753483466885,0.0140811783532503,EPCI
243400488,CC La Domitienne,1968_1975,1971.5,7,13081,13591,1199,1031,510,-168,678,0.00547881313924914,-0.00180478550469383,0.00728359864394297,EPCI
243400488,CC La Domitienne,1975_1982,1978.5,7,13591,14605,1315,853,1014,-462,1476,0.0103324617066722,-0.00470768965333587,0.0150401513600081,EPCI
243400488,CC La Domitienne,1982_1990,1986,8,14605,17141,1514,1191,2536,-323,2859,0.0202152810056495,-0.0025747380776123,0.0227900190832618,EPCI
243400488,CC La Domitienne,1990_1999,1994.5,9,17141,19155,2049,1609,2014,-440,2454,0.0124198855792845,-0.00271338115932731,0.0151332667386118,EPCI
243400488,CC La Domitienne,1999_2010,2004.5,11,19155,25376,2802,2566,6221,-236,6457,0.0258969251093251,-0.000982426350393942,0.026879351459719,EPCI
243400520,CC du Pays de Lunel,2010_2015,2012.5,5,47584,48544,2070,3262,960,1192,-232,0.00400279645326496,0.00497013892947065,-0.000967342476205698,EPCI
243400520,CC du Pays de Lunel,1968_1975,1971.5,7,19022,21735,1710,2164,2713,454,2259,0.0192293562263699,0.00321788710902025,0.0160114691173497,EPCI
243400520,CC du Pays de Lunel,1975_1982,1978.5,7,21735,26109,1799,2333,4374,534,3840,0.0265398166097313,0.00324011478500148,0.0232997018247298,EPCI
243400520,CC du Pays de Lunel,1982_1990,1986,8,26109,32306,2199,3137,6197,938,5259,0.0269791317574848,0.00408365750984682,0.022895474247638,EPCI
243400520,CC du Pays de Lunel,1990_1999,1994.5,9,32306,40461,2783,4516,8155,1733,6422,0.0253248696897459,0.00538172889912074,0.0199431407906252,EPCI
243400520,CC du Pays de Lunel,1999_2010,2004.5,11,40461,47584,4106,6784,7123,2678,4445,0.0148508323192755,0.00558339589372734,0.00926743642554819,EPCI
243400694,CC Vallée de l'Hérault,2010_2015,2012.5,5,33755,37090,1443,2071,3335,628,2707,0.0190224316578982,0.00358203510679462,0.0154403965511036,EPCI
243400694,CC Vallée de l'Hérault,1968_1975,1971.5,7,17694,16913,1676,1319,-781,-357,-424,-0.00642825580067696,-0.00293839605741572,-0.00348985974326124,EPCI
243400694,CC Vallée de l'Hérault,1975_1982,1978.5,7,16913,18157,1671,1107,1244,-564,1808,0.0101906610232603,-0.00462020322919517,0.0148108642524554,EPCI
243400694,CC Vallée de l'Hérault,1982_1990,1986,8,18157,21615,2017,1807,3458,-210,3668,0.0220305866921569,-0.0013378898800905,0.0233684765722474,EPCI
243400694,CC Vallée de l'Hérault,1990_1999,1994.5,9,21615,25496,2268,2388,3881,120,3761,0.0185175917781828,0.000572561456681767,0.017945030321501,EPCI
243400694,CC Vallée de l'Hérault,1999_2010,2004.5,11,25496,33755,3014,4121,8259,1107,7152,0.0258378827171843,0.00346319604890702,0.0223746866682773,EPCI
243400736,CC des Cévennes Gangeoises et Suménoises,2010_2015,2012.5,5,12562,13113,825,709,551,-116,667,0.00862250558962874,-0.00181526433465868,0.0104377699242874,EPCI
243400736,CC des Cévennes Gangeoises et Suménoises,1968_1975,1971.5,7,10654,9332,1029,745,-1322,-284,-1038,-0.0187485961298062,-0.00402768630927757,-0.0147209098205286,EPCI
243400736,CC des Cévennes Gangeoises et Suménoises,1975_1982,1978.5,7,9332,9146,1010,568,-186,-442,256,-0.00287197210674162,-0.00682479393107416,0.00395282182433255,EPCI
243400736,CC des Cévennes Gangeoises et Suménoises,1982_1990,1986,8,9146,9291,1142,760,145,-382,527,0.00196812978287375,-0.00518500397970878,0.00715313376258253,EPCI
243400736,CC des Cévennes Gangeoises et Suménoises,1990_1999,1994.5,9,9291,10331,1379,948,1040,-431,1471,0.0118589771042557,-0.00491463378070595,0.0167736108849616,EPCI
243400736,CC des Cévennes Gangeoises et Suménoises,1999_2010,2004.5,11,10331,12562,1705,1346,2231,-359,2590,0.0179341283464316,-0.00288585929016985,0.0208199876366015,EPCI
243400769,CA de Béziers-Méditerranée,2010_2015,2012.5,5,114221,122498,6775,7632,8277,857,7420,0.0140902518907939,0.00145890369341675,0.0126313481973772,EPCI
243400769,CA de Béziers-Méditerranée,1968_1975,1971.5,7,100602,105788,8285,9189,5186,904,4282,0.00720655070933418,0.00125621323587314,0.00595033747346104,EPCI
243400769,CA de Béziers-Méditerranée,1975_1982,1978.5,7,105788,102637,8579,8024,-3151,-555,-2596,-0.00431048307489779,-0.00075922504175445,-0.00355125803314334,EPCI
243400769,CA de Béziers-Méditerranée,1982_1990,1986,8,102637,103381,10041,9619,744,-422,1166,0.000903245338445213,-0.000512324640892312,0.00141556997933753,EPCI
243400769,CA de Béziers-Méditerranée,1990_1999,1994.5,9,103381,105697,11114,10626,2316,-488,2804,0.00246473441913575,-0.000519339549455201,0.00298407396859095,EPCI
243400769,CA de Béziers-Méditerranée,1999_2010,2004.5,11,105697,114221,14264,14715,8524,451,8073,0.00707570241085431,0.000374371396914042,0.00670133101394027,EPCI
243400819,CA Hérault-Méditerranée,2010_2015,2012.5,5,71390,76156,4274,3875,4766,-399,5165,0.0130091045300256,-0.00108909624579946,0.014098200775825,EPCI
243400819,CA Hérault-Méditerranée,1968_1975,1971.5,7,42471,42045,3872,3689,-426,-183,-243,-0.001439108744971,-0.000618208686219935,-0.000820900058751061,EPCI
243400819,CA Hérault-Méditerranée,1975_1982,1978.5,7,42045,44724,3964,3567,2679,-397,3076,0.00886330524116707,-0.00131344986216623,0.0101767551033333,EPCI
243400819,CA Hérault-Méditerranée,1982_1990,1986,8,44724,52391,4910,4491,7667,-419,8086,0.0199749506625198,-0.00109162701546834,0.0210665776779881,EPCI
243400819,CA Hérault-Méditerranée,1990_1999,1994.5,9,52391,58276,5778,5481,5885,-297,6182,0.0118986236099972,-0.000600491284990511,0.0124991148949877,EPCI
243400819,CA Hérault-Méditerranée,1999_2010,2004.5,11,58276,71390,8226,7980,13114,-246,13360,0.0186228695463648,-0.000349338562483281,0.0189722081088481,EPCI
243500139,Rennes Métropole,2010_2015,2012.5,5,409757,438865,12384,26341,29108,13957,15151,0.01382013677241,0.00662661979292725,0.00719351697948276,EPCI
243500139,Rennes Métropole,1968_1975,1971.5,7,243257,284058,13055,39774,40801,26719,14082,0.0223985850787969,0.0146679687929309,0.00773061628586598,EPCI
243500139,Rennes Métropole,1975_1982,1978.5,7,284058,306622,13689,35560,22564,21871,693,0.0109794473967009,0.0106422395857669,0.000337207810933953,EPCI
243500139,Rennes Métropole,1982_1990,1986,8,306622,334531,15397,37259,27909,21862,6047,0.0109487324801893,0.00857648749442472,0.00237224498576463,EPCI
243500139,Rennes Métropole,1990_1999,1994.5,9,334531,373833,17952,42327,39302,24375,14927,0.0124186593248758,0.00770202078886186,0.00471663853601399,EPCI
243500139,Rennes Métropole,1999_2010,2004.5,11,373833,409757,24468,53575,35924,29107,6817,0.00837626142398884,0.00678676765583017,0.00158949376815867,EPCI
243500550,CC Montfort Communauté,2010_2015,2012.5,5,24060,25111,795,1580,1051,785,266,0.00858772204371427,0.00641423577955824,0.00217348626415604,EPCI
243500550,CC Montfort Communauté,1968_1975,1971.5,7,10368,11789,849,1258,1421,409,1012,0.0185183414451167,0.00533005042297869,0.013188291022138,EPCI
243500550,CC Montfort Communauté,1975_1982,1978.5,7,11789,16065,922,1477,4276,555,3721,0.045202734934757,0.00586705282712585,0.0393356821076312,EPCI
243500550,CC Montfort Communauté,1982_1990,1986,8,16065,17576,1064,1952,1511,888,623,0.0112997834688844,0.00664077281295125,0.00465901065593314,EPCI
243500550,CC Montfort Communauté,1990_1999,1994.5,9,17576,19411,1230,2126,1835,896,939,0.0110950519773985,0.0054175294668932,0.00567752251050526,EPCI
243500550,CC Montfort Communauté,1999_2010,2004.5,11,19411,24060,1533,3313,4649,1780,2869,0.019710907565748,0.00754687362164583,0.0121640339441022,EPCI
243500618,CC de Brocéliande,2010_2015,2012.5,5,16313,17865,613,1292,1552,679,873,0.018342424187098,0.00802481058185536,0.0103176136052426,EPCI
243500618,CC de Brocéliande,1968_1975,1971.5,7,9085,9685,860,958,600,98,502,0.00917809058043062,0.001499088128137,0.00767900245229362,EPCI
243500618,CC de Brocéliande,1975_1982,1978.5,7,9685,10495,864,865,810,1,809,0.0115404626926985,1.42474848058006e-05,0.0115262152078927,EPCI
243500618,CC de Brocéliande,1982_1990,1986,8,10495,11310,985,1087,815,102,713,0.00939237621521394,0.00117548757540101,0.00821688863981293,EPCI
243500618,CC de Brocéliande,1990_1999,1994.5,9,11310,12627,993,1413,1317,420,897,0.012314100506494,0.00392704799751516,0.0083870525089788,EPCI
243500618,CC de Brocéliande,1999_2010,2004.5,11,12627,16313,1248,2590,3686,1342,2344,0.023557277610432,0.00857674079034177,0.0149805368200903,EPCI
243500634,CC Au Pays de la Roche aux Fées,2010_2015,2012.5,5,24988,26222,1058,1746,1234,688,546,0.00968722905291686,0.00540098345900065,0.00428624559391621,EPCI
243500634,CC Au Pays de la Roche aux Fées,1968_1975,1971.5,7,19670,19289,1613,2264,-381,651,-1032,-0.00279033506650683,0.00476773786954317,-0.00755807293605,EPCI
243500634,CC Au Pays de la Roche aux Fées,1975_1982,1978.5,7,19289,19043,1551,1910,-246,359,-605,-0.00183194925241648,0.00267345439681917,-0.00450540364923564,EPCI
243500634,CC Au Pays de la Roche aux Fées,1982_1990,1986,8,19043,18868,1617,1903,-175,286,-461,-0.00115336118646048,0.00188492171044398,-0.00303828289690446,EPCI
243500634,CC Au Pays de la Roche aux Fées,1990_1999,1994.5,9,18868,19618,1879,2081,750,202,548,0.00434052030138332,0.00116904680117257,0.00317147350021075,EPCI
243500634,CC Au Pays de la Roche aux Fées,1999_2010,2004.5,11,19618,24988,2300,3655,5370,1355,4015,0.0222389704095296,0.00561150929327982,0.0166274611162498,EPCI
243500659,CC Pays de Châteaugiron Communauté,2010_2015,2012.5,5,23012,24970,632,1595,1958,963,995,0.0164659508411744,0.00809842219614452,0.0083675286450299,EPCI
243500659,CC Pays de Châteaugiron Communauté,1968_1975,1971.5,7,9509,10323,742,1260,814,518,296,0.0118027805453136,0.00751086034701774,0.00429192019829585,EPCI
243500659,CC Pays de Châteaugiron Communauté,1975_1982,1978.5,7,10323,13391,841,1292,3068,451,2617,0.0378721753276285,0.00556725915018268,0.0323049161774459,EPCI
243500659,CC Pays de Châteaugiron Communauté,1982_1990,1986,8,13391,15391,922,1589,2000,667,1333,0.0175522724553632,0.00585368286386362,0.0116985895914996,EPCI
243500659,CC Pays de Châteaugiron Communauté,1990_1999,1994.5,9,15391,19032,1009,2298,3641,1289,2352,0.0238737270192995,0.0084518632595103,0.0154218637597892,EPCI
243500659,CC Pays de Châteaugiron Communauté,1999_2010,2004.5,11,19032,23012,1446,3278,3980,1832,2148,0.0174129634723139,0.0080152133370048,0.00939775013530912,EPCI
243500667,CC du Val d'Ille-Aubigné,2010_2015,2012.5,5,32463,34929,990,2542,2466,1552,914,0.0147510283037284,0.00928369664533111,0.00546733165839732,EPCI
243500667,CC du Val d'Ille-Aubigné,1968_1975,1971.5,7,15327,17170,1404,1876,1843,472,1371,0.0163533757007357,0.00418816784088293,0.0121652078598528,EPCI
243500667,CC du Val d'Ille-Aubigné,1975_1982,1978.5,7,17170,20226,1394,1963,3056,569,2487,0.0236766929511623,0.00440838949254297,0.0192683034586193,EPCI
243500667,CC du Val d'Ille-Aubigné,1982_1990,1986,8,20226,22312,1464,2439,2086,975,1111,0.0123450468166741,0.00577009618708403,0.00657495062959011,EPCI
243500667,CC du Val d'Ille-Aubigné,1990_1999,1994.5,9,22312,25357,1544,2877,3045,1333,1712,0.0143159698417135,0.00626705674844139,0.00804891309327207,EPCI
243500667,CC du Val d'Ille-Aubigné,1999_2010,2004.5,11,25357,32463,2076,5241,7106,3165,3941,0.0227128373910441,0.0101162581399739,0.0125965792510702,EPCI
243500725,CC Côte d'Émeraude,2010_2015,2012.5,5,29874,30260,1911,1290,386,-621,1007,0.002570933490462,-0.00413613911289353,0.00670707260335553,EPCI
243500725,CC Côte d'Émeraude,1968_1975,1971.5,7,21898,22294,2356,2092,396,-264,660,0.00256360550504375,-0.00170907033669584,0.00427267584173959,EPCI
243500725,CC Côte d'Émeraude,1975_1982,1978.5,7,22294,24080,2471,2075,1786,-396,2182,0.0110699717388612,-0.0024544842153354,0.0135244559541965,EPCI
243500725,CC Côte d'Émeraude,1982_1990,1986,8,24080,25775,2944,2284,1695,-660,2355,0.00853917873772003,-0.00332498995097063,0.0118641686886907,EPCI
243500725,CC Côte d'Émeraude,1990_1999,1994.5,9,25775,27182,3315,2528,1407,-787,2194,0.00592302321401483,-0.00331302009198982,0.00923604330600465,EPCI
243500725,CC Côte d'Émeraude,1999_2010,2004.5,11,27182,29874,4122,2824,2692,-1298,3990,0.00862182359758701,-0.00415717943152598,0.012779003029113,EPCI
243500733,CC Bretagne Romantique,2010_2015,2012.5,5,32423,34575,1474,2464,2152,990,1162,0.0129355152261739,0.00595081787821196,0.00698469734796191,EPCI
243500733,CC Bretagne Romantique,1968_1975,1971.5,7,23537,22557,2217,2322,-980,105,-1085,-0.0060570405751007,0.000648968633046504,-0.00670600920814721,EPCI
243500733,CC Bretagne Romantique,1975_1982,1978.5,7,22557,22862,2150,2117,305,-33,338,0.00192051390612047,-0.000207793307875329,0.0021283072139958,EPCI
243500733,CC Bretagne Romantique,1982_1990,1986,8,22862,23371,2228,2245,509,17,492,0.002756265776791,9.20560279085403e-05,0.00266420974888246,EPCI
243500733,CC Bretagne Romantique,1990_1999,1994.5,9,23371,24458,2299,2423,1087,124,963,0.0050640484162634,0.000577683535985889,0.00448636488027751,EPCI
243500733,CC Bretagne Romantique,1999_2010,2004.5,11,24458,32423,2989,4719,7965,1730,6235,0.0259594712351992,0.005638403670671,0.0203210675645281,EPCI
243500741,CA Redon Agglomération,2010_2015,2012.5,5,64940,65903,3596,3731,963,135,828,0.00294837740377596,0.000413323935108779,0.00253505346866718,EPCI
243500741,CA Redon Agglomération,1968_1975,1971.5,7,54508,54500,5181,6321,-8,1140,-1148,-2.09680970771897e-05,0.00298795383349954,-0.00300892193057672,EPCI
243500741,CA Redon Agglomération,1975_1982,1978.5,7,54500,55497,5120,5849,997,729,268,0.00259310824256653,0.00189606410113441,0.000697044141432127,EPCI
243500741,CA Redon Agglomération,1982_1990,1986,8,55497,56356,5494,5667,859,173,686,0.00192181268863401,0.000387047258595673,0.00153476543003833,EPCI
243500741,CA Redon Agglomération,1990_1999,1994.5,9,56356,57454,5884,5864,1098,-20,1118,0.00214629059589422,-3.90945463733009e-05,0.00218538514226752,EPCI
243500741,CA Redon Agglomération,1999_2010,2004.5,11,57454,64940,7479,8431,7486,952,6534,0.0111966860757078,0.00142389061502455,0.00977279546068323,EPCI
243500774,CC Liffré-Cormier Communauté,2010_2015,2012.5,5,23306,25186,931,1731,1880,800,1080,0.0156364794209032,0.00665382103017157,0.00898265839073162,EPCI
243500774,CC Liffré-Cormier Communauté,1968_1975,1971.5,7,10813,11874,968,1136,1061,168,893,0.0134615186445808,0.00213151284852929,0.0113300057960515,EPCI
243500774,CC Liffré-Cormier Communauté,1975_1982,1978.5,7,11874,14465,1119,1301,2591,182,2409,0.0285985632038652,0.00200885314670146,0.0265897100571638,EPCI
243500774,CC Liffré-Cormier Communauté,1982_1990,1986,8,14465,16434,1282,1847,1969,565,1404,0.0160804739213485,0.0046142548326876,0.0114662190886609,EPCI
243500774,CC Liffré-Cormier Communauté,1990_1999,1994.5,9,16434,19251,1427,2265,2817,838,1979,0.0177343801812622,0.00527561611355971,0.0124587640677025,EPCI
243500774,CC Liffré-Cormier Communauté,1999_2010,2004.5,11,19251,23306,1856,3791,4055,1935,2120,0.0175289352470467,0.00836460905130341,0.00916432619574327,EPCI
243500782,CA du Pays de Saint-Malo - Saint-Malo Agglomération,2010_2015,2012.5,5,80603,81941,4580,3938,1338,-642,1980,0.00329814824807606,-0.0015825195629782,0.00488066781105426,EPCI
243500782,CA du Pays de Saint-Malo - Saint-Malo Agglomération,1968_1975,1971.5,7,64509,67495,5978,8021,2986,2043,943,0.00648504775202552,0.00443702362939991,0.00204802412262561,EPCI
243500782,CA du Pays de Saint-Malo - Saint-Malo Agglomération,1975_1982,1978.5,7,67495,70544,6139,7263,3049,1124,1925,0.00633183435187612,0.00233420197163292,0.0039976323802432,EPCI
243500782,CA du Pays de Saint-Malo - Saint-Malo Agglomération,1982_1990,1986,8,70544,74764,6870,8348,4220,1478,2742,0.0072889179171447,0.00255284850273457,0.00473606941441013,EPCI
243500782,CA du Pays de Saint-Malo - Saint-Malo Agglomération,1990_1999,1994.5,9,74764,79045,7485,8512,4281,1027,3254,0.00620593583374562,0.00148878675572454,0.00471714907802108,EPCI
243500782,CA du Pays de Saint-Malo - Saint-Malo Agglomération,1999_2010,2004.5,11,79045,80603,9778,9847,1558,69,1489,0.00177598966993653,7.86542280010401e-05,0.00169733544193549,EPCI
243600202,CC Chabris - Pays de Bazelle,2010_2015,2012.5,5,6482,6357,462,281,-125,-181,56,-0.00388693359446501,-0.00562827984478534,0.00174134625032033,EPCI
243600202,CC Chabris - Pays de Bazelle,1968_1975,1971.5,7,7158,6573,818,464,-585,-354,-231,-0.0121061611659724,-0.00732577957735766,-0.00478038158861475,EPCI
243600202,CC Chabris - Pays de Bazelle,1975_1982,1978.5,7,6573,6344,785,379,-229,-406,177,-0.00505302813305908,-0.00895864376428815,0.00390561563122907,EPCI
243600202,CC Chabris - Pays de Bazelle,1982_1990,1986,8,6344,6224,883,437,-120,-446,326,-0.0023842403551082,-0.00886142665315215,0.00647718629804395,EPCI
243600202,CC Chabris - Pays de Bazelle,1990_1999,1994.5,9,6224,6181,935,421,-43,-514,471,-0.00077000519361603,-0.00920424812834045,0.00843424293472442,EPCI
243600202,CC Chabris - Pays de Bazelle,1999_2010,2004.5,11,6181,6482,1109,612,301,-497,798,0.00433199554045949,-0.00715282984587497,0.0114848253863345,EPCI
243600236,CC du Pays d'Issoudun,2010_2015,2012.5,5,21582,20331,1371,880,-1251,-491,-760,-0.0118715344473483,-0.00465941120195686,-0.00721212324539148,EPCI
243600236,CC du Pays d'Issoudun,1968_1975,1971.5,7,23442,23903,2143,2457,461,314,147,0.00278597202313358,0.00189760350382634,0.000888368519307236,EPCI
243600236,CC du Pays d'Issoudun,1975_1982,1978.5,7,23903,22811,2165,1799,-1092,-366,-726,-0.00665789425447572,-0.00223149203034626,-0.00442640222412946,EPCI
243600236,CC du Pays d'Issoudun,1982_1990,1986,8,22811,22137,2334,1832,-674,-502,-172,-0.00374203843508769,-0.00278709687598519,-0.000954941559102497,EPCI
243600236,CC du Pays d'Issoudun,1990_1999,1994.5,9,22137,21828,2565,2025,-309,-540,231,-0.00156065506714598,-0.00272735836976967,0.00116670330262369,EPCI
243600236,CC du Pays d'Issoudun,1999_2010,2004.5,11,21828,21582,3088,2398,-246,-690,444,-0.00102982530943607,-0.00288853440451581,0.00185870909507974,EPCI
243600293,CC de la Région de Levroux,2010_2015,2012.5,5,6507,6417,457,295,-90,-162,72,-0.00278168427551251,-0.00500703169592252,0.00222534742041001,EPCI
243600293,CC de la Région de Levroux,1968_1975,1971.5,7,7629,7090,819,675,-539,-144,-395,-0.0104127557539295,-0.00278188650939861,-0.00763086924453091,EPCI
243600293,CC de la Région de Levroux,1975_1982,1978.5,7,7090,7033,826,437,-57,-389,332,-0.00115247584876432,-0.00786514219595301,0.00671266634718869,EPCI
243600293,CC de la Région de Levroux,1982_1990,1986,8,7033,6728,914,524,-305,-390,85,-0.0055266011704791,-0.00706680149667819,0.00154020032619909,EPCI
243600293,CC de la Région de Levroux,1990_1999,1994.5,9,6728,6367,830,518,-361,-312,-49,-0.00610898841130436,-0.00527979053830183,-0.000829197873002531,EPCI
243600293,CC de la Région de Levroux,1999_2010,2004.5,11,6367,6507,1048,688,140,-360,500,0.00197923970315261,-0.00508947352239243,0.00706871322554505,EPCI
243600301,CC Val de l'Indre - Brenne,2010_2015,2012.5,5,13725,13716,947,766,-9,-181,172,-0.000131181953878956,-0.00263821485023234,0.00250703289635338,EPCI
243600301,CC Val de l'Indre - Brenne,1968_1975,1971.5,7,14216,13864,1368,1269,-352,-99,-253,-0.00357538424320758,-0.00100557681840213,-0.00256980742480545,EPCI
243600301,CC Val de l'Indre - Brenne,1975_1982,1978.5,7,13864,13397,1352,971,-467,-381,-86,-0.00488300363091132,-0.00398377812286341,-0.000899225508047909,EPCI
243600301,CC Val de l'Indre - Brenne,1982_1990,1986,8,13397,13282,1415,972,-115,-443,328,-0.00107705283382487,-0.0041489948294297,0.00307194199560483,EPCI
243600301,CC Val de l'Indre - Brenne,1990_1999,1994.5,9,13282,13016,1497,1114,-266,-383,117,-0.00224529390393102,-0.00323288558347963,0.000987591679548608,EPCI
243600301,CC Val de l'Indre - Brenne,1999_2010,2004.5,11,13016,13725,1890,1625,709,-265,974,0.00483342691141142,-0.00180657000214954,0.00663999691356096,EPCI
243600319,CC Brenne - Val de Creuse,2010_2015,2012.5,5,18897,18325,1312,832,-572,-480,-92,-0.00612852978705702,-0.00514282219892897,-0.000985707588128053,EPCI
243600319,CC Brenne - Val de Creuse,1968_1975,1971.5,7,21056,20984,2048,1853,-72,-195,123,-0.000489210665754247,-0.00132494555308442,0.000835734887330172,EPCI
243600319,CC Brenne - Val de Creuse,1975_1982,1978.5,7,20984,19724,2028,1424,-1260,-604,-656,-0.00880728296141198,-0.00422190389578796,-0.00458537906562401,EPCI
243600319,CC Brenne - Val de Creuse,1982_1990,1986,8,19724,19094,2282,1527,-630,-755,125,-0.00404953079529613,-0.00485300912769616,0.000803478332400027,EPCI
243600319,CC Brenne - Val de Creuse,1990_1999,1994.5,9,19094,18337,2397,1601,-757,-796,39,-0.00448472158010904,-0.00471577064434187,0.000231049064232831,EPCI
243600319,CC Brenne - Val de Creuse,1999_2010,2004.5,11,18337,18897,2756,2019,560,-737,1297,0.00273849764766898,-0.00360405851130721,0.00634255615897619,EPCI
243600327,CA Châteauroux Métropole,2010_2015,2012.5,5,75663,73187,3638,4108,-2476,470,-2946,-0.00663220121023911,0.00125893964814717,-0.00789114085838627,EPCI
243600327,CA Châteauroux Métropole,1968_1975,1971.5,7,64712,74723,5127,9026,10011,3899,6112,0.0207613345830737,0.00808594980915038,0.0126753847739233,EPCI
243600327,CA Châteauroux Métropole,1975_1982,1978.5,7,74723,76968,5102,8107,2245,3005,-760,0.00423778383940365,0.00567240108570511,-0.00143461724630146,EPCI
243600327,CA Châteauroux Métropole,1982_1990,1986,8,76968,78484,5619,8146,1516,2527,-1011,0.00244110356569638,0.00406904268503611,-0.00162793911933974,EPCI
243600327,CA Châteauroux Métropole,1990_1999,1994.5,9,78484,77497,6056,8362,-987,2306,-3293,-0.00140518473821816,0.00328303546740737,-0.00468822020562552,EPCI
243600327,CA Châteauroux Métropole,1999_2010,2004.5,11,77497,75663,7795,10007,-1834,2212,-4046,-0.00217490023721389,0.00262316211816638,-0.00479806235538027,EPCI
243600343,CC Coeur de Brenne,2010_2015,2012.5,5,5127,4887,395,182,-240,-213,-27,-0.00954259262382373,-0.00846905095364356,-0.00107354167018017,EPCI
243600343,CC Coeur de Brenne,1968_1975,1971.5,7,7275,6406,636,592,-869,-44,-825,-0.0180085528287979,-0.000911825459685968,-0.0170967273691119,EPCI
243600343,CC Coeur de Brenne,1975_1982,1978.5,7,6406,5941,678,398,-465,-280,-185,-0.0107076296278001,-0.00644760493716998,-0.00426002469063016,EPCI
243600343,CC Coeur de Brenne,1982_1990,1986,8,5941,5614,728,387,-327,-341,14,-0.00705176770488858,-0.00735367824882876,0.000301910543940184,EPCI
243600343,CC Coeur de Brenne,1990_1999,1994.5,9,5614,5304,777,383,-310,-394,84,-0.00629148355180897,-0.00799627264326689,0.00170478909145791,EPCI
243600343,CC Coeur de Brenne,1999_2010,2004.5,11,5304,5127,962,484,-177,-478,301,-0.00308075018209308,-0.00831976602847737,0.00523901584638428,EPCI
243600350,CC de la Châtre et Sainte-Sévère,2010_2015,2012.5,5,17359,16843,1263,643,-516,-620,104,-0.00601701754034478,-0.00722974975777862,0.00121273221743383,EPCI
243600350,CC de la Châtre et Sainte-Sévère,1968_1975,1971.5,7,20052,18583,2022,1653,-1469,-369,-1100,-0.0108099642696062,-0.00271536883286909,-0.00809459543673714,EPCI
243600350,CC de la Châtre et Sainte-Sévère,1975_1982,1978.5,7,18583,17973,1949,1298,-610,-651,41,-0.00475672968850416,-0.00507644430691181,0.000319714618407656,EPCI
243600350,CC de la Châtre et Sainte-Sévère,1982_1990,1986,8,17973,17360,2287,1257,-613,-1030,417,-0.00432834591009013,-0.00727275087666041,0.00294440496657028,EPCI
243600350,CC de la Châtre et Sainte-Sévère,1990_1999,1994.5,9,17360,17111,2257,1254,-249,-1003,754,-0.00160395425294702,-0.00646090809520424,0.00485695384225723,EPCI
243600350,CC de la Châtre et Sainte-Sévère,1999_2010,2004.5,11,17111,17359,2761,1635,248,-1126,1374,0.00130899893187708,-0.00594327740844191,0.00725227634031899,EPCI
243700499,CC du Castelrenaudais,2010_2015,2012.5,5,16333,16828,688,1065,495,377,118,0.00598917675965272,0.00456145381492742,0.00142772294472529,EPCI
243700499,CC du Castelrenaudais,1968_1975,1971.5,7,11636,12491,1025,1425,855,400,455,0.0101807092589599,0.00476290491647245,0.00541780434248741,EPCI
243700499,CC du Castelrenaudais,1975_1982,1978.5,7,12491,13298,1017,1290,807,273,534,0.00898372256797608,0.00303910317355325,0.00594461939442284,EPCI
243700499,CC du Castelrenaudais,1982_1990,1986,8,13298,14008,1059,1526,710,467,243,0.00652305140647069,0.00429051409411523,0.00223253731235546,EPCI
243700499,CC du Castelrenaudais,1990_1999,1994.5,9,14008,14410,1269,1522,402,253,149,0.00314870401254019,0.00198164705266833,0.00116705695987186,EPCI
243700499,CC du Castelrenaudais,1999_2010,2004.5,11,14410,16333,1548,2253,1923,705,1218,0.0114528318366061,0.00419877610234388,0.00725405573426218,EPCI
243700754,Tours Métropole Val de Loire,2010_2015,2012.5,5,287005,292268,11744,16684,5263,4940,323,0.00364092258370219,0.00341747246123671,0.000223450122465477,EPCI
243700754,Tours Métropole Val de Loire,1968_1975,1971.5,7,207812,243867,13635,30765,36055,17130,18925,0.023118786124684,0.0109839080936302,0.0121348780310538,EPCI
243700754,Tours Métropole Val de Loire,1975_1982,1978.5,7,243867,255809,14205,27432,11942,13227,-1285,0.00685310112468995,0.00759051821941668,-0.000737417094726729,EPCI
243700754,Tours Métropole Val de Loire,1982_1990,1986,8,255809,265274,16395,29318,9465,12923,-3458,0.00455185107094858,0.0062148517052159,-0.00166300063426732,EPCI
243700754,Tours Métropole Val de Loire,1990_1999,1994.5,9,265274,278103,19070,30335,12829,11265,1564,0.0052613809946449,0.00461995922555732,0.000641421769087585,EPCI
243700754,Tours Métropole Val de Loire,1999_2010,2004.5,11,278103,287005,24305,36488,8902,12183,-3281,0.00286847791790579,0.00392570955671155,-0.00105723163880576,EPCI
243700820,CC de Bléré Val de Cher,2010_2015,2012.5,5,20641,21436,954,1150,795,196,599,0.00758710987558064,0.00187053274919976,0.00571657712638089,EPCI
243700820,CC de Bléré Val de Cher,1968_1975,1971.5,7,13270,13616,1331,1165,346,-166,512,0.00368387219384458,-0.00176740689068844,0.00545127908453303,EPCI
243700820,CC de Bléré Val de Cher,1975_1982,1978.5,7,13616,14947,1475,1103,1331,-372,1703,0.0134127313597414,-0.00374871229588565,0.0171614436556271,EPCI
243700820,CC de Bléré Val de Cher,1982_1990,1986,8,14947,16648,1570,1395,1701,-175,1876,0.0135635969676322,-0.00139543178679344,0.0149590287544256,EPCI
243700820,CC de Bléré Val de Cher,1990_1999,1994.5,9,16648,17655,1838,1628,1007,-210,1217,0.00654677486515642,-0.00136526586065824,0.00791204072581467,EPCI
243700820,CC de Bléré Val de Cher,1999_2010,2004.5,11,17655,20641,2121,2561,2986,440,2546,0.0143068646464606,0.00210817831361107,0.0121986863328495,EPCI
243800604,CA Porte de l'Isère (C.A.P.I),2010_2015,2012.5,5,99448,104941,2769,7980,5493,5211,282,0.0108106964066941,0.0102556961542477,0.000555000252446336,EPCI
243800604,CA Porte de l'Isère (C.A.P.I),1968_1975,1971.5,7,37611,45761,2784,5045,8150,2261,5889,0.0284156118637637,0.00788315318085519,0.0205324586829085,EPCI
243800604,CA Porte de l'Isère (C.A.P.I),1975_1982,1978.5,7,45761,60291,2822,6430,14530,3608,10922,0.0401791400955565,0.00997703630177341,0.030202103793783,EPCI
243800604,CA Porte de l'Isère (C.A.P.I),1982_1990,1986,8,60291,75073,3533,9282,14782,5749,9033,0.0277888702732736,0.0108076184008287,0.0169812518724449,EPCI
243800604,CA Porte de l'Isère (C.A.P.I),1990_1999,1994.5,9,75073,87098,4235,12233,12025,7998,4027,0.0166451169995838,0.0110709060925298,0.00557421090705398,EPCI
243800604,CA Porte de l'Isère (C.A.P.I),1999_2010,2004.5,11,87098,99448,5700,16777,12350,11077,1273,0.0121275838426314,0.0108775098157755,0.00125007402685585,EPCI
243800745,CC de l'Oisans,2010_2015,2012.5,5,10841,10685,434,629,-156,195,-351,-0.00289467311285063,0.00361834139106329,-0.00651301450391392,EPCI
243800745,CC de l'Oisans,1968_1975,1971.5,7,7981,8707,679,787,726,108,618,0.0125153240087821,0.00186178373684362,0.0106535402719385,EPCI
243800745,CC de l'Oisans,1975_1982,1978.5,7,8707,10325,605,719,1618,114,1504,0.0246475412753231,0.00173660055957159,0.0229109407157515,EPCI
243800745,CC de l'Oisans,1982_1990,1986,8,10325,9476,668,1134,-849,466,-1315,-0.0106684160101017,0.00585569123758233,-0.016524107247684,EPCI
243800745,CC de l'Oisans,1990_1999,1994.5,9,9476,10558,762,1251,1082,489,593,0.0120859609423174,0.00546213946468873,0.00662382147762867,EPCI
243800745,CC de l'Oisans,1999_2010,2004.5,11,10558,10841,930,1566,283,636,-353,0.00240756410985088,0.00541063877690869,-0.00300307466705781,EPCI
243800778,CC du Pays Roussillonnais,2010_2015,2012.5,5,50239,52011,1839,3196,1772,1357,415,0.00695681039139262,0.00532753482004503,0.00162927557134759,EPCI
243800778,CC du Pays Roussillonnais,1968_1975,1971.5,7,32885,34390,2008,3645,1505,1637,-132,0.00641321971765541,0.00697570809156272,-0.000562488373907318,EPCI
243800778,CC du Pays Roussillonnais,1975_1982,1978.5,7,34390,36693,2077,3009,2303,932,1371,0.00930303192595461,0.0037648396678201,0.00553819225813451,EPCI
243800778,CC du Pays Roussillonnais,1982_1990,1986,8,36693,40572,2520,4168,3879,1648,2231,0.0126407488452212,0.00537044446943141,0.00727030437578974,EPCI
243800778,CC du Pays Roussillonnais,1990_1999,1994.5,9,40572,43730,2947,4701,3158,1754,1404,0.00836324392142873,0.00464506961310513,0.0037181743083236,EPCI
243800778,CC du Pays Roussillonnais,1999_2010,2004.5,11,43730,50239,3657,6764,6509,3107,3402,0.0126941914604983,0.00605943353322604,0.00663475792727229,EPCI
243800844,CC du Territoire de Beaurepaire,2010_2015,2012.5,5,14826,15323,679,886,497,207,290,0.00661630595706919,0.0027556847748759,0.00386062118219329,EPCI
243800844,CC du Territoire de Beaurepaire,1968_1975,1971.5,7,9110,9211,818,867,101,49,52,0.00157634265742845,0.000764760299148458,0.000811582358279996,EPCI
243800844,CC du Territoire de Beaurepaire,1975_1982,1978.5,7,9211,10011,797,780,800,-17,817,0.0119690723610013,-0.000254342787671278,0.0122234151486726,EPCI
243800844,CC du Territoire de Beaurepaire,1982_1990,1986,8,10011,11087,890,1052,1076,162,914,0.0128428655263688,0.0019335912781336,0.0109092742482352,EPCI
243800844,CC du Territoire de Beaurepaire,1990_1999,1994.5,9,11087,12188,1061,1212,1101,151,950,0.0105753737131626,0.00145039185348552,0.00912498185967712,EPCI
243800844,CC du Territoire de Beaurepaire,1999_2010,2004.5,11,12188,14826,1352,1769,2638,417,2221,0.0179714441770626,0.00284082343511566,0.015130620741947,EPCI
243800935,CC Lyon Saint-Éxupéry-en-Dauphiné,2010_2015,2012.5,5,23891,26673,757,1994,2782,1237,1545,0.0222744520042077,0.00990420457555894,0.0123702474286488,EPCI
243800935,CC Lyon Saint-Éxupéry-en-Dauphiné,1968_1975,1971.5,7,11011,15039,735,1806,4028,1071,2957,0.0455426236055461,0.0121092725624478,0.0334333510430982,EPCI
243800935,CC Lyon Saint-Éxupéry-en-Dauphiné,1975_1982,1978.5,7,15039,18448,712,2172,3409,1460,1949,0.029617134963287,0.0126843699168082,0.0169327650464788,EPCI
243800935,CC Lyon Saint-Éxupéry-en-Dauphiné,1982_1990,1986,8,18448,21975,861,2948,3527,2087,1440,0.0221095573467813,0.0130826895896605,0.00902686775712081,EPCI
243800935,CC Lyon Saint-Éxupéry-en-Dauphiné,1990_1999,1994.5,9,21975,22374,1168,2705,399,1537,-1138,0.00200134745593039,0.00770945122748123,-0.00570810377155084,EPCI
243800935,CC Lyon Saint-Éxupéry-en-Dauphiné,1999_2010,2004.5,11,22374,23891,1481,3619,1517,2138,-621,0.00598165988197308,0.00843031564117234,-0.00244865575919926,EPCI
243800984,CA du Pays Voironnais,2010_2015,2012.5,5,90259,93303,3570,5446,3044,1876,1168,0.00665584160557398,0.00410195757294901,0.00255388403262497,EPCI
243800984,CA du Pays Voironnais,1968_1975,1971.5,7,54552,60007,4620,6729,5455,2109,3346,0.013708373634195,0.00529990100724422,0.00840847262695076,EPCI
243800984,CA du Pays Voironnais,1975_1982,1978.5,7,60007,68510,4694,6575,8503,1881,6622,0.0191115455895712,0.00422778046030617,0.014883765129265,EPCI
243800984,CA du Pays Voironnais,1982_1990,1986,8,68510,75561,5238,7876,7051,2638,4413,0.0123203474428415,0.00460942796117088,0.00771091948167062,EPCI
243800984,CA du Pays Voironnais,1990_1999,1994.5,9,75561,82980,6088,9020,7419,2932,4487,0.0104609300074281,0.00413417533114694,0.00632675467628115,EPCI
243800984,CA du Pays Voironnais,1999_2010,2004.5,11,82980,90259,7382,12006,7279,4624,2655,0.00767326249927569,0.00487445607867163,0.00279880642060406,EPCI
243801024,CC du Massif du Vercors,2010_2015,2012.5,5,11528,11696,327,611,168,284,-116,0.00289779938910417,0.00489866087205705,-0.00200086148295288,EPCI
243801024,CC du Massif du Vercors,1968_1975,1971.5,7,5957,6656,361,737,699,376,323,0.0159765249784576,0.00859395335035773,0.00738257162809986,EPCI
243801024,CC du Massif du Vercors,1975_1982,1978.5,7,6656,7390,350,752,734,402,332,0.0150563694430375,0.00824613149332569,0.00681023794971176,EPCI
243801024,CC du Massif du Vercors,1982_1990,1986,8,7390,8234,416,942,844,526,318,0.0136098051310047,0.00848194016458352,0.00512786496642122,EPCI
243801024,CC du Massif du Vercors,1990_1999,1994.5,9,8234,9951,502,1095,1717,593,1124,0.0212675679837109,0.0073451763624581,0.0139223916212528,EPCI
243801024,CC du Massif du Vercors,1999_2010,2004.5,11,9951,11528,713,1593,1577,880,697,0.013463077398471,0.00751268745127105,0.00595038994719991,EPCI
243801073,CC de Bièvre Est,2010_2015,2012.5,5,21030,21898,726,1309,868,583,285,0.00812186861738318,0.00545512604139907,0.00266674257598411,EPCI
243801073,CC de Bièvre Est,1968_1975,1971.5,7,12741,13535,1141,1390,794,249,545,0.00867365475956938,0.00272007561099846,0.00595357914857092,EPCI
243801073,CC de Bièvre Est,1975_1982,1978.5,7,13535,14511,1073,1279,976,206,770,0.009996500135381,0.00210991703677099,0.00788658309861001,EPCI
243801073,CC de Bièvre Est,1982_1990,1986,8,14511,16676,1205,1587,2165,382,1783,0.0175349098578881,0.00309391942989065,0.0144409904279974,EPCI
243801073,CC de Bièvre Est,1990_1999,1994.5,9,16676,17419,1217,1752,743,535,208,0.00485519338129792,0.00349600061775826,0.00135919276353966,EPCI
243801073,CC de Bièvre Est,1999_2010,2004.5,11,17419,21030,1533,2662,3611,1129,2482,0.0172737149931614,0.00540072673145369,0.0118729882617078,EPCI
243801255,CC des Collines du Nord Dauphiné,2010_2015,2012.5,5,23375,23898,709,1246,523,537,-14,0.0044353468131535,0.0045540750261251,-0.000118728212971603,EPCI
243801255,CC des Collines du Nord Dauphiné,1968_1975,1971.5,7,7730,9546,605,945,1816,340,1476,0.0306037186471433,0.00572977111235062,0.0248739475347927,EPCI
243801255,CC des Collines du Nord Dauphiné,1975_1982,1978.5,7,9546,13155,667,998,3609,331,3278,0.0468769357767807,0.00429932550349526,0.0425776102732854,EPCI
243801255,CC des Collines du Nord Dauphiné,1982_1990,1986,8,13155,17031,737,1501,3876,764,3112,0.0328057854987085,0.00646636226032335,0.0263394232383852,EPCI
243801255,CC des Collines du Nord Dauphiné,1990_1999,1994.5,9,17031,20128,947,1960,3097,1013,2084,0.0187374578503312,0.00612884882221037,0.0126086090281208,EPCI
243801255,CC des Collines du Nord Dauphiné,1999_2010,2004.5,11,20128,23375,1330,2988,3247,1658,1589,0.0136887716932601,0.00698983168075924,0.00669894001250086,EPCI
243900354,CC de la Station des Rousses-Haut Jura,2010_2015,2012.5,5,6357,6897,155,404,540,249,291,0.0164396615506086,0.00758051060389175,0.00885915094671686,EPCI
243900354,CC de la Station des Rousses-Haut Jura,1968_1975,1971.5,7,3512,3963,206,302,451,96,355,0.0174091805633627,0.00370572357889761,0.0137034569844651,EPCI
243900354,CC de la Station des Rousses-Haut Jura,1975_1982,1978.5,7,3963,4285,207,283,322,76,246,0.0112223950008865,0.00264876403747632,0.00857363096341019,EPCI
243900354,CC de la Station des Rousses-Haut Jura,1982_1990,1986,8,4285,5184,235,420,899,185,714,0.0240927010356808,0.00495789732102442,0.0191348037146564,EPCI
243900354,CC de la Station des Rousses-Haut Jura,1990_1999,1994.5,9,5184,5544,292,640,360,348,12,0.0074878170802144,0.00723822317754059,0.000249593902673814,EPCI
243900354,CC de la Station des Rousses-Haut Jura,1999_2010,2004.5,11,5544,6357,326,885,813,559,254,0.0125177268286854,0.00860689950459423,0.00391082732409112,EPCI
243900412,CC Jura Sud,2010_2015,2012.5,5,7242,7031,260,375,-211,115,-326,-0.00589624215696349,0.00321359169692323,-0.00910983385388672,EPCI
243900412,CC Jura Sud,1968_1975,1971.5,7,5410,5523,408,609,113,201,-88,0.00295752172919683,0.0052607244917572,-0.00230320276256037,EPCI
243900412,CC Jura Sud,1975_1982,1978.5,7,5523,5762,385,542,239,157,82,0.00607027069192467,0.00398758367628525,0.00208268701563943,EPCI
243900412,CC Jura Sud,1982_1990,1986,8,5762,6153,462,602,391,140,251,0.00824066023599968,0.00295062003335027,0.00529004020264941,EPCI
243900412,CC Jura Sud,1990_1999,1994.5,9,6153,6727,472,755,574,283,291,0.00995921181725401,0.00491020373568447,0.00504900808156954,EPCI
243900412,CC Jura Sud,1999_2010,2004.5,11,6727,7242,613,1020,515,407,108,0.0067287307141024,0.00531765708862073,0.00141107362548167,EPCI
243900420,CC du Val d'Amour,2010_2015,2012.5,5,9115,9204,441,478,89,37,52,0.0019452423423798,0.000808696254697222,0.00113654608768258,EPCI
243900420,CC du Val d'Amour,1968_1975,1971.5,7,7423,7240,754,739,-183,-15,-168,-0.0035596610082822,-0.000291775492482148,-0.00326788551580005,EPCI
243900420,CC du Val d'Amour,1975_1982,1978.5,7,7240,7492,682,530,252,-152,404,0.00489976164848427,-0.00295541178797464,0.00785517343645891,EPCI
243900420,CC du Val d'Amour,1982_1990,1986,8,7492,7774,681,638,282,-43,325,0.00462931329665262,-0.000705888197716534,0.00533520149436915,EPCI
243900420,CC du Val d'Amour,1990_1999,1994.5,9,7774,8002,955,743,228,-212,440,0.00321701663855678,-0.00299126108497385,0.00620827772353063,EPCI
243900420,CC du Val d'Amour,1999_2010,2004.5,11,8002,9115,1091,1119,1113,28,1085,0.0119094409244291,0.000299608576715198,0.0116098323477139,EPCI
243900479,CC du Haut-Jura (Arcade),2010_2015,2012.5,5,9607,9444,427,573,-163,146,-309,-0.00341662604546789,0.00306029081373197,-0.00647691685919986,EPCI
243900479,CC du Haut-Jura (Arcade),1968_1975,1971.5,7,9019,9633,626,1216,614,590,24,0.00945315007630598,0.00908364583879565,0.000369504237510331,EPCI
243900479,CC du Haut-Jura (Arcade),1975_1982,1978.5,7,9633,9939,603,1069,306,466,-160,0.00447738053628788,0.00681849454219004,-0.00234111400590216,EPCI
243900479,CC du Haut-Jura (Arcade),1982_1990,1986,8,9939,10843,724,1308,904,584,320,0.0109410829365022,0.00706813322446602,0.00387294971203618,EPCI
243900479,CC du Haut-Jura (Arcade),1990_1999,1994.5,9,10843,10408,748,1470,-435,722,-1157,-0.00453910800002322,0.00753387580693509,-0.0120729838069583,EPCI
243900479,CC du Haut-Jura (Arcade),1999_2010,2004.5,11,10408,9607,861,1420,-801,559,-1360,-0.00725381243282142,0.00506227359543967,-0.0123160860282611,EPCI
243900560,CC Jura Nord,2010_2015,2012.5,5,11282,11505,515,723,223,208,15,0.00392230983584141,0.0036584773356727,0.000263832500168705,EPCI
243900560,CC Jura Nord,1968_1975,1971.5,7,7657,7624,757,741,-33,-16,-17,-0.00061682336892821,-0.000299065875843981,-0.000317757493084229,EPCI
243900560,CC Jura Nord,1975_1982,1978.5,7,7624,8335,759,720,711,-39,750,0.0128189457581702,-0.000703148923443936,0.0135220946816142,EPCI
243900560,CC Jura Nord,1982_1990,1986,8,8335,8971,809,928,636,119,517,0.00923407799159226,0.00172775987578534,0.00750631811580692,EPCI
243900560,CC Jura Nord,1990_1999,1994.5,9,8971,9975,891,1054,1004,163,841,0.0118569439432756,0.00192498193501387,0.00993196200826176,EPCI
243900560,CC Jura Nord,1999_2010,2004.5,11,9975,11282,1117,1649,1307,532,775,0.0112562044280935,0.00458171442673737,0.00667449000135613,EPCI
243900610,CC La Grandvallière,2010_2015,2012.5,5,5073,5197,226,284,124,58,66,0.00484151794431376,0.00226458097395321,0.00257693697036055,EPCI
243900610,CC La Grandvallière,1968_1975,1971.5,7,3960,3974,323,451,14,128,-114,0.000504286947536459,0.00461062352033334,-0.00410633657279688,EPCI
243900610,CC La Grandvallière,1975_1982,1978.5,7,3974,4188,300,437,214,137,77,0.00752102026860912,0.00481485877009089,0.00270616149851824,EPCI
243900610,CC La Grandvallière,1982_1990,1986,8,4188,4491,326,526,303,200,103,0.00876974348365933,0.00578860956017118,0.00298113392348816,EPCI
243900610,CC La Grandvallière,1990_1999,1994.5,9,4491,4826,335,583,335,248,87,0.00802565350695472,0.00594137931261126,0.00208427419434347,EPCI
243900610,CC La Grandvallière,1999_2010,2004.5,11,4826,5073,412,679,247,267,-20,0.00454798276693857,0.00491624048086073,-0.000368257713922152,EPCI
243900719,CC du Pays des Lacs,2010_2015,2012.5,5,5987,6103,331,310,116,-21,137,0.00384537487856762,-0.000696145452154483,0.0045415203307221,EPCI
243900719,CC du Pays des Lacs,1968_1975,1971.5,7,5471,5153,486,542,-318,56,-374,-0.00851813416797442,0.00150004878429738,-0.0100181829522718,EPCI
243900719,CC du Pays des Lacs,1975_1982,1978.5,7,5153,5177,420,432,24,12,12,0.000664030166721119,0.00033201508336056,0.00033201508336056,EPCI
243900719,CC du Pays des Lacs,1982_1990,1986,8,5177,5201,477,527,24,50,-26,0.000578314268148805,0.00120482139197668,-0.000626507123827872,EPCI
243900719,CC du Pays des Lacs,1990_1999,1994.5,9,5201,5436,544,553,235,9,226,0.00492236204766416,0.000188515993314798,0.00473384605434937,EPCI
243900719,CC du Pays des Lacs,1999_2010,2004.5,11,5436,5987,625,753,551,128,423,0.00881562673567271,0.00204791328886771,0.006767713446805,EPCI
243901071,CC de la Région d'Orgelet,2010_2015,2012.5,5,5740,5735,303,283,-5,-20,15,-0.000174276762068715,-0.000697107048274859,0.000522830286206144,EPCI
243901071,CC de la Région d'Orgelet,1968_1975,1971.5,7,5044,4718,479,483,-326,4,-330,-0.00949951143044403,0.000116558422459436,-0.00961606985290347,EPCI
243901071,CC de la Région d'Orgelet,1975_1982,1978.5,7,4718,4867,492,356,149,-136,285,0.00445170092037972,-0.00406329748437344,0.00851499840475316,EPCI
243901071,CC de la Région d'Orgelet,1982_1990,1986,8,4867,5014,442,465,147,23,124,0.00372645966030083,0.00058305151147564,0.00314340814882519,EPCI
243901071,CC de la Région d'Orgelet,1990_1999,1994.5,9,5014,5118,537,513,104,-24,128,0.00228368564704629,-0.000527004380087604,0.00281069002713389,EPCI
243901071,CC de la Région d'Orgelet,1999_2010,2004.5,11,5118,5740,595,683,622,88,534,0.01048141028883,0.00148290049102418,0.00899850979780581,EPCI
243901089,CC de la Plaine Jurassienne,2010_2015,2012.5,5,9187,9337,467,523,150,56,94,0.00324436363453806,0.00121122909022754,0.00203313454431052,EPCI
243901089,CC de la Plaine Jurassienne,1968_1975,1971.5,7,7590,7198,751,659,-392,-92,-300,-0.00754686145497285,-0.00177120217820791,-0.00577565927676494,EPCI
243901089,CC de la Plaine Jurassienne,1975_1982,1978.5,7,7198,7907,735,579,709,-156,865,0.0135112101049775,-0.00297284735737163,0.0164840574623491,EPCI
243901089,CC de la Plaine Jurassienne,1982_1990,1986,8,7907,8125,817,689,218,-128,346,0.00340544604138793,-0.00199952795090667,0.0054049739922946,EPCI
243901089,CC de la Plaine Jurassienne,1990_1999,1994.5,9,8125,8118,911,681,-7,-230,223,-9.57631698699224e-05,-0.00314650415286888,0.00305074098299896,EPCI
243901089,CC de la Plaine Jurassienne,1999_2010,2004.5,11,8118,9187,1040,1068,1069,28,1041,0.0113094393055813,0.000296224790043288,0.011013214515538,EPCI
244000543,CC de Mimizan,2010_2015,2012.5,5,11918,12005,688,457,87,-231,318,0.0014557320203572,-0.00386521950232775,0.00532095152268495,EPCI
244000543,CC de Mimizan,1968_1975,1971.5,7,9890,10952,800,1055,1062,255,807,0.014677811106443,0.00352433317527585,0.0111534779311671,EPCI
244000543,CC de Mimizan,1975_1982,1978.5,7,10952,10770,781,812,-182,31,-213,-0.00239107920766701,0.000407271733174052,-0.00279835094084106,EPCI
244000543,CC de Mimizan,1982_1990,1986,8,10770,10363,951,823,-407,-128,-279,-0.00480376495744028,-0.00151076637482151,-0.00329299858261877,EPCI
244000543,CC de Mimizan,1990_1999,1994.5,9,10363,10523,1027,883,160,-144,304,0.00170384629457154,-0.00153346166511439,0.00323730795968593,EPCI
244000543,CC de Mimizan,1999_2010,2004.5,11,10523,11918,1395,985,1395,-410,1805,0.0113812357861685,-0.00334502270417854,0.014726258490347,EPCI
244000659,CC du Seignanx,2010_2015,2012.5,5,24848,26580,1083,1285,1732,202,1530,0.0135675727696536,0.00158236125835452,0.0119852115112991,EPCI
244000659,CC du Seignanx,1968_1975,1971.5,7,10547,13202,934,1100,2655,166,2489,0.0325952234583846,0.00203796877366925,0.0305572546847154,EPCI
244000659,CC du Seignanx,1975_1982,1978.5,7,13202,16072,1062,1108,2870,46,2824,0.0285000416498329,0.000456795092645405,0.0280432465571875,EPCI
244000659,CC du Seignanx,1982_1990,1986,8,16072,17870,1330,1321,1798,-9,1807,0.0133438324911388,-6.67933773193822e-05,0.0134106258684582,EPCI
244000659,CC du Seignanx,1990_1999,1994.5,9,17870,20483,1583,1656,2613,73,2540,0.0152790993307601,0.000426855817506884,0.0148522435132532,EPCI
244000659,CC du Seignanx,1999_2010,2004.5,11,20483,24848,2136,2762,4365,626,3739,0.017717117970333,0.00254087419230893,0.0151762437780241,EPCI
244000675,CA du Grand Dax,2010_2015,2012.5,5,53341,54541,3135,2612,1200,-523,1723,0.00445940291168157,-0.00194355643567455,0.00640295934735611,EPCI
244000675,CA du Grand Dax,1968_1975,1971.5,7,35619,38525,3462,3941,2906,479,2427,0.0112670255657237,0.0018571594101795,0.00940986615554417,EPCI
244000675,CA du Grand Dax,1975_1982,1978.5,7,38525,40553,3572,3448,2028,-124,2152,0.0073558335372157,-0.000449764969731137,0.00780559850694683,EPCI
244000675,CA du Grand Dax,1982_1990,1986,8,40553,43509,4163,3817,2956,-346,3302,0.00883354408268233,-0.00103396693254671,0.00986751101522905,EPCI
244000675,CA du Grand Dax,1990_1999,1994.5,9,43509,45929,4623,4164,2420,-459,2879,0.00603244597870467,-0.00114417053893613,0.0071766165176408,EPCI
244000675,CA du Grand Dax,1999_2010,2004.5,11,45929,53341,6013,5528,7412,-485,7897,0.0136936877030949,-0.000896038658391934,0.0145897263614868,EPCI
244000691,CC du Pays Morcenais,2010_2015,2012.5,5,9459,9393,707,363,-66,-344,278,-0.00139940755850776,-0.00729388182010105,0.00589447426159329,EPCI
244000691,CC du Pays Morcenais,1968_1975,1971.5,7,10448,10641,885,1084,193,199,-6,0.00261826338394733,0.00269966017308559,-8.13967891382587e-05,EPCI
244000691,CC du Pays Morcenais,1975_1982,1978.5,7,10641,10261,944,826,-380,-118,-262,-0.00518141045480225,-0.0016089642991228,-0.00357244615567945,EPCI
244000691,CC du Pays Morcenais,1982_1990,1986,8,10261,9185,1061,782,-1076,-279,-797,-0.0137518896083843,-0.00356577806760149,-0.0101861115407828,EPCI
244000691,CC du Pays Morcenais,1990_1999,1994.5,9,9185,8924,1106,705,-261,-401,140,-0.00319792483260517,-0.00491328681178036,0.00171536197917519,EPCI
244000691,CC du Pays Morcenais,1999_2010,2004.5,11,8924,9459,1514,835,535,-679,1214,0.00530697716621331,-0.00673539718852119,0.0120423743547345,EPCI
244000766,CC du Pays Tarusate,2010_2015,2012.5,5,16165,17426,967,887,1261,-80,1341,0.0151363988071016,-0.000960279067857358,0.016096677874959,EPCI
244000766,CC du Pays Tarusate,1968_1975,1971.5,7,14792,14575,1414,1175,-217,-239,22,-0.00210902456837059,-0.0023228427273759,0.000213818159005313,EPCI
244000766,CC du Pays Tarusate,1975_1982,1978.5,7,14575,14205,1425,932,-370,-493,123,-0.00366664949646167,-0.00488556270744758,0.00121891321098591,EPCI
244000766,CC du Pays Tarusate,1982_1990,1986,8,14205,14217,1525,1080,12,-445,457,0.000105557614239249,-0.00391442819470548,0.00401998580894473,EPCI
244000766,CC du Pays Tarusate,1990_1999,1994.5,9,14217,14185,1747,1076,-32,-671,639,-0.000250342369423451,-0.00524936655884798,0.00499902418942453,EPCI
244000766,CC du Pays Tarusate,1999_2010,2004.5,11,14185,16165,2028,1624,1980,-404,2384,0.0119493151019592,-0.00243814308140985,0.014387458183369,EPCI
244000774,CC du Pays de Villeneuve en Armagnac Landais,2010_2015,2012.5,5,6025,6259,313,283,234,-30,264,0.00764970030660339,-0.000980730808538896,0.00863043111514229,EPCI
244000774,CC du Pays de Villeneuve en Armagnac Landais,1968_1975,1971.5,7,5425,5311,542,466,-114,-76,-38,-0.00302936760455697,-0.00201957840303798,-0.00100978920151899,EPCI
244000774,CC du Pays de Villeneuve en Armagnac Landais,1975_1982,1978.5,7,5311,5266,570,297,-45,-273,228,-0.00121484438781938,-0.00737005595277091,0.00615521156495153,EPCI
244000774,CC du Pays de Villeneuve en Armagnac Landais,1982_1990,1986,8,5266,5306,655,389,40,-266,306,0.000946346834036937,-0.00629320644634563,0.00723955328038257,EPCI
244000774,CC du Pays de Villeneuve en Armagnac Landais,1990_1999,1994.5,9,5306,5401,630,456,95,-174,269,0.00197370807995001,-0.00361500216748739,0.0055887102474374,EPCI
244000774,CC du Pays de Villeneuve en Armagnac Landais,1999_2010,2004.5,11,5401,6025,769,644,624,-125,749,0.00998895602082928,-0.00200099279263407,0.0119899488134633,EPCI
244000808,CA Mont-de-Marsan Agglomération,2010_2015,2012.5,5,53315,53926,2183,2878,611,695,-84,0.00228160268456423,0.00259527637605915,-0.000313673691494919,EPCI
244000808,CA Mont-de-Marsan Agglomération,1968_1975,1971.5,7,35877,39359,2468,4659,3482,2191,1291,0.0133205446337967,0.00838176717192666,0.00493877746187007,EPCI
244000808,CA Mont-de-Marsan Agglomération,1975_1982,1978.5,7,39359,41788,2562,4009,2429,1447,982,0.00859163398509155,0.00511819447362185,0.0034734395114697,EPCI
244000808,CA Mont-de-Marsan Agglomération,1982_1990,1986,8,41788,44656,3004,4898,2868,1894,974,0.00833195157744515,0.00550234180184139,0.00282960977560376,EPCI
244000808,CA Mont-de-Marsan Agglomération,1990_1999,1994.5,9,44656,46598,3609,4971,1942,1362,580,0.0047410863259103,0.00332510791755398,0.00141597840835632,EPCI
244000808,CA Mont-de-Marsan Agglomération,1999_2010,2004.5,11,46598,53315,4463,6255,6717,1792,4925,0.0123170647487045,0.0032860175717848,0.00903104717691973,EPCI
244000824,CC du Pays Grenadois,2010_2015,2012.5,5,7777,7718,385,379,-59,-6,-53,-0.00152192002281082,-0.000154771527743473,-0.00136714849506735,EPCI
244000824,CC du Pays Grenadois,1968_1975,1971.5,7,6038,5970,531,581,-68,50,-118,-0.00161667803447163,0.0011887338488762,-0.00280541188334783,EPCI
244000824,CC du Pays Grenadois,1975_1982,1978.5,7,5970,6336,556,572,366,16,350,0.00853633233124063,0.000373172998087022,0.0081631593331536,EPCI
244000824,CC du Pays Grenadois,1982_1990,1986,8,6336,6739,553,634,403,81,322,0.00773776943205196,0.00155523405458116,0.00618253537747079,EPCI
244000824,CC du Pays Grenadois,1990_1999,1994.5,9,6739,6933,623,676,194,53,141,0.00315843002869554,0.000862870059385894,0.00229555996930964,EPCI
244000824,CC du Pays Grenadois,1999_2010,2004.5,11,6933,7777,707,915,844,208,636,0.0104981814025384,0.00258722953996208,0.00791095186257636,EPCI
244000857,CC Côte Landes Nature,2010_2015,2012.5,5,10531,11317,655,435,786,-220,1006,0.0145006756910449,-0.00405871329774792,0.0185593889887928,EPCI
244000857,CC Côte Landes Nature,1968_1975,1971.5,7,8471,8356,815,741,-115,-74,-41,-0.00195076930781835,-0.00125527764155267,-0.000695491666265671,EPCI
244000857,CC Côte Landes Nature,1975_1982,1978.5,7,8356,8204,845,554,-152,-291,139,-0.00261913598887853,-0.00501426692607666,0.00239513093719813,EPCI
244000857,CC Côte Landes Nature,1982_1990,1986,8,8204,8652,940,680,448,-260,708,0.00666821770605375,-0.00386994777583476,0.0105381654818885,EPCI
244000857,CC Côte Landes Nature,1990_1999,1994.5,9,8652,9255,1090,783,603,-307,910,0.00751402722756356,-0.0038255495171841,0.0113395767447477,EPCI
244000857,CC Côte Landes Nature,1999_2010,2004.5,11,9255,10531,1272,972,1276,-300,1576,0.0118109634404018,-0.00277687228222612,0.0145878357226279,EPCI
244000865,CC Maremne Adour Côte Sud,2010_2015,2012.5,5,57596,63714,2886,3119,6118,233,5885,0.0203954411438272,0.000776746941240885,0.0196186942025863,EPCI
244000865,CC Maremne Adour Côte Sud,1968_1975,1971.5,7,27616,30271,2527,2635,2655,108,2547,0.0131999087509951,0.000536945440718444,0.0126629633102766,EPCI
244000865,CC Maremne Adour Côte Sud,1975_1982,1978.5,7,30271,32903,2837,2295,2632,-542,3174,0.0119817385482011,-0.00246736409313259,0.0144491026413336,EPCI
244000865,CC Maremne Adour Côte Sud,1982_1990,1986,8,32903,37210,3317,2680,4307,-637,4944,0.015495542856846,-0.00229177172041116,0.0177873145772571,EPCI
244000865,CC Maremne Adour Côte Sud,1990_1999,1994.5,9,37210,44095,4154,3556,6885,-598,7483,0.0190422403294457,-0.00165392297995766,0.0206961633094033,EPCI
244000865,CC Maremne Adour Côte Sud,1999_2010,2004.5,11,44095,57596,5612,5999,13501,387,13114,0.0245796484561955,0.000704564399122115,0.0238750840570734,EPCI
244000873,CC des Grands Lacs,2010_2015,2012.5,5,25079,28880,1186,1354,3801,168,3633,0.0286257563985248,0.00126522680214474,0.0273605295963801,EPCI
244000873,CC des Grands Lacs,1968_1975,1971.5,7,14455,15970,961,1992,1515,1031,484,0.01434065264874,0.00975921642300389,0.00458143622573607,EPCI
244000873,CC des Grands Lacs,1975_1982,1978.5,7,15970,16289,992,1408,319,416,-97,0.00282943404948299,0.00368979487330698,-0.000860360823823982,EPCI
244000873,CC des Grands Lacs,1982_1990,1986,8,16289,17947,1235,1629,1658,394,1264,0.0121903206672893,0.00289685545410856,0.00929346521318075,EPCI
244000873,CC des Grands Lacs,1990_1999,1994.5,9,17947,18836,1553,1742,889,189,700,0.00538633914737607,0.0011451272203083,0.00424121192706778,EPCI
244000873,CC des Grands Lacs,1999_2010,2004.5,11,18836,25079,2223,2561,6243,338,5905,0.0263652926532254,0.00142743375248922,0.0249378589007362,EPCI
244000881,CC Coteaux et Vallées des Luys,2010_2015,2012.5,5,7524,7638,452,350,114,-102,216,0.00301210276560782,-0.00269503931659647,0.00570714208220428,EPCI
244000881,CC Coteaux et Vallées des Luys,1968_1975,1971.5,7,7283,6912,665,524,-371,-141,-230,-0.00744129455282072,-0.0028280930780262,-0.00461320147479452,EPCI
244000881,CC Coteaux et Vallées des Luys,1975_1982,1978.5,7,6912,6668,652,432,-244,-220,-24,-0.0051209951397303,-0.00461729069975683,-0.000503704439973472,EPCI
244000881,CC Coteaux et Vallées des Luys,1982_1990,1986,8,6668,6752,792,484,84,-308,392,0.00156607406581877,-0.00574227157466882,0.00730834564048758,EPCI
244000881,CC Coteaux et Vallées des Luys,1990_1999,1994.5,9,6752,6682,783,514,-70,-269,199,-0.00115726466984323,-0.00444720280268326,0.00328993813284003,EPCI
244000881,CC Coteaux et Vallées des Luys,1999_2010,2004.5,11,6682,7524,997,707,842,-290,1132,0.0108475551835721,-0.00373609382807114,0.0145836490116432,EPCI
244100293,CC des Collines du Perche,2010_2015,2012.5,5,6299,6221,398,259,-78,-139,61,-0.00248894245496778,-0.0044354230928272,0.00194648063785942,EPCI
244100293,CC des Collines du Perche,1968_1975,1971.5,7,7900,7454,637,655,-446,18,-464,-0.00826734432351772,0.000333659636375155,-0.00860100395989288,EPCI
244100293,CC des Collines du Perche,1975_1982,1978.5,7,7454,6957,664,476,-497,-188,-309,-0.0098090676063235,-0.00371047225349863,-0.00609859535282487,EPCI
244100293,CC des Collines du Perche,1982_1990,1986,8,6957,6445,641,513,-512,-128,-384,-0.00950995544096678,-0.00237748886024169,-0.00713246658072508,EPCI
244100293,CC des Collines du Perche,1990_1999,1994.5,9,6445,6352,681,534,-93,-147,54,-0.0016136868767751,-0.00255066635361226,0.000936979476837155,EPCI
244100293,CC des Collines du Perche,1999_2010,2004.5,11,6352,6299,930,623,-53,-307,254,-0.00076142208960861,-0.00441050153792157,0.00364907944831296,EPCI
244100780,CC de la Sologne des Étangs,2010_2015,2012.5,5,8021,7959,490,379,-62,-111,49,-0.00155074406411115,-0.00277633211477965,0.00122558805066849,EPCI
244100780,CC de la Sologne des Étangs,1968_1975,1971.5,7,7716,7121,693,601,-595,-92,-503,-0.0113985288602158,-0.00176246160527706,-0.00963606725493869,EPCI
244100780,CC de la Sologne des Étangs,1975_1982,1978.5,7,7121,6899,768,451,-222,-317,95,-0.00451430709389056,-0.00644610517460949,0.00193179808071893,EPCI
244100780,CC de la Sologne des Étangs,1982_1990,1986,8,6899,6835,797,546,-64,-251,187,-0.00116432207396533,-0.00456632563383278,0.00340200355986745,EPCI
244100780,CC de la Sologne des Étangs,1990_1999,1994.5,9,6835,7108,915,619,273,-296,569,0.00436108643701738,-0.0047285039756672,0.00908959041268458,EPCI
244100780,CC de la Sologne des Étangs,1999_2010,2004.5,11,7108,8021,1139,892,913,-247,1160,0.0110462176963015,-0.00298840719713744,0.014034624893439,EPCI
244100798,CC du Grand Chambord,2010_2015,2012.5,5,20517,21084,951,1072,567,121,446,0.00546701954886242,0.00116668318414877,0.00430033636471365,EPCI
244100798,CC du Grand Chambord,1968_1975,1971.5,7,12382,12569,1069,1389,187,320,-133,0.00214367436948537,0.00366831977665946,-0.00152464540717409,EPCI
244100798,CC du Grand Chambord,1975_1982,1978.5,7,12569,16050,1055,1241,3481,186,3295,0.0355420971346407,0.00189911808878,0.0336429790458607,EPCI
244100798,CC du Grand Chambord,1982_1990,1986,8,16050,17548,1263,1577,1498,314,1184,0.0112163282871875,0.0023510861696775,0.00886524211751005,EPCI
244100798,CC du Grand Chambord,1990_1999,1994.5,9,17548,18370,1525,1711,822,186,636,0.00509950465178122,0.00115390251244685,0.00394560213933437,EPCI
244100798,CC du Grand Chambord,1999_2010,2004.5,11,18370,20517,1995,2406,2147,411,1736,0.0100992853245689,0.00193330520186206,0.00816598012270688,EPCI
244100806,CC de la Sologne des Rivières,2010_2015,2012.5,5,12160,11860,780,517,-300,-263,-37,-0.00498363686174586,-0.00436898831546387,-0.000614648546281988,EPCI
244100806,CC de la Sologne des Rivières,1968_1975,1971.5,7,11797,12284,1009,1175,487,166,321,0.00579563590487719,0.00197551449735034,0.00382012140752686,EPCI
244100806,CC de la Sologne des Rivières,1975_1982,1978.5,7,12284,12572,1069,963,288,-106,394,0.00331613143227938,-0.00122052059660283,0.00453665202888221,EPCI
244100806,CC de la Sologne des Rivières,1982_1990,1986,8,12572,12664,1261,1122,92,-139,231,0.000911815907023383,-0.00137763490300272,0.0022894508100261,EPCI
244100806,CC de la Sologne des Rivières,1990_1999,1994.5,9,12664,12528,1369,1040,-136,-329,193,-0.00119896769989136,-0.00290044392106072,0.00170147622116936,EPCI
244100806,CC de la Sologne des Rivières,1999_2010,2004.5,11,12528,12160,1721,1243,-368,-478,110,-0.00270671773513875,-0.00351579097118566,0.00080907323604691,EPCI
244200614,CC des Vals d'Aix et Isable,2010_2015,2012.5,5,5911,6023,311,313,112,2,110,0.00376114586753751,6.71633190631698e-05,0.00369398254847434,EPCI
244200614,CC des Vals d'Aix et Isable,1968_1975,1971.5,7,6132,5705,600,611,-427,11,-438,-0.0102581621128199,0.000264261787449694,-0.0105224239002696,EPCI
244200614,CC des Vals d'Aix et Isable,1975_1982,1978.5,7,5705,5504,538,434,-201,-104,-97,-0.00511087803148214,-0.00264443440434897,-0.00246644362713317,EPCI
244200614,CC des Vals d'Aix et Isable,1982_1990,1986,8,5504,5277,538,437,-227,-101,-126,-0.00525083419783579,-0.00233627424661416,-0.00291455995122163,EPCI
244200614,CC des Vals d'Aix et Isable,1990_1999,1994.5,9,5277,5252,597,491,-25,-106,81,-0.000527505040599841,-0.00223662137214332,0.00170911633154348,EPCI
244200614,CC des Vals d'Aix et Isable,1999_2010,2004.5,11,5252,5911,654,682,659,28,631,0.0108039516430978,0.000459044986353168,0.0103449066567446,EPCI
244200622,CC des Monts du Pilat,2010_2015,2012.5,5,15344,15109,957,803,-235,-154,-81,-0.0030820258537797,-0.00201971055949819,-0.00106231529428151,EPCI
244200622,CC des Monts du Pilat,1968_1975,1971.5,7,11999,11932,1237,1221,-67,-16,-51,-0.000799601052814403,-0.000190949505149708,-0.000608651547664695,EPCI
244200622,CC des Monts du Pilat,1975_1982,1978.5,7,11932,12995,1268,1111,1063,-157,1220,0.0122661628592742,-0.00181165340442714,0.0140778162637013,EPCI
244200622,CC des Monts du Pilat,1982_1990,1986,8,12995,13084,1435,1256,89,-179,268,0.000853544259589834,-0.00171667890411888,0.00257022316370871,EPCI
244200622,CC des Monts du Pilat,1990_1999,1994.5,9,13084,14084,1555,1379,1000,-176,1176,0.00821682897218778,-0.00144616189910505,0.00966299087129283,EPCI
244200622,CC des Monts du Pilat,1999_2010,2004.5,11,14084,15344,1912,1886,1260,-26,1286,0.0078199735974207,-0.000161364534549951,0.00798133813197066,EPCI
244200630,CC du Pays entre Loire et Rhône,2010_2015,2012.5,5,13274,13798,828,844,524,16,508,0.00777334063189517,0.00023735391242428,0.00753598671947089,EPCI
244200630,CC du Pays entre Loire et Rhône,1968_1975,1971.5,7,12859,12095,1235,1264,-764,29,-793,-0.00871208665225642,0.00033069438863277,-0.00904278104088919,EPCI
244200630,CC du Pays entre Loire et Rhône,1975_1982,1978.5,7,12095,12064,1276,1053,-31,-223,192,-0.000366551774390045,-0.00263680792545097,0.00227025615106092,EPCI
244200630,CC du Pays entre Loire et Rhône,1982_1990,1986,8,12064,11943,1406,1155,-121,-251,130,-0.00125926628037421,-0.00261219699482583,0.00135293071445163,EPCI
244200630,CC du Pays entre Loire et Rhône,1990_1999,1994.5,9,11943,11765,1461,1189,-178,-272,94,-0.00166708780802483,-0.00254746002125142,0.000880372213226593,EPCI
244200630,CC du Pays entre Loire et Rhône,1999_2010,2004.5,11,11765,13274,1670,1688,1509,18,1491,0.0110311459084811,0.000131584245429198,0.0108995616630519,EPCI
244200770,Saint-Etienne Métropole,2010_2015,2012.5,5,400662,402882,19067,26758,2220,7691,-5471,0.00110571805523452,0.00383066556883273,-0.00272494751359822,EPCI
244200770,Saint-Etienne Métropole,1968_1975,1971.5,7,434076,445790,32772,52711,11714,19939,-8225,0.0038112953185665,0.00648740117439794,-0.00267610585583144,EPCI
244200770,Saint-Etienne Métropole,1975_1982,1978.5,7,445790,432882,31086,45825,-12908,14739,-27647,-0.00418874770316735,0.00478292162976322,-0.00897166933293057,EPCI
244200770,Saint-Etienne Métropole,1982_1990,1986,8,432882,431823,32791,47001,-1059,14210,-15269,-0.000306127068428586,0.00410771071045345,-0.00441383777888203,EPCI
244200770,Saint-Etienne Métropole,1990_1999,1994.5,9,431823,408009,35265,46707,-23814,11442,-35256,-0.00628312797628539,0.00301887756381361,-0.009302005540099,EPCI
244200770,Saint-Etienne Métropole,1999_2010,2004.5,11,408009,400662,41154,56556,-7347,15402,-22749,-0.00165055033014128,0.00346015736829127,-0.00511070769843254,EPCI
244200820,CC du Pays d'Urfé,2010_2015,2012.5,5,5181,5194,368,274,13,-94,107,0.000501330705835024,-0.00362500664219171,0.00412633734802673,EPCI
244200820,CC du Pays d'Urfé,1968_1975,1971.5,7,7486,6607,581,646,-879,65,-944,-0.0176853058503738,0.00130778712204129,-0.018993092972415,EPCI
244200820,CC du Pays d'Urfé,1975_1982,1978.5,7,6607,6095,570,432,-512,-138,-374,-0.0114568546364153,-0.00308798035122132,-0.00836887428519401,EPCI
244200820,CC du Pays d'Urfé,1982_1990,1986,8,6095,5512,618,426,-583,-192,-391,-0.0124890104916525,-0.0041130188926197,-0.00837599159903282,EPCI
244200820,CC du Pays d'Urfé,1990_1999,1994.5,9,5512,5097,671,441,-415,-230,-185,-0.00865955511125749,-0.00479927150744391,-0.00386028360381358,EPCI
244200820,CC du Pays d'Urfé,1999_2010,2004.5,11,5097,5181,722,535,84,-187,271,0.00148710068237423,-0.00331056937623787,0.00479767005861211,EPCI
244200895,CC du Pilat Rhodanien,2010_2015,2012.5,5,16015,16743,652,981,728,329,399,0.00893053688933798,0.00403591570960466,0.00489462117973332,EPCI
244200895,CC du Pilat Rhodanien,1968_1975,1971.5,7,9750,9793,953,940,43,-13,56,0.000628849032541901,-0.000190117149373133,0.000818966181915033,EPCI
244200895,CC du Pilat Rhodanien,1975_1982,1978.5,7,9793,10489,892,782,696,-110,806,0.00985672409923199,-0.00155781559039586,0.0114145396896279,EPCI
244200895,CC du Pilat Rhodanien,1982_1990,1986,8,10489,11967,1009,1185,1478,176,1302,0.0166147362786895,0.00197848009813894,0.0146362561805505,EPCI
244200895,CC du Pilat Rhodanien,1990_1999,1994.5,9,11967,13216,1036,1404,1249,368,881,0.0110916563417669,0.00326799802543652,0.00782365831633037,EPCI
244200895,CC du Pilat Rhodanien,1999_2010,2004.5,11,13216,16015,1366,2077,2799,711,2088,0.0176167920780437,0.00447500506162524,0.0131417870164184,EPCI
244300307,CC du Pays de Montfaucon,2010_2015,2012.5,5,8417,8315,437,423,-102,-14,-88,-0.00243550086035127,-0.000334284431812919,-0.00210121642853835,EPCI
244300307,CC du Pays de Montfaucon,1968_1975,1971.5,7,8697,8205,809,855,-492,46,-538,-0.00828469320986158,0.000774585137507384,-0.00905927834736897,EPCI
244300307,CC du Pays de Montfaucon,1975_1982,1978.5,7,8205,7957,759,722,-248,-37,-211,-0.00437492773495873,-0.000652710992715618,-0.00372221674224312,EPCI
244300307,CC du Pays de Montfaucon,1982_1990,1986,8,7957,8009,808,779,52,-29,81,0.000814564696041575,-0.000454276465100109,0.00126884116114168,EPCI
244300307,CC du Pays de Montfaucon,1990_1999,1994.5,9,8009,7877,845,824,-132,-21,-111,-0.00184482827745114,-0.000293495407776317,-0.00155133286967482,EPCI
244300307,CC du Pays de Montfaucon,1999_2010,2004.5,11,7877,8417,979,1079,540,100,440,0.00604605400154301,0.00111963962991537,0.00492641437162764,EPCI
244301016,CC des Sucs,2010_2015,2012.5,5,16905,17630,1019,970,725,-49,774,0.00843387849147548,-0.000570013856665239,0.00900389234814072,EPCI
244301016,CC des Sucs,1968_1975,1971.5,7,13736,13876,1489,1438,140,-51,191,0.00144970774211051,-0.000528107820340256,0.00197781556245076,EPCI
244301016,CC des Sucs,1975_1982,1978.5,7,13876,13720,1425,1121,-156,-304,148,-0.00161385444978124,-0.00314494713290703,0.00153109268312579,EPCI
244301016,CC des Sucs,1982_1990,1986,8,13720,13568,1586,1186,-152,-400,248,-0.00139159873326933,-0.00366210192965613,0.0022705031963868,EPCI
244301016,CC des Sucs,1990_1999,1994.5,9,13568,14496,1650,1476,928,-174,1102,0.00737804801783137,-0.00138338400334338,0.00876143202117476,EPCI
244301016,CC des Sucs,1999_2010,2004.5,11,14496,16905,2019,2090,2409,71,2338,0.0140741841880983,0.000414805760628882,0.0136593784274694,EPCI
244301032,CC Brioude Sud Auvergne,2010_2015,2012.5,5,16708,16923,902,786,215,-116,331,0.00256047178130103,-0.00138146384479498,0.00394193562609601,EPCI
244301032,CC Brioude Sud Auvergne,1968_1975,1971.5,7,15614,15838,1463,1647,224,184,40,0.00203695293142481,0.00167321133652752,0.000363741594897287,EPCI
244301032,CC Brioude Sud Auvergne,1975_1982,1978.5,7,15838,15933,1386,1357,95,-29,124,0.00085469566151497,-0.000260907096672991,0.00111560275818796,EPCI
244301032,CC Brioude Sud Auvergne,1982_1990,1986,8,15933,16110,1529,1520,177,-9,186,0.00138192486444533,-7.02673659887455e-05,0.00145219223043407,EPCI
244301032,CC Brioude Sud Auvergne,1990_1999,1994.5,9,16110,15886,1632,1452,-224,-180,-44,-0.00155456585074609,-0.0012492047014924,-0.000305361149253697,EPCI
244301032,CC Brioude Sud Auvergne,1999_2010,2004.5,11,15886,16708,1955,1851,822,-104,926,0.00459684489902434,-0.000581595948295051,0.00517844084731939,EPCI
244301099,CC Auzon Communauté,2010_2015,2012.5,5,9215,9188,483,440,-27,-43,16,-0.000586689089599801,-0.000934356698251535,0.000347667608651734,EPCI
244301099,CC Auzon Communauté,1968_1975,1971.5,7,10201,10086,940,913,-115,-27,-88,-0.00161832210883173,-0.000379953886421362,-0.00123836822241037,EPCI
244301099,CC Auzon Communauté,1975_1982,1978.5,7,10086,9886,916,787,-200,-129,-71,-0.0028571546522802,-0.00184286475072073,-0.00101428990155947,EPCI
244301099,CC Auzon Communauté,1982_1990,1986,8,9886,9114,966,758,-772,-208,-564,-0.0101120165201637,-0.00272448113496638,-0.00738753538519731,EPCI
244301099,CC Auzon Communauté,1990_1999,1994.5,9,9114,8725,1115,624,-389,-491,102,-0.00483485480759016,-0.0061026059396575,0.00126775113206734,EPCI
244301099,CC Auzon Communauté,1999_2010,2004.5,11,8725,9215,1224,1021,490,-203,693,0.00497964131929374,-0.00206299426085026,0.007042635580144,EPCI
244301107,CC du Haut-Lignon,2010_2015,2012.5,5,8401,8219,494,306,-182,-188,6,-0.00437085971016293,-0.00451495398632215,0.000144094276159218,EPCI
244301107,CC du Haut-Lignon,1968_1975,1971.5,7,8899,8277,789,693,-622,-96,-526,-0.0102978003772914,-0.00158937111932472,-0.00870842925796672,EPCI
244301107,CC du Haut-Lignon,1975_1982,1978.5,7,8277,7783,798,600,-494,-198,-296,-0.00875271512837095,-0.00350817327007581,-0.00524454185829514,EPCI
244301107,CC du Haut-Lignon,1982_1990,1986,8,7783,7852,908,684,69,-224,293,0.00110390991512732,-0.00358370755055826,0.00468761746568558,EPCI
244301107,CC du Haut-Lignon,1990_1999,1994.5,9,7852,7734,807,711,-118,-96,-22,-0.00168103916031614,-0.00136762507957924,-0.000313414080736908,EPCI
244301107,CC du Haut-Lignon,1999_2010,2004.5,11,7734,8401,1009,879,667,-130,797,0.00754876326155585,-0.00147127319940369,0.00902003646095953,EPCI
244301123,CC des Pays de Cayres et de Pradelles,2010_2015,2012.5,5,5363,5236,376,222,-127,-154,27,-0.00478166565303384,-0.0057982402406867,0.00101657458765286,EPCI
244301123,CC des Pays de Cayres et de Pradelles,1968_1975,1971.5,7,8115,7054,775,527,-1061,-248,-813,-0.0198180416200273,-0.00463230379054361,-0.0151857378294837,EPCI
244301123,CC des Pays de Cayres et de Pradelles,1975_1982,1978.5,7,7054,6223,753,406,-831,-347,-484,-0.0177467420708566,-0.00741049277808331,-0.0103362492927733,EPCI
244301123,CC des Pays de Cayres et de Pradelles,1982_1990,1986,8,6223,5509,769,382,-714,-387,-327,-0.0151181787033475,-0.00819430694425139,-0.00692387175909614,EPCI
244301123,CC des Pays de Cayres et de Pradelles,1990_1999,1994.5,9,5509,5220,771,384,-289,-387,98,-0.00596941367075432,-0.00799364391204817,0.00202423024129385,EPCI
244301123,CC des Pays de Cayres et de Pradelles,1999_2010,2004.5,11,5220,5363,881,560,143,-321,464,0.00245994052872689,-0.00552196440364568,0.00798190493237256,EPCI
244301131,CC Loire et Semène,2010_2015,2012.5,5,19571,20493,811,1170,922,359,563,0.00924941098984644,0.00360145178454975,0.00564795920529669,EPCI
244301131,CC Loire et Semène,1968_1975,1971.5,7,12301,12470,1158,1180,169,22,147,0.00195121540604859,0.000254004372385024,0.00169721103366357,EPCI
244301131,CC Loire et Semène,1975_1982,1978.5,7,12470,13687,1172,1162,1217,-10,1227,0.0133918376922539,-0.000110039750963467,0.0135018774432174,EPCI
244301131,CC Loire et Semène,1982_1990,1986,8,13687,15863,1308,1554,2176,246,1930,0.0186139794196551,0.00210433774689116,0.016509641672764,EPCI
244301131,CC Loire et Semène,1990_1999,1994.5,9,15863,17221,1395,1733,1358,338,1020,0.00916846588948017,0.00228198930091627,0.0068864765885639,EPCI
244301131,CC Loire et Semène,1999_2010,2004.5,11,17221,19571,1774,2595,2350,821,1529,0.0116969081458975,0.00408645173948165,0.00761045640641588,EPCI
244400404,Nantes Métropole,2010_2015,2012.5,5,587522,630372,20298,38689,42850,18391,24459,0.0141788657717119,0.00608549639224162,0.00809336937947028,EPCI
244400404,Nantes Métropole,1968_1975,1971.5,7,411555,460825,26784,59736,49270,32952,16318,0.0162848463125571,0.0108913792508906,0.00539346706166647,EPCI
244400404,Nantes Métropole,1975_1982,1978.5,7,460825,475229,27261,54521,14404,27260,-12856,0.00440659945069277,0.00833962100985039,-0.00393302155915761,EPCI
244400404,Nantes Métropole,1982_1990,1986,8,475229,505076,30241,57145,29847,26904,2943,0.00764307530541553,0.00688944610905281,0.000753629196362713,EPCI
244400404,Nantes Métropole,1990_1999,1994.5,9,505076,554478,33739,65049,49402,31310,18092,0.0104226319932581,0.00660565579751652,0.00381697619574158,EPCI
244400404,Nantes Métropole,1999_2010,2004.5,11,554478,587522,42497,80319,33044,37822,-4778,0.00527628550714243,0.00603921046032989,-0.000762924953187463,EPCI
244400438,CC de Grand Lieu,2010_2015,2012.5,5,35730,38050,1111,2554,2320,1443,877,0.0126615698765176,0.00787527816026502,0.00478629171625255,EPCI
244400438,CC de Grand Lieu,1968_1975,1971.5,7,15506,17506,1362,2002,2000,640,1360,0.0174819998823155,0.00559423996234095,0.0118877599199745,EPCI
244400438,CC de Grand Lieu,1975_1982,1978.5,7,17506,21110,1268,2172,3604,904,2700,0.0271041234072575,0.00679859255276382,0.0203055308544937,EPCI
244400438,CC de Grand Lieu,1982_1990,1986,8,21110,24191,1585,2717,3081,1132,1949,0.0171750489974238,0.00631033932654456,0.0108647096708793,EPCI
244400438,CC de Grand Lieu,1990_1999,1994.5,9,24191,27720,1757,3130,3529,1373,2156,0.0152454339684405,0.0059314199032782,0.00931401406516227,EPCI
244400438,CC de Grand Lieu,1999_2010,2004.5,11,27720,35730,2215,5544,8010,3329,4681,0.0233443570624379,0.00970204302882093,0.0136423140336169,EPCI
244400453,CC de la Région de Blain,2010_2015,2012.5,5,15231,16071,747,1107,840,360,480,0.0107945615617133,0.00462624066930571,0.00616832089240761,EPCI
244400453,CC de la Région de Blain,1968_1975,1971.5,7,10697,10768,910,1284,71,374,-303,0.000945510224430013,0.0049805749850257,-0.00403506476059569,EPCI
244400453,CC de la Région de Blain,1975_1982,1978.5,7,10768,11138,961,1078,370,117,253,0.00483793839609192,0.00152983457389934,0.00330810382219259,EPCI
244400453,CC de la Région de Blain,1982_1990,1986,8,11138,11483,1007,1256,345,249,96,0.00382040366160519,0.00275733481663679,0.0010630688449684,EPCI
244400453,CC de la Région de Blain,1990_1999,1994.5,9,11483,11741,1198,1177,258,-21,279,0.0024718621209352,-0.000201198079611004,0.0026730602005462,EPCI
244400453,CC de la Région de Blain,1999_2010,2004.5,11,11741,15231,1534,2251,3490,717,2773,0.0239407998210983,0.00491849669677006,0.0190223031243283,EPCI
244400503,CC d'Erdre et Gesvres,2010_2015,2012.5,5,54601,60180,1615,3887,5579,2272,3307,0.0196481070866565,0.00800152344522023,0.0116465836414363,EPCI
244400503,CC d'Erdre et Gesvres,1968_1975,1971.5,7,21608,23984,2060,2451,2376,391,1985,0.0150149405349418,0.00247089299207165,0.0125440475428701,EPCI
244400503,CC d'Erdre et Gesvres,1975_1982,1978.5,7,23984,31987,2085,3173,8003,1088,6915,0.0419924121210142,0.0057088272382436,0.0362835848827706,EPCI
244400503,CC d'Erdre et Gesvres,1982_1990,1986,8,31987,37035,2306,3878,5048,1572,3476,0.0184855103783967,0.00575658128265445,0.0127289290957423,EPCI
244400503,CC d'Erdre et Gesvres,1990_1999,1994.5,9,37035,43201,2586,4576,6166,1990,4176,0.0172583709358736,0.00556992509931696,0.0116884458365566,EPCI
244400503,CC d'Erdre et Gesvres,1999_2010,2004.5,11,43201,54601,3219,7832,11400,4613,6787,0.0215181147395882,0.00870728625383512,0.0128108284857531,EPCI
244400537,CC de Nozay,2010_2015,2012.5,5,14522,15604,502,1243,1082,741,341,0.0144762912634544,0.00991398505195906,0.00456230621149533,EPCI
244400537,CC de Nozay,1968_1975,1971.5,7,10953,10473,995,1258,-480,263,-743,-0.00638139110725411,0.00349647054418298,-0.00987786165143709,EPCI
244400537,CC de Nozay,1975_1982,1978.5,7,10473,10556,950,1056,83,106,-23,0.00112833635732357,0.00144100787802769,-0.000312671520704121,EPCI
244400537,CC de Nozay,1982_1990,1986,8,10556,10593,1004,1120,37,116,-79,0.000437469033339299,0.00137152453695564,-0.000934055503616342,EPCI
244400537,CC de Nozay,1990_1999,1994.5,9,10593,10922,1038,1182,329,144,185,0.00340419204710951,0.00148998071362848,0.00191421133348103,EPCI
244400537,CC de Nozay,1999_2010,2004.5,11,10922,14522,1193,2422,3600,1229,2371,0.0262369795449209,0.00895701329464105,0.0172799662502798,EPCI
244400552,CC du Pays d'Ancenis,2010_2015,2012.5,5,62838,65944,2458,4613,3106,2155,951,0.00969588565276824,0.00672718402502111,0.00296870162774713,EPCI
244400552,CC du Pays d'Ancenis,1968_1975,1971.5,7,41963,43719,3498,5476,1756,1978,-222,0.00587354093550441,0.00661609565514107,-0.000742554719636662,EPCI
244400552,CC du Pays d'Ancenis,1975_1982,1978.5,7,43719,47332,3466,5367,3613,1901,1712,0.011407981661681,0.0060023728588031,0.00540560880287791,EPCI
244400552,CC du Pays d'Ancenis,1982_1990,1986,8,47332,49813,3981,5696,2481,1715,766,0.0064066094161519,0.00442859135376885,0.00197801806238305,EPCI
244400552,CC du Pays d'Ancenis,1990_1999,1994.5,9,49813,51123,4150,5559,1310,1409,-99,0.00288844127013066,0.00310672805314053,-0.000218286783009874,EPCI
244400552,CC du Pays d'Ancenis,1999_2010,2004.5,11,51123,62838,5221,9453,11715,4232,7483,0.0189338778995107,0.00683979268209385,0.0120940852174169,EPCI
244400586,CC du Sud-Estuaire,2010_2015,2012.5,5,27424,29468,1574,1627,2044,53,1991,0.014481127429312,0.000375489116317776,0.0141056383129942,EPCI
244400586,CC du Sud-Estuaire,1968_1975,1971.5,7,18825,19029,1629,2132,204,503,-299,0.00154095142364707,0.00379950277497293,-0.00225855135132586,EPCI
244400586,CC du Sud-Estuaire,1975_1982,1978.5,7,19029,19658,1533,1954,629,421,208,0.00465655805878962,0.00311671056081149,0.00153984749797812,EPCI
244400586,CC du Sud-Estuaire,1982_1990,1986,8,19658,20225,1888,2161,567,273,294,0.00356070966842448,0.00171441576627845,0.00184629390214603,EPCI
244400586,CC du Sud-Estuaire,1990_1999,1994.5,9,20225,21708,2195,2121,1483,-74,1557,0.007893366678978,-0.000393869948917311,0.00828723662789531,EPCI
244400586,CC du Sud-Estuaire,1999_2010,2004.5,11,21708,27424,2952,3646,5716,694,5022,0.0214762455893125,0.00260750777448966,0.0188687378148228,EPCI
244400610,CA de la Presqu'île de Guérande Atlantique (Cap Atlantique),2010_2015,2012.5,5,72262,73463,4452,3099,1201,-1353,2554,0.00330213506391375,-0.00372005723686536,0.00702219230077911,EPCI
244400610,CA de la Presqu'île de Guérande Atlantique (Cap Atlantique),1968_1975,1971.5,7,44385,48376,4189,5277,3991,1088,2903,0.0123762812830768,0.00337393987371274,0.00900234140936404,EPCI
244400610,CA de la Presqu'île de Guérande Atlantique (Cap Atlantique),1975_1982,1978.5,7,48376,52434,4254,4921,4058,667,3391,0.0115738088888369,0.00190234857783494,0.00967146031100192,EPCI
244400610,CA de la Presqu'île de Guérande Atlantique (Cap Atlantique),1982_1990,1986,8,52434,58461,5139,5744,6027,605,5422,0.0136934872679273,0.00137457438146607,0.0123189128864612,EPCI
244400610,CA de la Presqu'île de Guérande Atlantique (Cap Atlantique),1990_1999,1994.5,9,58461,64058,6278,6033,5597,-245,5842,0.0102105598157185,-0.000446951430203865,0.0106575112459224,EPCI
244400610,CA de la Presqu'île de Guérande Atlantique (Cap Atlantique),1999_2010,2004.5,11,64058,72262,8562,7772,8204,-790,8994,0.0110156375136052,-0.00106074520182205,0.0120763827154273,EPCI
244400644,CA de la Région Nazairienne et de l'Estuaire (Carene),2010_2015,2012.5,5,117299,122932,5883,7119,5633,1236,4397,0.00942516503410973,0.00206808165846967,0.00735708337564006,EPCI
244400644,CA de la Région Nazairienne et de l'Estuaire (Carene),1968_1975,1971.5,7,99337,106515,7102,13424,7178,6322,856,0.0100166499038785,0.00882213160940652,0.001194518294472,EPCI
244400644,CA de la Région Nazairienne et de l'Estuaire (Carene),1975_1982,1978.5,7,106515,110471,7221,12262,3956,5041,-1085,0.00522319683169625,0.00665574702441375,-0.0014325501927175,EPCI
244400644,CA de la Région Nazairienne et de l'Estuaire (Carene),1982_1990,1986,8,110471,108399,8080,12161,-2072,4081,-6153,-0.00236397380299913,0.00465607002415032,-0.00702004382714945,EPCI
244400644,CA de la Région Nazairienne et de l'Estuaire (Carene),1990_1999,1994.5,9,108399,110275,9150,12039,1876,2889,-1013,0.00190830540387155,0.0029387496331476,-0.00103044422927605,EPCI
244400644,CA de la Région Nazairienne et de l'Estuaire (Carene),1999_2010,2004.5,11,110275,117299,11658,15750,7024,4092,2932,0.00562932950590556,0.00327950118709646,0.0023498283188091,EPCI
244500203,CA Montargoise et Rives du Loing (A.M.E.),2010_2015,2012.5,5,59859,61452,3173,4027,1593,854,739,0.0052667378843172,0.00282347404469987,0.00244326383961733,EPCI
244500203,CA Montargoise et Rives du Loing (A.M.E.),1968_1975,1971.5,7,48401,53450,3703,6132,5049,2429,2620,0.0142761101845401,0.00686802765661476,0.00740808252792535,EPCI
244500203,CA Montargoise et Rives du Loing (A.M.E.),1975_1982,1978.5,7,53450,55957,3908,5510,2507,1602,905,0.00656961460506955,0.00419805448636674,0.00237156011870281,EPCI
244500203,CA Montargoise et Rives du Loing (A.M.E.),1982_1990,1986,8,55957,57101,4532,5960,1144,1428,-284,0.00253296392185653,0.00316177664371602,-0.00062881272185949,EPCI
244500203,CA Montargoise et Rives du Loing (A.M.E.),1990_1999,1994.5,9,57101,58412,5306,6599,1311,1293,18,0.00252537434771449,0.00249070101570926,3.46733320052335e-05,EPCI
244500203,CA Montargoise et Rives du Loing (A.M.E.),1999_2010,2004.5,11,58412,59859,6860,8116,1447,1256,191,0.00222706245144866,0.00193309636421528,0.000293966087233375,EPCI
244500211,CC Giennoises,2010_2015,2012.5,5,25577,25500,1424,1618,-77,194,-271,-0.00060282982189952,0.00151881799283775,-0.00212164781473727,EPCI
244500211,CC Giennoises,1968_1975,1971.5,7,19140,21686,1797,2211,2546,414,2132,0.0180010293623989,0.00292711160881113,0.0150739177535878,EPCI
244500211,CC Giennoises,1975_1982,1978.5,7,21686,24363,1822,2537,2677,715,1962,0.0167674063689562,0.00447840700552996,0.0122889993634263,EPCI
244500211,CC Giennoises,1982_1990,1986,8,24363,25989,1982,2916,1626,934,692,0.00810867158567619,0.00465774862301449,0.0034509229626617,EPCI
244500211,CC Giennoises,1990_1999,1994.5,9,25989,25094,2422,2911,-895,489,-1384,-0.00388627302313371,0.0021233379981144,-0.00600961102124811,EPCI
244500211,CC Giennoises,1999_2010,2004.5,11,25094,25577,3067,3504,483,437,46,0.00173466064169725,0.00156945486629751,0.000165205775399738,EPCI
244500419,CC des Quatre Vallées,2010_2015,2012.5,5,16563,17324,829,869,761,40,721,0.00902478629358083,0.000474364588361673,0.00855042170521916,EPCI
244500419,CC des Quatre Vallées,1968_1975,1971.5,7,9286,9926,961,730,640,-231,871,0.00956685652032041,-0.00345303727530315,0.0130198937956236,EPCI
244500419,CC des Quatre Vallées,1975_1982,1978.5,7,9926,11257,992,681,1331,-311,1642,0.0181386251618116,-0.00423825125869528,0.0223768764205069,EPCI
244500419,CC des Quatre Vallées,1982_1990,1986,8,11257,13108,1167,944,1851,-223,2074,0.0192112783738949,-0.00231448680571505,0.02152576517961,EPCI
244500419,CC des Quatre Vallées,1990_1999,1994.5,9,13108,14514,1297,1254,1406,-43,1449,0.0113855464157642,-0.000348206611577425,0.0117337530273416,EPCI
244500419,CC des Quatre Vallées,1999_2010,2004.5,11,14514,16563,1765,1881,2049,116,1933,0.0120775876409158,0.000683748251023053,0.0113938393898928,EPCI
244500427,CC des Loges,2010_2015,2012.5,5,40398,41655,1565,2636,1257,1071,186,0.00614704212145334,0.00523745593641728,0.000909586185036055,EPCI
244500427,CC des Loges,1968_1975,1971.5,7,20476,22759,1956,2245,2283,289,1994,0.0152156256493892,0.00192611292714563,0.0132895127222435,EPCI
244500427,CC des Loges,1975_1982,1978.5,7,22759,28818,1961,2415,6059,454,5605,0.0342948927186468,0.00256971138707141,0.0317251813315754,EPCI
244500427,CC des Loges,1982_1990,1986,8,28818,31728,2387,3074,2910,687,2223,0.0120975125351501,0.00285601069128802,0.00924150184386211,EPCI
244500427,CC des Loges,1990_1999,1994.5,9,31728,34673,2640,3455,2945,815,2130,0.00991120657057687,0.00274282966214606,0.00716837690843081,EPCI
244500427,CC des Loges,1999_2010,2004.5,11,34673,40398,3257,5698,5725,2441,3284,0.0139895868115847,0.00596481771302676,0.00802476909855792,EPCI
244500468,Orléans Métropole,2010_2015,2012.5,5,273047,281899,9395,19620,8852,10225,-1373,0.00640138367963439,0.00739427791733638,-0.000992894237701989,EPCI
244500468,Orléans Métropole,1968_1975,1971.5,7,171160,210796,10741,26579,39636,15838,23798,0.0302031410199881,0.0120687593973805,0.0181343816226077,EPCI
244500468,Orléans Métropole,1975_1982,1978.5,7,210796,222870,11105,25353,12074,14248,-2174,0.00798856835590045,0.00942696057105099,-0.00143839221515054,EPCI
244500468,Orléans Métropole,1982_1990,1986,8,222870,245849,12670,30129,22979,17459,5520,0.0123416478298228,0.00937694544849109,0.00296470238133174,EPCI
244500468,Orléans Métropole,1990_1999,1994.5,9,245849,266446,14598,32793,20597,18195,2402,0.00897941635889699,0.00793224647522118,0.00104716988367581,EPCI
244500468,Orléans Métropole,1999_2010,2004.5,11,266446,273047,19457,41053,6601,21596,-14995,0.00222723525783275,0.00728667968916165,-0.0050594444313289,EPCI
244500484,CC de la Forêt,2010_2015,2012.5,5,15638,16304,535,932,666,397,269,0.00837621114038534,0.00499302676086033,0.00338318437952501,EPCI
244500484,CC de la Forêt,1968_1975,1971.5,7,7484,8825,703,838,1341,135,1206,0.0238252778050669,0.00239851789983895,0.021426759905228,EPCI
244500484,CC de la Forêt,1975_1982,1978.5,7,8825,10918,656,900,2093,244,1849,0.0308703621539566,0.00359883820619465,0.0272715239477619,EPCI
244500484,CC de la Forêt,1982_1990,1986,8,10918,12906,811,1319,1988,508,1480,0.0211300840300017,0.00539943797144913,0.0157306460585526,EPCI
244500484,CC de la Forêt,1990_1999,1994.5,9,12906,13853,977,1319,947,342,605,0.00789875364885861,0.00285255939589192,0.0050461942529667,EPCI
244500484,CC de la Forêt,1999_2010,2004.5,11,13853,15638,1205,2185,1785,980,805,0.0110792924942431,0.00608274882036877,0.00499654367387434,EPCI
244500542,CC de la Plaine du Nord Loiret,2010_2015,2012.5,5,6735,6872,324,375,137,51,86,0.00403559614016902,0.00150230221276365,0.00253329392740537,EPCI
244500542,CC de la Plaine du Nord Loiret,1968_1975,1971.5,7,5818,5632,448,497,-186,49,-235,-0.00463094982000867,0.00121998140419583,-0.0058509312242045,EPCI
244500542,CC de la Plaine du Nord Loiret,1975_1982,1978.5,7,5632,5694,491,395,62,-96,158,0.00156527662575745,-0.00242365413020508,0.00398893075596253,EPCI
244500542,CC de la Plaine du Nord Loiret,1982_1990,1986,8,5694,5720,546,522,26,-24,50,0.000569639249832443,-0.000525820845999178,0.00109546009583162,EPCI
244500542,CC de la Plaine du Nord Loiret,1990_1999,1994.5,9,5720,6071,587,646,351,59,292,0.00663911192495759,0.00111597607855412,0.00552313584640346,EPCI
244500542,CC de la Plaine du Nord Loiret,1999_2010,2004.5,11,6071,6735,711,863,664,152,512,0.00948051933746163,0.00217023936640688,0.00731027997105476,EPCI
244600433,CC de la Vallée du Lot et du Vignoble,2010_2015,2012.5,5,14725,14617,1006,555,-108,-451,343,-0.00147121562574759,-0.0061436874741867,0.00467247184843911,EPCI
244600433,CC de la Vallée du Lot et du Vignoble,1968_1975,1971.5,7,13530,13608,1371,1104,78,-267,345,0.000821539122962012,-0.00281219161321612,0.00363373073617813,EPCI
244600433,CC de la Vallée du Lot et du Vignoble,1975_1982,1978.5,7,13608,13782,1350,907,174,-443,617,0.00181672508353326,-0.00462534029888064,0.0064420653824139,EPCI
244600433,CC de la Vallée du Lot et du Vignoble,1982_1990,1986,8,13782,13900,1546,1045,118,-501,619,0.0010662489398594,-0.00452703999042001,0.00559328893027942,EPCI
244600433,CC de la Vallée du Lot et du Vignoble,1990_1999,1994.5,9,13900,13966,1862,1034,66,-828,894,0.000526467900848537,-0.0066047791197362,0.00713124702058473,EPCI
244600433,CC de la Vallée du Lot et du Vignoble,1999_2010,2004.5,11,13966,14725,2229,1257,759,-972,1731,0.0048225846011869,-0.0061759581453935,0.0109985427465804,EPCI
244600482,CC Quercy - Bouriane,2010_2015,2012.5,5,10552,10521,733,378,-31,-355,324,-0.000588258026134825,-0.0067365032025117,0.00614824517637688,EPCI
244600482,CC Quercy - Bouriane,1968_1975,1971.5,7,9734,9241,960,715,-493,-245,-248,-0.00739747534758573,-0.00367623014230934,-0.00372124520527639,EPCI
244600482,CC Quercy - Bouriane,1975_1982,1978.5,7,9241,9488,989,569,247,-420,667,0.00377535696640519,-0.0064196353274906,0.0101949922938958,EPCI
244600482,CC Quercy - Bouriane,1982_1990,1986,8,9488,9524,1091,724,36,-367,403,0.000473497860894456,-0.00482704763745182,0.00530054549834627,EPCI
244600482,CC Quercy - Bouriane,1990_1999,1994.5,9,9524,10061,1155,784,537,-371,908,0.00611323609747916,-0.00422348341185245,0.0103367195093316,EPCI
244600482,CC Quercy - Bouriane,1999_2010,2004.5,11,10061,10552,1485,924,491,-561,1052,0.00434110926129039,-0.00496000467532364,0.00930111393661403,EPCI
244600532,CC du Pays de Lalbenque-Limogne,2010_2015,2012.5,5,7888,8237,429,353,349,-76,425,0.0086963116478882,-0.00189375267976935,0.0105900643276576,EPCI
244600532,CC du Pays de Lalbenque-Limogne,1968_1975,1971.5,7,5653,5462,590,361,-191,-229,38,-0.0048981582266292,-0.00587266091046119,0.000974502683831988,EPCI
244600532,CC du Pays de Lalbenque-Limogne,1975_1982,1978.5,7,5462,5693,603,336,231,-267,498,0.00593501811677011,-0.00685995600509792,0.012794974121868,EPCI
244600532,CC du Pays de Lalbenque-Limogne,1982_1990,1986,8,5693,5831,593,417,138,-176,314,0.00299838146430398,-0.00382402273708334,0.00682240420138731,EPCI
244600532,CC du Pays de Lalbenque-Limogne,1990_1999,1994.5,9,5831,6419,702,457,588,-245,833,0.0107320497156751,-0.00447168738153129,0.0152037370972064,EPCI
244600532,CC du Pays de Lalbenque-Limogne,1999_2010,2004.5,11,6419,7888,934,744,1469,-190,1659,0.0189111635919117,-0.00244596397717034,0.021357127569082,EPCI
244600573,CC du Causse de Labastide-Murat,2010_2015,2012.5,5,3847,3831,243,109,-16,-134,118,-0.000833204302691959,-0.00697808603504516,0.0061448817323532,EPCI
244600573,CC du Causse de Labastide-Murat,1968_1975,1971.5,7,3687,3582,479,233,-105,-246,141,-0.00411889621252193,-0.00964998541219423,0.0055310891996723,EPCI
244600573,CC du Causse de Labastide-Murat,1975_1982,1978.5,7,3582,3654,406,217,72,-189,261,0.00284706726514417,-0.00747355157100343,0.0103206188361476,EPCI
244600573,CC du Causse de Labastide-Murat,1982_1990,1986,8,3654,3374,434,250,-280,-184,-96,-0.00991594382354588,-0.00651619165547301,-0.00339975216807287,EPCI
244600573,CC du Causse de Labastide-Murat,1990_1999,1994.5,9,3374,3469,427,233,95,-194,289,0.00309002920190826,-0.00631016489652845,0.00940019409843671,EPCI
244600573,CC du Causse de Labastide-Murat,1999_2010,2004.5,11,3469,3847,518,318,378,-200,578,0.00944681995922125,-0.0049983174387414,0.0144451373979627,EPCI
244700449,CC du Pays de Duras,2010_2015,2012.5,5,5563,5664,324,223,101,-101,202,0.00360504766859426,-0.00360504766859426,0.00721009533718853,EPCI
244700449,CC du Pays de Duras,1968_1975,1971.5,7,6187,5566,545,518,-621,-27,-594,-0.014996930844246,-0.000652040471488958,-0.0143448903727571,EPCI
244700449,CC du Pays de Duras,1975_1982,1978.5,7,5566,5308,473,362,-258,-111,-147,-0.00675728711105994,-0.00290720491987463,-0.00385008219118531,EPCI
244700449,CC du Pays de Duras,1982_1990,1986,8,5308,5102,529,404,-206,-125,-81,-0.0049355918343581,-0.00299489795774157,-0.00194069387661653,EPCI
244700449,CC du Pays de Duras,1990_1999,1994.5,9,5102,5107,527,379,5,-148,153,0.000108842361332018,-0.00322173389542773,0.00333057625675974,EPCI
244700449,CC du Pays de Duras,1999_2010,2004.5,11,5107,5563,599,471,456,-128,584,0.00780533892806323,-0.00219097233068442,0.00999631125874765,EPCI
244700464,CC du Pays de Lauzun,2010_2015,2012.5,5,10637,10530,651,445,-107,-206,99,-0.00201998969395056,-0.0038889521210637,0.00186896242711314,EPCI
244700464,CC du Pays de Lauzun,1968_1975,1971.5,7,11097,11496,921,1108,399,187,212,0.00505908951766454,0.00237105197945681,0.00268803753820772,EPCI
244700464,CC du Pays de Lauzun,1975_1982,1978.5,7,11496,11143,931,826,-353,-105,-248,-0.00444546819732539,-0.00132230640430359,-0.0031231617930218,EPCI
244700464,CC du Pays de Lauzun,1982_1990,1986,8,11143,10688,1044,804,-455,-240,-215,-0.00519768022908529,-0.0027416335274296,-0.00245604670165569,EPCI
244700464,CC du Pays de Lauzun,1990_1999,1994.5,9,10688,10258,1206,745,-430,-461,31,-0.00455224341219285,-0.00488042840237419,0.000328184990181345,EPCI
244700464,CC du Pays de Lauzun,1999_2010,2004.5,11,10258,10637,1414,877,379,-537,916,0.00330368155761418,-0.00468094194311033,0.00798462350072451,EPCI
244701355,CC des Coteaux et Landes de Gascogne,2010_2015,2012.5,5,12448,12530,805,508,82,-297,379,0.00131402286689153,-0.00475932672520468,0.00607334959209621,EPCI
244701355,CC des Coteaux et Landes de Gascogne,1968_1975,1971.5,7,12763,11839,1225,999,-924,-226,-698,-0.0106784608673031,-0.00261183133767369,-0.00806662952962937,EPCI
244701355,CC des Coteaux et Landes de Gascogne,1975_1982,1978.5,7,11839,11545,1142,802,-294,-340,46,-0.00358594417917346,-0.00414701027523462,0.000561066096061154,EPCI
244701355,CC des Coteaux et Landes de Gascogne,1982_1990,1986,8,11545,11702,1277,830,157,-447,604,0.00168984174606313,-0.00481120548082941,0.00650104722689253,EPCI
244701355,CC des Coteaux et Landes de Gascogne,1990_1999,1994.5,9,11702,11405,1352,906,-297,-446,149,-0.00285235889774338,-0.00428334029762137,0.00143098139987799,EPCI
244701355,CC des Coteaux et Landes de Gascogne,1999_2010,2004.5,11,11405,12448,1646,1118,1043,-528,1571,0.00798701022217174,-0.00404328034257592,0.0120302905647477,EPCI
244701405,CC Lot et Tolzac,2010_2015,2012.5,5,7243,7285,524,342,42,-182,224,0.0011570597645405,-0.00501392564634218,0.00617098541088268,EPCI
244701405,CC Lot et Tolzac,1968_1975,1971.5,7,7801,7111,759,611,-690,-148,-542,-0.0131427342521555,-0.00281902125988263,-0.0103237129922729,EPCI
244701405,CC Lot et Tolzac,1975_1982,1978.5,7,7111,6992,816,514,-119,-302,183,-0.00240798792707853,-0.00611102818468668,0.00370304025760815,EPCI
244701405,CC Lot et Tolzac,1982_1990,1986,8,6992,7259,846,673,267,-173,440,0.004695419088381,-0.00304235019584237,0.00773776928422338,EPCI
244701405,CC Lot et Tolzac,1990_1999,1994.5,9,7259,6901,869,565,-358,-304,-54,-0.00560376772955029,-0.00475850667537231,-0.000845261054177977,EPCI
244701405,CC Lot et Tolzac,1999_2010,2004.5,11,6901,7243,1069,793,342,-276,618,0.00440687790460803,-0.00355642778266613,0.00796330568727416,EPCI
244800405,CC Coeur de Lozère,2010_2015,2012.5,5,15208,14902,658,839,-306,181,-487,-0.00405698273042798,0.00239971854316165,-0.00645670127358963,EPCI
244800405,CC Coeur de Lozère,1968_1975,1971.5,7,11529,12480,788,1613,951,825,126,0.0113874580017292,0.00987870962295124,0.00150874837877801,EPCI
244800405,CC Coeur de Lozère,1975_1982,1978.5,7,12480,13277,799,1532,797,733,64,0.00888291412729703,0.00816960609198083,0.000713308035316197,EPCI
244800405,CC Coeur de Lozère,1982_1990,1986,8,13277,13922,883,1555,645,672,-27,0.0059472535851941,0.00619620838643478,-0.000248954801240683,EPCI
244800405,CC Coeur de Lozère,1990_1999,1994.5,9,13922,14562,1024,1526,640,502,138,0.00500638731194458,0.00392688504780653,0.00107950226413805,EPCI
244800405,CC Coeur de Lozère,1999_2010,2004.5,11,14562,15208,1322,1981,646,659,-13,0.00395381480320056,0.00403338073577271,-7.95659325721473e-05,EPCI
244800470,CC du Gévaudan,2010_2015,2012.5,5,9870,9878,598,468,8,-130,138,0.000162054864079719,-0.00263339154129544,0.00279544640537516,EPCI
244800470,CC du Gévaudan,1968_1975,1971.5,7,7880,8763,776,1026,883,250,633,0.0152886085325989,0.00432859811228736,0.0109600104203116,EPCI
244800470,CC du Gévaudan,1975_1982,1978.5,7,8763,9626,825,981,863,156,707,0.0135089261419772,0.00244193798163203,0.0110669881603452,EPCI
244800470,CC du Gévaudan,1982_1990,1986,8,9626,9767,850,833,141,-17,158,0.00181935121283128,-0.000219354401547033,0.00203870561437831,EPCI
244800470,CC du Gévaudan,1990_1999,1994.5,9,9767,9757,997,839,-10,-158,148,-0.000113813560470466,-0.00179825425543336,0.0016844406949629,EPCI
244800470,CC du Gévaudan,1999_2010,2004.5,11,9757,9870,1277,1066,113,-211,324,0.00104735512276322,-0.00195568080445167,0.00300303592721489,EPCI
244900015,CU Angers Loire Métropole,2010_2015,2012.5,5,281585,292691,10037,17198,11106,7161,3945,0.00776662279665907,0.00500781432080638,0.0027588084758527,EPCI
244900015,CU Angers Loire Métropole,1968_1975,1971.5,7,191586,219017,12699,30092,27431,17393,10038,0.019299961857123,0.0122374042718436,0.00706255758527946,EPCI
244900015,CU Angers Loire Métropole,1975_1982,1978.5,7,219017,237526,13059,29248,18509,16189,2320,0.0116570974854151,0.0101959452802088,0.00146115220520628,EPCI
244900015,CU Angers Loire Métropole,1982_1990,1986,8,237526,256811,14539,31051,19285,16512,2773,0.0098056780053446,0.00839571455661136,0.00140996344873324,EPCI
244900015,CU Angers Loire Métropole,1990_1999,1994.5,9,256811,276888,16669,32162,20077,15493,4584,0.00839870471316795,0.00648110435429153,0.00191760035887642,EPCI
244900015,CU Angers Loire Métropole,1999_2010,2004.5,11,276888,281585,21707,38400,4697,16693,-11996,0.00153037560652458,0.00543890994245579,-0.00390853433593121,EPCI
244900809,CC Anjou Bleu Communauté,2010_2015,2012.5,5,34129,34709,1759,2212,580,453,127,0.0033759971980003,0.00263677022533472,0.000739226972665584,EPCI
244900809,CC Anjou Bleu Communauté,1968_1975,1971.5,7,34472,33691,2552,4265,-781,1713,-2494,-0.0032684556368362,0.00716884059654342,-0.0104372962333796,EPCI
244900809,CC Anjou Bleu Communauté,1975_1982,1978.5,7,33691,33295,2556,3663,-396,1107,-1503,-0.00168764629412466,0.00471773850403029,-0.00640538479815495,EPCI
244900809,CC Anjou Bleu Communauté,1982_1990,1986,8,33295,31947,2724,3577,-1348,853,-2201,-0.00515279803733104,0.00326063555329627,-0.00841343359062732,EPCI
244900809,CC Anjou Bleu Communauté,1990_1999,1994.5,9,31947,31337,2951,3437,-610,486,-1096,-0.0021397931126691,0.00170481877501177,-0.00384461188768087,EPCI
244900809,CC Anjou Bleu Communauté,1999_2010,2004.5,11,31337,34129,3807,4664,2792,857,1935,0.00778908327754557,0.00239084683698301,0.00539823644056257,EPCI
244900882,CC Baugeois Vallée,2010_2015,2012.5,5,34616,35336,1704,2261,720,557,163,0.00412574181015812,0.00319171970591399,0.00093402210424413,EPCI
244900882,CC Baugeois Vallée,1968_1975,1971.5,7,28234,27414,2514,3075,-820,561,-1381,-0.00420159046693713,0.0028745027462826,-0.00707609321321973,EPCI
244900882,CC Baugeois Vallée,1975_1982,1978.5,7,27414,28646,2405,2628,1232,223,1009,0.00629975846623987,0.00114029718991192,0.00515946127632795,EPCI
244900882,CC Baugeois Vallée,1982_1990,1986,8,28646,29462,2654,3064,816,410,406,0.0035171055560419,0.00176717313477595,0.00174993242126595,EPCI
244900882,CC Baugeois Vallée,1990_1999,1994.5,9,29462,30397,2945,3179,935,234,701,0.00347743473329731,0.000870288478707563,0.00260714625458975,EPCI
244900882,CC Baugeois Vallée,1999_2010,2004.5,11,30397,34616,3830,4774,4219,944,3275,0.0118857244271873,0.00265942731909571,0.00922629710809156,EPCI
245100615,CC de la Grande Vallée de la Marne,2010_2015,2012.5,5,15226,15095,819,739,-131,-80,-51,-0.00172669349158294,-0.00105446930783691,-0.000672224183746031,EPCI
245100615,CC de la Grande Vallée de la Marne,1968_1975,1971.5,7,14002,14232,1262,1608,230,346,-116,0.00233024993744446,0.00350550642763384,-0.00117525649018938,EPCI
245100615,CC de la Grande Vallée de la Marne,1975_1982,1978.5,7,14232,14684,1189,1275,452,86,366,0.00447649186989896,0.000851721904449802,0.00362476996544916,EPCI
245100615,CC de la Grande Vallée de la Marne,1982_1990,1986,8,14684,15091,1285,1431,407,146,261,0.00342335559304563,0.00122803419308271,0.00219532139996292,EPCI
245100615,CC de la Grande Vallée de la Marne,1990_1999,1994.5,9,15091,15485,1630,1537,394,-93,487,0.00286780138503051,-0.000676917585806694,0.0035447189708372,EPCI
245100615,CC de la Grande Vallée de la Marne,1999_2010,2004.5,11,15485,15226,1867,1846,-259,-21,-238,-0.00153221773044343,-0.000124233870035954,-0.00140798386040748,EPCI
245100888,CC de la Brie Champenoise,2010_2015,2012.5,5,7404,7474,469,446,70,-23,93,0.00188375931993501,-0.000618949490835788,0.0025027088107708,EPCI
245100888,CC de la Brie Champenoise,1968_1975,1971.5,7,6214,6162,564,633,-52,69,-121,-0.00119976696006341,0.00159199846623798,-0.00279176542630139,EPCI
245100888,CC de la Brie Champenoise,1975_1982,1978.5,7,6162,6281,605,555,119,-50,169,0.00273628012765315,-0.00114969753262737,0.00388597766028052,EPCI
245100888,CC de la Brie Champenoise,1982_1990,1986,8,6281,6472,702,609,191,-93,284,0.00375151642314187,-0.00182665459346698,0.00557817101660885,EPCI
245100888,CC de la Brie Champenoise,1990_1999,1994.5,9,6472,6707,809,766,235,-43,278,0.00397081592186854,-0.000726574828256797,0.00469739075012534,EPCI
245100888,CC de la Brie Champenoise,1999_2010,2004.5,11,6707,7404,965,970,697,5,692,0.00902857184543837,6.47673733532164e-05,0.00896380447208516,EPCI
245100979,CC du Sud Marnais,2010_2015,2012.5,5,6128,6149,292,326,21,34,-13,0.000684441029547234,0.00110814261926695,-0.000423701589719716,EPCI
245100979,CC du Sud Marnais,1968_1975,1971.5,7,5543,5787,463,588,244,125,119,0.00617299663205984,0.00316239581560442,0.00301060081645541,EPCI
245100979,CC du Sud Marnais,1975_1982,1978.5,7,5787,6103,425,574,316,149,167,0.00762412115263067,0.0035949178852594,0.00402920326737127,EPCI
245100979,CC du Sud Marnais,1982_1990,1986,8,6103,5977,469,593,-126,124,-250,-0.00260431334164168,0.0025629750346315,-0.00516728837627318,EPCI
245100979,CC du Sud Marnais,1990_1999,1994.5,9,5977,5866,518,576,-111,58,-169,-0.00208069892606244,0.00108721205145605,-0.00316791097751849,EPCI
245100979,CC du Sud Marnais,1999_2010,2004.5,11,5866,6128,634,789,262,155,107,0.00398021481583966,0.00235470723837842,0.00162550757746123,EPCI
245200597,CC des Trois Forêts,2010_2015,2012.5,5,8090,7824,557,428,-266,-129,-137,-0.00666425437040585,-0.00323191283376825,-0.0034323415366376,EPCI
245200597,CC des Trois Forêts,1968_1975,1971.5,7,8773,8220,813,837,-553,24,-577,-0.00925810793886816,0.000401798536225743,-0.00965990647509391,EPCI
245200597,CC des Trois Forêts,1975_1982,1978.5,7,8220,8250,812,727,30,-85,115,0.000520562771296307,-0.0014749278520062,0.00199549062330251,EPCI
245200597,CC des Trois Forêts,1982_1990,1986,8,8250,8275,915,814,25,-101,126,0.000378286646921522,-0.00152827805356295,0.00190656470048447,EPCI
245200597,CC des Trois Forêts,1990_1999,1994.5,9,8275,8186,1056,728,-89,-328,239,-0.00120078328131956,-0.00442535860980692,0.00322457532848736,EPCI
245200597,CC des Trois Forêts,1999_2010,2004.5,11,8186,8090,1235,996,-96,-239,143,-0.00107184761507639,-0.00266845395836727,0.00159660634329088,EPCI
245300223,CC du Pays de Meslay-Grez,2010_2015,2012.5,5,13687,14018,534,911,331,377,-46,0.00479058651300157,0.00545634778066946,-0.000665761267667892,EPCI
245300223,CC du Pays de Meslay-Grez,1968_1975,1971.5,7,12225,11194,918,1112,-1031,194,-1225,-0.0125075669639652,0.00235350920563457,-0.0148610761695997,EPCI
245300223,CC du Pays de Meslay-Grez,1975_1982,1978.5,7,11194,11057,823,945,-137,122,-259,-0.00175762626392517,0.00156518543210855,-0.00332281169603372,EPCI
245300223,CC du Pays de Meslay-Grez,1982_1990,1986,8,11057,11233,918,1094,176,176,0,0.00197597004831995,0.00197597004831995,0,EPCI
245300223,CC du Pays de Meslay-Grez,1990_1999,1994.5,9,11233,12087,1013,1386,854,373,481,0.00817485762254333,0.00357051743935441,0.00460434018318893,EPCI
245300223,CC du Pays de Meslay-Grez,1999_2010,2004.5,11,12087,13687,1112,2203,1600,1091,509,0.0113655556172243,0.00774988823649482,0.00361566738072948,EPCI
245300306,CC du Pays de Loiron,2010_2015,2012.5,5,16483,16928,521,1201,445,680,-235,0.00534212029444237,0.0081632400004962,-0.00282111970605383,EPCI
245300306,CC du Pays de Loiron,1968_1975,1971.5,7,11697,12378,825,1378,681,553,128,0.0081168076303737,0.00659118152657365,0.00152562610380005,EPCI
245300306,CC du Pays de Loiron,1975_1982,1978.5,7,12378,13507,784,1393,1129,609,520,0.0125476936732598,0.00676841935076636,0.00577927432249345,EPCI
245300306,CC du Pays de Loiron,1982_1990,1986,8,13507,13964,880,1536,457,656,-199,0.00416797691358384,0.00598291653240919,-0.00181493961882535,EPCI
245300306,CC du Pays de Loiron,1990_1999,1994.5,9,13964,14368,940,1624,404,684,-280,0.00317401793001615,0.00537383233695803,-0.00219981440694189,EPCI
245300306,CC du Pays de Loiron,1999_2010,2004.5,11,14368,16483,1217,2635,2115,1418,697,0.012562437756485,0.00842247599938334,0.00413996175710168,EPCI
245300330,CA de Laval,2010_2015,2012.5,5,95608,95834,3335,6001,226,2666,-2440,0.000472317407208545,0.00557167348503531,-0.00509935607782676,EPCI
245300330,CA de Laval,1968_1975,1971.5,7,61347,73601,4129,11039,12254,6910,5344,0.0263574202625412,0.0148628834677786,0.0114945367947625,EPCI
245300330,CA de Laval,1975_1982,1978.5,7,73601,79208,3916,10159,5607,6243,-636,0.0105435803676428,0.0117395349090769,-0.00119595454143407,EPCI
245300330,CA de Laval,1982_1990,1986,8,79208,84115,4355,10117,4907,5762,-855,0.00754174758974613,0.00885582832934934,-0.00131408073960321,EPCI
245300330,CA de Laval,1990_1999,1994.5,9,84115,88311,5097,10638,4196,5541,-1345,0.00542351708422073,0.00716198955282819,-0.00173847246860745,EPCI
245300330,CA de Laval,1999_2010,2004.5,11,88311,95608,6685,13993,7297,7308,-11,0.00724354697461305,0.00725446639584379,-1.09194212307437e-05,EPCI
245300355,CC de l'Ernée,2010_2015,2012.5,5,20697,21058,1070,1299,361,229,132,0.00346434164864995,0.0021976017660411,0.00126673988260885,EPCI
245300355,CC de l'Ernée,1968_1975,1971.5,7,19647,19361,1551,2085,-286,534,-820,-0.00209265326977226,0.00390726169950485,-0.00599991496927711,EPCI
245300355,CC de l'Ernée,1975_1982,1978.5,7,19361,19655,1532,1974,294,442,-148,0.00215532301468979,0.0032403155526969,-0.00108499253800711,EPCI
245300355,CC de l'Ernée,1982_1990,1986,8,19655,19662,1697,2093,7,396,-389,4.45109994486881e-05,0.00251805082595435,-0.00247353982650567,EPCI
245300355,CC de l'Ernée,1990_1999,1994.5,9,19662,19271,1846,2023,-391,177,-568,-0.00222934062397728,0.0010091900011355,-0.00323853062511278,EPCI
245300355,CC de l'Ernée,1999_2010,2004.5,11,19271,20697,2283,2975,1426,692,734,0.00651086659330669,0.00315955096954294,0.00335131562376375,EPCI
245300389,CC du Bocage Mayennais,2010_2015,2012.5,5,19709,19317,1317,918,-392,-399,7,-0.0040099081584194,-0.00408151366124831,7.16055028289172e-05,EPCI
245300389,CC du Bocage Mayennais,1968_1975,1971.5,7,23682,22431,1969,2232,-1251,263,-1514,-0.00772307053517896,0.00162363513249566,-0.00934670566767461,EPCI
245300389,CC du Bocage Mayennais,1975_1982,1978.5,7,22431,21878,1955,2002,-553,47,-600,-0.00355970132859984,0.000302542427566352,-0.00386224375616619,EPCI
245300389,CC du Bocage Mayennais,1982_1990,1986,8,21878,21118,2040,2054,-760,14,-774,-0.00440972452574495,8.12317675795123e-05,-0.00449095629332446,EPCI
245300389,CC du Bocage Mayennais,1990_1999,1994.5,9,21118,20243,2214,1888,-875,-326,-549,-0.00469081942478766,-0.00174766529426375,-0.00294315413052392,EPCI
245300389,CC du Bocage Mayennais,1999_2010,2004.5,11,20243,19709,2788,2244,-534,-544,10,-0.00242738281819765,-0.00247283942528001,4.54566070823533e-05,EPCI
245300447,CC du Pays de Château-Gontier,2010_2015,2012.5,5,29567,30208,1273,1853,641,580,61,0.00429879651514553,0.00388970667517068,0.000409089839974848,EPCI
245300447,CC du Pays de Château-Gontier,1968_1975,1971.5,7,21967,22785,1653,3014,818,1361,-543,0.00523667764172808,0.00871285852126152,-0.00347618087953343,EPCI
245300447,CC du Pays de Château-Gontier,1975_1982,1978.5,7,22785,23813,1747,2783,1028,1036,-8,0.00632408818137797,0.00637330287539648,-4.92146940185055e-05,EPCI
245300447,CC du Pays de Château-Gontier,1982_1990,1986,8,23813,25195,1902,2861,1382,959,423,0.00707666106972904,0.00491064975822732,0.00216601131150173,EPCI
245300447,CC du Pays de Château-Gontier,1990_1999,1994.5,9,25195,26528,2013,3183,1333,1170,163,0.00574479583725029,0.00504231892691886,0.000702476910331431,EPCI
245300447,CC du Pays de Château-Gontier,1999_2010,2004.5,11,26528,29567,2559,4205,3039,1646,1393,0.00990859511498199,0.00536674812743019,0.0045418469875518,EPCI
245400171,CC Moselle et Madon,2010_2015,2012.5,5,29231,28890,1110,1476,-341,366,-707,-0.00234410338590563,0.00251595847284885,-0.00486006185875448,EPCI
245400171,CC Moselle et Madon,1968_1975,1971.5,7,22104,23554,1548,2442,1450,894,556,0.00911804263573801,0.00562174490782744,0.00349629772791057,EPCI
245400171,CC Moselle et Madon,1975_1982,1978.5,7,23554,26027,1500,2337,2473,837,1636,0.0143648835879127,0.00486187123456648,0.00950301235334618,EPCI
245400171,CC Moselle et Madon,1982_1990,1986,8,26027,27058,1593,2664,1031,1071,-40,0.00486784080882718,0.00505669981207945,-0.000188859003252267,EPCI
245400171,CC Moselle et Madon,1990_1999,1994.5,9,27058,27973,1959,2792,915,833,82,0.00370206344411494,0.00337029382398661,0.000331769620128334,EPCI
245400171,CC Moselle et Madon,1999_2010,2004.5,11,27973,29231,2357,3476,1258,1119,139,0.0040071007476874,0.00356434478272035,0.000442755964967049,EPCI
245400189,CC des Pays du Sel et du Vermois,2010_2015,2012.5,5,29857,29458,1507,1684,-399,177,-576,-0.00268714277940318,0.00119204078184051,-0.0038791835612437,EPCI
245400189,CC des Pays du Sel et du Vermois,1968_1975,1971.5,7,27062,28077,2187,2885,1015,698,317,0.00527388767122106,0.00362677201429783,0.00164711565692323,EPCI
245400189,CC des Pays du Sel et du Vermois,1975_1982,1978.5,7,28077,28537,2262,2529,460,267,193,0.00232423328843212,0.00134906584350299,0.000975167444929129,EPCI
245400189,CC des Pays du Sel et du Vermois,1982_1990,1986,8,28537,28535,2485,3023,-2,538,-540,-8.76082509804199e-06,0.0023566619513733,-0.00236542277647134,EPCI
245400189,CC des Pays du Sel et du Vermois,1990_1999,1994.5,9,28535,28392,2775,2841,-143,66,-209,-0.000558065184164236,0.00025756854653734,-0.000815633730701576,EPCI
245400189,CC des Pays du Sel et du Vermois,1999_2010,2004.5,11,28392,29857,3204,3735,1465,531,934,0.00458428518273801,0.0016616078034361,0.00292267737930191,EPCI
245400262,CA de Longwy,2010_2015,2012.5,5,59175,60544,2609,3214,1369,605,764,0.0045847214281014,0.00202611867348528,0.00255860275461612,EPCI
245400262,CA de Longwy,1968_1975,1971.5,7,71897,71938,3641,8804,41,5163,-5122,8.14458446487532e-05,0.0102562169736954,-0.0101747711290467,EPCI
245400262,CA de Longwy,1975_1982,1978.5,7,71938,64514,3683,7370,-7424,3687,-11111,-0.0154399037377324,0.00766795865854248,-0.0231078623962749,EPCI
245400262,CA de Longwy,1982_1990,1986,8,64514,57148,4199,6079,-7366,1880,-9246,-0.0150404775006241,0.00383873169986062,-0.0188792092004847,EPCI
245400262,CA de Longwy,1990_1999,1994.5,9,57148,56212,4480,5501,-936,1021,-1957,-0.00183322167761035,0.00199970014192326,-0.00383292181953361,EPCI
245400262,CA de Longwy,1999_2010,2004.5,11,56212,59175,5497,7312,2963,1815,1148,0.0046808208084288,0.00286725945571997,0.00181356135270883,EPCI
245400510,CC du Pays de Colombey et du Sud Toulois,2010_2015,2012.5,5,11036,11412,390,779,376,389,-13,0.00672305434430909,0.00695550037217084,-0.00023244602786175,EPCI
245400510,CC du Pays de Colombey et du Sud Toulois,1968_1975,1971.5,7,9161,8379,782,826,-782,44,-826,-0.01266578619688,0.000712652931793758,-0.0133784391286737,EPCI
245400510,CC du Pays de Colombey et du Sud Toulois,1975_1982,1978.5,7,8379,8748,705,758,369,53,316,0.00617563784385955,0.000887015733670884,0.00528862211018867,EPCI
245400510,CC du Pays de Colombey et du Sud Toulois,1982_1990,1986,8,8748,9112,712,941,364,229,135,0.00510889654908664,0.00321411348829901,0.00189478306078763,EPCI
245400510,CC du Pays de Colombey et du Sud Toulois,1990_1999,1994.5,9,9112,9696,763,929,584,166,418,0.00692623206997545,0.00196875774591768,0.00495747432405777,EPCI
245400510,CC du Pays de Colombey et du Sud Toulois,1999_2010,2004.5,11,9696,11036,904,1659,1340,755,585,0.011837628198309,0.00666970842516665,0.00516791977314237,EPCI
245400601,CC du Bassin de Pompey,2010_2015,2012.5,5,40774,40571,1993,2323,-203,330,-533,-0.000997721485636482,0.00162191177468,-0.00261963326031648,EPCI
245400601,CC du Bassin de Pompey,1968_1975,1971.5,7,35211,38567,2367,4416,3356,2049,1307,0.0130904327930581,0.00799234111828846,0.00509809167476965,EPCI
245400601,CC du Bassin de Pompey,1975_1982,1978.5,7,38567,42720,2755,4001,4153,1246,2907,0.0147172775882429,0.00441553765349162,0.0103017399347513,EPCI
245400601,CC du Bassin de Pompey,1982_1990,1986,8,42720,41785,3003,4496,-935,1493,-2428,-0.00276239893480823,0.00441097498360287,-0.0071733739184111,EPCI
245400601,CC du Bassin de Pompey,1990_1999,1994.5,9,41785,41385,3395,4350,-400,955,-1355,-0.00106819874866204,0.00255032451243062,-0.00361852326109267,EPCI
245400601,CC du Bassin de Pompey,1999_2010,2004.5,11,41385,40774,4363,4926,-611,563,-1174,-0.0013512564989957,0.00124510214228245,-0.00259635864127816,EPCI
245400676,Métropole du Grand Nancy,2010_2015,2012.5,5,256956,256558,9966,14762,-398,4796,-5194,-0.000309972769515832,0.00373524975527118,-0.00404522252478701,EPCI
245400676,Métropole du Grand Nancy,1968_1975,1971.5,7,231933,252292,15109,34626,20359,19517,842,0.0120923295425568,0.0115922194450651,0.000500110097491666,EPCI
245400676,Métropole du Grand Nancy,1975_1982,1978.5,7,252292,250951,15050,30674,-1341,15624,-16965,-0.000761059662781283,0.0088671112388477,-0.00962817090162898,EPCI
245400676,Métropole du Grand Nancy,1982_1990,1986,8,250951,256371,16319,32593,5420,16274,-10854,0.00267455941639461,0.00803058670524093,-0.00535602728884632,EPCI
245400676,Métropole du Grand Nancy,1990_1999,1994.5,9,256371,258268,17136,32369,1897,15233,-13336,0.000819467952597019,0.00658036653764386,-0.00576089858504684,EPCI
245400676,Métropole du Grand Nancy,1999_2010,2004.5,11,258268,256956,21075,33532,-1312,12457,-13769,-0.000462887512861498,0.00439496169795403,-0.00485784921081553,EPCI
245400759,CC du Pays du Sanon,2010_2015,2012.5,5,6007,6007,255,358,0,103,-103,0,,,EPCI
245400759,CC du Pays du Sanon,1968_1975,1971.5,7,5422,5168,434,482,-254,48,-302,-0.00683070460974933,0.00129084181601562,-0.00812154642576495,EPCI
245400759,CC du Pays du Sanon,1975_1982,1978.5,7,5168,5300,474,334,132,-140,272,0.00360950636026436,-0.0038282643214925,0.00743777068175686,EPCI
245400759,CC du Pays du Sanon,1982_1990,1986,8,5300,5451,442,561,151,119,32,0.00351770484271174,0.00277223096875959,0.000745473873952158,EPCI
245400759,CC du Pays du Sanon,1990_1999,1994.5,9,5451,5659,441,528,208,87,121,0.00416957080346103,0.00174400317260149,0.00242556763085954,EPCI
245400759,CC du Pays du Sanon,1999_2010,2004.5,11,5659,6007,566,801,348,235,113,0.00544003972511131,0.0036735900442562,0.00176644968085511,EPCI
245500327,CC du Sammiellois,2010_2015,2012.5,5,9152,8749,497,447,-403,-50,-353,-0.00896616732714983,-0.00111242770808311,-0.00785373961906673,EPCI
245500327,CC du Sammiellois,1968_1975,1971.5,7,9416,9509,892,1328,93,436,-343,0.00140503593930053,0.00658705021005408,-0.00518201427075355,EPCI
245500327,CC du Sammiellois,1975_1982,1978.5,7,9509,9480,823,1148,-29,325,-354,-0.000436248000497019,0.0048889862124666,-0.00532523421296362,EPCI
245500327,CC du Sammiellois,1982_1990,1986,8,9480,9711,821,1229,231,408,-177,0.00301390111300792,0.00532325391388412,-0.0023093528008762,EPCI
245500327,CC du Sammiellois,1990_1999,1994.5,9,9711,9627,888,1248,-84,360,-444,-0.000964824570108935,0.00413496244332401,-0.00509978701343294,EPCI
245500327,CC du Sammiellois,1999_2010,2004.5,11,9627,9152,1102,1203,-475,101,-576,-0.00458936527273235,0.000975843984307299,-0.00556520925703965,EPCI
245501176,CC du Territoire de Fresnes-en-Woëvre,2010_2015,2012.5,5,5071,4958,251,302,-113,51,-164,-0.0044969788142768,0.00202960990732847,-0.00652658872160526,EPCI
245501176,CC du Territoire de Fresnes-en-Woëvre,1968_1975,1971.5,7,4677,4359,458,410,-318,-48,-270,-0.0100087479567575,-0.00151075440856718,-0.00849799354819037,EPCI
245501176,CC du Territoire de Fresnes-en-Woëvre,1975_1982,1978.5,7,4359,4206,450,326,-153,-124,-29,-0.00509136568990776,-0.00412633559182067,-0.000965030098087091,EPCI
245501176,CC du Territoire de Fresnes-en-Woëvre,1982_1990,1986,8,4206,4325,475,427,119,-48,167,0.00349359631931101,-0.00140918170862965,0.00490277802794066,EPCI
245501176,CC du Territoire de Fresnes-en-Woëvre,1990_1999,1994.5,9,4325,4424,490,443,99,-47,146,0.00251784488704643,-0.00119534050193113,0.00371318538897756,EPCI
245501176,CC du Territoire de Fresnes-en-Woëvre,1999_2010,2004.5,11,4424,5071,557,579,647,22,625,0.0124858299415502,0.000424556814086716,0.0120612731274635,EPCI
245501184,CC du Pays de Revigny-sur-Ornain,2010_2015,2012.5,5,7463,7381,320,424,-82,104,-186,-0.00220722994985556,0.00279941359493876,-0.00500664354479432,EPCI
245501184,CC du Pays de Revigny-sur-Ornain,1968_1975,1971.5,7,8010,8108,567,1056,98,489,-391,0.00173871946705262,0.008675855299885,-0.00693713583283239,EPCI
245501184,CC du Pays de Revigny-sur-Ornain,1975_1982,1978.5,7,8108,8511,571,913,403,342,61,0.00695381137193274,0.00590124935285607,0.00105256201907667,EPCI
245501184,CC du Pays de Revigny-sur-Ornain,1982_1990,1986,8,8511,7926,651,1052,-585,401,-986,-0.00886186882124285,0.00607454597832202,-0.0149364147995649,EPCI
245501184,CC du Pays de Revigny-sur-Ornain,1990_1999,1994.5,9,7926,7844,608,912,-82,304,-386,-0.00115484225963713,0.00428136642597182,-0.00543620868560895,EPCI
245501184,CC du Pays de Revigny-sur-Ornain,1999_2010,2004.5,11,7844,7463,730,1004,-381,274,-655,-0.00451626452062659,0.00324791726680232,-0.00776418178742891,EPCI
245501242,CC du Pays d'Étain,2010_2015,2012.5,5,8030,7777,394,520,-253,126,-379,-0.00638231957153046,0.0031785465059796,-0.00956086607751006,EPCI
245501242,CC du Pays d'Étain,1968_1975,1971.5,7,6425,7130,635,852,705,217,488,0.0149846759630357,0.0046123045162819,0.0103723714467538,EPCI
245501242,CC du Pays d'Étain,1975_1982,1978.5,7,7130,7134,597,725,4,128,-124,8.01249970496798e-05,0.00256399990558975,-0.00248387490854007,EPCI
245501242,CC du Pays d'Étain,1982_1990,1986,8,7134,6826,620,816,-308,196,-504,-0.00550146576105648,0.00350093275703594,-0.00900239851809242,EPCI
245501242,CC du Pays d'Étain,1990_1999,1994.5,9,6826,7141,654,943,315,289,26,0.00502524798108617,0.00461046560804414,0.000414782373042033,EPCI
245501242,CC du Pays d'Étain,1999_2010,2004.5,11,7141,8030,780,1146,889,366,523,0.0107236087859617,0.00441489405586274,0.00630871473009894,EPCI
245501259,CC du Pays de Montmédy,2010_2015,2012.5,5,7431,7242,275,327,-189,52,-241,-0.00513935366469231,0.00141400206647619,-0.00655335573116851,EPCI
245501259,CC du Pays de Montmédy,1968_1975,1971.5,7,7416,6809,675,704,-607,29,-636,-0.0121251142496763,0.000579288819177288,-0.0127044030688536,EPCI
245501259,CC du Pays de Montmédy,1975_1982,1978.5,7,6809,6346,627,564,-463,-63,-400,-0.0100096485446484,-0.00136200401363466,-0.00864764453101371,EPCI
245501259,CC du Pays de Montmédy,1982_1990,1986,8,6346,6125,599,628,-221,29,-250,-0.00442094083449385,0.000580123457920007,-0.00500106429241385,EPCI
245501259,CC du Pays de Montmédy,1990_1999,1994.5,9,6125,6795,547,518,670,-29,699,0.0116010305791816,-0.000502134159397413,0.012103164738579,EPCI
245501259,CC du Pays de Montmédy,1999_2010,2004.5,11,6795,7431,631,748,636,117,519,0.00816711509089352,0.00150244098370211,0.00666467410719141,EPCI
245600440,CC de Blavet Bellevue Océan,2010_2015,2012.5,5,16499,17779,555,984,1280,429,851,0.0150558569983354,0.00504606457209837,0.0100097924262371,EPCI
245600440,CC de Blavet Bellevue Océan,1968_1975,1971.5,7,8232,8339,731,896,107,165,-58,0.00184660381580359,0.00284756663184666,-0.00100096281604307,EPCI
245600440,CC de Blavet Bellevue Océan,1975_1982,1978.5,7,8339,10077,666,834,1738,168,1570,0.027413638214393,0.00264987987342809,0.0247637583409649,EPCI
245600440,CC de Blavet Bellevue Océan,1982_1990,1986,8,10077,11796,791,1107,1719,316,1403,0.0198832005317013,0.00365508514718884,0.0162281153845125,EPCI
245600440,CC de Blavet Bellevue Océan,1990_1999,1994.5,9,11796,12544,823,1144,748,321,427,0.00685471705570095,0.00294166333540108,0.00391305372029988,EPCI
245600440,CC de Blavet Bellevue Océan,1999_2010,2004.5,11,12544,16499,1044,2120,3955,1076,2879,0.0252272556599209,0.0068633443969848,0.0183639112629361,EPCI
245600465,CC de Belle-Ile-en-Mer,2010_2015,2012.5,5,5187,5387,343,218,200,-125,325,0.00759532894802395,-0.00474708059251497,0.0123424095405389,EPCI
245600465,CC de Belle-Ile-en-Mer,1968_1975,1971.5,7,4412,4328,457,460,-84,3,-87,-0.00274231294950666,9.79397481966666e-05,-0.00284025269770333,EPCI
245600465,CC de Belle-Ile-en-Mer,1975_1982,1978.5,7,4328,4191,509,333,-137,-176,39,-0.00458462588525266,-0.00588973836353626,0.0013051124782836,EPCI
245600465,CC de Belle-Ile-en-Mer,1982_1990,1986,8,4191,4489,545,409,298,-136,434,0.0086232920670537,-0.00393546215140706,0.0125587542184608,EPCI
245600465,CC de Belle-Ile-en-Mer,1990_1999,1994.5,9,4489,4735,650,453,246,-197,443,0.00594557930211193,-0.0047612972460002,0.0107068765481121,EPCI
245600465,CC de Belle-Ile-en-Mer,1999_2010,2004.5,11,4735,5187,768,621,452,-147,599,0.00832296934880694,-0.00270680640326243,0.0110297757520694,EPCI
245614383,CC Questembert Communauté,2010_2015,2012.5,5,21790,23024,1014,1372,1234,358,876,0.0110781130790325,0.00321390962908723,0.00786420344994528,EPCI
245614383,CC Questembert Communauté,1968_1975,1971.5,7,15472,15538,1396,1742,66,346,-280,0.000608284618283106,0.00318888602918113,-0.00258060141089803,EPCI
245614383,CC Questembert Communauté,1975_1982,1978.5,7,15538,16142,1369,1599,604,230,374,0.00546285791246026,0.00208022735077129,0.00338263056168897,EPCI
245614383,CC Questembert Communauté,1982_1990,1986,8,16142,16522,1582,1695,380,113,267,0.00291276578748634,0.000866164563120937,0.0020466012243654,EPCI
245614383,CC Questembert Communauté,1990_1999,1994.5,9,16522,17355,1733,1671,833,-62,895,0.00548027575783361,-0.000407895674652682,0.00588817143248629,EPCI
245614383,CC Questembert Communauté,1999_2010,2004.5,11,17355,21790,2245,2695,4435,450,3985,0.0209037120475597,0.00212100798678734,0.0187827040607724,EPCI
245614417,CC Roi Morvan Communauté,2010_2015,2012.5,5,25767,25178,2061,1111,-589,-950,361,-0.00461412329589295,-0.00744213434821443,0.00282801105232148,EPCI
245614417,CC Roi Morvan Communauté,1968_1975,1971.5,7,35028,32292,3455,2695,-2736,-760,-1976,-0.0115510851404128,-0.00320863476122578,-0.00834245037918703,EPCI
245614417,CC Roi Morvan Communauté,1975_1982,1978.5,7,32292,30149,3649,1930,-2143,-1719,-424,-0.00976172294082622,-0.0078303321209894,-0.00193139081983683,EPCI
245614417,CC Roi Morvan Communauté,1982_1990,1986,8,30149,27509,3911,2126,-2640,-1785,-855,-0.0113894597866111,-0.00770082792390182,-0.00368863186270928,EPCI
245614417,CC Roi Morvan Communauté,1990_1999,1994.5,9,27509,25712,4012,2061,-1797,-1951,154,-0.00747805636269083,-0.00811891372488025,0.000640857362189421,EPCI
245614417,CC Roi Morvan Communauté,1999_2010,2004.5,11,25712,25767,4716,2486,55,-2230,2285,0.000194272910087223,-0.00787688344535468,0.00807115635544191,EPCI
245614433,CC Pontivy Communauté,2010_2015,2012.5,5,44964,45598,2654,2372,634,-282,916,0.00280426186890392,-0.00124732152528534,0.00405158339418926,EPCI
245614433,CC Pontivy Communauté,1968_1975,1971.5,7,39166,40006,3431,4526,840,1095,-255,0.00303608808940647,0.0039577576879763,-0.000921669598569822,EPCI
245614433,CC Pontivy Communauté,1975_1982,1978.5,7,40006,41262,3367,3858,1256,491,765,0.0044258419074974,0.00173016590492135,0.00269567600257604,EPCI
245614433,CC Pontivy Communauté,1982_1990,1986,8,41262,41765,3941,4082,503,141,362,0.00151573364505042,0.000424887562529045,0.00109084608252138,EPCI
245614433,CC Pontivy Communauté,1990_1999,1994.5,9,41765,42585,4087,4188,820,101,719,0.00216271423165848,0.000266383094387203,0.00189633113727128,EPCI
245614433,CC Pontivy Communauté,1999_2010,2004.5,11,42585,44964,5482,5423,2379,-59,2438,0.00495405741896016,-0.000122862289919567,0.00507691970887972,EPCI
245700133,CC du District Urbain de Faulquemont (Duf),2010_2015,2012.5,5,24799,24831,1061,1355,32,294,-262,0.000257941820082541,0.00236984047200835,-0.00211189865192581,EPCI
245700133,CC du District Urbain de Faulquemont (Duf),1968_1975,1971.5,7,20633,20691,1264,2532,58,1268,-1210,0.000401092889703802,0.00876872041628313,-0.00836762752657933,EPCI
245700133,CC du District Urbain de Faulquemont (Duf),1975_1982,1978.5,7,20691,22794,1304,2259,2103,955,1148,0.0139244140617747,0.00632325983309312,0.00760115422868157,EPCI
245700133,CC du District Urbain de Faulquemont (Duf),1982_1990,1986,8,22794,22922,1510,2551,128,1041,-913,0.000700220620197589,0.00569476301270071,-0.00499454239250312,EPCI
245700133,CC du District Urbain de Faulquemont (Duf),1990_1999,1994.5,9,22922,23410,1626,2451,488,825,-337,0.0023434230255599,0.00396172950017811,-0.00161830647461821,EPCI
245700133,CC du District Urbain de Faulquemont (Duf),1999_2010,2004.5,11,23410,24799,2093,3114,1389,1021,368,0.00525375722273069,0.00386183306292875,0.00139192415980194,EPCI
245700372,CA de Forbach Porte de France,2010_2015,2012.5,5,79990,78290,3771,4241,-1700,470,-2170,-0.00428713308326723,0.00118526620537388,-0.00547239928864111,EPCI
245700372,CA de Forbach Porte de France,1968_1975,1971.5,7,81676,82705,4661,10050,1029,5389,-4360,0.00179015164509666,0.0093752451073138,-0.00758509346221714,EPCI
245700372,CA de Forbach Porte de France,1975_1982,1978.5,7,82705,85537,4902,8311,2832,3409,-577,0.00482143893653908,0.00580377307014891,-0.000982334133609834,EPCI
245700372,CA de Forbach Porte de France,1982_1990,1986,8,85537,86362,5559,10526,825,4967,-4142,0.00120056177001748,0.0072281094686992,-0.00602754769868171,EPCI
245700372,CA de Forbach Porte de France,1990_1999,1994.5,9,86362,82146,6336,8626,-4216,2290,-6506,-0.00554563392538865,0.00301221577066888,-0.00855784969605753,EPCI
245700372,CA de Forbach Porte de France,1999_2010,2004.5,11,82146,79990,7968,9180,-2156,1212,-3368,-0.00241494522744612,0.00135756661208938,-0.0037725118395355,EPCI
245700398,CC de Freyming-Merlebach,2010_2015,2012.5,5,33741,32520,1683,1913,-1221,230,-1451,-0.00734458184642961,0.00138350026591221,-0.00872808211234182,EPCI
245700398,CC de Freyming-Merlebach,1968_1975,1971.5,7,41405,39807,2290,4825,-1598,2535,-4133,-0.00560691798318258,0.00889457890323394,-0.0145014968864165,EPCI
245700398,CC de Freyming-Merlebach,1975_1982,1978.5,7,39807,39946,2337,4261,139,1924,-1785,0.000498090551718899,0.00689443324825297,-0.00639634269653407,EPCI
245700398,CC de Freyming-Merlebach,1982_1990,1986,8,39946,38518,2715,5197,-1428,2482,-3910,-0.00454002249122576,0.00789099147284477,-0.0124310139640705,EPCI
245700398,CC de Freyming-Merlebach,1990_1999,1994.5,9,38518,37826,2940,4533,-692,1593,-2285,-0.00201230233667404,0.00463236650624531,-0.00664466884291935,EPCI
245700398,CC de Freyming-Merlebach,1999_2010,2004.5,11,37826,33741,3870,4542,-4085,672,-4757,-0.0103355789766633,0.00170024701892722,-0.0120358259955905,EPCI
245700695,CC de Cattenom et Environs,2010_2015,2012.5,5,24239,25523,784,1174,1284,390,894,0.0103768903815482,0.00315185922804034,0.00722503115350787,EPCI
245700695,CC de Cattenom et Environs,1968_1975,1971.5,7,14415,15726,1139,1524,1311,385,926,0.0125127897622317,0.00367461789356156,0.00883817186867013,EPCI
245700695,CC de Cattenom et Environs,1975_1982,1978.5,7,15726,17091,1037,1262,1365,225,1140,0.0119619234269932,0.00197174561983404,0.00999017780715916,EPCI
245700695,CC de Cattenom et Environs,1982_1990,1986,8,17091,18284,1179,1740,1193,561,632,0.00846996277984236,0.00398294142455286,0.0044870213552895,EPCI
245700695,CC de Cattenom et Environs,1990_1999,1994.5,9,18284,19549,1324,1925,1265,601,664,0.00746077993137373,0.00354460769862104,0.00391617223275269,EPCI
245700695,CC de Cattenom et Environs,1999_2010,2004.5,11,19549,24239,1632,2922,4690,1290,3400,0.0197413118250356,0.00542991306061746,0.0143113987644181,EPCI
245700950,CC du Pays de Phalsbourg,2010_2015,2012.5,5,17604,17639,752,941,35,189,-154,0.000397321047205024,0.00214553365490713,-0.0017482126077021,EPCI
245700950,CC du Pays de Phalsbourg,1968_1975,1971.5,7,15180,15937,1288,1716,757,428,329,0.00697631876807292,0.00394433874865946,0.00303198001941346,EPCI
245700950,CC du Pays de Phalsbourg,1975_1982,1978.5,7,15937,15670,1285,1366,-267,81,-348,-0.00241071718707886,0.000731341169113811,-0.00314205835619267,EPCI
245700950,CC du Pays de Phalsbourg,1982_1990,1986,8,15670,15771,1419,1609,101,190,-89,0.000803416833732085,0.00151137820207026,-0.000707961368338174,EPCI
245700950,CC du Pays de Phalsbourg,1990_1999,1994.5,9,15771,16709,1397,1873,938,476,462,0.00644005811485937,0.0032680891926152,0.00317196892224417,EPCI
245700950,CC du Pays de Phalsbourg,1999_2010,2004.5,11,16709,17604,1539,2200,895,661,234,0.00475478213891134,0.00351163239533005,0.00124314974358129,EPCI
245701164,CC du Warndt,2010_2015,2012.5,5,18351,18102,1013,924,-249,-89,-160,-0.00272859849425289,-0.000975282192724928,-0.00175331630152796,EPCI
245701164,CC du Warndt,1968_1975,1971.5,7,18482,19782,1097,2425,1300,1328,-28,0.00975803758747773,0.00996821070474648,-0.000210173117268751,EPCI
245701164,CC du Warndt,1975_1982,1978.5,7,19782,19689,1176,2025,-93,849,-942,-0.00067296333823863,0.00614350402327524,-0.00681646736151387,EPCI
245701164,CC du Warndt,1982_1990,1986,8,19689,19865,1325,2438,176,1113,-937,0.00111302959656312,0.007038647391902,-0.00592561779533888,EPCI
245701164,CC du Warndt,1990_1999,1994.5,9,19865,19093,1492,2011,-772,519,-1291,-0.00439449510628465,0.00295433025927685,-0.0073488253655615,EPCI
245701164,CC du Warndt,1999_2010,2004.5,11,19093,18351,1949,2082,-742,133,-875,-0.00359694333609317,0.000644735126280852,-0.00424167846237402,EPCI
245701206,CC du Saulnois,2010_2015,2012.5,5,29927,29449,1584,1578,-478,-6,-472,-0.0032150464933961,-4.03562321346791e-05,-0.00317469026126142,EPCI
245701206,CC du Saulnois,1968_1975,1971.5,7,30465,29275,2793,3213,-1190,420,-1610,-0.00567591282539171,0.00200326335013825,-0.00767917617552995,EPCI
245701206,CC du Saulnois,1975_1982,1978.5,7,29275,28739,2778,2590,-536,-188,-348,-0.00263635072881663,-0.000924690181002847,-0.00171166054781378,EPCI
245701206,CC du Saulnois,1982_1990,1986,8,28739,28315,2960,3081,-424,121,-545,-0.00185619835011319,0.00052971698198985,-0.00238591533210304,EPCI
245701206,CC du Saulnois,1990_1999,1994.5,9,28315,28480,3144,3057,165,-87,252,0.00064580699671235,-0.00034051641644833,0.00098632341316068,EPCI
245701206,CC du Saulnois,1999_2010,2004.5,11,28480,29927,3646,3988,1447,342,1105,0.00451552771906227,0.00106724981335128,0.003448277905711,EPCI
245701222,CA du Val de Fensch,2010_2015,2012.5,5,68777,69926,3472,4454,1149,982,167,0.0033191268031989,0.0028367123766243,0.000482414426574601,EPCI
245701222,CA du Val de Fensch,1968_1975,1971.5,7,89007,88806,4533,12234,-201,7701,-7902,-0.000322919713280134,0.012372162746121,-0.0126950824594011,EPCI
245701222,CA du Val de Fensch,1975_1982,1978.5,7,88806,77909,4429,8213,-10897,3784,-14681,-0.0185280255592568,0.00643388535525629,-0.0249619109145131,EPCI
245701222,CA du Val de Fensch,1982_1990,1986,8,77909,73149,4927,8372,-4760,3445,-8205,-0.00784940898820719,0.00568092730343986,-0.0135303362916471,EPCI
245701222,CA du Val de Fensch,1990_1999,1994.5,9,73149,68978,5556,7211,-4171,1655,-5826,-0.00650219571461796,0.00257998894933894,-0.00908218466395691,EPCI
245701222,CA du Val de Fensch,1999_2010,2004.5,11,68978,68777,7173,8900,-201,1727,-1928,-0.000265258126917467,0.00227910838401227,-0.00254436651092973,EPCI
245701271,CC du Pays Orne Moselle,2010_2015,2012.5,5,53042,53926,2511,3077,884,566,318,0.00331120673762331,0.00212007128223393,0.00119113545538938,EPCI
245701271,CC du Pays Orne Moselle,1968_1975,1971.5,7,61856,61419,3569,7665,-437,4096,-4533,-0.00101232575040877,0.00948852694204651,-0.0105008526924553,EPCI
245701271,CC du Pays Orne Moselle,1975_1982,1978.5,7,61419,55829,3423,5265,-5590,1842,-7432,-0.0135397567353723,0.00446157994750552,-0.0180013366828778,EPCI
245701271,CC du Pays Orne Moselle,1982_1990,1986,8,55829,53358,3722,5683,-2471,1961,-4432,-0.00564271076459599,0.00447808814624555,-0.0101207989108415,EPCI
245701271,CC du Pays Orne Moselle,1990_1999,1994.5,9,53358,52792,4114,5488,-566,1374,-1940,-0.0011842155476457,0.00287475647078655,-0.00405897201843224,EPCI
245701271,CC du Pays Orne Moselle,1999_2010,2004.5,11,52792,53042,5178,6430,250,1252,-1002,0.000429582105451409,0.00215134718410066,-0.00172176507864925,EPCI
245701354,CC de l'Arc Mosellan,2010_2015,2012.5,5,32124,34201,1100,1813,2077,713,1364,0.0126091268707578,0.00432850623921535,0.00828062063154242,EPCI
245701354,CC de l'Arc Mosellan,1968_1975,1971.5,7,24547,26145,1125,3126,1598,2001,-403,0.00905047012459126,0.0113329103374888,-0.00228244021289755,EPCI
245701354,CC de l'Arc Mosellan,1975_1982,1978.5,7,26145,27334,1185,2536,1189,1351,-162,0.0063735654043251,0.00724195699011204,-0.000868391585786936,EPCI
245701354,CC de l'Arc Mosellan,1982_1990,1986,8,27334,27294,1320,2738,-40,1418,-1458,-0.00018303958704613,0.00648875336078531,-0.00667179294783144,EPCI
245701354,CC de l'Arc Mosellan,1990_1999,1994.5,9,27294,27991,1569,2647,697,1078,-381,0.00280572114637878,0.00433940802840219,-0.00153368688202341,EPCI
245701354,CC de l'Arc Mosellan,1999_2010,2004.5,11,27991,32124,2098,3567,4133,1469,2664,0.0125987386971385,0.00447799350256385,0.00812074519457461,EPCI
245701362,CA Portes de France-Thionville,2010_2015,2012.5,5,78950,78892,3482,4364,-58,882,-940,-0.000146971630690329,0.00223498238394604,-0.00238195401463637,EPCI
245701362,CA Portes de France-Thionville,1968_1975,1971.5,7,76625,79752,4298,10776,3127,6478,-3351,0.00573041716482847,0.0118713279161365,-0.00614091075130803,EPCI
245701362,CA Portes de France-Thionville,1975_1982,1978.5,7,79752,75656,4523,8635,-4096,4112,-8208,-0.00750385728160274,0.00753316922410901,-0.0150370265057117,EPCI
245701362,CA Portes de France-Thionville,1982_1990,1986,8,75656,74889,5073,9317,-767,4244,-5011,-0.00127290572469663,0.00704330103730441,-0.00831620676200104,EPCI
245701362,CA Portes de France-Thionville,1990_1999,1994.5,9,74889,77026,5610,9276,2137,3666,-1529,0.00313111505922525,0.00537139345209161,-0.00224027839286636,EPCI
245701362,CA Portes de France-Thionville,1999_2010,2004.5,11,77026,78950,7347,10774,1924,3427,-1503,0.00224540018965902,0.00399947320684068,-0.00175407301718166,EPCI
245701404,CC du Pays Haut Val d'Alzette,2010_2015,2012.5,5,26631,27979,1271,1082,1348,-189,1537,0.00992458081641034,-0.00139150279992697,0.0113160836163373,EPCI
245701404,CC du Pays Haut Val d'Alzette,1968_1975,1971.5,7,35333,31722,1950,3460,-3611,1510,-5121,-0.0152830005350579,0.00639084209580102,-0.021673842630859,EPCI
245701404,CC du Pays Haut Val d'Alzette,1975_1982,1978.5,7,31722,28276,1895,2580,-3446,685,-4131,-0.0162939450167863,0.00323892987129965,-0.0195328748880859,EPCI
245701404,CC du Pays Haut Val d'Alzette,1982_1990,1986,8,28276,26101,2184,2377,-2175,193,-2368,-0.00995508685283197,0.000883370925331757,-0.0108384577781637,EPCI
245701404,CC du Pays Haut Val d'Alzette,1990_1999,1994.5,9,26101,25497,2494,2191,-604,-303,-301,-0.00259804473449765,-0.00130332376581587,-0.00129472096868178,EPCI
245701404,CC du Pays Haut Val d'Alzette,1999_2010,2004.5,11,25497,26631,2945,2831,1134,-114,1248,0.00396375795225135,-0.000398473021654897,0.00436223097390624,EPCI
245801063,CC Loire et Allier,2010_2015,2012.5,5,7287,7244,324,343,-43,19,-62,-0.00118297946086676,0.000522711854801593,-0.00170569131566835,EPCI
245801063,CC Loire et Allier,1968_1975,1971.5,7,5589,5673,421,522,84,101,-17,0.00213337212937859,0.0025651260127052,-0.000431753883326619,EPCI
245801063,CC Loire et Allier,1975_1982,1978.5,7,5673,6314,394,448,641,54,587,0.0154105815491636,0.00129823931927432,0.0141123422298893,EPCI
245801063,CC Loire et Allier,1982_1990,1986,8,6314,7055,463,596,741,133,608,0.0139675466656604,0.00250699555537494,0.0114605511102854,EPCI
245801063,CC Loire et Allier,1990_1999,1994.5,9,7055,7114,534,630,59,96,-37,0.000925771397766395,0.00150633990145041,-0.00058056850368401,EPCI
245801063,CC Loire et Allier,1999_2010,2004.5,11,7114,7287,696,762,173,66,107,0.00218668414710987,0.000834226322018796,0.00135245782509108,EPCI
245804406,CA de Nevers,2010_2015,2012.5,5,70267,67060,3799,3448,-3207,-351,-2856,-0.0092993968154933,-0.00101780114818776,-0.00828159566730554,EPCI
245804406,CA de Nevers,1968_1975,1971.5,7,69571,75877,5223,8657,6306,3434,2872,0.0124722512760973,0.00679189833208343,0.00568035294401387,EPCI
245804406,CA de Nevers,1975_1982,1978.5,7,75877,75736,5396,7888,-141,2492,-2633,-0.000265678893825227,0.00469554470505296,-0.00496122359887818,EPCI
245804406,CA de Nevers,1982_1990,1986,8,75736,75741,6244,8179,5,1935,-1930,8.25211192467812e-06,0.00319356731485043,-0.00318531520292575,EPCI
245804406,CA de Nevers,1990_1999,1994.5,9,75741,74208,7037,8072,-1533,1035,-2568,-0.00226938375468855,0.00153216711422221,-0.00380155086891076,EPCI
245804406,CA de Nevers,1999_2010,2004.5,11,74208,70267,8359,8748,-3941,389,-4330,-0.00494859599470299,0.000488455681791287,-0.00543705167649427,EPCI
245804497,CC du Nivernais Bourbonnais,2010_2015,2012.5,5,5782,5632,406,260,-150,-146,-4,-0.00524321107923631,-0.00510339211712334,-0.000139818962112968,EPCI
245804497,CC du Nivernais Bourbonnais,1968_1975,1971.5,7,6425,6144,671,517,-281,-154,-127,-0.00636829802132832,-0.00349009927147531,-0.00287819874985301,EPCI
245804497,CC du Nivernais Bourbonnais,1975_1982,1978.5,7,6144,5731,679,372,-413,-307,-106,-0.00989160452462345,-0.00735283919869104,-0.00253876532593241,EPCI
245804497,CC du Nivernais Bourbonnais,1982_1990,1986,8,5731,5515,747,409,-216,-338,122,-0.00479078526200272,-0.00749669175257833,0.00270590649057561,EPCI
245804497,CC du Nivernais Bourbonnais,1990_1999,1994.5,9,5515,5518,737,462,3,-275,278,6.04266133508169e-05,-0.00553910622382488,0.0055995328371757,EPCI
245804497,CC du Nivernais Bourbonnais,1999_2010,2004.5,11,5518,5782,868,657,264,-211,475,0.0042575986379183,-0.00340285345682107,0.00766045209473937,EPCI
245900410,Métropole Européenne de Lille,2010_2015,2012.5,5,1118332,1141440,40777,85470,23108,44693,-21585,0.00409884411441674,0.0079275419770481,-0.00382869786263136,EPCI
245900410,Métropole Européenne de Lille,1968_1975,1971.5,7,994634,1046430,78866,142342,51796,63476,-11680,0.00727847738870202,0.00891977432089832,-0.0016412969321963,EPCI
245900410,Métropole Européenne de Lille,1975_1982,1978.5,7,1046430,1052137,76847,132826,5707,55979,-50272,0.000777296644133285,0.00762437162115598,-0.00684707497702269,EPCI
245900410,Métropole Européenne de Lille,1982_1990,1986,8,1052137,1072719,79350,150085,20582,70735,-50153,0.00242458616729868,0.00833267430492043,-0.00590808813762174,EPCI
245900410,Métropole Européenne de Lille,1990_1999,1994.5,9,1072719,1097074,80470,154195,24355,73725,-49370,0.00249756806623558,0.00756038619105802,-0.00506281812482244,EPCI
245900410,Métropole Européenne de Lille,1999_2010,2004.5,11,1097074,1118332,92210,188053,21258,95843,-74585,0.00174621866599378,0.00787293421793405,-0.00612671555194027,EPCI
245900428,CU de Dunkerque,2010_2015,2012.5,5,201932,199893,9042,12665,-2039,3623,-5662,-0.00202769817273318,0.0036029183324239,-0.00563061650515708,EPCI
245900428,CU de Dunkerque,1968_1975,1971.5,7,178000,205555,11907,29651,27555,17744,9811,0.0207742838168654,0.0133775682107226,0.00739671560614286,EPCI
245900428,CU de Dunkerque,1975_1982,1978.5,7,205555,216443,11882,29387,10888,17505,-6617,0.00740062098990424,0.0118982246903264,-0.00449760370042215,EPCI
245900428,CU de Dunkerque,1982_1990,1986,8,216443,213616,12929,31254,-2827,18325,-21152,-0.0016420531886191,0.0106440129753962,-0.0122860661640153,EPCI
245900428,CU de Dunkerque,1990_1999,1994.5,9,213616,213698,14526,28867,82,14341,-14259,4.26445447196944e-05,0.00745811482713582,-0.00741547028241612,EPCI
245900428,CU de Dunkerque,1999_2010,2004.5,11,213698,201932,18586,30535,-11766,11949,-23715,-0.00513520554594205,0.00521507488258214,-0.0103502804285242,EPCI
245900758,CC Flandre Lys,2010_2015,2012.5,5,38233,39586,1702,2415,1353,713,640,0.00697954495291375,0.00367806027452144,0.00330148467839231,EPCI
245900758,CC Flandre Lys,1968_1975,1971.5,7,27825,28636,2516,3574,811,1058,-247,0.00411268689075772,0.00536525614108714,-0.00125256925032942,EPCI
245900758,CC Flandre Lys,1975_1982,1978.5,7,28636,31533,2468,3587,2897,1119,1778,0.0138623389698092,0.00535448992309853,0.00850784904671062,EPCI
245900758,CC Flandre Lys,1982_1990,1986,8,31533,35091,2740,4324,3558,1584,1974,0.0134534529836539,0.00598939559474641,0.00746405738890745,EPCI
245900758,CC Flandre Lys,1990_1999,1994.5,9,35091,35874,2931,4229,783,1298,-515,0.00245502106215612,0.00406975394467259,-0.00161473288251647,EPCI
245900758,CC Flandre Lys,1999_2010,2004.5,11,35874,38233,3763,5241,2359,1478,881,0.00580644862449198,0.00363795297456513,0.00216849564992685,EPCI
245901038,CC du Pays Solesmois,2010_2015,2012.5,5,14899,15054,856,922,155,66,89,0.00207207178129454,0.000882301532680255,0.00118977024861428,EPCI
245901038,CC du Pays Solesmois,1968_1975,1971.5,7,18016,17097,1632,1916,-919,284,-1203,-0.00745170341917167,0.00230281150276905,-0.00975451492194072,EPCI
245901038,CC du Pays Solesmois,1975_1982,1978.5,7,17097,16228,1481,1566,-869,85,-954,-0.00742442522807796,0.000726209602286106,-0.00815063483036406,EPCI
245901038,CC du Pays Solesmois,1982_1990,1986,8,16228,15284,1590,1619,-944,29,-973,-0.00746346098495543,0.000229280051444605,-0.00769274103640003,EPCI
245901038,CC du Pays Solesmois,1990_1999,1994.5,9,15284,14734,1615,1437,-550,-178,-372,-0.00406380711064114,-0.0013151957558075,-0.00274861135483364,EPCI
245901038,CC du Pays Solesmois,1999_2010,2004.5,11,14734,14899,1817,1956,165,139,26,0.00101290794916387,0.000853298211719863,0.000159609737444003,EPCI
245901061,CC de la Haute-Deûle,2010_2015,2012.5,5,23383,24268,878,1419,885,541,344,0.00745753945973426,0.00455878965843643,0.00289874980129784,EPCI
245901061,CC de la Haute-Deûle,1968_1975,1971.5,7,15464,15524,1220,2005,60,785,-725,0.000553363277661534,0.00723983621607173,-0.0066864729384102,EPCI
245901061,CC de la Haute-Deûle,1975_1982,1978.5,7,15524,18320,1301,1973,2796,672,2124,0.0239400918159547,0.00575384180984319,0.0181862500061115,EPCI
245901061,CC de la Haute-Deûle,1982_1990,1986,8,18320,21458,1362,2669,3138,1307,1831,0.0199596035213494,0.00831332116074049,0.0116462823606089,EPCI
245901061,CC de la Haute-Deûle,1990_1999,1994.5,9,21458,22939,1412,2735,1481,1323,158,0.00744322886362214,0.00664915042982586,0.000794078433796285,EPCI
245901061,CC de la Haute-Deûle,1999_2010,2004.5,11,22939,23383,1765,3595,444,1830,-1386,0.00174431444412693,0.00718940412782044,-0.00544508968369351,EPCI
245901152,CC Coeur d'Ostrevent [C.C.C.O.],2010_2015,2012.5,5,73183,72312,3493,4890,-871,1397,-2268,-0.00239174781477025,0.00383613283264528,-0.00622788064741553,EPCI
245901152,CC Coeur d'Ostrevent [C.C.C.O.],1968_1975,1971.5,7,75314,72654,5611,9121,-2660,3510,-6170,-0.00512362828045987,0.00676087791895268,-0.0118845061994126,EPCI
245901152,CC Coeur d'Ostrevent [C.C.C.O.],1975_1982,1978.5,7,72654,70918,5803,7798,-1736,1995,-3731,-0.00344891976310557,0.00396347634066568,-0.00741239610377125,EPCI
245901152,CC Coeur d'Ostrevent [C.C.C.O.],1982_1990,1986,8,70918,71967,6051,9140,1049,3089,-2040,0.00183711049824575,0.00540975627176466,-0.00357264577351891,EPCI
245901152,CC Coeur d'Ostrevent [C.C.C.O.],1990_1999,1994.5,9,71967,71814,6452,8368,-153,1916,-2069,-0.000236442875932608,0.00296094477311684,-0.00319738764904945,EPCI
245901152,CC Coeur d'Ostrevent [C.C.C.O.],1999_2010,2004.5,11,71814,73183,7942,10856,1369,2914,-1545,0.00171817532362506,0.00365724097373515,-0.00193906565011009,EPCI
245901160,CA Valenciennes Métropole,2010_2015,2012.5,5,191708,192531,9253,13924,823,4671,-3848,0.000857126857444879,0.0048646896125456,-0.00400756275510072,EPCI
245901160,CA Valenciennes Métropole,1968_1975,1971.5,7,195613,199420,15584,26906,3807,11322,-7515,0.0027573567975625,0.00820036607880291,-0.0054430092812404,EPCI
245901160,CA Valenciennes Métropole,1975_1982,1978.5,7,199420,197998,15523,24621,-1422,9098,-10520,-0.00102179529234303,0.00653747789714268,-0.00755927318948571,EPCI
245901160,CA Valenciennes Métropole,1982_1990,1986,8,197998,191854,16827,24918,-6144,8091,-14235,-0.00393253021312312,0.00517872753163723,-0.00911125774476035,EPCI
245901160,CA Valenciennes Métropole,1990_1999,1994.5,9,191854,191819,16652,23682,-35,7030,-7065,-2.02716869958097e-05,0.00407171313087264,-0.00409198481786845,EPCI
245901160,CA Valenciennes Métropole,1999_2010,2004.5,11,191819,191708,20063,29575,-111,9512,-9623,-5.26202529533837e-05,0.00450922383867194,-0.00456184409162533,EPCI
246000129,CC du Liancourtois,2010_2015,2012.5,5,23000,23534,972,1535,534,563,-29,0.00460094561908342,0.00485080970701117,-0.000249864087927751,EPCI
246000129,CC du Liancourtois,1968_1975,1971.5,7,13950,16095,1201,1837,2145,636,1509,0.0206429140629993,0.0061206961977005,0.0145222178652988,EPCI
246000129,CC du Liancourtois,1975_1982,1978.5,7,16095,17422,1129,1445,1327,316,1011,0.0113821623844284,0.00271044710887668,0.00867171527555167,EPCI
246000129,CC du Liancourtois,1982_1990,1986,8,17422,20423,1361,1918,3001,557,2444,0.0200646347263127,0.00372409248335761,0.0163405422429551,EPCI
246000129,CC du Liancourtois,1990_1999,1994.5,9,20423,21479,1535,2499,1056,964,92,0.00561727325485628,0.00512788960007714,0.000489383654779145,EPCI
246000129,CC du Liancourtois,1999_2010,2004.5,11,21479,23000,1818,2992,1521,1174,347,0.00623924736600445,0.00481582932786931,0.00142341803813514,EPCI
246000376,CC du Clermontois,2010_2015,2012.5,5,36959,37621,1425,2345,662,920,-258,0.0035569539989575,0.00494319891093792,-0.00138624491198042,EPCI
246000376,CC du Clermontois,1968_1975,1971.5,7,25844,29037,1705,3199,3193,1494,1699,0.0167810189741797,0.00785181407686329,0.00892920489731642,EPCI
246000376,CC du Clermontois,1975_1982,1978.5,7,29037,31206,1810,2856,2169,1046,1123,0.0103444960384447,0.00498863202222827,0.0053558640162164,EPCI
246000376,CC du Clermontois,1982_1990,1986,8,31206,33880,2075,3670,2674,1595,1079,0.0103297984994699,0.00616156641984088,0.00416823207962903,EPCI
246000376,CC du Clermontois,1990_1999,1994.5,9,33880,35307,2257,4255,1427,1998,-571,0.00459456443391426,0.00643303415484281,-0.00183846972092855,EPCI
246000376,CC du Clermontois,1999_2010,2004.5,11,35307,36959,3097,5297,1652,2200,-548,0.00416573862826319,0.00554759381487835,-0.00138185518661515,EPCI
246000566,CC du Plateau Picard,2010_2015,2012.5,5,29149,30330,1124,1976,1181,852,329,0.00797497500992117,0.00575332659479495,0.00222164841512622,EPCI
246000566,CC du Plateau Picard,1968_1975,1971.5,7,19643,20106,1691,2344,463,653,-190,0.00333372127688092,0.0047017710449314,-0.00136804976805048,EPCI
246000566,CC du Plateau Picard,1975_1982,1978.5,7,20106,21547,1679,2014,1441,335,1106,0.00993738219607243,0.00231021723503419,0.00762716496103824,EPCI
246000566,CC du Plateau Picard,1982_1990,1986,8,21547,24895,1848,2882,3348,1034,2314,0.0182177530423737,0.00562639087389917,0.0125913621684746,EPCI
246000566,CC du Plateau Picard,1990_1999,1994.5,9,24895,27296,2083,3416,2401,1333,1068,0.0102828635659593,0.00570889509930186,0.00457396846665745,EPCI
246000566,CC du Plateau Picard,1999_2010,2004.5,11,27296,29149,2486,4162,1853,1676,177,0.0059888103359782,0.00541675451867213,0.000572055817306067,EPCI
246000582,CC des Sablons,2010_2015,2012.5,5,34412,36463,1250,2484,2051,1234,817,0.0116458321813384,0.00700680493016655,0.00463902725117186,EPCI
246000582,CC des Sablons,1968_1975,1971.5,7,16960,19564,1536,2203,2604,667,1937,0.0206143883422316,0.00528025999395871,0.0153341283482729,EPCI
246000582,CC des Sablons,1975_1982,1978.5,7,19564,25620,1483,2488,6056,1005,5051,0.0392777720613429,0.00651819037675852,0.0327595816845843,EPCI
246000582,CC des Sablons,1982_1990,1986,8,25620,29140,1735,3309,3520,1574,1946,0.0162224916610447,0.00725403462343307,0.00896845703761166,EPCI
246000582,CC des Sablons,1990_1999,1994.5,9,29140,32434,2002,3995,3294,1993,1301,0.0119705755992807,0.00724267066465285,0.00472790493462787,EPCI
246000582,CC des Sablons,1999_2010,2004.5,11,32434,34412,2506,5202,1978,2696,-718,0.00539615119195624,0.007354915881453,-0.00195876468949676,EPCI
246000707,CC du Vexin-Thelle,2010_2015,2012.5,5,18773,19568,961,1049,795,88,707,0.00832968267498035,0.000922027767796567,0.00740765490718379,EPCI
246000707,CC du Vexin-Thelle,1968_1975,1971.5,7,10912,11408,1148,1343,496,195,301,0.006370457392334,0.00250451449900228,0.00386594289333172,EPCI
246000707,CC du Vexin-Thelle,1975_1982,1978.5,7,11408,13748,1086,1092,2340,6,2334,0.0270124676635843,6.92627375989342e-05,0.0269432049259854,EPCI
246000707,CC du Vexin-Thelle,1982_1990,1986,8,13748,16178,1289,1515,2430,226,2204,0.0205532344272059,0.00191153538294178,0.0186416990442641,EPCI
246000707,CC du Vexin-Thelle,1990_1999,1994.5,9,16178,17759,1452,1906,1581,454,1127,0.0104138657682427,0.00299044595748398,0.00742341981075868,EPCI
246000707,CC du Vexin-Thelle,1999_2010,2004.5,11,17759,18773,1826,2280,1014,454,560,0.00506069296472456,0.00226583294475833,0.00279486001996622,EPCI
246000749,CC des Lisières de l'Oise,2010_2015,2012.5,5,16390,16347,748,887,-43,139,-182,-0.000525261699081625,0.00169793898075223,-0.00222320067983385,EPCI
246000749,CC des Lisières de l'Oise,1968_1975,1971.5,7,12396,13030,1171,1608,634,437,197,0.00715124190522687,0.00492916831637877,0.0022220735888481,EPCI
246000749,CC des Lisières de l'Oise,1975_1982,1978.5,7,13030,13473,1060,1299,443,239,204,0.00478760866955574,0.00258293108808989,0.00220467758146585,EPCI
246000749,CC des Lisières de l'Oise,1982_1990,1986,8,13473,14674,1206,1577,1201,371,830,0.0107308592557547,0.00331486160190257,0.00741599765385211,EPCI
246000749,CC des Lisières de l'Oise,1990_1999,1994.5,9,14674,15942,1438,1759,1268,321,947,0.00925141171249289,0.00234203719220049,0.0069093745202924,EPCI
246000749,CC des Lisières de l'Oise,1999_2010,2004.5,11,15942,16390,1766,2255,448,489,-41,0.0025226544379644,0.00275352236643882,-0.000230867928474421,EPCI
246000756,CC du Pays Noyonnais,2010_2015,2012.5,5,33441,33336,1570,2340,-105,770,-875,-0.000628761837466962,0.00461092014142439,-0.00523968197889135,EPCI
246000756,CC du Pays Noyonnais,1968_1975,1971.5,7,24993,27974,2083,3587,2981,1504,1477,0.0162273594415994,0.00818716826573816,0.00804019117586121,EPCI
246000756,CC du Pays Noyonnais,1975_1982,1978.5,7,27974,29393,1990,3586,1419,1596,-177,0.00709376286148089,0.00797860854610536,-0.000884845684624467,EPCI
246000756,CC du Pays Noyonnais,1982_1990,1986,8,29393,31421,2161,4066,2028,1905,123,0.0083748631415268,0.00786692025868272,0.000507942882844082,EPCI
246000756,CC du Pays Noyonnais,1990_1999,1994.5,9,31421,32508,2472,4269,1087,1797,-710,0.0037860104223888,0.00625893351336952,-0.00247292309098072,EPCI
246000756,CC du Pays Noyonnais,1999_2010,2004.5,11,32508,33441,3501,5323,933,1822,-889,0.00257571867688244,0.00502996723395478,-0.00245424855707234,EPCI
246000764,CC de l'Aire Cantilienne,2010_2015,2012.5,5,45338,44740,1798,2302,-598,504,-1102,-0.00265199261485116,0.00223512421051001,-0.00488711682536117,EPCI
246000764,CC de l'Aire Cantilienne,1968_1975,1971.5,7,28498,33930,2118,3475,5432,1357,4075,0.0252368581942599,0.00630456858792539,0.0189322896063345,EPCI
246000764,CC de l'Aire Cantilienne,1975_1982,1978.5,7,33930,38576,2343,3414,4646,1071,3575,0.0185020436731689,0.00426510735556691,0.014236936317602,EPCI
246000764,CC de l'Aire Cantilienne,1982_1990,1986,8,38576,43050,2639,4036,4474,1397,3077,0.0138109912972362,0.00431246196742042,0.00949852932981576,EPCI
246000764,CC de l'Aire Cantilienne,1990_1999,1994.5,9,43050,43214,3147,4637,164,1490,-1326,0.000422565472283365,0.00383916191281838,-0.00341659644053501,EPCI
246000764,CC de l'Aire Cantilienne,1999_2010,2004.5,11,43214,45338,4151,5789,2124,1638,486,0.00437143753538161,0.003371193353557,0.0010002441818246,EPCI
246000772,CC des Deux Vallées,2010_2015,2012.5,5,22866,22888,901,1314,22,413,-391,0.000192351422769077,0.00361096080016495,-0.00341860937739587,EPCI
246000772,CC des Deux Vallées,1968_1975,1971.5,7,16090,18924,1029,2158,2834,1129,1705,0.0234467960410989,0.00934066080818654,0.0141061352329124,EPCI
246000772,CC des Deux Vallées,1975_1982,1978.5,7,18924,21046,937,2093,2122,1156,966,0.0152986385234182,0.00833422532189982,0.00696441320151836,EPCI
246000772,CC des Deux Vallées,1982_1990,1986,8,21046,22383,1189,2391,1337,1202,135,0.00772861573633499,0.00694823942787932,0.000780376308455664,EPCI
246000772,CC des Deux Vallées,1990_1999,1994.5,9,22383,23095,1342,2649,712,1307,-595,0.00348543803135759,0.00639812852104547,-0.00291269048968787,EPCI
246000772,CC des Deux Vallées,1999_2010,2004.5,11,23095,22866,1742,3113,-229,1371,-1600,-0.000905503671423391,0.00542115953502825,-0.00632666320645164,EPCI
246000848,CC de la Picardie Verte,2010_2015,2012.5,5,32109,33084,1453,2076,975,623,352,0.00600061542502894,0.00383423939465952,0.00216637603036942,EPCI
246000848,CC de la Picardie Verte,1968_1975,1971.5,7,25720,25591,1984,2850,-129,866,-995,-0.000718052390690116,0.0048204137235476,-0.00553846611423772,EPCI
246000848,CC de la Picardie Verte,1975_1982,1978.5,7,25591,25765,2070,2343,174,273,-99,0.00096850507090096,0.00151955105951702,-0.000551045988616064,EPCI
246000848,CC de la Picardie Verte,1982_1990,1986,8,25765,26792,2304,2978,1027,674,353,0.00489774916840102,0.0032142969225923,0.00168345224580873,EPCI
246000848,CC de la Picardie Verte,1990_1999,1994.5,9,26792,28451,2373,3205,1659,832,827,0.00669788381462322,0.00335903516200513,0.00333884865261808,EPCI
246000848,CC de la Picardie Verte,1999_2010,2004.5,11,28451,32109,3010,4332,3658,1322,2336,0.0110564075529171,0.00399578206259061,0.00706062549032653,EPCI
246000855,CC du Pays des Sources,2010_2015,2012.5,5,21156,22038,741,1363,882,622,260,0.00820239337484674,0.00578445428475586,0.00241793909009088,EPCI
246000855,CC du Pays des Sources,1968_1975,1971.5,7,13806,13415,1291,1369,-391,78,-469,-0.00409584567869492,0.000817074074010751,-0.00491291975270567,EPCI
246000855,CC du Pays des Sources,1975_1982,1978.5,7,13415,14965,1164,1257,1550,93,1457,0.0157427252575164,0.000944563515450985,0.0147981617420654,EPCI
246000855,CC du Pays des Sources,1982_1990,1986,8,14965,16908,1271,1672,1943,401,1542,0.0153761070497551,0.00317334993667103,0.0122027571130841,EPCI
246000855,CC du Pays des Sources,1990_1999,1994.5,9,16908,18751,1274,2034,1843,760,1083,0.0115619060305909,0.00476779630127461,0.00679410972931632,EPCI
246000855,CC du Pays des Sources,1999_2010,2004.5,11,18751,21156,1553,2951,2405,1398,1007,0.0110309856445925,0.00641219040795854,0.00461879523663394,EPCI
246000871,CC du Pays de Valois,2010_2015,2012.5,5,53071,55142,1983,3435,2071,1452,619,0.00768559100603494,0.00538844912639437,0.00229714187964057,EPCI
246000871,CC du Pays de Valois,1968_1975,1971.5,7,30448,34355,2414,3879,3907,1465,2442,0.0173963350532591,0.00652306906911302,0.0108732659841461,EPCI
246000871,CC du Pays de Valois,1975_1982,1978.5,7,34355,39776,2491,3741,5421,1250,4171,0.0211514652897482,0.00487720561006922,0.016274259679679,EPCI
246000871,CC du Pays de Valois,1982_1990,1986,8,39776,46184,3043,4954,6408,1911,4497,0.0188466098219833,0.0056204543336158,0.0132261554883675,EPCI
246000871,CC du Pays de Valois,1990_1999,1994.5,9,46184,50100,3560,5893,3916,2333,1583,0.00908407764178554,0.00541193900364802,0.00367213863813751,EPCI
246000871,CC du Pays de Valois,1999_2010,2004.5,11,50100,53071,4458,7691,2971,3233,-262,0.00525097754772674,0.00571403918269962,-0.000463061634972874,EPCI
246000897,CC de la Plaine d'Estrées,2010_2015,2012.5,5,16671,17579,566,984,908,418,490,0.0106633171797292,0.00490888389991941,0.00575443327980983,EPCI
246000897,CC de la Plaine d'Estrées,1968_1975,1971.5,7,10251,11555,809,1168,1304,359,945,0.0172532881391381,0.00474994665793755,0.0125033414812005,EPCI
246000897,CC de la Plaine d'Estrées,1975_1982,1978.5,7,11555,13280,754,1225,1725,471,1254,0.0200761399036162,0.00548165906933522,0.014594480834281,EPCI
246000897,CC de la Plaine d'Estrées,1982_1990,1986,8,13280,14914,879,1528,1634,649,985,0.0146108633638309,0.00580321317204789,0.008807650191783,EPCI
246000897,CC de la Plaine d'Estrées,1990_1999,1994.5,9,14914,15843,963,1714,929,751,178,0.00673674527564661,0.00544595877503832,0.00129078650060828,EPCI
246000897,CC de la Plaine d'Estrées,1999_2010,2004.5,11,15843,16671,1154,2265,828,1111,-283,0.0046419150605399,0.00622846332398531,-0.0015865482634454,EPCI
246000913,CC du Pays de Bray,2010_2015,2012.5,5,18001,18492,600,1152,491,552,-61,0.00539668878805966,0.00606715317924426,-0.000670464391184601,EPCI
246000913,CC du Pays de Bray,1968_1975,1971.5,7,11080,11514,842,1298,434,456,-22,0.00550394922686337,0.00578295126140483,-0.000279002034541461,EPCI
246000913,CC du Pays de Bray,1975_1982,1978.5,7,11514,12815,839,1124,1301,285,1016,0.0154107790858586,0.00337592009182914,0.0120348589940295,EPCI
246000913,CC du Pays de Bray,1982_1990,1986,8,12815,15199,896,1630,2384,734,1650,0.0215556980645772,0.00663669562894283,0.0149190024356344,EPCI
246000913,CC du Pays de Bray,1990_1999,1994.5,9,15199,16792,1043,1764,1593,721,872,0.0111363241129319,0.00504035761796853,0.00609596649496333,EPCI
246000913,CC du Pays de Bray,1999_2010,2004.5,11,16792,18001,1326,2504,1209,1178,31,0.00634044600973449,0.00617787047102335,0.000162575538711141,EPCI
246000921,CC des Pays d'Oise et d'Halatte,2010_2015,2012.5,5,33101,34189,1133,2136,1088,1003,85,0.00648905558175228,0.00598209811442788,0.000506957467324397,EPCI
246000921,CC des Pays d'Oise et d'Halatte,1968_1975,1971.5,7,19736,22079,1281,2557,2343,1276,1067,0.0161551851250128,0.00879812898826988,0.00735705613674292,EPCI
246000921,CC des Pays d'Oise et d'Halatte,1975_1982,1978.5,7,22079,25311,1334,2172,3232,838,2394,0.0197077043880556,0.00510985652140798,0.0145978478666476,EPCI
246000921,CC des Pays d'Oise et d'Halatte,1982_1990,1986,8,25311,29136,1515,2986,3825,1471,2354,0.0177475792750952,0.00682527819965098,0.0109223010754442,EPCI
246000921,CC des Pays d'Oise et d'Halatte,1990_1999,1994.5,9,29136,32751,1799,3918,3615,2119,1496,0.0130802491645452,0.00766723318939731,0.00541301597514789,EPCI
246000921,CC des Pays d'Oise et d'Halatte,1999_2010,2004.5,11,32751,33101,2348,4542,350,2194,-1844,0.000966830483265291,0.00606064594366871,-0.00509381546040342,EPCI
246100390,CC du Val d'Orne,2010_2015,2012.5,5,5776,5778,219,302,2,83,-81,6.92424878541154e-05,0.00287356324594579,-0.00280432075809167,EPCI
246100390,CC du Val d'Orne,1968_1975,1971.5,7,6510,5699,553,579,-811,26,-837,-0.0188274688958306,0.000603593330815779,-0.0194310622266464,EPCI
246100390,CC du Val d'Orne,1975_1982,1978.5,7,5699,5394,462,453,-305,-9,-296,-0.00782685173362852,-0.000230956280664448,-0.00759589545296407,EPCI
246100390,CC du Val d'Orne,1982_1990,1986,8,5394,5254,444,471,-140,27,-167,-0.00328179478236457,0.000632917565170309,-0.00391471234753488,EPCI
246100390,CC du Val d'Orne,1990_1999,1994.5,9,5254,5155,462,495,-99,33,-132,-0.00211138719009141,0.000703795730030469,-0.00281518292012188,EPCI
246100390,CC du Val d'Orne,1999_2010,2004.5,11,5155,5776,520,709,621,189,432,0.0103940360421364,0.00316340227369369,0.00723063376844271,EPCI
246100663,CU d'Alençon,2010_2015,2012.5,5,56839,56614,2502,3158,-225,656,-881,-0.000792966512433102,0.00231193792069384,-0.00310490443312695,EPCI
246100663,CU d'Alençon,1968_1975,1971.5,7,48530,53590,3005,7673,5060,4668,392,0.0142694677533046,0.0131640070103609,0.00110546074294376,EPCI
246100663,CU d'Alençon,1975_1982,1978.5,7,53590,56861,2816,6674,3271,3858,-587,0.00849980704983144,0.01002514692701,-0.00152533987717856,EPCI
246100663,CU d'Alençon,1982_1990,1986,8,56861,57340,3326,6782,479,3456,-2977,0.00104914588529947,0.00756962041669099,-0.00652047453139151,EPCI
246100663,CU d'Alençon,1990_1999,1994.5,9,57340,57942,3819,6834,602,3015,-2413,0.00116112355566567,0.00581526166168104,-0.00465413810601537,EPCI
246100663,CU d'Alençon,1999_2010,2004.5,11,57942,56839,5217,7550,-1103,2333,-3436,-0.00174572901962256,0.00369246219653619,-0.00543819121615875,EPCI
246200299,CA d'Hénin-Carvin,2010_2015,2012.5,5,123680,125608,5985,9160,1928,3175,-1247,0.00309846262957403,0.00510249940295516,-0.00200403677338113,EPCI
246200299,CA d'Hénin-Carvin,1968_1975,1971.5,7,127920,126887,9091,16596,-1033,7505,-8538,-0.00115763541132397,0.00841050702999648,-0.00956814244132044,EPCI
246200299,CA d'Hénin-Carvin,1975_1982,1978.5,7,126887,128905,9215,15304,2018,6089,-4071,0.00225665275207199,0.00680909742684159,-0.0045524446747696,EPCI
246200299,CA d'Hénin-Carvin,1982_1990,1986,8,128905,129039,10041,18053,134,8012,-7878,0.000129881596328651,0.00776575634168027,-0.00763587474535161,EPCI
246200299,CA d'Hénin-Carvin,1990_1999,1994.5,9,129039,125313,10615,16011,-3726,5396,-9122,-0.0032502704789269,0.00470704763936917,-0.00795731811829607,EPCI
246200299,CA d'Hénin-Carvin,1999_2010,2004.5,11,125313,123680,12775,19407,-1633,6632,-8265,-0.00119174591329807,0.00483996258235934,-0.00603170849565741,EPCI
246200364,CA de Lens - Liévin,2010_2015,2012.5,5,244561,242645,12483,17158,-1916,4675,-6591,-0.00157182273510548,0.00383521465898648,-0.00540703739409196,EPCI
246200364,CA de Lens - Liévin,1968_1975,1971.5,7,277620,262363,19127,34335,-15257,15208,-30465,-0.0080423758094712,0.00801654658913535,-0.0160589223986066,EPCI
246200364,CA de Lens - Liévin,1975_1982,1978.5,7,262363,254282,19528,29144,-8081,9616,-17697,-0.0044593351706782,0.00530639363955471,-0.00976572881023291,EPCI
246200364,CA de Lens - Liévin,1982_1990,1986,8,254282,251585,21457,34232,-2697,12775,-15472,-0.0013319849664456,0.00630927250513256,-0.00764125747157816,EPCI
246200364,CA de Lens - Liévin,1990_1999,1994.5,9,251585,250199,22757,32013,-1386,9256,-10642,-0.000613623143466802,0.0040979046290972,-0.004711527772564,EPCI
246200364,CA de Lens - Liévin,1999_2010,2004.5,11,250199,244561,27402,38233,-5638,10831,-16469,-0.00206983989109644,0.00397631001427199,-0.00604614990536843,EPCI
246200380,CC de la Terre des Deux Caps,2010_2015,2012.5,5,22016,22098,913,1295,82,382,-300,0.000743805474209047,0.00346504501399824,-0.0027212395397892,EPCI
246200380,CC de la Terre des Deux Caps,1968_1975,1971.5,7,18384,18467,1266,2389,83,1123,-1040,0.000643726296803981,0.00870969435314303,-0.00806596805633904,EPCI
246200380,CC de la Terre des Deux Caps,1975_1982,1978.5,7,18467,18977,1321,1800,510,479,31,0.0038993490572099,0.00366232980079126,0.000237019256418641,EPCI
246200380,CC de la Terre des Deux Caps,1982_1990,1986,8,18977,19701,1417,2270,724,853,-129,0.0046911788249755,0.0055270380355029,-0.000835859210527402,EPCI
246200380,CC de la Terre des Deux Caps,1990_1999,1994.5,9,19701,20561,1589,2452,860,863,-3,0.0047586958736856,0.00477529597557055,-1.66001018849496e-05,EPCI
246200380,CC de la Terre des Deux Caps,1999_2010,2004.5,11,20561,22016,1912,3218,1455,1306,149,0.00623512013851468,0.00559660955388328,0.000638510584631401,EPCI
246200729,CA du Boulonnais,2010_2015,2012.5,5,118261,116014,5782,7387,-2247,1605,-3852,-0.00382928408544836,0.0027352029181774,-0.00656448700362576,EPCI
246200729,CA du Boulonnais,1968_1975,1971.5,7,116128,120968,8582,16628,4840,8046,-3206,0.0058503348665746,0.00972557734224365,-0.00387524247566904,EPCI
246200729,CA du Boulonnais,1975_1982,1978.5,7,120968,120990,8885,14211,22,5326,-5304,2.59788721619358e-05,0.00628924877883956,-0.00626326990667762,EPCI
246200729,CA du Boulonnais,1982_1990,1986,8,120990,119925,9680,16257,-1065,6577,-7642,-0.00110455829656453,0.00682129569624874,-0.00792585399281326,EPCI
246200729,CA du Boulonnais,1990_1999,1994.5,9,119925,122755,10384,16540,2830,6156,-3326,0.00259491115275523,0.00564461945454459,-0.00304970830178936,EPCI
246200729,CA du Boulonnais,1999_2010,2004.5,11,122755,118261,12860,18408,-4494,5548,-10042,-0.00338484506494718,0.00417870948382888,-0.00756355454877606,EPCI
246200844,CC de la Région d'Audruicq,2010_2015,2012.5,5,26074,27082,880,1813,1008,933,75,0.00761497785124621,0.0070483872373142,0.000566590613932009,EPCI
246200844,CC de la Région d'Audruicq,1968_1975,1971.5,7,16047,16191,1267,2165,144,898,-754,0.00127704559880115,0.00796379824807941,-0.00668675264927825,EPCI
246200844,CC de la Région d'Audruicq,1975_1982,1978.5,7,16191,20172,1269,2271,3981,1002,2979,0.031904073054897,0.00803011333861008,0.0238739597162869,EPCI
246200844,CC de la Région d'Audruicq,1982_1990,1986,8,20172,22918,1377,3010,2746,1633,1113,0.0160813252331569,0.00956329355635293,0.00651803167680393,EPCI
246200844,CC de la Région d'Audruicq,1990_1999,1994.5,9,22918,24026,1437,2867,1108,1430,-322,0.00525977868816496,0.00678834253075442,-0.00152856384258946,EPCI
246200844,CC de la Région d'Audruicq,1999_2010,2004.5,11,24026,26074,1817,3862,2048,2045,3,0.00746427181815701,0.00745333782623588,1.0933991921128e-05,EPCI
246201016,CC du Pays de Lumbres,2010_2015,2012.5,5,23275,24168,947,1619,893,672,221,0.007558345354993,0.00568780299950201,0.00187054235549099,EPCI
246201016,CC du Pays de Lumbres,1968_1975,1971.5,7,17334,17368,1275,2324,34,1049,-1015,0.000279973737309813,0.0086380132481763,-0.00835803951086648,EPCI
246201016,CC du Pays de Lumbres,1975_1982,1978.5,7,17368,18535,1347,2052,1167,705,462,0.00933348843573234,0.00563848273109794,0.0036950057046344,EPCI
246201016,CC du Pays de Lumbres,1982_1990,1986,8,18535,20126,1457,2533,1591,1076,515,0.0103471244330018,0.00699780382772465,0.00334932060527713,EPCI
246201016,CC du Pays de Lumbres,1990_1999,1994.5,9,20126,20376,1539,2155,250,616,-366,0.00137263299571178,0.00338216770143382,-0.00200953470572204,EPCI
246201016,CC du Pays de Lumbres,1999_2010,2004.5,11,20376,23275,1941,3272,2899,1331,1568,0.0121663318166623,0.00558585293134787,0.0065804788853144,EPCI
246201149,CA du Calaisis,2010_2015,2012.5,5,100958,104575,4378,7438,3617,3060,557,0.00706482466527336,0.00597687682492023,0.00108794784035313,EPCI
246201149,CA du Calaisis,1968_1975,1971.5,7,92304,98090,6970,13826,5786,6856,-1070,0.00872324871506902,0.0103364315918619,-0.00161318287679292,EPCI
246201149,CA du Calaisis,1975_1982,1978.5,7,98090,99068,7337,12618,978,5281,-4303,0.00141829890145129,0.00765852402716181,-0.00624022512571052,EPCI
246201149,CA du Calaisis,1982_1990,1986,8,99068,100214,7781,14340,1146,6559,-5413,0.00143871100490434,0.00823429797658599,-0.00679558697168165,EPCI
246201149,CA du Calaisis,1990_1999,1994.5,9,100214,103070,7720,15021,2856,7301,-4445,0.00312715377553818,0.00799417006834884,-0.00486701629281065,EPCI
246201149,CA du Calaisis,1999_2010,2004.5,11,103070,100958,9490,17090,-2112,7600,-9712,-0.00188039168757126,0.00676656099694203,-0.00864695268451329,EPCI
246300701,Clermont Auvergne Métropole,2010_2015,2012.5,5,280440,286190,11448,15854,5750,4406,1344,0.00406747532916474,0.00311674718266084,0.000950728146503897,EPCI
246300701,Clermont Auvergne Métropole,1968_1975,1971.5,7,230379,263791,13975,32768,33412,18793,14619,0.019535707430929,0.0109881045657084,0.00854760286522062,EPCI
246300701,Clermont Auvergne Métropole,1975_1982,1978.5,7,263791,269841,14472,29152,6050,14680,-8630,0.00324464875702368,0.00787296590960457,-0.00462831715258089,EPCI
246300701,Clermont Auvergne Métropole,1982_1990,1986,8,269841,270032,16700,28486,191,11786,-11595,8.84506425034015e-05,0.00545800666253974,-0.00536955602003634,EPCI
246300701,Clermont Auvergne Métropole,1990_1999,1994.5,9,270032,275391,19236,27023,5359,7787,-2428,0.0021858783928792,0.00317623344753692,-0.000990355054657717,EPCI
246300701,Clermont Auvergne Métropole,1999_2010,2004.5,11,275391,280440,23829,33600,5049,9771,-4722,0.00165299126063601,0.00319892604628132,-0.00154593478564532,EPCI
246300966,CC du Massif du Sancy,2010_2015,2012.5,5,9825,9590,715,394,-235,-321,86,-0.00483015089351491,-0.00659778058220547,0.00176762968869056,EPCI
246300966,CC du Massif du Sancy,1968_1975,1971.5,7,13688,12930,1226,1232,-758,6,-764,-0.00810544993633144,6.41592343245233e-05,-0.00816960917065597,EPCI
246300966,CC du Massif du Sancy,1975_1982,1978.5,7,12930,12417,1137,967,-513,-170,-343,-0.00576669290385778,-0.00191098985118094,-0.00385570305267684,EPCI
246300966,CC du Massif du Sancy,1982_1990,1986,8,12417,11484,1254,991,-933,-263,-670,-0.00971645463076254,-0.00273893629998987,-0.00697751833077267,EPCI
246300966,CC du Massif du Sancy,1990_1999,1994.5,9,11484,10575,1269,911,-909,-358,-551,-0.00912060126525105,-0.00359205198345421,-0.00552854928179684,EPCI
246300966,CC du Massif du Sancy,1999_2010,2004.5,11,10575,9825,1537,958,-750,-579,-171,-0.00666519450207259,-0.00514553015560004,-0.00151966434647255,EPCI
246301097,CC Entre Dore et Allier,2010_2015,2012.5,5,17569,18738,1063,1101,1169,38,1131,0.012966862437799,0.000421506221245818,0.0125453562165532,EPCI
246301097,CC Entre Dore et Allier,1968_1975,1971.5,7,11429,12391,1471,1072,962,-399,1361,0.0116121056039538,-0.00481624754259621,0.01642835314655,EPCI
246301097,CC Entre Dore et Allier,1975_1982,1978.5,7,12391,13257,1430,869,866,-561,1427,0.00969747762620021,-0.0062820842359103,0.0159795618621105,EPCI
246301097,CC Entre Dore et Allier,1982_1990,1986,8,13257,14215,1543,1189,958,-354,1312,0.00875964690774511,-0.00323686326236093,0.011996510170106,EPCI
246301097,CC Entre Dore et Allier,1990_1999,1994.5,9,14215,14893,1735,1316,678,-419,1097,0.005190486230785,-0.00320768986828748,0.00839817609907248,EPCI
246301097,CC Entre Dore et Allier,1999_2010,2004.5,11,14893,17569,2128,2084,2676,-44,2720,0.0151356448092335,-0.000248867104486649,0.0153845119137201,EPCI
246400337,CC de la Vallée d'Ossau,2010_2015,2012.5,5,10170,9890,612,420,-280,-192,-88,-0.00556805349142409,-0.0038180938226908,-0.00174995966873328,EPCI
246400337,CC de la Vallée d'Ossau,1968_1975,1971.5,7,11500,11016,946,1050,-484,104,-588,-0.00612378330023811,0.00131585426286108,-0.00743963756309919,EPCI
246400337,CC de la Vallée d'Ossau,1975_1982,1978.5,7,11016,10609,904,764,-407,-140,-267,-0.00536357353433026,-0.00184496386930279,-0.00351860966502747,EPCI
246400337,CC de la Vallée d'Ossau,1982_1990,1986,8,10609,10469,996,784,-140,-212,72,-0.00165914561110103,-0.00251242049681013,0.000853274885709102,EPCI
246400337,CC de la Vallée d'Ossau,1990_1999,1994.5,9,10469,9953,1053,841,-516,-212,-304,-0.00560031456210086,-0.00230090443249105,-0.00329941012960981,EPCI
246400337,CC de la Vallée d'Ossau,1999_2010,2004.5,11,9953,10170,1242,1009,217,-233,450,0.0019626686810903,-0.0021073815792352,0.0040700502603255,EPCI
246401756,CC Pays de Nay,2010_2015,2012.5,5,27305,28493,1354,1359,1188,5,1183,0.0085541004985743,3.60021064754811e-05,0.00851809839209882,EPCI
246401756,CC Pays de Nay,1968_1975,1971.5,7,20993,21447,1913,2007,454,94,360,0.00306120833374624,0.000633818465577414,0.00242738986816882,EPCI
246401756,CC Pays de Nay,1975_1982,1978.5,7,21447,22897,1776,1785,1450,9,1441,0.00938968365169734,5.82807950795008e-05,0.00933140285661784,EPCI
246401756,CC Pays de Nay,1982_1990,1986,8,22897,23692,1965,1961,795,-4,799,0.00427555682378666,-2.15122355913794e-05,0.00429706905937804,EPCI
246401756,CC Pays de Nay,1990_1999,1994.5,9,23692,24533,2429,2123,841,-306,1147,0.00388326614878265,-0.00141293631572829,0.00529620246451094,EPCI
246401756,CC Pays de Nay,1999_2010,2004.5,11,24533,27305,2909,2947,2772,38,2734,0.00977938924834176,0.000134060891571785,0.00964532835676998,EPCI
246500482,CC de la Haute-Bigorre,2010_2015,2012.5,5,17474,17082,1135,647,-392,-488,96,-0.00452747680703636,-0.00563624663733098,0.00110876983029462,EPCI
246500482,CC de la Haute-Bigorre,1968_1975,1971.5,7,18786,18183,1868,1457,-603,-411,-192,-0.00464984440683369,-0.00316929693401102,-0.00148054747282267,EPCI
246500482,CC de la Haute-Bigorre,1975_1982,1978.5,7,18183,17802,1826,1206,-381,-620,239,-0.00302061175901436,-0.00491543120889476,0.0018948194498804,EPCI
246500482,CC de la Haute-Bigorre,1982_1990,1986,8,17802,17236,2014,1276,-566,-738,172,-0.00403067876806029,-0.00525554934775353,0.00122487057969323,EPCI
246500482,CC de la Haute-Bigorre,1990_1999,1994.5,9,17236,16918,2135,1303,-318,-832,514,-0.00206698038911113,-0.00540794869100773,0.0033409683018966,EPCI
246500482,CC de la Haute-Bigorre,1999_2010,2004.5,11,16918,17474,2306,1588,556,-718,1274,0.00294395385448643,-0.00380172458187276,0.00674567843635918,EPCI
246500573,CC Aure-Louron,2010_2015,2012.5,5,7159,7018,362,307,-141,-55,-86,-0.00397050247846342,-0.00154877756252119,-0.00242172491594223,EPCI
246500573,CC Aure-Louron,1968_1975,1971.5,7,6793,6222,636,491,-571,-145,-426,-0.0124647027737722,-0.00316529229806825,-0.00929941047570396,EPCI
246500573,CC Aure-Louron,1975_1982,1978.5,7,6222,6334,609,388,112,-221,333,0.00255190051792975,-0.00503544655770067,0.00758734707563042,EPCI
246500573,CC Aure-Louron,1982_1990,1986,8,6334,6707,705,536,373,-169,542,0.00717811617600161,-0.00325228320038679,0.0104303993763884,EPCI
246500573,CC Aure-Louron,1990_1999,1994.5,9,6707,6874,698,666,167,-32,199,0.00273645074388851,-0.000524349843140313,0.00326080058702882,EPCI
246500573,CC Aure-Louron,1999_2010,2004.5,11,6874,7159,824,775,285,-49,334,0.00369993045021788,-0.000636128393195355,0.00433605884341324,EPCI
246600282,CC Sud-Roussillon,2010_2015,2012.5,5,20975,22199,1276,967,1224,-309,1533,0.0114077761073137,-0.00287990426238557,0.0142876803696993,EPCI
246600282,CC Sud-Roussillon,1968_1975,1971.5,7,5309,6686,439,496,1377,57,1320,0.0334932960643279,0.00138643273468896,0.032106863329639,EPCI
246600282,CC Sud-Roussillon,1975_1982,1978.5,7,6686,9067,562,635,2381,73,2308,0.0444787441286778,0.00136369102116484,0.043115053107513,EPCI
246600282,CC Sud-Roussillon,1982_1990,1986,8,9067,13391,866,1058,4324,192,4132,0.049950136355124,0.00221795240059755,0.0477321839545265,EPCI
246600282,CC Sud-Roussillon,1990_1999,1994.5,9,13391,16734,1560,1401,3343,-159,3502,0.0250713225560586,-0.00119244399832884,0.0262637665543874,EPCI
246600282,CC Sud-Roussillon,1999_2010,2004.5,11,16734,20975,2715,1993,4241,-722,4963,0.0207476347474573,-0.0035321368280274,0.0242797715754847,EPCI
246600373,CC du Vallespir,2010_2015,2012.5,5,20163,20580,1335,870,417,-465,882,0.00410249001719842,-0.0045747190839263,0.00867720910112472,EPCI
246600373,CC du Vallespir,1968_1975,1971.5,7,12079,13645,1290,836,1566,-454,2020,0.0175674883899715,-0.00509300110411689,0.0226604894940884,EPCI
246600373,CC du Vallespir,1975_1982,1978.5,7,13645,15577,1533,935,1932,-598,2530,0.019097542402053,-0.00591114407682592,0.0250086864788789,EPCI
246600373,CC du Vallespir,1982_1990,1986,8,15577,17180,1917,1176,1603,-741,2344,0.0123190683977821,-0.00569459119323551,0.0180136595910176,EPCI
246600373,CC du Vallespir,1990_1999,1994.5,9,17180,18097,2265,1425,917,-840,1757,0.00579453062203394,-0.00530796698201583,0.0111024976040498,EPCI
246600373,CC du Vallespir,1999_2010,2004.5,11,18097,20163,2740,1765,2066,-975,3041,0.00987600014239187,-0.00466074546894099,0.0145367456113329,EPCI
246600399,CC Pyrénées Cerdagne,2010_2015,2012.5,5,8874,8751,393,224,-123,-169,46,-0.00278764197072223,-0.00383017474026063,0.0010425327695384,EPCI
246600399,CC Pyrénées Cerdagne,1968_1975,1971.5,7,5780,6433,469,567,653,98,555,0.0154085504331269,0.00231246239272043,0.0130960880404065,EPCI
246600399,CC Pyrénées Cerdagne,1975_1982,1978.5,7,6433,7068,494,540,635,46,589,0.0135389124374941,0.000980771609645239,0.0125581408278488,EPCI
246600399,CC Pyrénées Cerdagne,1982_1990,1986,8,7068,7409,586,708,341,122,219,0.00590711899473195,0.00211339741160498,0.00379372158312697,EPCI
246600399,CC Pyrénées Cerdagne,1990_1999,1994.5,9,7409,8043,715,747,634,32,602,0.00916470445549344,0.000462571833715758,0.00870213262177769,EPCI
246600399,CC Pyrénées Cerdagne,1999_2010,2004.5,11,8043,8874,905,628,831,-277,1108,0.00897856814562892,-0.00299285604854297,0.0119714241941719,EPCI
246600415,CC Roussillon-Conflent,2010_2015,2012.5,5,16997,18318,1078,1036,1321,-42,1363,0.0150820686288993,-0.000479520728549409,0.0155615893574487,EPCI
246600415,CC Roussillon-Conflent,1968_1975,1971.5,7,13292,12644,1318,977,-648,-341,-307,-0.00711450779999634,-0.00374389993796104,-0.0033706078620353,EPCI
246600415,CC Roussillon-Conflent,1975_1982,1978.5,7,12644,13004,1437,792,360,-645,1005,0.00401865437877347,-0.00720008909530246,0.0112187434740759,EPCI
246600415,CC Roussillon-Conflent,1982_1990,1986,8,13004,13521,1570,1067,517,-503,1020,0.00488527296588792,-0.00475298317570914,0.00963825614159706,EPCI
246600415,CC Roussillon-Conflent,1990_1999,1994.5,9,13521,14636,1848,1270,1115,-578,1693,0.00884334164261791,-0.00458426140756336,0.0134276030501813,EPCI
246600415,CC Roussillon-Conflent,1999_2010,2004.5,11,14636,16997,2178,1940,2361,-238,2599,0.0136885335760937,-0.00137986911948763,0.0150684026955813,EPCI
246600423,CC Agly Fenouillèdes,2010_2015,2012.5,5,6181,6013,490,248,-168,-242,74,-0.00549609661547335,-0.00791699631514613,0.00242089969967278,EPCI
246600423,CC Agly Fenouillèdes,1968_1975,1971.5,7,8077,7128,755,490,-949,-265,-684,-0.0176972212353025,-0.00494179518161766,-0.0127554260536848,EPCI
246600423,CC Agly Fenouillèdes,1975_1982,1978.5,7,7128,6736,761,357,-392,-404,12,-0.00804806992912188,-0.00829443941674806,0.000246369487626181,EPCI
246600423,CC Agly Fenouillèdes,1982_1990,1986,8,6736,6112,830,383,-624,-447,-177,-0.0120779964585742,-0.00865202630926711,-0.00342597014930711,EPCI
246600423,CC Agly Fenouillèdes,1990_1999,1994.5,9,6112,5750,858,394,-362,-464,102,-0.00676084164732305,-0.00866583017778424,0.00190498853046119,EPCI
246600423,CC Agly Fenouillèdes,1999_2010,2004.5,11,5750,6181,962,547,431,-415,846,0.00659256463074409,-0.00634782905280464,0.0129403936835487,EPCI
246600449,CC des Aspres,2010_2015,2012.5,5,18721,20530,912,1029,1809,117,1692,0.0186194891137954,0.00120424556457383,0.0174152435492216,EPCI
246600449,CC des Aspres,1968_1975,1971.5,7,10366,11908,1103,843,1542,-260,1802,0.0200088641755181,-0.00337373844723391,0.023382602622752,EPCI
246600449,CC des Aspres,1975_1982,1978.5,7,11908,12859,1168,848,951,-320,1271,0.011036675681928,-0.00371370790559092,0.0147503835875189,EPCI
246600449,CC des Aspres,1982_1990,1986,8,12859,14309,1399,1112,1450,-287,1737,0.0134451786525116,-0.00266121811949712,0.0161063967720087,EPCI
246600449,CC des Aspres,1990_1999,1994.5,9,14309,16040,1501,1500,1731,-1,1732,0.0127693847390222,-7.37688315368124e-06,0.0127767616221759,EPCI
246600449,CC des Aspres,1999_2010,2004.5,11,16040,18721,1906,2041,2681,135,2546,0.0141501134500635,0.000712519700021845,0.0134375937500416,EPCI
246600464,CC Pyrénées Catalanes,2010_2015,2012.5,5,5967,5990,188,200,23,12,11,0.00076972080061366,0.000401593461189736,0.000368127339423924,EPCI
246600464,CC Pyrénées Catalanes,1968_1975,1971.5,7,4522,4829,305,505,307,200,107,0.00942773992858847,0.00614185011634428,0.00328588981224419,EPCI
246600464,CC Pyrénées Catalanes,1975_1982,1978.5,7,4829,5189,291,440,360,149,211,0.0103245907607203,0.00427323339818703,0.00605135736253331,EPCI
246600464,CC Pyrénées Catalanes,1982_1990,1986,8,5189,5253,323,657,64,334,-270,0.00153346725858117,0.00800278225572047,-0.0064693149971393,EPCI
246600464,CC Pyrénées Catalanes,1990_1999,1994.5,9,5253,5926,360,761,673,401,272,0.0134845639484011,0.0080346361713356,0.00544992777706554,EPCI
246600464,CC Pyrénées Catalanes,1999_2010,2004.5,11,5926,5967,350,681,41,331,-290,0.000627000063193384,0.00506187855895146,-0.00443487849575808,EPCI
246600548,CC du Haut Vallespir,2010_2015,2012.5,5,10144,9738,973,332,-406,-641,235,-0.00813604970904114,-0.0128453395652595,0.00470928985621839,EPCI
246600548,CC du Haut Vallespir,1968_1975,1971.5,7,11350,11283,1314,572,-67,-742,675,-0.000845438953658295,-0.00936292094946948,0.00851748199581118,EPCI
246600548,CC du Haut Vallespir,1975_1982,1978.5,7,11283,10657,1477,578,-626,-899,273,-0.0081211601620762,-0.0116628162710967,0.00354165610902045,EPCI
246600548,CC du Haut Vallespir,1982_1990,1986,8,10657,10062,1712,628,-595,-1084,489,-0.00715565068754642,-0.0130365131853787,0.00588086249783227,EPCI
246600548,CC du Haut Vallespir,1990_1999,1994.5,9,10062,9734,1807,620,-328,-1187,859,-0.00367556635903998,-0.0133015160615258,0.00962594970248581,EPCI
246600548,CC du Haut Vallespir,1999_2010,2004.5,11,9734,10144,2123,840,410,-1283,1693,0.00375772317571133,-0.0117589239864332,0.0155166471621446,EPCI
246700306,CC de la Vallée de la Bruche,2010_2015,2012.5,5,21619,21339,1141,1027,-280,-114,-166,-0.0026038387662366,-0.0010601343548249,-0.0015437044114117,EPCI
246700306,CC de la Vallée de la Bruche,1968_1975,1971.5,7,19660,19399,1787,2039,-261,252,-513,-0.00190740663633648,0.00184163399370419,-0.00374904063004068,EPCI
246700306,CC de la Vallée de la Bruche,1975_1982,1978.5,7,19399,18881,1721,1576,-518,-145,-373,-0.00385901947716305,-0.00108022745982363,-0.00277879201733942,EPCI
246700306,CC de la Vallée de la Bruche,1982_1990,1986,8,18881,18635,1904,1871,-246,-33,-213,-0.00163798110290669,-0.000219729172341142,-0.00141825193056555,EPCI
246700306,CC de la Vallée de la Bruche,1990_1999,1994.5,9,18635,19989,1969,2004,1354,35,1319,0.00782384639087108,0.000202241228715279,0.0076216051621558,EPCI
246700306,CC de la Vallée de la Bruche,1999_2010,2004.5,11,19989,21619,2335,2535,1630,200,1430,0.00715185645920013,0.000877528399901857,0.00627432805929828,EPCI
246700488,Eurométropole de Strasbourg,2010_2015,2012.5,5,474715,487299,17649,32445,12584,14796,-2212,0.00524636900024467,0.00616856927269708,-0.000922200272452415,EPCI
246700488,Eurométropole de Strasbourg,1968_1975,1971.5,7,369808,397665,27114,48566,27857,21452,6405,0.0104291498676377,0.00803123534338094,0.00239791452425671,EPCI
246700488,Eurométropole de Strasbourg,1975_1982,1978.5,7,397665,409098,26728,43490,11433,16762,-5329,0.00405746557736308,0.00594867821287151,-0.00189121263550843,EPCI
246700488,Eurométropole de Strasbourg,1982_1990,1986,8,409098,430272,29106,51422,21174,22316,-1142,0.00632779024454999,0.00666907372708877,-0.000341283482538778,EPCI
246700488,Eurométropole de Strasbourg,1990_1999,1994.5,9,430272,458629,31411,58523,28357,27112,1245,0.00711676437824438,0.00680430637313403,0.000312458005110352,EPCI
246700488,Eurométropole de Strasbourg,1999_2010,2004.5,11,458629,474715,37011,70406,16086,33395,-17309,0.00313882670556764,0.00651629478008402,-0.00337746807451637,EPCI
246700744,CC des Portes de Rosheim,2010_2015,2012.5,5,17583,17838,613,863,255,250,5,0.00288384772785189,0.00282730169397244,5.65460338794489e-05,EPCI
246700744,CC des Portes de Rosheim,1968_1975,1971.5,7,10034,11119,996,1065,1085,69,1016,0.0147761074615689,0.000939678723362445,0.0138364287382064,EPCI
246700744,CC des Portes de Rosheim,1975_1982,1978.5,7,11119,12400,934,966,1281,32,1249,0.0156992608821478,0.000392175135229297,0.0153070857469185,EPCI
246700744,CC des Portes de Rosheim,1982_1990,1986,8,12400,13525,1074,1254,1125,180,945,0.0109145528566963,0.00174632845707141,0.00916822439962488,EPCI
246700744,CC des Portes de Rosheim,1990_1999,1994.5,9,13525,15645,1132,1615,2120,483,1637,0.0163106510982096,0.00371605871718644,0.0125945923810232,EPCI
246700744,CC des Portes de Rosheim,1999_2010,2004.5,11,15645,17583,1362,2127,1938,765,1173,0.0106730227518066,0.00421303529676576,0.00645998745504083,EPCI
246700777,CC de la Vallée de Villé,2010_2015,2012.5,5,10807,10963,477,544,156,67,89,0.00287049086610391,0.00123283902582668,0.00163765184027723,EPCI
246700777,CC de la Vallée de Villé,1968_1975,1971.5,7,8623,8839,821,864,216,43,173,0.00354063846262354,0.000704849323577834,0.0028357891390457,EPCI
246700777,CC de la Vallée de Villé,1975_1982,1978.5,7,8839,8922,729,706,83,-23,106,0.00133609014952829,-0.000370241848664466,0.00170633199819276,EPCI
246700777,CC de la Vallée de Villé,1982_1990,1986,8,8922,9092,809,791,170,-18,188,0.00236213160786125,-0.000250108052597074,0.00261223966045832,EPCI
246700777,CC de la Vallée de Villé,1990_1999,1994.5,9,9092,9768,841,887,676,46,630,0.0080003700453255,0.000544403878823925,0.00745596616650158,EPCI
246700777,CC de la Vallée de Villé,1999_2010,2004.5,11,9768,10807,1033,1168,1039,135,904,0.00923165450216268,0.00119949312588254,0.00803216137628013,EPCI
246700843,CC de la Basse-Zorn,2010_2015,2012.5,5,16810,17017,610,816,207,206,1,0.00245077765159407,0.00243893814603082,1.18395055632562e-05,EPCI
246700843,CC de la Basse-Zorn,1968_1975,1971.5,7,12605,13308,932,1324,703,392,311,0.00778324714378975,0.00434001832199941,0.00344322882179035,EPCI
246700843,CC de la Basse-Zorn,1975_1982,1978.5,7,13308,13880,965,1116,572,151,421,0.00603005041319382,0.00159184897271375,0.00443820144048007,EPCI
246700843,CC de la Basse-Zorn,1982_1990,1986,8,13880,14604,1047,1278,724,231,493,0.00637605463257618,0.00203434892282472,0.00434170570975146,EPCI
246700843,CC de la Basse-Zorn,1990_1999,1994.5,9,14604,15683,1069,1516,1079,447,632,0.0079516544012368,0.00329415154527604,0.00465750285596076,EPCI
246700843,CC de la Basse-Zorn,1999_2010,2004.5,11,15683,16810,1237,1787,1127,550,577,0.00632872631746806,0.00308855321615566,0.0032401731013124,EPCI
246700926,CC du Pays de Wissembourg,2010_2015,2012.5,5,16627,16289,704,723,-338,19,-357,-0.0040991448123473,0.000230425300102363,-0.00432957011244966,EPCI
246700926,CC du Pays de Wissembourg,1968_1975,1971.5,7,14307,14449,1158,1852,142,694,-552,0.00141189293039434,0.00690037812460334,-0.00548848519420899,EPCI
246700926,CC du Pays de Wissembourg,1975_1982,1978.5,7,14449,15104,1173,1643,655,470,185,0.00635358484469695,0.00455906088092758,0.00179452396376937,EPCI
246700926,CC du Pays de Wissembourg,1982_1990,1986,8,15104,15400,1234,1739,296,505,-209,0.00242893259083621,0.00414395594044691,-0.0017150233496107,EPCI
246700926,CC du Pays de Wissembourg,1990_1999,1994.5,9,15400,16560,1242,1906,1160,664,496,0.00810182576458507,0.00463759681696938,0.00346422894761568,EPCI
246700926,CC du Pays de Wissembourg,1999_2010,2004.5,11,16560,16627,1449,1961,67,512,-445,0.000367133840877054,0.00280556009744853,-0.00243842625657148,EPCI
246700959,CC du Pays de la Zorn,2010_2015,2012.5,5,15500,16002,605,884,502,279,223,0.0063950999877096,0.00355424879795015,0.00284085118975944,EPCI
246700959,CC du Pays de la Zorn,1968_1975,1971.5,7,12200,12343,1045,1221,143,176,-33,0.00166612201616734,0.00205061171220595,-0.000384489696038617,EPCI
246700959,CC du Pays de la Zorn,1975_1982,1978.5,7,12343,12830,1051,1047,487,-4,491,0.00554346242017623,-4.55315188515501e-05,0.00558899393902778,EPCI
246700959,CC du Pays de la Zorn,1982_1990,1986,8,12830,13215,1097,1222,385,125,260,0.00370263405448879,0.00120215391379506,0.00250048014069372,EPCI
246700959,CC du Pays de la Zorn,1990_1999,1994.5,9,13215,14175,1085,1371,960,286,674,0.00782235842295664,0.00233041094683917,0.00549194747611748,EPCI
246700959,CC du Pays de la Zorn,1999_2010,2004.5,11,14175,15500,1310,1685,1325,375,950,0.00815673860618071,0.00230851092627756,0.00584822767990315,EPCI
246700967,CC de Sélestat,2010_2015,2012.5,5,35987,36524,1303,2191,537,888,-351,0.00296675545927894,0.00490591964215958,-0.00193916418288065,EPCI
246700967,CC de Sélestat,1968_1975,1971.5,7,27118,28310,2127,3459,1192,1332,-140,0.00616426207207743,0.00688825258389861,-0.000723990511821175,EPCI
246700967,CC de Sélestat,1975_1982,1978.5,7,28310,28505,2139,2741,195,602,-407,0.000981111169243709,0.00302886627633186,-0.00204775510708815,EPCI
246700967,CC de Sélestat,1982_1990,1986,8,28505,29047,2222,3137,542,915,-373,0.00235723607986538,0.00397946681379487,-0.00162223073392949,EPCI
246700967,CC de Sélestat,1990_1999,1994.5,9,29047,31809,2322,3754,2762,1432,1330,0.0101437762351355,0.00525919173378496,0.00488458450135056,EPCI
246700967,CC de Sélestat,1999_2010,2004.5,11,31809,35987,2814,4853,4178,2039,2139,0.0112821224270552,0.00550604299396015,0.00577607943309503,EPCI
246701064,CC de la Région de Molsheim-Mutzig,2010_2015,2012.5,5,38464,39808,1427,2139,1344,712,632,0.00689267754912715,0.00365147798733522,0.00324119956179193,EPCI
246701064,CC de la Région de Molsheim-Mutzig,1968_1975,1971.5,7,24433,26713,2151,2728,2280,577,1703,0.012826659254775,0.00324604490789701,0.00958061434687799,EPCI
246701064,CC de la Région de Molsheim-Mutzig,1975_1982,1978.5,7,26713,28726,2238,2484,2013,246,1767,0.0104329472752276,0.00127496524078787,0.00915798203443972,EPCI
246701064,CC de la Région de Molsheim-Mutzig,1982_1990,1986,8,28726,31367,2369,3186,2641,817,1824,0.0110548771214356,0.00341985407353763,0.00763502304789797,EPCI
246701064,CC de la Région de Molsheim-Mutzig,1990_1999,1994.5,9,31367,35485,2498,3660,4118,1162,2956,0.013800322570104,0.00389411724780496,0.00990620532229903,EPCI
246701064,CC de la Région de Molsheim-Mutzig,1999_2010,2004.5,11,35485,38464,3091,4736,2979,1645,1334,0.00735534288484852,0.00406161095856858,0.00329373192627993,EPCI
246701080,CC du Pays de Sainte-Odile,2010_2015,2012.5,5,17600,17731,664,947,131,283,-152,0.00148422397789316,0.00320637699041042,-0.00172215301251726,EPCI
246701080,CC du Pays de Sainte-Odile,1968_1975,1971.5,7,10872,12736,990,1595,1864,605,1259,0.0228634449671836,0.00742080697700971,0.0154426379901739,EPCI
246701080,CC du Pays de Sainte-Odile,1975_1982,1978.5,7,12736,14181,889,1429,1445,540,905,0.015471377391133,0.00578169120499089,0.00968968618614214,EPCI
246701080,CC du Pays de Sainte-Odile,1982_1990,1986,8,14181,15066,1052,1643,885,591,294,0.00759589214329837,0.00507251102450772,0.00252338111879064,EPCI
246701080,CC du Pays de Sainte-Odile,1990_1999,1994.5,9,15066,16836,1145,2010,1770,865,905,0.012418578194761,0.00606896617992557,0.00634961201483543,EPCI
246701080,CC du Pays de Sainte-Odile,1999_2010,2004.5,11,16836,17600,1327,2326,764,999,-235,0.00404264509106755,0.00528612885599017,-0.00124348376492261,EPCI
246701098,CC du Pays de Niederbronn-les-Bains,2010_2015,2012.5,5,23514,23304,1053,1157,-210,104,-314,-0.00179258515425573,0.000887756457345696,-0.00268034161160143,EPCI
246701098,CC du Pays de Niederbronn-les-Bains,1968_1975,1971.5,7,20742,21801,1652,2331,1059,679,380,0.00713896321280871,0.00457729558215025,0.00256166763065846,EPCI
246701098,CC du Pays de Niederbronn-les-Bains,1975_1982,1978.5,7,21801,22313,1740,2044,512,304,208,0.00332173734682573,0.00197228154967777,0.00134945579714795,EPCI
246701098,CC du Pays de Niederbronn-les-Bains,1982_1990,1986,8,22313,22552,1841,2277,239,436,-197,0.00133267291531802,0.00243115226392744,-0.00109847934860942,EPCI
246701098,CC du Pays de Niederbronn-les-Bains,1990_1999,1994.5,9,22552,22898,2025,2306,346,281,65,0.00169318923886785,0.00137510455526551,0.000318084683602342,EPCI
246701098,CC du Pays de Niederbronn-les-Bains,1999_2010,2004.5,11,22898,23514,2344,2702,616,358,258,0.00241622510045803,0.00140423471747398,0.00101199038298404,EPCI
246800205,CC de la Vallée de Saint-Amarin,2010_2015,2012.5,5,13016,12547,709,549,-469,-160,-309,-0.00731268658658868,-0.00249473316386821,-0.00481795342272047,EPCI
246800205,CC de la Vallée de Saint-Amarin,1968_1975,1971.5,7,13075,12353,1238,1129,-722,-109,-613,-0.00808188756846506,-0.00122011876033614,-0.00686176880812892,EPCI
246800205,CC de la Vallée de Saint-Amarin,1975_1982,1978.5,7,12353,12536,1092,951,183,-141,324,0.00210300199890523,-0.00162034580243518,0.00372334780134041,EPCI
246800205,CC de la Vallée de Saint-Amarin,1982_1990,1986,8,12536,12824,1167,1193,288,26,262,0.00284327323747879,0.000256684389494613,0.00258658884798418,EPCI
246800205,CC de la Vallée de Saint-Amarin,1990_1999,1994.5,9,12824,13137,1261,1262,313,1,312,0.00268295505265459,8.57174138228304e-06,0.00267438331127231,EPCI
246800205,CC de la Vallée de Saint-Amarin,1999_2010,2004.5,11,13137,13016,1477,1434,-121,-43,-78,-0.000840855970560273,-0.00029881658457927,-0.000542039385981002,EPCI
246800395,CC du Val d'Argent,2010_2015,2012.5,5,10103,9653,621,528,-450,-93,-357,-0.00907133720697106,-0.00187474302277402,-0.00719659418419704,EPCI
246800395,CC du Val d'Argent,1968_1975,1971.5,7,12187,11320,1431,1148,-867,-283,-584,-0.0104872974934778,-0.00342318937791719,-0.00706410811556057,EPCI
246800395,CC du Val d'Argent,1975_1982,1978.5,7,11320,10624,1299,904,-696,-395,-301,-0.00902410471664272,-0.00512143874004867,-0.00390266597659405,EPCI
246800395,CC du Val d'Argent,1982_1990,1986,8,10624,10021,1229,1072,-603,-157,-446,-0.0072774776853447,-0.00189479933101015,-0.00538267835433456,EPCI
246800395,CC du Val d'Argent,1990_1999,1994.5,9,10021,10303,1217,1105,282,-112,394,0.00308833955645693,-0.0012265745756141,0.00431491413207103,EPCI
246800395,CC du Val d'Argent,1999_2010,2004.5,11,10303,10103,1299,1323,-200,24,-224,-0.00178047720445618,0.000213657264534741,-0.00199413446899092,EPCI
246800445,CC du Centre du Haut-Rhin,2010_2015,2012.5,5,14291,15261,546,885,970,339,631,0.0132207485792224,0.00462044718387257,0.00860030139534983,EPCI
246800445,CC du Centre du Haut-Rhin,1968_1975,1971.5,7,10204,10836,764,1035,632,271,361,0.00862183056482579,0.00369701911877815,0.00492481144604764,EPCI
246800445,CC du Centre du Haut-Rhin,1975_1982,1978.5,7,10836,11363,709,923,527,214,313,0.0068071409355277,0.00276419005731106,0.00404295087821664,EPCI
246800445,CC du Centre du Haut-Rhin,1982_1990,1986,8,11363,12044,881,1211,681,330,351,0.00730204934784418,0.00353843800996854,0.00376361133787563,EPCI
246800445,CC du Centre du Haut-Rhin,1990_1999,1994.5,9,12044,12883,930,1263,839,333,506,0.00751050812773269,0.00298092873246124,0.00452957939527144,EPCI
246800445,CC du Centre du Haut-Rhin,1999_2010,2004.5,11,12883,14291,1111,1785,1408,674,734,0.00947380924879937,0.00453504789324629,0.00493876135555308,EPCI
246800494,"CC du Pays de Rouffach, Vignobles et Châteaux",2010_2015,2012.5,5,13214,13255,552,677,41,125,-84,0.000619785214191593,0.00188958906765729,-0.0012698038534657,EPCI
246800494,"CC du Pays de Rouffach, Vignobles et Châteaux",1968_1975,1971.5,7,11875,11703,851,1115,-172,264,-436,-0.00208213373569377,0.00319583317571602,-0.00527796691140979,EPCI
246800494,"CC du Pays de Rouffach, Vignobles et Châteaux",1975_1982,1978.5,7,11703,11653,808,826,-50,18,-68,-0.000611464636614989,0.000220127269181396,-0.000831591905796385,EPCI
246800494,"CC du Pays de Rouffach, Vignobles et Châteaux",1982_1990,1986,8,11653,11708,901,1020,55,119,-64,0.000588762157253342,0.00127386721296632,-0.00068510505571298,EPCI
246800494,"CC du Pays de Rouffach, Vignobles et Châteaux",1990_1999,1994.5,9,11708,12006,927,1269,298,342,-44,0.00279658717456188,0.00320950608624216,-0.000412918911680278,EPCI
246800494,"CC du Pays de Rouffach, Vignobles et Châteaux",1999_2010,2004.5,11,12006,13214,1062,1497,1208,435,773,0.00875357668131072,0.00315215716586934,0.00560141951544138,EPCI
246800551,CC de la Vallée de Kaysersberg,2010_2015,2012.5,5,17196,16837,877,757,-359,-120,-239,-0.00421070062769224,-0.00140747653293334,-0.0028032240947589,EPCI
246800551,CC de la Vallée de Kaysersberg,1968_1975,1971.5,7,14659,14824,1358,1459,165,101,64,0.00160028018036673,0.000979565443739635,0.000620714736627096,EPCI
246800551,CC de la Vallée de Kaysersberg,1975_1982,1978.5,7,14824,14755,1371,1111,-69,-260,191,-0.000666275166939512,-0.0025106020783228,0.00184432691138329,EPCI
246800551,CC de la Vallée de Kaysersberg,1982_1990,1986,8,14755,15673,1412,1481,918,69,849,0.0075732176308505,0.000569228776175038,0.00700398885467547,EPCI
246800551,CC de la Vallée de Kaysersberg,1990_1999,1994.5,9,15673,16574,1588,1811,901,223,678,0.00622996106611162,0.0015419326501031,0.00468802841600852,EPCI
246800551,CC de la Vallée de Kaysersberg,1999_2010,2004.5,11,16574,17196,1783,2029,622,246,376,0.00335485097664612,0.00132683816761245,0.00202801280903367,EPCI
246800569,CC de la Région de Guebwiller,2010_2015,2012.5,5,38871,38532,1660,2061,-339,401,-740,-0.00175034763558546,0.00207047021200522,-0.00382081784759068,EPCI
246800569,CC de la Région de Guebwiller,1968_1975,1971.5,7,30883,32287,2933,3535,1404,602,802,0.00637146939397337,0.00273192633559257,0.0036395430583808,EPCI
246800569,CC de la Région de Guebwiller,1975_1982,1978.5,7,32287,32391,2783,3118,104,335,-231,0.000459524692024038,0.00148019972911589,-0.00102067503709185,EPCI
246800569,CC de la Région de Guebwiller,1982_1990,1986,8,32391,33635,2743,3601,1244,858,386,0.00472193650203034,0.00325676970959971,0.00146516679243064,EPCI
246800569,CC de la Région de Guebwiller,1990_1999,1994.5,9,33635,36769,2861,4069,3134,1208,1926,0.00994781012629264,0.0038343824609322,0.00611342766536045,EPCI
246800569,CC de la Région de Guebwiller,1999_2010,2004.5,11,36769,38871,3458,5061,2102,1603,499,0.00506673566227711,0.00386392829049962,0.00120280737177749,EPCI
246800577,CC du Pays de Ribeauvillé,2010_2015,2012.5,5,18280,18102,953,951,-178,-2,-176,-0.00195511359484157,-2.1967568481366e-05,-0.00193314602636021,EPCI
246800577,CC du Pays de Ribeauvillé,1968_1975,1971.5,7,15679,15907,1648,1451,228,-197,425,0.00206456063907434,-0.00178385283288441,0.00384841347195875,EPCI
246800577,CC du Pays de Ribeauvillé,1975_1982,1978.5,7,15907,16184,1597,1289,277,-308,585,0.00246930600496809,-0.00274565433043383,0.00521496033540191,EPCI
246800577,CC du Pays de Ribeauvillé,1982_1990,1986,8,16184,16627,1880,1631,443,-249,692,0.0033813012694659,-0.00190055082640408,0.00528185209586998,EPCI
246800577,CC du Pays de Ribeauvillé,1990_1999,1994.5,9,16627,17679,1742,1880,1052,138,914,0.00683990989043548,0.000897250536958267,0.00594265935347721,EPCI
246800577,CC du Pays de Ribeauvillé,1999_2010,2004.5,11,17679,18280,2103,2187,601,84,517,0.00304372014761278,0.000425411800997461,0.00261830834661532,EPCI
246800585,CC de la Vallée de Munster,2010_2015,2012.5,5,16792,16310,754,718,-482,-36,-446,-0.0058079017265541,-0.000433785191194912,-0.00537411653535919,EPCI
246800585,CC de la Vallée de Munster,1968_1975,1971.5,7,15323,15303,1567,1477,-20,-90,70,-0.00018656544980733,-0.000839544524132985,0.000652979074325655,EPCI
246800585,CC de la Vallée de Munster,1975_1982,1978.5,7,15303,14726,1415,1176,-577,-239,-338,-0.00547556111893133,-0.00226804004752961,-0.00320752107140171,EPCI
246800585,CC de la Vallée de Munster,1982_1990,1986,8,14726,15097,1422,1428,371,6,365,0.00311501782102219,5.03776467011675e-05,0.00306464017432103,EPCI
246800585,CC de la Vallée de Munster,1990_1999,1994.5,9,15097,16194,1499,1635,1097,136,961,0.00782431282988805,0.000970015081918664,0.00685429774796938,EPCI
246800585,CC de la Vallée de Munster,1999_2010,2004.5,11,16194,16792,1759,1935,598,176,422,0.00330196490210177,0.000971815757140321,0.00233014914496145,EPCI
246800676,CC de la Vallée de la Doller et du Soultzbach,2010_2015,2012.5,5,16023,16267,661,851,244,190,54,0.00302723801027027,0.00235727549980062,0.000669962510469651,EPCI
246800676,CC de la Vallée de la Doller et du Soultzbach,1968_1975,1971.5,7,11892,12190,1002,1251,298,249,49,0.00354197779583587,0.00295957205088299,0.000582405744952878,EPCI
246800676,CC de la Vallée de la Doller et du Soultzbach,1975_1982,1978.5,7,12190,12613,1050,1133,423,83,340,0.00488504807528556,0.000958531891840902,0.00392651618344466,EPCI
246800676,CC de la Vallée de la Doller et du Soultzbach,1982_1990,1986,8,12613,13548,1041,1424,935,383,552,0.0089789343026061,0.00367800196566646,0.00530093233693964,EPCI
246800676,CC de la Vallée de la Doller et du Soultzbach,1990_1999,1994.5,9,13548,14598,1046,1484,1050,438,612,0.00832844547642164,0.00347415154159303,0.00485429393482862,EPCI
246800676,CC de la Vallée de la Doller et du Soultzbach,1999_2010,2004.5,11,14598,16023,1335,1780,1425,445,980,0.00850328170677694,0.00265541077860754,0.00584787092816941,EPCI
246800726,CA Colmar Agglomération,2010_2015,2012.5,5,109922,113975,4437,6693,4053,2256,1797,0.00726790448989534,0.00404549531931998,0.00322240917057536,EPCI
246800726,CA Colmar Agglomération,1968_1975,1971.5,7,85060,95130,7123,11666,10070,4543,5527,0.0161123530676996,0.00726895928367026,0.00884339378402939,EPCI
246800726,CA Colmar Agglomération,1975_1982,1978.5,7,95130,96142,6797,10142,1012,3345,-2333,0.00151284148136921,0.00500044936282609,-0.00348760788145688,EPCI
246800726,CA Colmar Agglomération,1982_1990,1986,8,96142,98724,7456,11745,2582,4289,-1707,0.00331821973403512,0.00551194594859668,-0.00219372621456156,EPCI
246800726,CA Colmar Agglomération,1990_1999,1994.5,9,98724,104149,8057,13010,5425,4953,472,0.00596153163665014,0.00544285091176556,0.000518680724884584,EPCI
246800726,CA Colmar Agglomération,1999_2010,2004.5,11,104149,109922,9476,14903,5773,5427,346,0.00491645148359243,0.00462178801341696,0.000294663470175469,EPCI
246900575,CC de l'Est Lyonnais (Ccel),2010_2015,2012.5,5,37940,40387,1183,2101,2447,918,1529,0.0125788538379354,0.00471899788444002,0.00785985595349542,EPCI
246900575,CC de l'Est Lyonnais (Ccel),1968_1975,1971.5,7,10482,16289,800,1426,5807,626,5181,0.0650010556993874,0.00700717424966704,0.0579938814497204,EPCI
246900575,CC de l'Est Lyonnais (Ccel),1975_1982,1978.5,7,16289,19854,842,1272,3565,430,3135,0.0286771308876999,0.00345895267369171,0.0252181782140081,EPCI
246900575,CC de l'Est Lyonnais (Ccel),1982_1990,1986,8,19854,29161,1193,2432,9307,1239,8068,0.049226617210852,0.0065533231679645,0.0426732940428875,EPCI
246900575,CC de l'Est Lyonnais (Ccel),1990_1999,1994.5,9,29161,33858,1547,3206,4697,1659,3038,0.0167321184465468,0.0059098540563809,0.0108222643901659,EPCI
246900575,CC de l'Est Lyonnais (Ccel),1999_2010,2004.5,11,33858,37940,2133,4176,4082,2043,2039,0.0104019697028892,0.00520608135791344,0.00519588834497577,EPCI
246900625,CC du Pays de l'Arbresle (Ccpa),2010_2015,2012.5,5,35964,37036,1186,2146,1072,960,112,0.00589168298611664,0.00527613401741789,0.000615548968698754,EPCI
246900625,CC du Pays de l'Arbresle (Ccpa),1968_1975,1971.5,7,17515,19117,1307,2036,1602,729,873,0.0125813930704717,0.00572524066690003,0.00685615240357165,EPCI
246900625,CC du Pays de l'Arbresle (Ccpa),1975_1982,1978.5,7,19117,23204,1346,2126,4087,780,3307,0.0280646950781058,0.00535611993171582,0.02270857514639,EPCI
246900625,CC du Pays de l'Arbresle (Ccpa),1982_1990,1986,8,23204,27124,1486,2826,3920,1340,2580,0.0197033823649682,0.00673533989006565,0.0129680424749025,EPCI
246900625,CC du Pays de l'Arbresle (Ccpa),1990_1999,1994.5,9,27124,31550,1926,3431,4426,1505,2921,0.016936788698684,0.00575912042284668,0.0111776682758373,EPCI
246900625,CC du Pays de l'Arbresle (Ccpa),1999_2010,2004.5,11,31550,35964,2801,4717,4414,1916,2498,0.0119752127083581,0.0051981213296815,0.00677709137867661,EPCI
246900724,CC des Vallons du Lyonnais (Ccvl),2010_2015,2012.5,5,26878,28657,1052,1518,1779,466,1313,0.0129004284035701,0.0033792015941898,0.00952122680938028,EPCI
246900724,CC des Vallons du Lyonnais (Ccvl),1968_1975,1971.5,7,10307,12523,786,1292,2216,506,1710,0.0282111300391605,0.00644171110099965,0.0217694189381609,EPCI
246900724,CC des Vallons du Lyonnais (Ccvl),1975_1982,1978.5,7,12523,15467,848,1287,2944,439,2505,0.0306226248761909,0.00456634929369831,0.0260562755824926,EPCI
246900724,CC des Vallons du Lyonnais (Ccvl),1982_1990,1986,8,15467,17825,1026,1667,2358,641,1717,0.0178948841028173,0.00486455500844184,0.0130303290943754,EPCI
246900724,CC des Vallons du Lyonnais (Ccvl),1990_1999,1994.5,9,17825,22182,1459,2194,4357,735,3622,0.0245952811786245,0.00414907772923779,0.0204462034493867,EPCI
246900724,CC des Vallons du Lyonnais (Ccvl),1999_2010,2004.5,11,22182,26878,2091,3294,4696,1203,3493,0.0176102601703703,0.00451131664926649,0.0130989435211038,EPCI
246900740,CC du Pays Mornantais (Copamo),2010_2015,2012.5,5,25985,27926,738,1624,1941,886,1055,0.0145120329830069,0.00662424586447402,0.00788778711853283,EPCI
246900740,CC du Pays Mornantais (Copamo),1968_1975,1971.5,7,11126,12759,917,1314,1633,397,1236,0.0197572400726518,0.00480319920933421,0.0149540408633176,EPCI
246900740,CC du Pays Mornantais (Copamo),1975_1982,1978.5,7,12759,15481,864,1327,2722,463,2259,0.0280103375300866,0.00476443287157609,0.0232459046585106,EPCI
246900740,CC du Pays Mornantais (Copamo),1982_1990,1986,8,15481,18778,1022,1842,3297,820,2477,0.024427646820357,0.00607542323102601,0.018352223589331,EPCI
246900740,CC du Pays Mornantais (Copamo),1990_1999,1994.5,9,18778,22772,1247,2633,3994,1386,2608,0.021658517519384,0.0075159502458353,0.0141425672735487,EPCI
246900740,CC du Pays Mornantais (Copamo),1999_2010,2004.5,11,22772,25985,1573,3347,3213,1774,1439,0.0120711606243045,0.00666487362200938,0.00540628700229509,EPCI
246900757,CC de la Vallée du Garon (Ccvg),2010_2015,2012.5,5,28517,30283,849,1621,1766,772,994,0.0120897165540725,0.00528497235546093,0.00680474419861161,EPCI
246900757,CC de la Vallée du Garon (Ccvg),1968_1975,1971.5,7,11285,16317,793,1643,5032,850,4182,0.0540882307209243,0.00913652545961559,0.0449517052613087,EPCI
246900757,CC de la Vallée du Garon (Ccvg),1975_1982,1978.5,7,16317,20661,863,1958,4344,1095,3249,0.0342950162094413,0.008644807262739,0.0256502089467023,EPCI
246900757,CC de la Vallée du Garon (Ccvg),1982_1990,1986,8,20661,23999,957,2356,3338,1399,1939,0.0188968650530108,0.00791992636583646,0.0109769386871743,EPCI
246900757,CC de la Vallée du Garon (Ccvg),1990_1999,1994.5,9,23999,27515,1256,2687,3516,1431,2085,0.0153069863905584,0.00622989121868289,0.00907709517187549,EPCI
246900757,CC de la Vallée du Garon (Ccvg),1999_2010,2004.5,11,27515,28517,1610,3610,1002,2000,-998,0.00325702809612793,0.00650105408408769,-0.00324402598795976,EPCI
246900765,CC du Pays de l'Ozon,2010_2015,2012.5,5,24070,25290,776,1459,1220,683,537,0.00993761516019953,0.00556343537247236,0.00437417978772717,EPCI
246900765,CC du Pays de l'Ozon,1968_1975,1971.5,7,9704,12725,653,1431,3021,778,2243,0.0394779617322416,0.0101667839217756,0.029311177810466,EPCI
246900765,CC du Pays de l'Ozon,1975_1982,1978.5,7,12725,17456,725,1531,4731,806,3925,0.0461944705447395,0.0078699520733587,0.0383245184713808,EPCI
246900765,CC du Pays de l'Ozon,1982_1990,1986,8,17456,19589,825,1757,2133,932,1201,0.0145149275694325,0.00634219995063812,0.0081727276187944,EPCI
246900765,CC du Pays de l'Ozon,1990_1999,1994.5,9,19589,22010,1058,2197,2421,1139,1282,0.0130318181474003,0.00613103712097849,0.0069007810264218,EPCI
246900765,CC du Pays de l'Ozon,1999_2010,2004.5,11,22010,24070,1500,2964,2060,1464,596,0.00816674524800676,0.00580393934130189,0.00236280590670487,EPCI
247000011,CA de Vesoul,2010_2015,2012.5,5,32756,32437,1494,1849,-319,355,-674,-0.00195536674645957,0.00217603509402241,-0.00413140184048199,EPCI
247000011,CA de Vesoul,1968_1975,1971.5,7,25160,29584,1813,3933,4424,2120,2304,0.0234095499879965,0.0112179579508482,0.0121915920371483,EPCI
247000011,CA de Vesoul,1975_1982,1978.5,7,29584,32145,1829,3805,2561,1976,585,0.0119310774691956,0.00920570444323724,0.0027253730259584,EPCI
247000011,CA de Vesoul,1982_1990,1986,8,32145,32795,2052,4058,650,2006,-1356,0.00250552699364315,0.00773244176807408,-0.00522691477443094,EPCI
247000011,CA de Vesoul,1990_1999,1994.5,9,32795,33069,2288,3626,274,1338,-1064,0.000924896664883823,0.00451646619567356,-0.00359156953078974,EPCI
247000011,CA de Vesoul,1999_2010,2004.5,11,33069,32756,3125,4238,-313,1113,-1426,-0.000864184217673425,0.00307296177083234,-0.00393714598850576,EPCI
247000367,CC des Combes,2010_2015,2012.5,5,7539,7621,368,430,82,62,20,0.00216595178286139,0.00163767086021227,0.000528280922649118,EPCI
247000367,CC des Combes,1968_1975,1971.5,7,6656,6365,699,664,-291,-35,-256,-0.0063660036625568,-0.000765670543606488,-0.00560033311895031,EPCI
247000367,CC des Combes,1975_1982,1978.5,7,6365,6697,606,581,332,-25,357,0.00729007744639665,-0.000548951614939507,0.00783902906133615,EPCI
247000367,CC des Combes,1982_1990,1986,8,6697,6941,694,716,244,22,222,0.00448329395371339,0.000404231422056125,0.00407906253165726,EPCI
247000367,CC des Combes,1990_1999,1994.5,9,6941,6977,661,624,36,-37,73,0.000574961738242896,-0.000590932897638532,0.00116589463588143,EPCI
247000367,CC des Combes,1999_2010,2004.5,11,6977,7539,794,939,562,145,417,0.00706763341386529,0.00182349972421791,0.00524413368964738,EPCI
247000623,CC des Quatre Rivières,2010_2015,2012.5,5,10148,9726,571,447,-422,-124,-298,-0.00845880720623427,-0.00248552628808779,-0.00597328091814647,EPCI
247000623,CC des Quatre Rivières,1968_1975,1971.5,7,10997,10404,1119,1130,-593,11,-604,-0.0078876083751287,0.000146313140179453,-0.00803392151530815,EPCI
247000623,CC des Quatre Rivières,1975_1982,1978.5,7,10404,10092,1093,825,-312,-268,-44,-0.00434017080442328,-0.00372809543456872,-0.000612075369854566,EPCI
247000623,CC des Quatre Rivières,1982_1990,1986,8,10092,9834,1023,807,-258,-216,-42,-0.00323192377779502,-0.00270579665117723,-0.000526127126617794,EPCI
247000623,CC des Quatre Rivières,1990_1999,1994.5,9,9834,9434,1112,842,-400,-270,-130,-0.00460332585904699,-0.00310724495485672,-0.00149608090419027,EPCI
247000623,CC des Quatre Rivières,1999_2010,2004.5,11,9434,10148,1392,1193,714,-199,913,0.00665444827561212,-0.00185467115804876,0.00850911943366088,EPCI
247000664,CC du Pays de Lure,2010_2015,2012.5,5,19365,19694,860,1168,329,308,21,0.0033750241835202,0.00315959710797636,0.000215427075543843,EPCI
247000664,CC du Pays de Lure,1968_1975,1971.5,7,15558,17082,1293,2025,1524,732,792,0.0134395528070173,0.00645521827738624,0.00698433452963101,EPCI
247000664,CC du Pays de Lure,1975_1982,1978.5,7,17082,18149,1231,2113,1067,882,185,0.00869330999231766,0.00718603506394018,0.00150727492837748,EPCI
247000664,CC du Pays de Lure,1982_1990,1986,8,18149,18168,1373,2098,19,725,-706,0.00013080130736931,0.00499110251803948,-0.00486030121067017,EPCI
247000664,CC du Pays de Lure,1990_1999,1994.5,9,18168,18164,1635,2070,-4,435,-439,-2.44654304445424e-05,0.00266061556084399,-0.00268508099128853,EPCI
247000664,CC du Pays de Lure,1999_2010,2004.5,11,18164,19365,1824,2609,1201,785,416,0.00583749028605762,0.00381551196882201,0.00202197831723561,EPCI
247000698,CC des Monts de Gy,2010_2015,2012.5,5,6016,6150,274,333,134,59,75,0.00441561927755463,0.00194419057743077,0.00247142870012386,EPCI
247000698,CC des Monts de Gy,1968_1975,1971.5,7,5550,5229,488,541,-321,53,-374,-0.00847500756722786,0.00139930031483824,-0.0098743078820661,EPCI
247000698,CC des Monts de Gy,1975_1982,1978.5,7,5229,5134,509,465,-95,-44,-51,-0.00261585449683255,-0.00121155366169086,-0.00140430083514168,EPCI
247000698,CC des Monts de Gy,1982_1990,1986,8,5134,5018,450,509,-116,59,-175,-0.00285262781602968,0.00145090552711855,-0.00430353334314823,EPCI
247000698,CC des Monts de Gy,1990_1999,1994.5,9,5018,5361,520,533,343,13,330,0.00737361630851918,0.000279466507319969,0.00709414980119921,EPCI
247000698,CC des Monts de Gy,1999_2010,2004.5,11,5361,6016,612,769,655,157,498,0.0105343782839731,0.00252503418409736,0.00800934409987571,EPCI
247000706,CC du Pays Riolais,2010_2015,2012.5,5,11373,12366,335,873,993,538,455,0.0168826572965308,0.00914689791090995,0.00773575938562087,EPCI
247000706,CC du Pays Riolais,1968_1975,1971.5,7,5376,5811,497,551,435,54,381,0.0111774445686623,0.00138754484300636,0.00978989972565596,EPCI
247000706,CC du Pays Riolais,1975_1982,1978.5,7,5811,6782,479,545,971,66,905,0.0223196334811566,0.00151709146215895,0.0208025420189977,EPCI
247000706,CC du Pays Riolais,1982_1990,1986,8,6782,7561,526,685,779,159,620,0.013684209923728,0.00279305440035013,0.0108911555233779,EPCI
247000706,CC du Pays Riolais,1990_1999,1994.5,9,7561,8774,559,897,1213,338,875,0.0166695617541714,0.00464493971385816,0.0120246220403133,EPCI
247000706,CC du Pays Riolais,1999_2010,2004.5,11,8774,11373,724,1643,2599,919,1680,0.023866658716875,0.00843919175098427,0.0154274669658907,EPCI
247000714,CC du Pays de Villersexel,2010_2015,2012.5,5,7935,7934,494,394,-1,-100,99,-2.52060595686832e-05,-0.00252060595686832,0.00249539989729963,EPCI
247000714,CC du Pays de Villersexel,1968_1975,1971.5,7,7249,7250,694,819,1,125,-124,1.97059867093063e-05,0.00246324833866329,-0.00244354235195399,EPCI
247000714,CC du Pays de Villersexel,1975_1982,1978.5,7,7250,7611,692,650,361,-42,403,0.00696602212946806,-0.000810451328082157,0.00777647345755022,EPCI
247000714,CC du Pays de Villersexel,1982_1990,1986,8,7611,7580,780,770,-31,-10,-21,-0.000510041088671143,-0.000164529383442304,-0.000345511705228839,EPCI
247000714,CC du Pays de Villersexel,1990_1999,1994.5,9,7580,7368,882,669,-212,-213,1,-0.00314691590321359,-0.00316175984615327,1.48439429396869e-05,EPCI
247000714,CC du Pays de Villersexel,1999_2010,2004.5,11,7368,7935,1033,905,567,-128,695,0.00676249538094798,-0.0015266303505491,0.00828912573149708,EPCI
247000722,CC du Pays d'Héricourt,2010_2015,2012.5,5,21183,21039,858,1133,-144,275,-419,-0.001363292866712,0.00260351068295694,-0.00396680354966893,EPCI
247000722,CC du Pays d'Héricourt,1968_1975,1971.5,7,14141,15944,1039,1838,1803,799,1004,0.0172912500749307,0.00766262274535199,0.00962862732957872,EPCI
247000722,CC du Pays d'Héricourt,1975_1982,1978.5,7,15944,18985,1090,1720,3041,630,2411,0.0252516424141818,0.00523134979313861,0.0200202926210432,EPCI
247000722,CC du Pays d'Héricourt,1982_1990,1986,8,18985,19007,1207,1896,22,689,-667,0.000144777814913288,0.00453417793069344,-0.00438940011578015,EPCI
247000722,CC du Pays d'Héricourt,1990_1999,1994.5,9,19007,19817,1396,1975,810,579,231,0.0046477477424951,0.00332227894185761,0.00132546880063749,EPCI
247000722,CC du Pays d'Héricourt,1999_2010,2004.5,11,19817,21183,1687,2625,1366,938,428,0.00607829084098266,0.00417381904014768,0.00190447180083498,EPCI
247000755,CC du Pays de Luxeuil,2010_2015,2012.5,5,16263,15464,861,797,-799,-64,-735,-0.0100249809038294,-0.000803002225087713,-0.0092219786787417,EPCI
247000755,CC du Pays de Luxeuil,1968_1975,1971.5,7,17473,18477,1322,2536,1004,1214,-210,0.00801334823633004,0.00968944697102059,-0.00167609873469055,EPCI
247000755,CC du Pays de Luxeuil,1975_1982,1978.5,7,18477,18897,1176,2105,420,929,-509,0.00321608395575579,0.00711367141642173,-0.00389758746066594,EPCI
247000755,CC du Pays de Luxeuil,1982_1990,1986,8,18897,17591,1334,2261,-1306,927,-2233,-0.00891202186296725,0.00632576130702193,-0.0152377831699892,EPCI
247000755,CC du Pays de Luxeuil,1990_1999,1994.5,9,17591,16977,1478,2174,-614,696,-1310,-0.00393976543397323,0.00446592303264718,-0.00840568846662041,EPCI
247000755,CC du Pays de Luxeuil,1999_2010,2004.5,11,16977,16263,1719,2273,-714,554,-1268,-0.00389846281195105,0.00302485770002925,-0.0069233205119803,EPCI
247000821,CC Rahin et Cherimont,2010_2015,2012.5,5,12035,12049,551,637,14,86,-72,0.000232546575984705,0.00142850039533461,-0.00119595381934991,EPCI
247000821,CC Rahin et Cherimont,1968_1975,1971.5,7,10187,10415,931,1076,228,145,83,0.00316710143087584,0.00201416538367104,0.0011529360472048,EPCI
247000821,CC Rahin et Cherimont,1975_1982,1978.5,7,10415,11212,952,932,797,-20,817,0.0105896141835649,-0.000265736867843535,0.0108553510514084,EPCI
247000821,CC Rahin et Cherimont,1982_1990,1986,8,11212,11205,1072,1054,-7,-18,11,-7.80627091545583e-05,-0.00020073268068315,0.000122669971528592,EPCI
247000821,CC Rahin et Cherimont,1990_1999,1994.5,9,11205,11064,1026,1038,-141,12,-153,-0.00140606754726325,0.00011966532317134,-0.00152573287043459,EPCI
247000821,CC Rahin et Cherimont,1999_2010,2004.5,11,11064,12035,1266,1550,971,284,687,0.00767681469528525,0.00224532994177241,0.00543148475351284,EPCI
247000854,CC de la Haute Vallée de l'Ognon,2010_2015,2012.5,5,8881,8703,453,360,-178,-93,-85,-0.0040410866388052,-0.00211135425510609,-0.00192973238369911,EPCI
247000854,CC de la Haute Vallée de l'Ognon,1968_1975,1971.5,7,11411,10680,911,1126,-731,215,-946,-0.00941326788364927,0.00276860820107331,-0.0121818760847226,EPCI
247000854,CC de la Haute Vallée de l'Ognon,1975_1982,1978.5,7,10680,10107,910,840,-573,-70,-503,-0.00784684868329066,-0.000958602805986643,-0.00688824587730402,EPCI
247000854,CC de la Haute Vallée de l'Ognon,1982_1990,1986,8,10107,9146,977,776,-961,-201,-760,-0.0124112901499956,-0.00259590980244446,-0.00981538034755119,EPCI
247000854,CC de la Haute Vallée de l'Ognon,1990_1999,1994.5,9,9146,8683,966,715,-463,-251,-212,-0.00575554349262364,-0.00312017584589316,-0.00263536764673048,EPCI
247000854,CC de la Haute Vallée de l'Ognon,1999_2010,2004.5,11,8683,8881,1089,914,198,-175,373,0.0020518359765993,-0.00181349139345898,0.00386532737005828,EPCI
247100290,CU Le Creusot Montceau-les-Mines,2010_2015,2012.5,5,98086,95642,5939,4809,-2444,-1130,-1314,-0.00503380586939028,-0.00232741433404706,-0.00270639153534322,EPCI
247100290,CU Le Creusot Montceau-les-Mines,1968_1975,1971.5,7,116628,119597,10215,12404,2969,2189,780,0.00359765254071709,0.00265249626528451,0.000945156275432579,EPCI
247100290,CU Le Creusot Montceau-les-Mines,1975_1982,1978.5,7,119597,120079,9727,11841,482,2114,-1632,0.000574751094601478,0.00252079629457993,-0.00194604519997845,EPCI
247100290,CU Le Creusot Montceau-les-Mines,1982_1990,1986,8,120079,112539,10658,11395,-7540,737,-8277,-0.0080734868320882,0.000789145861438859,-0.00886263269352705,EPCI
247100290,CU Le Creusot Montceau-les-Mines,1990_1999,1994.5,9,112539,104030,11024,9634,-8509,-1390,-7119,-0.00869756753007001,-0.00142080372156508,-0.00727676380850492,EPCI
247100290,CU Le Creusot Montceau-les-Mines,1999_2010,2004.5,11,104030,98086,12876,10612,-5944,-2264,-3680,-0.00533432841744808,-0.00203178323302531,-0.00330254518442277,EPCI
247100589,CA Le Grand Chalon,2010_2015,2012.5,5,112193,113746,4968,6451,1553,1483,70,0.00275324119144105,0.00262914145969548,0.000124099731745572,EPCI
247100589,CA Le Grand Chalon,1968_1975,1971.5,7,90865,104395,6756,12708,13530,5952,7578,0.0200274678004584,0.00881030956011296,0.0112171582403454,EPCI
247100589,CA Le Grand Chalon,1975_1982,1978.5,7,104395,107866,6895,11458,3471,4563,-1092,0.00468349550427138,0.00615695476404216,-0.00147345925977077,EPCI
247100589,CA Le Grand Chalon,1982_1990,1986,8,107866,110447,7627,12328,2581,4701,-2120,0.00296012903747966,0.0053915407226625,-0.00243141168518283,EPCI
247100589,CA Le Grand Chalon,1990_1999,1994.5,9,110447,110608,8404,12649,161,4245,-4084,0.000161863244803273,0.004267760709254,-0.00410589746445073,EPCI
247100589,CA Le Grand Chalon,1999_2010,2004.5,11,110608,112193,10564,14424,1585,3860,-2275,0.00129430810810582,0.0031520689572798,-0.00185776084917397,EPCI
247100639,CC de Marcigny,2010_2015,2012.5,5,6404,6235,370,319,-169,-51,-118,-0.00533456360981011,-0.00160983872248707,-0.00372472488732303,EPCI
247100639,CC de Marcigny,1968_1975,1971.5,7,7836,7454,748,796,-382,48,-430,-0.00711424438549013,0.000893936467286718,-0.00800818085277685,EPCI
247100639,CC de Marcigny,1975_1982,1978.5,7,7454,7135,709,619,-319,-90,-229,-0.006228883870533,-0.00175736535532279,-0.00447151851521021,EPCI
247100639,CC de Marcigny,1982_1990,1986,8,7135,6556,702,561,-579,-141,-438,-0.0105231884791034,-0.00256264175397854,-0.00796054672512484,EPCI
247100639,CC de Marcigny,1990_1999,1994.5,9,6556,6185,683,486,-371,-197,-174,-0.00645172600066202,-0.00342584911625449,-0.00302587688440752,EPCI
247100639,CC de Marcigny,1999_2010,2004.5,11,6185,6404,784,680,219,-104,323,0.00316826193791786,-0.00150456274677378,0.00467282468469164,EPCI
247100647,CC Bresse Nord Intercom,2010_2015,2012.5,5,6423,6529,480,272,106,-208,314,0.00327906318985516,-0.00643438814613088,0.00971345133598604,EPCI
247100647,CC Bresse Nord Intercom,1968_1975,1971.5,7,8084,7479,875,544,-605,-331,-274,-0.0110510133975699,-0.00604609162743079,-0.00500492177013908,EPCI
247100647,CC Bresse Nord Intercom,1975_1982,1978.5,7,7479,6827,890,377,-652,-513,-139,-0.0129460065117311,-0.0101860450007945,-0.00275996151093653,EPCI
247100647,CC Bresse Nord Intercom,1982_1990,1986,8,6827,6304,1004,434,-523,-570,47,-0.00991316069935799,-0.0108040183530288,0.000890857653670795,EPCI
247100647,CC Bresse Nord Intercom,1990_1999,1994.5,9,6304,6094,981,470,-210,-511,301,-0.00375733149772362,-0.00914283997779413,0.00538550848007051,EPCI
247100647,CC Bresse Nord Intercom,1999_2010,2004.5,11,6094,6423,1052,553,329,-499,828,0.0047914988490485,-0.00726734931816171,0.0120588481672102,EPCI
247103765,CC Entre Saône et Grosne,2010_2015,2012.5,5,11103,11349,594,540,246,-54,300,0.00439247722090563,-0.000964202316784163,0.0053566795376898,EPCI
247103765,CC Entre Saône et Grosne,1968_1975,1971.5,7,8717,8387,1009,712,-330,-297,-33,-0.00549800946511314,-0.00494820851860183,-0.000549800946511314,EPCI
247103765,CC Entre Saône et Grosne,1975_1982,1978.5,7,8387,8688,979,588,301,-391,692,0.00504983266901382,-0.00655974941390168,0.0116095820829155,EPCI
247103765,CC Entre Saône et Grosne,1982_1990,1986,8,8688,9097,1088,745,409,-343,752,0.00576680507461425,-0.00483622039264715,0.0106030254672614,EPCI
247103765,CC Entre Saône et Grosne,1990_1999,1994.5,9,9097,9997,1078,946,900,-132,1032,0.0105373935023418,-0.00154548438034347,0.0120828778826853,EPCI
247103765,CC Entre Saône et Grosne,1999_2010,2004.5,11,9997,11103,1296,1305,1106,9,1097,0.00958476004095288,7.79953348721301e-05,0.00950676470608075,EPCI
247103864,CC du Canton de Semur-en-Brionnais,2010_2015,2012.5,5,5032,5216,266,231,184,-35,219,0.00720851822580282,-0.00137118553208206,0.00857970375788488,EPCI
247103864,CC du Canton de Semur-en-Brionnais,1968_1975,1971.5,7,5593,5163,644,456,-430,-188,-242,-0.0113632323186876,-0.00496811087421692,-0.00639512144447071,EPCI
247103864,CC du Canton de Semur-en-Brionnais,1975_1982,1978.5,7,5163,5143,548,363,-20,-185,165,-0.000554309043194201,-0.00512735864954636,0.00457304960635216,EPCI
247103864,CC du Canton de Semur-en-Brionnais,1982_1990,1986,8,5143,4865,521,437,-278,-84,-194,-0.00692216209161956,-0.00209158854566922,-0.00483057354595034,EPCI
247103864,CC du Canton de Semur-en-Brionnais,1990_1999,1994.5,9,4865,4965,531,432,100,-99,199,0.00226328869755044,-0.00224065581057493,0.00450394450812537,EPCI
247103864,CC du Canton de Semur-en-Brionnais,1999_2010,2004.5,11,4965,5032,616,531,67,-85,152,0.00121930838012507,-0.00154688376583032,0.00276619214595539,EPCI
247104094,CC Sud Côte Chalonnaise,2010_2015,2012.5,5,11425,11495,633,558,70,-75,145,0.00122239079831665,-0.00130970442676784,0.00253209522508449,EPCI
247104094,CC Sud Côte Chalonnaise,1968_1975,1971.5,7,9119,8688,1001,697,-431,-304,-127,-0.00689290360128192,-0.00486181599719189,-0.00203108760409003,EPCI
247104094,CC Sud Côte Chalonnaise,1975_1982,1978.5,7,8688,9124,978,622,436,-356,792,0.00701960001804469,-0.00573160001473374,0.0127512000327784,EPCI
247104094,CC Sud Côte Chalonnaise,1982_1990,1986,8,9124,9635,1074,848,511,-226,737,0.00683500241466284,-0.00302291691920509,0.00985791933386793,EPCI
247104094,CC Sud Côte Chalonnaise,1990_1999,1994.5,9,9635,10290,1111,952,655,-159,814,0.00733457250381719,-0.00178045347802585,0.00911502598184305,EPCI
247104094,CC Sud Côte Chalonnaise,1999_2010,2004.5,11,10290,11425,1305,1285,1135,-20,1155,0.00955732658585617,-0.000168411041160461,0.00972573762701663,EPCI
247200090,CC de Sablé-sur-Sarthe,2010_2015,2012.5,5,29269,29160,1310,1796,-109,486,-595,-0.000745927318990258,0.00332587777091069,-0.00407180508990095,EPCI
247200090,CC de Sablé-sur-Sarthe,1968_1975,1971.5,7,19423,20788,1483,2609,1365,1126,239,0.00974978911611513,0.00804268318296383,0.00170710593315129,EPCI
247200090,CC de Sablé-sur-Sarthe,1975_1982,1978.5,7,20788,23074,1576,2746,2286,1170,1116,0.0150159875217943,0.00768534794422545,0.00733063957756889,EPCI
247200090,CC de Sablé-sur-Sarthe,1982_1990,1986,8,23074,24634,1971,2889,1560,918,642,0.00821117327244392,0.00483195965647661,0.0033792136159673,EPCI
247200090,CC de Sablé-sur-Sarthe,1990_1999,1994.5,9,24634,26699,2236,3249,2065,1013,1052,0.00898439836380827,0.00440735861624105,0.00457703974756721,EPCI
247200090,CC de Sablé-sur-Sarthe,1999_2010,2004.5,11,26699,29269,2778,4317,2570,1539,1031,0.00838980093604747,0.00502408701967979,0.00336571391636768,EPCI
247200132,CU Le Mans Métropole,2010_2015,2012.5,5,202571,205188,9049,12896,2617,3847,-1230,0.00257053611226343,0.00377869790748087,-0.00120816179521743,EPCI
247200132,CU Le Mans Métropole,1968_1975,1971.5,7,176177,199979,10513,28335,23802,17822,5980,0.0182681710826058,0.0136784868932947,0.0045896841893111,EPCI
247200132,CU Le Mans Métropole,1975_1982,1978.5,7,199979,201297,10876,23968,1318,13092,-11774,0.000938878809586763,0.0093261011950758,-0.00838722238548903,EPCI
247200132,CU Le Mans Métropole,1982_1990,1986,8,201297,202745,12140,23874,1448,11734,-10286,0.00089635178010461,0.00726366836170407,-0.00636731658159946,EPCI
247200132,CU Le Mans Métropole,1990_1999,1994.5,9,202745,205768,14222,24539,3023,10317,-7294,0.00164582942228053,0.00561694414477944,-0.00397111472249891,EPCI
247200132,CU Le Mans Métropole,1999_2010,2004.5,11,205768,202571,18771,27426,-3197,8655,-11852,-0.00142252163406176,0.00385108687607273,-0.00527360851013449,EPCI
247200348,CC du Pays Fléchois,2010_2015,2012.5,5,26698,27345,1090,1514,647,424,223,0.00480049373999325,0.00314591861786266,0.0016545751221306,EPCI
247200348,CC du Pays Fléchois,1968_1975,1971.5,7,22600,23088,1818,2996,488,1178,-690,0.00305653252074767,0.00737826907672285,-0.00432173655597519,EPCI
247200348,CC du Pays Fléchois,1975_1982,1978.5,7,23088,23475,1752,2386,387,634,-247,0.0023775394554717,0.0038949871182663,-0.0015174476627946,EPCI
247200348,CC du Pays Fléchois,1982_1990,1986,8,23475,23738,1848,2575,263,727,-464,0.00139360948994716,0.00385229695510107,-0.00245868746515392,EPCI
247200348,CC du Pays Fléchois,1990_1999,1994.5,9,23738,24360,2079,2873,622,794,-172,0.00287805625309701,0.00367391746777978,-0.000795861214682773,EPCI
247200348,CC du Pays Fléchois,1999_2010,2004.5,11,24360,26698,2624,3698,2338,1074,1264,0.00836627726092298,0.00384319152191244,0.00452308573901054,EPCI
247200421,CC du Sud Est du Pays Manceau,2010_2015,2012.5,5,16527,17125,695,885,598,190,408,0.00713412286427984,0.00226669455554042,0.00486742830873942,EPCI
247200421,CC du Sud Est du Pays Manceau,1968_1975,1971.5,7,9630,11373,610,1099,1743,489,1254,0.0240502084001122,0.00674730459417949,0.0173029038059327,EPCI
247200421,CC du Sud Est du Pays Manceau,1975_1982,1978.5,7,11373,12137,676,961,764,285,479,0.00933134128219582,0.00348093228458875,0.00585040899760706,EPCI
247200421,CC du Sud Est du Pays Manceau,1982_1990,1986,8,12137,12889,822,1124,752,302,450,0.00754275386595804,0.00302913785574379,0.00451361601021425,EPCI
247200421,CC du Sud Est du Pays Manceau,1990_1999,1994.5,9,12889,14117,1243,1418,1228,175,1053,0.0101630196134888,0.00144831305566819,0.00871470655782057,EPCI
247200421,CC du Sud Est du Pays Manceau,1999_2010,2004.5,11,14117,16527,1367,1957,2410,590,1820,0.0144318444106837,0.00353310713788522,0.0108987372727985,EPCI
247200447,CC Orée de Bercé - Belinois,2010_2015,2012.5,5,19110,19461,704,1167,351,463,-112,0.00364677428870763,0.00481041736658585,-0.00116364307787822,EPCI
247200447,CC Orée de Bercé - Belinois,1968_1975,1971.5,7,11239,12767,789,1445,1528,656,872,0.0183773723453551,0.00788976194931475,0.0104876103960403,EPCI
247200447,CC Orée de Bercé - Belinois,1975_1982,1978.5,7,12767,14226,756,1333,1459,577,882,0.015578319135072,0.0061608568477975,0.00941746228727451,EPCI
247200447,CC Orée de Bercé - Belinois,1982_1990,1986,8,14226,15194,941,1483,968,542,426,0.00826261563047837,0.00462638189227198,0.00363623373820639,EPCI
247200447,CC Orée de Bercé - Belinois,1990_1999,1994.5,9,15194,16135,1080,1682,941,602,339,0.00669902905439535,0.00428567002204676,0.00241335903234859,EPCI
247200447,CC Orée de Bercé - Belinois,1999_2010,2004.5,11,16135,19110,1393,2674,2975,1281,1694,0.0155026597204828,0.00667526289140789,0.00882739682907492,EPCI
247200629,CC du Val de Sarthe,2010_2015,2012.5,5,30000,30450,921,1736,450,815,-365,0.00298216031816145,0.00540102368733685,-0.0024188633691754,EPCI
247200629,CC du Val de Sarthe,1968_1975,1971.5,7,15297,17980,1272,1980,2683,708,1975,0.0233547340571565,0.00616293392190339,0.0171918001352531,EPCI
247200629,CC du Val de Sarthe,1975_1982,1978.5,7,17980,21542,1236,1840,3562,604,2958,0.0261568817711375,0.00443536119869934,0.0217215205724382,EPCI
247200629,CC du Val de Sarthe,1982_1990,1986,8,21542,23360,1411,2178,1818,767,1051,0.010179037508925,0.0042944564187819,0.00588458109014312,EPCI
247200629,CC du Val de Sarthe,1990_1999,1994.5,9,23360,24959,1597,2510,1599,913,686,0.00738371737666732,0.0042159687085036,0.00316774866816372,EPCI
247200629,CC du Val de Sarthe,1999_2010,2004.5,11,24959,30000,2064,4252,5041,2188,2853,0.0168645275507235,0.00731989412437673,0.00954463342634681,EPCI
247200686,CC du Pays de l'huisne Sarthoise,2010_2015,2012.5,5,29081,28824,1424,1677,-257,253,-510,-0.00177375833274729,0.00174615119916367,-0.00351990953191096,EPCI
247200686,CC du Pays de l'huisne Sarthoise,1968_1975,1971.5,7,22747,23638,1781,2683,891,902,-11,0.00550399419958625,0.00557194474526015,-6.79505456739043e-05,EPCI
247200686,CC du Pays de l'huisne Sarthoise,1975_1982,1978.5,7,23638,24413,1751,2305,775,554,221,0.00461923459689229,0.00330200769893978,0.00131722689795251,EPCI
247200686,CC du Pays de l'huisne Sarthoise,1982_1990,1986,8,24413,25142,1994,2527,729,533,196,0.00368476928019135,0.00269407685369271,0.000990692426498634,EPCI
247200686,CC du Pays de l'huisne Sarthoise,1990_1999,1994.5,9,25142,26087,2323,2701,945,378,567,0.00410812100736369,0.00164324840294547,0.00246487260441821,EPCI
247200686,CC du Pays de l'huisne Sarthoise,1999_2010,2004.5,11,26087,29081,2858,3686,2994,828,2166,0.00992602430730916,0.00274507285452638,0.00718095145278278,EPCI
247300015,CC des Vallées d'Aigueblanche,2010_2015,2012.5,5,7056,7051,235,347,-5,112,-117,-0.000141763544116325,0.00317550338820567,-0.00331726693232199,EPCI
247300015,CC des Vallées d'Aigueblanche,1968_1975,1971.5,7,6235,6411,493,709,176,216,-40,0.00398458685178249,0.00489017477264215,-0.000905587920859657,EPCI
247300015,CC des Vallées d'Aigueblanche,1975_1982,1978.5,7,6411,6115,401,603,-296,202,-498,-0.00673017820071131,0.00459289188021515,-0.0113230700809265,EPCI
247300015,CC des Vallées d'Aigueblanche,1982_1990,1986,8,6115,6326,454,562,211,108,103,0.00424942276809737,0.0021750599950451,0.00207436277305227,EPCI
247300015,CC des Vallées d'Aigueblanche,1990_1999,1994.5,9,6326,6226,462,705,-100,243,-343,-0.00176888399556396,0.00429838810922043,-0.0060672721047844,EPCI
247300015,CC des Vallées d'Aigueblanche,1999_2010,2004.5,11,6226,7056,537,832,830,295,535,0.0114417110313716,0.00406663223404171,0.00737507879732988,EPCI
247300254,CC de Haute-Tarentaise,2010_2015,2012.5,5,16187,16153,436,994,-34,558,-592,-0.000420443592850983,0.00690022131796613,-0.00732066491081712,EPCI
247300254,CC de Haute-Tarentaise,1968_1975,1971.5,7,9137,10228,589,1343,1091,754,337,0.0162443787380309,0.0112266375513064,0.00501774118672447,EPCI
247300254,CC de Haute-Tarentaise,1975_1982,1978.5,7,10228,11896,572,1343,1668,771,897,0.0218164520360058,0.0100842233331897,0.0117322287028161,EPCI
247300254,CC de Haute-Tarentaise,1982_1990,1986,8,11896,13253,673,1638,1357,965,392,0.0135942899691992,0.00966727326475846,0.00392701670444074,EPCI
247300254,CC de Haute-Tarentaise,1990_1999,1994.5,9,13253,14566,776,2021,1313,1245,68,0.0105515124647515,0.0100050518039723,0.00054646066077921,EPCI
247300254,CC de Haute-Tarentaise,1999_2010,2004.5,11,14566,16187,976,2476,1621,1500,121,0.00963873857231956,0.00891925222608226,0.000719486346237303,EPCI
247300262,CC de Yenne,2010_2015,2012.5,5,6807,7063,342,417,256,75,181,0.00741100576688392,0.00217119309576677,0.00523981267111714,EPCI
247300262,CC de Yenne,1968_1975,1971.5,7,4277,4260,504,368,-17,-136,119,-0.000568790886169124,-0.00455032708935299,0.00398153620318387,EPCI
247300262,CC de Yenne,1975_1982,1978.5,7,4260,4535,464,331,275,-133,408,0.0089766107409055,-0.00434141537651066,0.0133180261174162,EPCI
247300262,CC de Yenne,1982_1990,1986,8,4535,5091,518,449,556,-69,625,0.0145611443731439,-0.0018070484923506,0.0163681928654945,EPCI
247300262,CC de Yenne,1990_1999,1994.5,9,5091,5628,576,568,537,-8,545,0.0112045127302678,-0.000166920115162276,0.0113714328454301,EPCI
247300262,CC de Yenne,1999_2010,2004.5,11,5628,6807,712,849,1179,137,1042,0.017441017561409,0.0020266491992477,0.0154143683621613,EPCI
247300361,CC du Canton de la Chambre,2010_2015,2012.5,5,7186,7394,362,343,208,-19,227,0.00572314936475782,-0.000522787682357685,0.0062459370471155,EPCI
247300361,CC du Canton de la Chambre,1968_1975,1971.5,7,5530,5491,610,378,-39,-232,193,-0.00101055008393758,-0.0060114774223979,0.00500092733846032,EPCI
247300361,CC du Canton de la Chambre,1975_1982,1978.5,7,5491,5706,559,361,215,-198,413,0.00550191804774758,-0.005066882667228,0.0105688007149756,EPCI
247300361,CC du Canton de la Chambre,1982_1990,1986,8,5706,5942,591,526,236,-65,301,0.0050787941038497,-0.00139882040995861,0.00647761451380831,EPCI
247300361,CC du Canton de la Chambre,1990_1999,1994.5,9,5942,6184,618,521,242,-97,339,0.00444535521190148,-0.00178181593204316,0.00622717114394464,EPCI
247300361,CC du Canton de la Chambre,1999_2010,2004.5,11,6184,7186,797,756,1002,-41,1043,0.0137453723785639,-0.000562435396727664,0.0143078077752915,EPCI
247300452,CC Maurienne Galibier,2010_2015,2012.5,5,5924,5514,278,287,-410,9,-419,-0.0142419272031895,0.000312627670313916,-0.0145545548735034,EPCI
247300452,CC Maurienne Galibier,1968_1975,1971.5,7,7235,6452,432,730,-783,298,-1081,-0.0162297408748942,0.0061768362461283,-0.0224065771210224,EPCI
247300452,CC Maurienne Galibier,1975_1982,1978.5,7,6452,5972,433,459,-480,26,-506,-0.0109832785629682,0.000594927588827445,-0.0115782061517957,EPCI
247300452,CC Maurienne Galibier,1982_1990,1986,8,5972,5516,450,452,-456,2,-458,-0.00987948898938262,4.33310920586957e-05,-0.00992282008144132,EPCI
247300452,CC Maurienne Galibier,1990_1999,1994.5,9,5516,5670,527,536,154,9,145,0.00306425836068214,0.000179080034065839,0.0028851783266163,EPCI
247300452,CC Maurienne Galibier,1999_2010,2004.5,11,5670,5924,539,674,254,135,119,0.00399183520408863,0.00212164469508648,0.00187019050900216,EPCI
247300528,CC Val Guiers,2010_2015,2012.5,5,11562,12181,535,694,619,159,460,0.0104852898038152,0.00269331353603655,0.0077919762677787,EPCI
247300528,CC Val Guiers,1968_1975,1971.5,7,7963,7777,736,681,-186,-55,-131,-0.00337075670998865,-0.000996729134674064,-0.00237402757531459,EPCI
247300528,CC Val Guiers,1975_1982,1978.5,7,7777,8328,735,608,551,-127,678,0.00982692328602575,-0.00226500772654314,0.0120919310125689,EPCI
247300528,CC Val Guiers,1982_1990,1986,8,8328,8595,740,761,267,21,246,0.00395245386526333,0.00031086715794206,0.00364158670732127,EPCI
247300528,CC Val Guiers,1990_1999,1994.5,9,8595,9194,856,900,599,44,555,0.00751369369732902,0.000551924077934018,0.006961769619395,EPCI
247300528,CC Val Guiers,1999_2010,2004.5,11,9194,11562,1224,1386,2368,162,2206,0.0210524278645789,0.0014402421089788,0.0196121857556002,EPCI
247300668,CC du Lac d'Aiguebelette (Ccla),2010_2015,2012.5,5,5548,5665,173,302,117,129,-12,0.00418260116764269,0.00461158590278552,-0.000428984735142839,EPCI
247300668,CC du Lac d'Aiguebelette (Ccla),1968_1975,1971.5,7,2535,2589,280,200,54,-80,134,0.00301569003275737,-0.00446768893741832,0.00748337897017569,EPCI
247300668,CC du Lac d'Aiguebelette (Ccla),1975_1982,1978.5,7,2589,2892,252,166,303,-86,389,0.0159365976903587,-0.00452325875039884,0.0204598564407576,EPCI
247300668,CC du Lac d'Aiguebelette (Ccla),1982_1990,1986,8,2892,3711,281,326,819,45,774,0.0316599786556908,0.0017395592667962,0.0299204193888946,EPCI
247300668,CC du Lac d'Aiguebelette (Ccla),1990_1999,1994.5,9,3711,4153,279,433,442,154,288,0.0125817798431134,0.00438369704941054,0.00819808279370283,EPCI
247300668,CC du Lac d'Aiguebelette (Ccla),1999_2010,2004.5,11,4153,5548,361,606,1395,245,1150,0.0266775070464307,0.0046852969364699,0.0219922101099608,EPCI
247300676,CC Porte de Maurienne,2010_2015,2012.5,5,6807,6797,331,383,-10,52,-62,-0.000293987997319833,0.00152873758606313,-0.00182272558338297,EPCI
247300676,CC Porte de Maurienne,1968_1975,1971.5,7,5087,4755,562,411,-332,-151,-181,-0.00959532112437977,-0.00436413701741369,-0.00523118410696608,EPCI
247300676,CC Porte de Maurienne,1975_1982,1978.5,7,4755,4718,495,299,-37,-196,159,-0.0011153368364093,-0.00590827080908709,0.00479293397267779,EPCI
247300676,CC Porte de Maurienne,1982_1990,1986,8,4718,4307,527,339,-411,-188,-223,-0.0113282682938445,-0.00518178695679504,-0.00614648133704944,EPCI
247300676,CC Porte de Maurienne,1990_1999,1994.5,9,4307,4966,550,469,659,-81,740,0.015945017668346,-0.00195985801386347,0.0179048756822095,EPCI
247300676,CC Porte de Maurienne,1999_2010,2004.5,11,4966,6807,678,740,1841,62,1779,0.0290818351345941,0.000979399119144395,0.0281024360154497,EPCI
247300817,CC Les Versants d'Aime,2010_2015,2012.5,5,9522,9602,303,528,80,225,-145,0.00167470061468844,0.00471009547881124,-0.0030353948641228,EPCI
247300817,CC Les Versants d'Aime,1968_1975,1971.5,7,6452,6321,452,803,-131,351,-482,-0.00292610156283224,0.00784016525613829,-0.0107662668189705,EPCI
247300817,CC Les Versants d'Aime,1975_1982,1978.5,7,6321,6717,407,578,396,171,225,0.00871838606582376,0.00376475761933299,0.00495362844649077,EPCI
247300817,CC Les Versants d'Aime,1982_1990,1986,8,6717,7753,476,802,1036,326,710,0.0180914833623786,0.00569287989974463,0.012398603462634,EPCI
247300817,CC Les Versants d'Aime,1990_1999,1994.5,9,7753,8347,475,994,594,519,75,0.00823621336102609,0.0071962874316036,0.00103992592942249,EPCI
247300817,CC Les Versants d'Aime,1999_2010,2004.5,11,8347,9522,630,1389,1175,759,416,0.0120449373291656,0.00778051696411631,0.00426442036504925,EPCI
247400047,CC de la Vallée Verte,2010_2015,2012.5,5,7264,7436,210,431,172,221,-49,0.00469145629449819,0.00602797582025639,-0.0013365195257582,EPCI
247400047,CC de la Vallée Verte,1968_1975,1971.5,7,3374,3310,293,335,-64,42,-106,-0.00273208885282961,0.00179293330966943,-0.00452502216249904,EPCI
247400047,CC de la Vallée Verte,1975_1982,1978.5,7,3310,3729,265,299,419,34,385,0.0171732087357217,0.00139353006447384,0.0157796786712479,EPCI
247400047,CC de la Vallée Verte,1982_1990,1986,8,3729,4802,324,494,1073,170,903,0.0321165013317939,0.00508835529021898,0.0270281460415749,EPCI
247400047,CC de la Vallée Verte,1990_1999,1994.5,9,4802,5707,348,643,905,295,610,0.0193697609036241,0.00631389996305978,0.0130558609405643,EPCI
247400047,CC de la Vallée Verte,1999_2010,2004.5,11,5707,7264,470,878,1557,408,1149,0.0221728942983799,0.00581023819764868,0.0163626561007312,EPCI
247400112,CC du Pays de Cruseilles,2010_2015,2012.5,5,13023,14837,280,929,1814,649,1165,0.0264245034137722,0.00945397062598576,0.0169705327877865,EPCI
247400112,CC du Pays de Cruseilles,1968_1975,1971.5,7,4686,5097,382,494,411,112,299,0.0120828132107358,0.00329264009635622,0.00879017311437956,EPCI
247400112,CC du Pays de Cruseilles,1975_1982,1978.5,7,5097,6091,436,484,994,48,946,0.0257781021419177,0.00124481780967007,0.0245332843322476,EPCI
247400112,CC du Pays de Cruseilles,1982_1990,1986,8,6091,7624,483,685,1533,202,1331,0.0284585334657426,0.00374991765171559,0.024708615814027,EPCI
247400112,CC du Pays de Cruseilles,1990_1999,1994.5,9,7624,9737,557,1133,2113,576,1537,0.0275541037690628,0.00751119913439666,0.0200429046346661,EPCI
247400112,CC du Pays de Cruseilles,1999_2010,2004.5,11,9737,13023,642,1518,3286,876,2410,0.0267874071057073,0.0071411347001216,0.0196462724055857,EPCI
247400567,CC Fier et Usses,2010_2015,2012.5,5,13912,14824,316,895,912,579,333,0.0127801189092984,0.00811369391281117,0.00466642499648725,EPCI
247400567,CC Fier et Usses,1968_1975,1971.5,7,3258,4126,253,375,868,122,746,0.0343178519737497,0.00482347689031966,0.02949437508343,EPCI
247400567,CC Fier et Usses,1975_1982,1978.5,7,4126,5948,277,528,1822,251,1571,0.0536386097018584,0.0073892925549761,0.0462493171468823,EPCI
247400567,CC Fier et Usses,1982_1990,1986,8,5948,8231,331,775,2283,444,1839,0.0414422805812753,0.00805973393696287,0.0333825466443124,EPCI
247400567,CC Fier et Usses,1990_1999,1994.5,9,8231,10270,373,1171,2039,798,1241,0.0248959104580482,0.00974347059613656,0.0151524398619116,EPCI
247400567,CC Fier et Usses,1999_2010,2004.5,11,10270,13912,488,1544,3642,1056,2586,0.0279773763752906,0.00811205641194588,0.0198653199633447,EPCI
247400583,CC Arve et Salève,2010_2015,2012.5,5,17659,19340,496,1090,1681,594,1087,0.018352356347723,0.00648500872727393,0.0118673476204491,EPCI
247400583,CC Arve et Salève,1968_1975,1971.5,7,6784,8199,958,757,1415,-201,1616,0.0274331596891726,-0.00389686579330296,0.0313300254824756,EPCI
247400583,CC Arve et Salève,1975_1982,1978.5,7,8199,9576,850,767,1377,-83,1460,0.022426018972949,-0.00135174987273404,0.0237777688456831,EPCI
247400583,CC Arve et Salève,1982_1990,1986,8,9576,11294,750,985,1718,235,1483,0.0208406508681049,0.00285072930966511,0.0179899215584398,EPCI
247400583,CC Arve et Salève,1990_1999,1994.5,9,11294,13156,838,1354,1862,516,1346,0.0171008307711729,0.0047390057346537,0.0123618250365192,EPCI
247400583,CC Arve et Salève,1999_2010,2004.5,11,13156,17659,1027,1841,4503,814,3689,0.0271219774690323,0.00490279583828388,0.0222191816307485,EPCI
247400617,CC des Vallées de Thônes,2010_2015,2012.5,5,18197,19018,599,1076,821,477,344,0.00886489323654605,0.00515049217275574,0.0037144010637903,EPCI
247400617,CC des Vallées de Thônes,1968_1975,1971.5,7,9636,10343,714,1288,707,574,133,0.0101661675658644,0.00825372020198893,0.00191244736387548,EPCI
247400617,CC des Vallées de Thônes,1975_1982,1978.5,7,10343,11696,728,1225,1353,497,856,0.0177175461863284,0.00650821910909475,0.0112093270772336,EPCI
247400617,CC des Vallées de Thônes,1982_1990,1986,8,11696,13373,871,1451,1677,580,1097,0.0168899041860215,0.00584146954555307,0.0110484346404685,EPCI
247400617,CC des Vallées de Thônes,1990_1999,1994.5,9,13373,15674,919,1967,2301,1048,1253,0.0177971301684214,0.00810577679987208,0.00969135336854935,EPCI
247400617,CC des Vallées de Thônes,1999_2010,2004.5,11,15674,18197,1211,2618,2523,1407,1116,0.0136609658584212,0.00761830319571886,0.00604266266270238,EPCI
247400666,CC des Quatre Rivières,2010_2015,2012.5,5,17431,18644,514,1052,1213,538,675,0.0135457532054066,0.00600792681328011,0.00753782639212653,EPCI
247400666,CC des Quatre Rivières,1968_1975,1971.5,7,8189,8773,700,889,584,189,395,0.00988958661491401,0.00320056827092251,0.0066890183439915,EPCI
247400666,CC des Quatre Rivières,1975_1982,1978.5,7,8773,9514,652,846,741,194,547,0.0116510038698079,0.00305033029789842,0.00860067357190946,EPCI
247400666,CC des Quatre Rivières,1982_1990,1986,8,9514,11930,745,1058,2416,313,2103,0.0286903411774035,0.00371691920054938,0.0249734219768542,EPCI
247400666,CC des Quatre Rivières,1990_1999,1994.5,9,11930,14422,806,1607,2492,801,1691,0.0213013222402343,0.00684685357721816,0.0144544686630161,EPCI
247400666,CC des Quatre Rivières,1999_2010,2004.5,11,14422,17431,1000,2247,3009,1247,1762,0.017376093625292,0.00720105973769995,0.0101750338875921,EPCI
247400682,CC du Haut-Chablais,2010_2015,2012.5,5,11981,12530,445,776,549,331,218,0.00900100907978274,0.00542683789691819,0.00357417118286455,EPCI
247400682,CC du Haut-Chablais,1968_1975,1971.5,7,8570,8865,717,935,295,218,77,0.00484645007717721,0.00358144446381231,0.0012650056133649,EPCI
247400682,CC du Haut-Chablais,1975_1982,1978.5,7,8865,9293,703,858,428,155,273,0.00675852056444448,0.00244759506422639,0.00431092550021809,EPCI
247400682,CC du Haut-Chablais,1982_1990,1986,8,9293,10075,769,1094,782,325,457,0.0101506315760582,0.00421861286728762,0.0059320187087706,EPCI
247400682,CC du Haut-Chablais,1990_1999,1994.5,9,10075,10682,763,1394,607,631,-24,0.00652150345417901,0.00677935532057159,-0.00025785186639258,EPCI
247400682,CC du Haut-Chablais,1999_2010,2004.5,11,10682,11981,935,1659,1299,724,575,0.0104875197832077,0.00584523812397413,0.00464228165923359,EPCI
247400690,CC du Genevois,2010_2015,2012.5,5,35635,43394,840,2402,7759,1562,6197,0.0401849941753754,0.00808982612475014,0.0320951680506252,EPCI
247400690,CC du Genevois,1968_1975,1971.5,7,12786,17401,977,1813,4615,836,3779,0.045008756475573,0.00815326552840283,0.0368554909471702,EPCI
247400690,CC du Genevois,1975_1982,1978.5,7,17401,19559,962,1970,2158,1008,1150,0.0168413666578533,0.00786658831840414,0.00897477833944916,EPCI
247400690,CC du Genevois,1982_1990,1986,8,19559,22942,1098,2283,3383,1185,2198,0.0201418835713145,0.00705531540999341,0.0130865681613211,EPCI
247400690,CC du Genevois,1990_1999,1994.5,9,22942,26905,1305,2814,3963,1509,2454,0.0178624195765722,0.00680151176912628,0.0110609078074459,EPCI
247400690,CC du Genevois,1999_2010,2004.5,11,26905,35635,1719,3929,8730,2210,6520,0.0258760427900941,0.00655052171433082,0.0193255210757633,EPCI
247400724,CC du Pays Rochois,2010_2015,2012.5,5,24716,27253,778,1632,2537,854,1683,0.019734765765951,0.00664307842495947,0.0130916873409915,EPCI
247400724,CC du Pays Rochois,1968_1975,1971.5,7,10717,12206,820,1294,1489,474,1015,0.0187589751369333,0.00597162808254289,0.0127873470543904,EPCI
247400724,CC du Pays Rochois,1975_1982,1978.5,7,12206,14114,894,1334,1908,440,1468,0.0209652580291582,0.00483475552035094,0.0161305025088072,EPCI
247400724,CC du Pays Rochois,1982_1990,1986,8,14114,16251,1101,1668,2137,567,1570,0.017779612574081,0.00471737965816749,0.0130622329159135,EPCI
247400724,CC du Pays Rochois,1990_1999,1994.5,9,16251,19903,1184,2388,3652,1204,2448,0.0227795838519449,0.00751002709686245,0.0152695567550825,EPCI
247400724,CC du Pays Rochois,1999_2010,2004.5,11,19903,24716,1551,3253,4813,1702,3111,0.019884230339474,0.00703157283145329,0.0128526575080207,EPCI
247400740,CC Rumilly Terre de Savoie,2010_2015,2012.5,5,27463,30510,881,1970,3047,1089,1958,0.0212659354188383,0.0076004606731588,0.0136654747456795,EPCI
247400740,CC Rumilly Terre de Savoie,1968_1975,1971.5,7,12795,13880,986,1547,1085,561,524,0.011695649100856,0.00604724345214765,0.00564840564870832,EPCI
247400740,CC Rumilly Terre de Savoie,1975_1982,1978.5,7,13880,16807,1038,1620,2927,582,2345,0.0277122505027136,0.00551025958065574,0.0222019909220579,EPCI
247400740,CC Rumilly Terre de Savoie,1982_1990,1986,8,16807,19637,1187,2165,2830,978,1852,0.0196429422905771,0.00678826768911108,0.012854674601466,EPCI
247400740,CC Rumilly Terre de Savoie,1990_1999,1994.5,9,19637,22799,1384,2627,3162,1243,1919,0.0167273765852416,0.00657562589989099,0.0101517506853506,EPCI
247400740,CC Rumilly Terre de Savoie,1999_2010,2004.5,11,22799,27463,1748,3758,4664,2010,2654,0.0170642284543765,0.00735400926099845,0.00971021919337805,EPCI
247400773,CC des Sources du Lac d'Annecy,2010_2015,2012.5,5,14784,15174,608,752,390,144,246,0.00522116743900236,0.00192781566978549,0.00329335176921687,EPCI
247400773,CC des Sources du Lac d'Annecy,1968_1975,1971.5,7,8275,9273,581,1053,998,472,526,0.0163998872243074,0.00775625928845,0.00864362793585741,EPCI
247400773,CC des Sources du Lac d'Annecy,1975_1982,1978.5,7,9273,10692,630,1116,1419,486,933,0.0205495572057839,0.00703811473009934,0.0135114424756845,EPCI
247400773,CC des Sources du Lac d'Annecy,1982_1990,1986,8,10692,11629,752,1239,937,487,450,0.0105560991036358,0.00548646773049158,0.00506963137314417,EPCI
247400773,CC des Sources du Lac d'Annecy,1990_1999,1994.5,9,11629,12698,917,1392,1069,475,594,0.00981928730284687,0.00436310708031082,0.00545618022253605,EPCI
247400773,CC des Sources du Lac d'Annecy,1999_2010,2004.5,11,12698,14784,1193,1877,2086,684,1402,0.0139234050834227,0.00456548853166881,0.0093579165517539,EPCI
247600497,CC du Canton de Criquetot-l'Esneval,2010_2015,2012.5,5,16206,16555,657,926,349,269,80,0.00427041774976122,0.00329152542889905,0.000978892320862172,EPCI
247600497,CC du Canton de Criquetot-l'Esneval,1968_1975,1971.5,7,8638,9614,723,900,976,177,799,0.015410288986482,0.00279469380185176,0.0126155951846302,EPCI
247600497,CC du Canton de Criquetot-l'Esneval,1975_1982,1978.5,7,9614,12116,764,1076,2502,312,2190,0.033595798479146,0.0041894041268959,0.0294063943522501,EPCI
247600497,CC du Canton de Criquetot-l'Esneval,1982_1990,1986,8,12116,13455,917,1295,1339,378,961,0.013189206672295,0.00372331599860156,0.00946589067369339,EPCI
247600497,CC du Canton de Criquetot-l'Esneval,1990_1999,1994.5,9,13455,14468,1097,1369,1013,272,741,0.0080980051077364,0.00217439031520661,0.00592361479252978,EPCI
247600497,CC du Canton de Criquetot-l'Esneval,1999_2010,2004.5,11,14468,16206,1396,2068,1738,672,1066,0.0103662915380738,0.00400814034153371,0.00635815119654007,EPCI
247600505,CC Campagne-De-Caux,2010_2015,2012.5,5,14856,15092,442,945,236,503,-267,0.00315716900324414,0.00672905088403307,-0.00357188188078892,EPCI
247600505,CC Campagne-De-Caux,1968_1975,1971.5,7,8948,8900,642,897,-48,255,-303,-0.00076810012992401,0.0040805319402213,-0.00484863207014531,EPCI
247600505,CC Campagne-De-Caux,1975_1982,1978.5,7,8900,10646,596,946,1746,350,1396,0.0259206684632352,0.00519601028759009,0.0207246581756451,EPCI
247600505,CC Campagne-De-Caux,1982_1990,1986,8,10646,11733,690,1120,1087,430,657,0.0122267871277142,0.00483672351878298,0.00739006360893121,EPCI
247600505,CC Campagne-De-Caux,1990_1999,1994.5,9,11733,12488,756,1248,755,492,263,0.00695326231462734,0.00453113252820749,0.00242212978641986,EPCI
247600505,CC Campagne-De-Caux,1999_2010,2004.5,11,12488,14856,949,2069,2368,1120,1248,0.0159103004071572,0.00752514208446626,0.00838515832269098,EPCI
247600539,CC Caux Estuaire,2010_2015,2012.5,5,17451,18315,721,981,864,260,604,0.00971154245018102,0.00292245490398966,0.00678908754619136,EPCI
247600539,CC Caux Estuaire,1968_1975,1971.5,7,10053,11924,818,1299,1871,481,1390,0.0246828540766357,0.00634551192456536,0.0183373421520704,EPCI
247600539,CC Caux Estuaire,1975_1982,1978.5,7,11924,13277,724,1157,1353,433,920,0.0154727740599305,0.00495174513521797,0.0105210289247126,EPCI
247600539,CC Caux Estuaire,1982_1990,1986,8,13277,14747,1045,1442,1470,397,1073,0.0132123287169215,0.00356822755144069,0.00964410116548077,EPCI
247600539,CC Caux Estuaire,1990_1999,1994.5,9,14747,16214,1113,1529,1467,416,1051,0.0105929785345562,0.00300387121361648,0.00758910732093972,EPCI
247600539,CC Caux Estuaire,1999_2010,2004.5,11,16214,17451,1550,2124,1237,574,663,0.00670619440390907,0.00311184768621165,0.00359434671769743,EPCI
247600588,CC des Villes Soeurs,2010_2015,2012.5,5,39405,38213,2219,1869,-1192,-350,-842,-0.00612455596601558,-0.00179831760747102,-0.00432623835854456,EPCI
247600588,CC des Villes Soeurs,1968_1975,1971.5,7,39402,42397,3020,5371,2995,2351,644,0.0105208199140954,0.00825858017296768,0.00226223974112769,EPCI
247600588,CC des Villes Soeurs,1975_1982,1978.5,7,42397,41621,3112,4477,-776,1365,-2141,-0.00263548633919264,0.00463587481056437,-0.00727136114975701,EPCI
247600588,CC des Villes Soeurs,1982_1990,1986,8,41621,41313,3522,4409,-308,887,-1195,-0.000928022517241778,0.00267258432725148,-0.00360060684449326,EPCI
247600588,CC des Villes Soeurs,1990_1999,1994.5,9,41313,40819,3793,4505,-494,712,-1206,-0.0013357250271101,0.00192517453300079,-0.0032608995601109,EPCI
247600588,CC des Villes Soeurs,1999_2010,2004.5,11,40819,39405,4743,5082,-1414,339,-1753,-0.00319986471088574,0.000767152855014331,-0.00396701756590007,EPCI
247600596,CA Havraise (Co.D.A.H.),2010_2015,2012.5,5,239661,236133,11103,15977,-3528,4874,-8402,-0.00296164948080924,0.00409157584168487,-0.00705322532249411,EPCI
247600596,CA Havraise (Co.D.A.H.),1968_1975,1971.5,7,252240,268063,17614,35223,15823,17609,-1786,0.00872945457445651,0.00971478010501198,-0.000985325530555477,EPCI
247600596,CA Havraise (Co.D.A.H.),1975_1982,1978.5,7,268063,259796,17917,32279,-8267,14362,-22629,-0.00446504759582744,0.00775698724703928,-0.0122220348428667,EPCI
247600596,CA Havraise (Co.D.A.H.),1982_1990,1986,8,259796,260189,19994,35346,393,15352,-14959,0.00018896564584403,0.00738168090330166,-0.00719271525745763,EPCI
247600596,CA Havraise (Co.D.A.H.),1990_1999,1994.5,9,260189,255082,20625,33300,-5107,12675,-17782,-0.00220015697845943,0.0054605423344377,-0.00766069931289713,EPCI
247600596,CA Havraise (Co.D.A.H.),1999_2010,2004.5,11,255082,239661,24408,36980,-15421,12572,-27993,-0.00565301914731708,0.00460863476558397,-0.0102616539129011,EPCI
247600604,CC de Londinières,2010_2015,2012.5,5,5211,5304,238,336,93,98,-5,0.00354416113019385,0.0037347074275161,-0.00019054629732225,EPCI
247600604,CC de Londinières,1968_1975,1971.5,7,5913,5425,349,676,-488,327,-815,-0.0122296619585319,0.00819487594352446,-0.0204245379020564,EPCI
247600604,CC de Londinières,1975_1982,1978.5,7,5425,5014,390,413,-411,23,-434,-0.011191744013757,0.000626301976438956,-0.011818045990196,EPCI
247600604,CC de Londinières,1982_1990,1986,8,5014,4747,408,397,-267,-11,-256,-0.00681680447680144,-0.000280842132003056,-0.00653596234479839,EPCI
247600604,CC de Londinières,1990_1999,1994.5,9,4747,4726,458,448,-21,-10,-11,-0.000492507656541741,-0.000234527455496067,-0.000257980201045674,EPCI
247600604,CC de Londinières,1999_2010,2004.5,11,4726,5211,520,594,485,74,411,0.00892069957592812,0.00136109643014161,0.00755960314578651,EPCI
247600620,CC de la Région d'Yvetot,2010_2015,2012.5,5,25895,26804,1204,1481,909,277,632,0.00692410759671613,0.00210998658337774,0.00481412101333839,EPCI
247600620,CC de la Région d'Yvetot,1968_1975,1971.5,7,17309,19009,1183,2460,1700,1277,423,0.0134736703953515,0.0101211041734493,0.00335256622190217,EPCI
247600620,CC de la Région d'Yvetot,1975_1982,1978.5,7,19009,21270,1384,2285,2261,901,1360,0.0161845853421914,0.00644949641455746,0.0097350889276339,EPCI
247600620,CC de la Région d'Yvetot,1982_1990,1986,8,21270,22917,1530,2772,1647,1242,405,0.00936626195214596,0.00706308278358548,0.00230317916856048,EPCI
247600620,CC de la Région d'Yvetot,1990_1999,1994.5,9,22917,23672,1796,2560,755,764,-9,0.00360804023749672,0.00365104998867218,-4.30097511754574e-05,EPCI
247600620,CC de la Région d'Yvetot,1999_2010,2004.5,11,23672,25895,2433,3243,2223,810,1413,0.00819310718449784,0.00298534269880488,0.00520776448569296,EPCI
247600646,CC Caux - Austreberthe,2010_2015,2012.5,5,24684,25243,1096,1724,559,628,-69,0.00448877030339911,0.0050428403408491,-0.00055407003744998,EPCI
247600646,CC Caux - Austreberthe,1968_1975,1971.5,7,18788,20582,1178,2752,1794,1574,220,0.0131136016399978,0.011505467659619,0.00160813398037877,EPCI
247600646,CC Caux - Austreberthe,1975_1982,1978.5,7,20582,23244,1301,2724,2662,1423,1239,0.0175275685848508,0.00936954549069975,0.00815802309415108,EPCI
247600646,CC Caux - Austreberthe,1982_1990,1986,8,23244,24317,1414,3214,1073,1800,-727,0.00565702336801266,0.00948988076647044,-0.00383285739845778,EPCI
247600646,CC Caux - Austreberthe,1990_1999,1994.5,9,24317,25055,1718,3246,738,1528,-790,0.0033274920943589,0.0068894416262607,-0.0035619495319018,EPCI
247600646,CC Caux - Austreberthe,1999_2010,2004.5,11,25055,24684,2108,3675,-371,1567,-1938,-0.00135527605123242,0.00572430612474719,-0.00707958217597961,EPCI
247600729,CC Falaises du Talou,2010_2015,2012.5,5,22583,23474,951,1340,891,389,502,0.00776922800648805,0.00339195251910645,0.00437727548738159,EPCI
247600729,CC Falaises du Talou,1968_1975,1971.5,7,15968,16587,1029,1902,619,873,-254,0.00544800619824959,0.00768353701304021,-0.00223553081479062,EPCI
247600729,CC Falaises du Talou,1975_1982,1978.5,7,16587,18237,1090,1556,1650,466,1184,0.0136397905521546,0.0038522075135176,0.00978758303863699,EPCI
247600729,CC Falaises du Talou,1982_1990,1986,8,18237,19988,1246,2070,1751,824,927,0.011525866287591,0.00542393707651341,0.00610192921107759,EPCI
247600729,CC Falaises du Talou,1990_1999,1994.5,9,19988,20093,1516,2112,105,596,-491,0.000582325287849628,0.00330538925293693,-0.00272306396508731,EPCI
247600729,CC Falaises du Talou,1999_2010,2004.5,11,20093,22583,1966,2977,2490,1011,1479,0.01067713584024,0.00433517443151913,0.00634196140872086,EPCI
247600786,CA de la Région Dieppoise,2010_2015,2012.5,5,50222,47725,2885,2425,-2497,-460,-2037,-0.0101477224856976,-0.00186942424646412,-0.0082782982392335,EPCI
247600786,CA de la Région Dieppoise,1968_1975,1971.5,7,51969,53292,3806,6903,1323,3097,-1774,0.00359771904375839,0.00842187141233539,-0.004824152368577,EPCI
247600786,CA de la Région Dieppoise,1975_1982,1978.5,7,53292,51710,3985,5973,-1582,1988,-3570,-0.00429575241626612,0.00539820215141406,-0.00969395456768018,EPCI
247600786,CA de la Région Dieppoise,1982_1990,1986,8,51710,52917,4315,6802,1207,2487,-1280,0.00288834599276155,0.00595138068268267,-0.00306303468992112,EPCI
247600786,CA de la Région Dieppoise,1990_1999,1994.5,9,52917,52675,4774,6662,-242,1888,-2130,-0.000509169063547366,0.00397236029742738,-0.00448152936097475,EPCI
247600786,CA de la Région Dieppoise,1999_2010,2004.5,11,52675,50222,5950,6985,-2453,1035,-3488,-0.00432586926369427,0.00182522408802428,-0.00615109335171856,EPCI
247700032,CC Moret Seine et Loing,2010_2015,2012.5,5,38873,38980,1543,2095,107,552,-445,0.000549905512388094,0.00283689572746007,-0.00228699021507198,EPCI
247700032,CC Moret Seine et Loing,1968_1975,1971.5,7,25097,27511,2151,2614,2414,463,1951,0.013206098555145,0.00253290125560569,0.0106731972995393,EPCI
247700032,CC Moret Seine et Loing,1975_1982,1978.5,7,27511,29427,2253,2339,1916,86,1830,0.0096645019317545,0.000433792884201924,0.00923070904755257,EPCI
247700032,CC Moret Seine et Loing,1982_1990,1986,8,29427,34368,2455,3285,4941,830,4111,0.0195910951682465,0.00329095506772812,0.0163001401005184,EPCI
247700032,CC Moret Seine et Loing,1990_1999,1994.5,9,34368,37598,2865,4101,3230,1236,1994,0.0100305227652122,0.00383830530582114,0.00619221745939107,EPCI
247700032,CC Moret Seine et Loing,1999_2010,2004.5,11,37598,38873,3501,4865,1275,1364,-89,0.00303633350888544,0.00324828149499587,-0.000211947986110434,EPCI
247700057,CA Melun Val de Seine,2010_2015,2012.5,5,125337,130067,4218,10275,4730,6057,-1327,0.00743623099582558,0.00952246324349165,-0.00208623224766608,EPCI
247700057,CA Melun Val de Seine,1968_1975,1971.5,7,70162,93123,4397,11686,22961,7289,15672,0.041273940775193,0.0131024674147634,0.0281714733604296,EPCI
247700057,CA Melun Val de Seine,1975_1982,1978.5,7,93123,101751,4707,11742,8628,7035,1593,0.0127386616936094,0.0103867043364096,0.00235195735719978,EPCI
247700057,CA Melun Val de Seine,1982_1990,1986,8,101751,114646,5814,14669,12895,8855,4040,0.0150268430029559,0.0103189371687611,0.00470790583419478,EPCI
247700057,CA Melun Val de Seine,1990_1999,1994.5,9,114646,119292,7200,17017,4646,9817,-5171,0.00442366108607462,0.00934719777916369,-0.00492353669308907,EPCI
247700057,CA Melun Val de Seine,1999_2010,2004.5,11,119292,125337,8999,21338,6045,12339,-6294,0.00450391596811439,0.00919335304062258,-0.00468943707250819,EPCI
247700065,CC du Pays de l'Ourcq,2010_2015,2012.5,5,17544,17887,628,1334,343,706,-363,0.00387994374781719,0.00798612328267912,-0.00410617953486193,EPCI
247700065,CC du Pays de l'Ourcq,1968_1975,1971.5,7,8970,10288,834,1063,1318,229,1089,0.0197776788549098,0.00343633418647522,0.0163413446684346,EPCI
247700065,CC du Pays de l'Ourcq,1975_1982,1978.5,7,10288,11343,873,1167,1055,294,761,0.0140437926938168,0.00391362564168924,0.0101301670521276,EPCI
247700065,CC du Pays de l'Ourcq,1982_1990,1986,8,11343,13600,971,1507,2257,536,1721,0.022942852137235,0.00544854618766414,0.0174943059495709,EPCI
247700065,CC du Pays de l'Ourcq,1990_1999,1994.5,9,13600,15606,1111,2086,2006,975,1031,0.0154047443177727,0.00748735080250668,0.00791739351526604,EPCI
247700065,CC du Pays de l'Ourcq,1999_2010,2004.5,11,15606,17544,1464,2720,1938,1256,682,0.0106983272320347,0.0069334876178718,0.00376483961416287,EPCI
247700107,CC Pays de Montereau,2010_2015,2012.5,5,38973,41627,1805,2911,2654,1106,1548,0.0132631650160653,0.00552715166080188,0.0077360133552634,EPCI
247700107,CC Pays de Montereau,1968_1975,1971.5,7,32484,35592,2509,4775,3108,2266,842,0.0131388854840313,0.00957938047194818,0.00355950501208313,EPCI
247700107,CC Pays de Montereau,1975_1982,1978.5,7,35592,35689,2391,4091,97,1700,-1603,0.000388879101427708,0.00681540693223819,-0.00642652783081048,EPCI
247700107,CC Pays de Montereau,1982_1990,1986,8,35689,36855,2690,4291,1166,1601,-435,0.00402668246131421,0.00552891819945459,-0.00150223573814038,EPCI
247700107,CC Pays de Montereau,1990_1999,1994.5,9,36855,37818,2975,5225,963,2250,-1287,0.0028700981030183,0.0067058366892951,-0.0038357385862768,EPCI
247700107,CC Pays de Montereau,1999_2010,2004.5,11,37818,38973,3599,6285,1155,2686,-1531,0.00273864497565368,0.00636883151913921,-0.00363018654348553,EPCI
247700339,CA Val d'Europe Agglomération,2010_2015,2012.5,5,29524,35204,503,2634,5680,2131,3549,0.0358177839200133,0.0134379749178782,0.0223798090021351,EPCI
247700339,CA Val d'Europe Agglomération,1968_1975,1971.5,7,3094,4040,416,275,946,-141,1087,0.0388469747339366,-0.00579008820030134,0.044637062934238,EPCI
247700339,CA Val d'Europe Agglomération,1975_1982,1978.5,7,4040,4912,526,354,872,-172,1044,0.0283129017351331,-0.00558465492940699,0.0338975566645401,EPCI
247700339,CA Val d'Europe Agglomération,1982_1990,1986,8,4912,7098,540,576,2186,36,2150,0.0470916699454733,0.000775526129019689,0.0463161438164536,EPCI
247700339,CA Val d'Europe Agglomération,1990_1999,1994.5,9,7098,14237,574,1314,7139,740,6399,0.0804058904745484,0.00833455091065497,0.0720713395638934,EPCI
247700339,CA Val d'Europe Agglomération,1999_2010,2004.5,11,14237,29524,738,4435,15287,3697,11590,0.0685529919909624,0.0165788193491586,0.0519741726418038,EPCI
247700438,CC Pays Créçois,2010_2015,2012.5,5,34628,36094,1051,2124,1466,1073,393,0.0083272892223889,0.00609493951952476,0.00223234970286415,EPCI
247700438,CC Pays Créçois,1968_1975,1971.5,7,12222,18754,1231,1375,6532,144,6388,0.0630765024598086,0.00139054138919358,0.061685961070615,EPCI
247700438,CC Pays Créçois,1975_1982,1978.5,7,18754,22372,1391,1768,3618,377,3241,0.0255206602607121,0.00265928383590062,0.0228613764248115,EPCI
247700438,CC Pays Créçois,1982_1990,1986,8,22372,26512,1590,2107,4140,517,3623,0.0214502288192104,0.00267868799505599,0.0187715408241545,EPCI
247700438,CC Pays Créçois,1990_1999,1994.5,9,26512,30189,1747,3239,3677,1492,2185,0.0145357602201364,0.00589811102758865,0.00863764919254772,EPCI
247700438,CC Pays Créçois,1999_2010,2004.5,11,30189,34628,2305,4890,4439,2585,1854,0.0125494538937958,0.00730802845583739,0.00524142543795842,EPCI
247700594,CA Marne et Gondoire,2010_2015,2012.5,5,92240,102090,2191,7380,9850,5189,4661,0.0204994662544147,0.0107991604461074,0.00970030580830729,EPCI
247700594,CA Marne et Gondoire,1968_1975,1971.5,7,31418,36887,2563,4033,5469,1470,3999,0.0231902664024004,0.00623325865999791,0.0169570077424025,EPCI
247700594,CA Marne et Gondoire,1975_1982,1978.5,7,36887,43516,2553,4388,6629,1835,4794,0.0238908495809265,0.00661332161427064,0.0172775279666558,EPCI
247700594,CA Marne et Gondoire,1982_1990,1986,8,43516,54001,2923,5611,10485,2688,7797,0.0273516062261754,0.00701202837729704,0.0203395778488783,EPCI
247700594,CA Marne et Gondoire,1990_1999,1994.5,9,54001,69200,3377,7637,15199,4260,10939,0.0279385268002161,0.00783065492262127,0.0201078718775949,EPCI
247700594,CA Marne et Gondoire,1999_2010,2004.5,11,69200,92240,4645,13797,23040,9152,13888,0.0264709300335175,0.0105148416522028,0.0159560883813147,EPCI
247700644,CC l'Orée de la Brie,2010_2015,2012.5,5,25304,26071,808,1761,767,953,-186,0.00599008915509613,0.00744270529961749,-0.00145261614452136,EPCI
247700644,CC l'Orée de la Brie,1968_1975,1971.5,7,8921,12121,757,1244,3200,487,2713,0.0447631461921847,0.00681239131112311,0.0379507548810616,EPCI
247700644,CC l'Orée de la Brie,1975_1982,1978.5,7,12121,14838,746,1323,2717,577,2140,0.0293145949049463,0.00622544028713802,0.0230891546178082,EPCI
247700644,CC l'Orée de la Brie,1982_1990,1986,8,14838,17066,872,1573,2228,701,1527,0.0176408846206986,0.0055503860498697,0.0120904985708289,EPCI
247700644,CC l'Orée de la Brie,1990_1999,1994.5,9,17066,21410,1119,2337,4344,1218,3126,0.0255167768289228,0.00715456587882781,0.018362210950095,EPCI
247700644,CC l'Orée de la Brie,1999_2010,2004.5,11,21410,25304,1653,3437,3894,1784,2110,0.0153072820185833,0.00701288934801044,0.00829439267057289,EPCI
247700701,CC Brie Nangissienne,2010_2015,2012.5,5,26343,27474,849,1853,1131,1004,127,0.00844294588706229,0.00749488741875379,0.000948058468308499,EPCI
247700701,CC Brie Nangissienne,1968_1975,1971.5,7,13195,16460,984,1965,3265,981,2284,0.0320891326583692,0.0096414821249189,0.0224476505334503,EPCI
247700701,CC Brie Nangissienne,1975_1982,1978.5,7,16460,18142,1135,1711,1682,576,1106,0.0139965467218146,0.00479310993565114,0.00920343678616347,EPCI
247700701,CC Brie Nangissienne,1982_1990,1986,8,18142,21664,1388,2279,3522,891,2631,0.0224255305935082,0.00567323900023162,0.0167522915932765,EPCI
247700701,CC Brie Nangissienne,1990_1999,1994.5,9,21664,24554,1556,2887,2890,1331,1559,0.0140108983624525,0.00645277014547553,0.00755812821697698,EPCI
247700701,CC Brie Nangissienne,1999_2010,2004.5,11,24554,26343,1950,3748,1789,1798,-9,0.00641391903669475,0.00644618581776253,-3.22667810677768e-05,EPCI
247800550,CC du Pays Houdanais (C.C.P.H.),2010_2015,2012.5,5,28192,28995,1056,1431,803,375,428,0.00563283540841231,0.00263052712098956,0.00300230828742275,EPCI
247800550,CC du Pays Houdanais (C.C.P.H.),1968_1975,1971.5,7,12643,15401,1310,1306,2758,-4,2762,0.0285909130256445,-4.14661537717832e-05,0.0286323791794163,EPCI
247800550,CC du Pays Houdanais (C.C.P.H.),1975_1982,1978.5,7,15401,19052,1350,1453,3651,103,3548,0.0308579093184487,0.00087054633245692,0.0299873629859918,EPCI
247800550,CC du Pays Houdanais (C.C.P.H.),1982_1990,1986,8,19052,22992,1571,1933,3940,362,3578,0.0237750050045795,0.00218440401311111,0.0215906009914684,EPCI
247800550,CC du Pays Houdanais (C.C.P.H.),1990_1999,1994.5,9,22992,25433,1772,2440,2441,668,1773,0.0112743275433875,0.00308531372346697,0.00818901381992056,EPCI
247800550,CC du Pays Houdanais (C.C.P.H.),1999_2010,2004.5,11,25433,28192,2223,3392,2759,1169,1590,0.0094067595351579,0.00398568390598028,0.00542107562917763,EPCI
247800584,CA Versailles Grand Parc (C.A.V.G.P.),2010_2015,2012.5,5,261451,264238,7945,17379,2787,9434,-6647,0.00212291554655053,0.00718607293367696,-0.00506315738712643,EPCI
247800584,CA Versailles Grand Parc (C.A.V.G.P.),1968_1975,1971.5,7,222674,259781,11545,31968,37107,20423,16684,0.0222627910688009,0.0122530245505732,0.0100097665182277,EPCI
247800584,CA Versailles Grand Parc (C.A.V.G.P.),1975_1982,1978.5,7,259781,259353,11877,28040,-428,16163,-16591,-0.000235529440338667,0.00889453818736885,-0.00913006762770751,EPCI
247800584,CA Versailles Grand Parc (C.A.V.G.P.),1982_1990,1986,8,259353,262031,13447,31405,2678,17958,-15280,0.00128491845900847,0.0086163426762039,-0.00733142421719543,EPCI
247800584,CA Versailles Grand Parc (C.A.V.G.P.),1990_1999,1994.5,9,262031,255445,14962,33563,-6586,18601,-25187,-0.00282441438081038,0.00797706223769418,-0.0108014766185046,EPCI
247800584,CA Versailles Grand Parc (C.A.V.G.P.),1999_2010,2004.5,11,255445,261451,17375,39240,6006,21865,-15859,0.00211493907772042,0.00769949099806145,-0.00558455192034103,EPCI
247800618,CC Coeur d'Yvelines,2010_2015,2012.5,5,47862,48879,1756,2277,1017,521,496,0.00421405149525356,0.00215882087416628,0.00205523062108728,EPCI
247800618,CC Coeur d'Yvelines,1968_1975,1971.5,7,19672,27558,1861,2342,7886,481,7405,0.049335023728021,0.00300914867019758,0.0463258750578234,EPCI
247800618,CC Coeur d'Yvelines,1975_1982,1978.5,7,27558,34347,2061,2756,6789,695,6094,0.0319603623227185,0.00327182969719979,0.0286885326255187,EPCI
247800618,CC Coeur d'Yvelines,1982_1990,1986,8,34347,38985,2266,3156,4638,890,3748,0.0159587874183722,0.00306238050934697,0.0128964069090252,EPCI
247800618,CC Coeur d'Yvelines,1990_1999,1994.5,9,38985,42864,2763,4137,3879,1374,2505,0.0105952200035202,0.00375298589451837,0.00684223410900183,EPCI
247800618,CC Coeur d'Yvelines,1999_2010,2004.5,11,42864,47862,3771,5420,4998,1649,3349,0.0100767553845311,0.0033246437833317,0.00675211160119943,EPCI
247900798,CC du Thouarsais,2010_2015,2012.5,5,36382,36058,1981,1952,-324,-29,-295,-0.00178747929661505,-0.000159990430869865,-0.00162748886574518,EPCI
247900798,CC du Thouarsais,1968_1975,1971.5,7,35948,36405,2926,4018,457,1092,-635,0.00180629768678342,0.00431614239380196,-0.00250984470701854,EPCI
247900798,CC du Thouarsais,1975_1982,1978.5,7,36405,36709,2964,3383,304,419,-115,0.00118868145918172,0.00163834714275375,-0.000449665683572031,EPCI
247900798,CC du Thouarsais,1982_1990,1986,8,36709,36422,3247,3490,-287,243,-530,-0.000980639974314634,0.000830297957346537,-0.00181093793166117,EPCI
247900798,CC du Thouarsais,1990_1999,1994.5,9,36422,35852,3738,3458,-570,-280,-290,-0.00175109106771532,-0.000860185085895243,-0.000890905981820073,EPCI
247900798,CC du Thouarsais,1999_2010,2004.5,11,35852,36382,4241,4486,530,245,285,0.00133496239232889,0.000617105256831278,0.000717857135497609,EPCI
248000499,CC du Val de Somme,2010_2015,2012.5,5,25536,26362,1510,1513,826,3,823,0.00638718321584886,2.31980019946084e-05,0.00636398521385425,EPCI
248000499,CC du Val de Somme,1968_1975,1971.5,7,19633,20711,2096,2417,1078,321,757,0.00766539215237971,0.00228255183758246,0.00538284031479726,EPCI
248000499,CC du Val de Somme,1975_1982,1978.5,7,20711,21977,2197,2094,1266,-103,1369,0.0085119497822761,-0.000692520400927676,0.00920447018320377,EPCI
248000499,CC du Val de Somme,1982_1990,1986,8,21977,23085,2412,2390,1108,-22,1130,0.00616726525111688,-0.000122454725202682,0.00628971997631957,EPCI
248000499,CC du Val de Somme,1990_1999,1994.5,9,23085,24194,2584,2620,1109,36,1073,0.00522712651373025,0.000169681293502515,0.00505744522022774,EPCI
248000499,CC du Val de Somme,1999_2010,2004.5,11,24194,25536,3224,3433,1342,209,1133,0.00491974903051862,0.000766190422785686,0.00415355860773293,EPCI
248000531,CA Amiens Métropole,2010_2015,2012.5,5,177992,178597,6836,11471,605,4635,-4030,0.00067888344252931,0.00520103265474934,-0.00452214921222003,EPCI
248000531,CA Amiens Métropole,1968_1975,1971.5,7,147709,166910,11338,22886,19201,11548,7653,0.0176119536367163,0.0105923045985522,0.00701964903816415,EPCI
248000531,CA Amiens Métropole,1975_1982,1978.5,7,166910,171097,10826,21359,4187,10533,-6346,0.00354568571692471,0.0089196817903912,-0.00537399607346649,EPCI
248000531,CA Amiens Métropole,1982_1990,1986,8,171097,173866,11725,23071,2769,11346,-8577,0.00200879498606077,0.0082310537782035,-0.00622225879214273,EPCI
248000531,CA Amiens Métropole,1990_1999,1994.5,9,173866,178385,12539,22972,4519,10433,-5914,0.00285509563453079,0.00659154962493024,-0.00373645399039945,EPCI
248000531,CA Amiens Métropole,1999_2010,2004.5,11,178385,177992,14790,26257,-393,11467,-11860,-0.000200482667171098,0.0058497067288829,-0.006050189396054,EPCI
248000747,CC du Pays du Coquelicot,2010_2015,2012.5,5,27905,28419,1566,1630,514,64,450,0.00365708112642871,0.000455356404847154,0.00320172472158155,EPCI
248000747,CC du Pays du Coquelicot,1968_1975,1971.5,7,28246,28470,2370,3363,224,993,-769,0.00112907215731717,0.00500521719739262,-0.00387614504007546,EPCI
248000747,CC du Pays du Coquelicot,1975_1982,1978.5,7,28470,27709,2491,2493,-761,2,-763,-0.00386303792860188,1.01525306927776e-05,-0.00387319045929465,EPCI
248000747,CC du Pays du Coquelicot,1982_1990,1986,8,27709,26841,2531,2709,-868,178,-1046,-0.00397043451568757,0.000814213529714732,-0.0047846480454023,EPCI
248000747,CC du Pays du Coquelicot,1990_1999,1994.5,9,26841,26911,2832,2586,70,-246,316,0.000289436958965217,-0.00101716417007776,0.00130660112904298,EPCI
248000747,CC du Pays du Coquelicot,1999_2010,2004.5,11,26911,27905,3416,3649,994,233,761,0.00330278396449457,0.000774193826687359,0.00252859013780721,EPCI
248100158,CC du Sor et de l'Agout,2010_2015,2012.5,5,21651,22728,1034,1140,1077,106,971,0.00975648756093306,0.000960248543601582,0.00879623901733148,EPCI
248100158,CC du Sor et de l'Agout,1968_1975,1971.5,7,13814,14101,1369,1090,287,-279,566,0.00294191126498511,-0.00285990676979389,0.005801818034779,EPCI
248100158,CC du Sor et de l'Agout,1975_1982,1978.5,7,14101,15786,1359,1118,1685,-241,1926,0.0162561093173068,-0.00232505777179284,0.0185811670890997,EPCI
248100158,CC du Sor et de l'Agout,1982_1990,1986,8,15786,17565,1433,1560,1779,127,1652,0.0134375854170232,0.000959287997730157,0.0124782974192931,EPCI
248100158,CC du Sor et de l'Agout,1990_1999,1994.5,9,17565,18878,1651,1718,1313,67,1246,0.00804204683527376,0.0004103710113963,0.00763167582387746,EPCI
248100158,CC du Sor et de l'Agout,1999_2010,2004.5,11,18878,21651,2141,2434,2773,293,2480,0.0125374355665664,0.0013247272344046,0.0112127083321618,EPCI
248100430,CA de Castres Mazamet,2010_2015,2012.5,5,79300,78244,4302,3985,-1056,-317,-739,-0.00267760469990641,-0.000803788532074178,-0.00187381616783223,EPCI
248100430,CA de Castres Mazamet,1968_1975,1971.5,7,78963,85085,6132,8994,6122,2862,3260,0.0107244372613033,0.00501361310713005,0.00571082415417329,EPCI
248100430,CA de Castres Mazamet,1975_1982,1978.5,7,85085,84191,6142,8152,-894,2010,-2904,-0.00150782346865253,0.00339007289931944,-0.00489789636797196,EPCI
248100430,CA de Castres Mazamet,1982_1990,1986,8,84191,82670,6916,8449,-1521,1533,-3054,-0.00227631125388428,0.00229427031703129,-0.00457058157091557,EPCI
248100430,CA de Castres Mazamet,1990_1999,1994.5,9,82670,79878,7549,8409,-2792,860,-3652,-0.00381009073543426,0.0011735952838372,-0.00498368601927146,EPCI
248100430,CA de Castres Mazamet,1999_2010,2004.5,11,79878,79300,9193,9348,-578,155,-733,-0.000659995019867132,0.000176988283874404,-0.000836983303741536,EPCI
248100497,CC Val 81,2010_2015,2012.5,5,5448,5593,449,241,145,-208,353,0.00526727296026519,-0.00755581224644938,0.0128230852067146,EPCI
248100497,CC Val 81,1968_1975,1971.5,7,5874,5201,555,346,-673,-209,-464,-0.0172333373639862,-0.00535180907737463,-0.0118815282866116,EPCI
248100497,CC Val 81,1975_1982,1978.5,7,5201,5073,519,351,-128,-168,40,-0.00355346518969601,-0.00466392306147602,0.00111045787178,EPCI
248100497,CC Val 81,1982_1990,1986,8,5073,4976,600,311,-97,-289,192,-0.00241034084568825,-0.00718132478766912,0.00477098394198087,EPCI
248100497,CC Val 81,1990_1999,1994.5,9,4976,4834,719,369,-142,-350,208,-0.00321172834792205,-0.00791623184346984,0.00470450349554779,EPCI
248100497,CC Val 81,1999_2010,2004.5,11,4834,5448,958,566,614,-392,1006,0.0109296870407947,-0.00697791094461158,0.0179075979854062,EPCI
248100737,CA de l'Albigeois (C2a),2010_2015,2012.5,5,80121,82047,4144,3915,1926,-229,2155,0.00476215555162418,-0.000566216833500487,0.00532837238512467,EPCI
248100737,CA de l'Albigeois (C2a),1968_1975,1971.5,7,58411,65062,4726,6366,6651,1640,5011,0.0155244765864511,0.00382801708040592,0.0116964595060451,EPCI
248100737,CA de l'Albigeois (C2a),1975_1982,1978.5,7,65062,68439,4816,6260,3377,1444,1933,0.00725507375065249,0.00310225836421149,0.004152815386441,EPCI
248100737,CA de l'Albigeois (C2a),1982_1990,1986,8,68439,72019,5646,6305,3580,659,2921,0.00639374521843239,0.00117694918964998,0.0052167960287824,EPCI
248100737,CA de l'Albigeois (C2a),1990_1999,1994.5,9,72019,73506,6411,6303,1487,-108,1595,0.00227336490066921,-0.000165113254386197,0.0024384781550554,EPCI
248100737,CA de l'Albigeois (C2a),1999_2010,2004.5,11,73506,80121,8429,8406,6615,-23,6638,0.00786448720428612,-2.7344399954434e-05,0.00789183160424055,EPCI
248100745,CC Thoré Montagne Noire,2010_2015,2012.5,5,5086,5100,319,203,14,-116,130,0.000549925699794951,-0.00455652722687245,0.0051064529266674,EPCI
248100745,CC Thoré Montagne Noire,1968_1975,1971.5,7,7023,6076,607,508,-947,-99,-848,-0.020479374487806,-0.00214092721678225,-0.0183384472710238,EPCI
248100745,CC Thoré Montagne Noire,1975_1982,1978.5,7,6076,5623,549,372,-453,-177,-276,-0.0110077175476747,-0.00430102871068085,-0.00670668883699386,EPCI
248100745,CC Thoré Montagne Noire,1982_1990,1986,8,5623,5615,575,453,-8,-122,114,-0.000177951804656185,-0.00271376502100681,0.00253581321635063,EPCI
248100745,CC Thoré Montagne Noire,1990_1999,1994.5,9,5615,5241,606,413,-374,-193,-181,-0.00762955366087004,-0.00393717608702652,-0.00369237757384352,EPCI
248100745,CC Thoré Montagne Noire,1999_2010,2004.5,11,5241,5086,705,414,-155,-291,136,-0.00272542951140564,-0.00511677411496156,0.00239134460355592,EPCI
248200016,CC des Deux Rives,2010_2015,2012.5,5,18432,18749,1014,873,317,-141,458,0.00341624875112223,-0.00151953020160326,0.00493577895272549,EPCI
248200016,CC des Deux Rives,1968_1975,1971.5,7,14714,14089,1327,1190,-625,-137,-488,-0.00618153953093292,-0.0013549934651805,-0.00482654606575243,EPCI
248200016,CC des Deux Rives,1975_1982,1978.5,7,14089,14588,1339,1007,499,-332,831,0.00498451325568294,-0.00331634950077502,0.00830086275645797,EPCI
248200016,CC des Deux Rives,1982_1990,1986,8,14588,16282,1473,1276,1694,-197,1891,0.0138273417634784,-0.00160802026411172,0.0154353620275902,EPCI
248200016,CC des Deux Rives,1990_1999,1994.5,9,16282,16248,1684,1532,-34,-152,118,-0.000232237348031461,-0.00103823755590536,0.000806000207873894,EPCI
248200016,CC des Deux Rives,1999_2010,2004.5,11,16248,18432,2039,1884,2184,-155,2339,0.0115312932000704,-0.00081838390385115,0.0123496771039216,EPCI
248200057,CC du Quercy Caussadais,2010_2015,2012.5,5,19361,20168,1115,999,807,-116,923,0.00820073460435289,-0.00117879208687105,0.00937952669122394,EPCI
248200057,CC du Quercy Caussadais,1968_1975,1971.5,7,15847,15831,1486,1545,-16,59,-75,-0.000144298854922953,0.000532102027528389,-0.000676400882451342,EPCI
248200057,CC du Quercy Caussadais,1975_1982,1978.5,7,15831,16260,1568,1273,429,-295,724,0.00382702744326746,-0.00263163891786457,0.00645866636113203,EPCI
248200057,CC du Quercy Caussadais,1982_1990,1986,8,16260,16616,1718,1412,356,-306,662,0.00271091571134052,-0.0023301691226691,0.00504108483400962,EPCI
248200057,CC du Quercy Caussadais,1990_1999,1994.5,9,16616,16896,1956,1510,280,-446,726,0.00185848272562938,-0.00296029748439538,0.00481878021002476,EPCI
248200057,CC du Quercy Caussadais,1999_2010,2004.5,11,16896,19361,2313,2108,2465,-205,2670,0.0124573015569667,-0.00103600276640088,0.0134933043233676,EPCI
248200065,CC de la Lomagne Tarn-et-Garonnaise,2010_2015,2012.5,5,9835,9907,795,468,72,-327,399,0.00145988983312706,-0.00663033299211873,0.00809022282524579,EPCI
248200065,CC de la Lomagne Tarn-et-Garonnaise,1968_1975,1971.5,7,9735,9453,954,789,-282,-165,-117,-0.00419055037686289,-0.00245191777369637,-0.00173863260316652,EPCI
248200065,CC de la Lomagne Tarn-et-Garonnaise,1975_1982,1978.5,7,9453,9322,947,616,-131,-331,200,-0.00199157895424218,-0.00503215751033711,0.00304057855609493,EPCI
248200065,CC de la Lomagne Tarn-et-Garonnaise,1982_1990,1986,8,9322,9154,1109,665,-168,-444,276,-0.00227070001631102,-0.00600113575739342,0.00373043574108239,EPCI
248200065,CC de la Lomagne Tarn-et-Garonnaise,1990_1999,1994.5,9,9154,9357,1320,799,203,-521,724,0.00244005922878721,-0.00626241802068046,0.00870247724946767,EPCI
248200065,CC de la Lomagne Tarn-et-Garonnaise,1999_2010,2004.5,11,9357,9835,1769,977,478,-792,1270,0.00453961164462702,-0.00752169962875439,0.0120613112733814,EPCI
248200099,CA Grand Montauban,2010_2015,2012.5,5,71045,75681,3156,4689,4636,1533,3103,0.0127229890200995,0.00420714887140046,0.00851584014869904,EPCI
248200099,CA Grand Montauban,1968_1975,1971.5,7,52689,55542,4150,6168,2853,2018,835,0.0075617015252949,0.00534858523590785,0.00221311628938704,EPCI
248200099,CA Grand Montauban,1975_1982,1978.5,7,55542,59228,4013,5259,3686,1246,2440,0.00922153183463514,0.00311720799401937,0.00610432384061578,EPCI
248200099,CA Grand Montauban,1982_1990,1986,8,59228,61357,4543,5786,2129,1243,886,0.00442411525813125,0.00258298509434342,0.00184113016378783,EPCI
248200099,CA Grand Montauban,1990_1999,1994.5,9,61357,63101,4960,6696,1744,1736,8,0.0031190043596725,0.00310469700022446,1.43073594480389e-05,EPCI
248200099,CA Grand Montauban,1999_2010,2004.5,11,63101,71045,6033,9207,7944,3174,4770,0.0108380251694435,0.00433029857600879,0.00650772659343476,EPCI
248200107,CC du Quercy Rouergue et des Gorges de l'Aveyron,2010_2015,2012.5,5,7756,7661,558,235,-95,-323,228,-0.00246180753850689,-0.00837014563092342,0.00590833809241653,EPCI
248200107,CC du Quercy Rouergue et des Gorges de l'Aveyron,1968_1975,1971.5,7,8868,7892,935,582,-976,-353,-623,-0.0165191380947077,-0.00597464728220474,-0.010544490812503,EPCI
248200107,CC du Quercy Rouergue et des Gorges de l'Aveyron,1975_1982,1978.5,7,7892,7924,879,458,32,-421,453,0.00057824435826781,-0.00760752733846087,0.00818577169672868,EPCI
248200107,CC du Quercy Rouergue et des Gorges de l'Aveyron,1982_1990,1986,8,7924,7478,991,534,-446,-457,11,-0.00721518867485482,-0.0073931417587638,0.000177953083908975,EPCI
248200107,CC du Quercy Rouergue et des Gorges de l'Aveyron,1990_1999,1994.5,9,7478,7385,1090,608,-93,-482,389,-0.00138952932795744,-0.00720164662446759,0.00581211729651015,EPCI
248200107,CC du Quercy Rouergue et des Gorges de l'Aveyron,1999_2010,2004.5,11,7385,7756,1240,709,371,-531,902,0.00446592642164134,-0.0063919324255837,0.010857858847225,EPCI
248300394,CA Sud Sainte-Baume,2010_2015,2012.5,5,59846,60394,3696,2589,548,-1107,1655,0.00182469598309298,-0.00368601907533564,0.00551071505842863,EPCI
248300394,CA Sud Sainte-Baume,1968_1975,1971.5,7,24923,29900,2627,2171,4977,-456,5433,0.0263508319630208,-0.00241430166267581,0.0287651336256966,EPCI
248300394,CA Sud Sainte-Baume,1975_1982,1978.5,7,29900,36103,3021,2169,6203,-852,7055,0.0272969878583622,-0.00374932027330721,0.0310463081316694,EPCI
248300394,CA Sud Sainte-Baume,1982_1990,1986,8,36103,45451,4047,3489,9348,-558,9906,0.0292005720808448,-0.00174303799969099,0.0309436100805358,EPCI
248300394,CA Sud Sainte-Baume,1990_1999,1994.5,9,45451,53531,5417,4634,8080,-783,8863,0.0183469527460538,-0.0017779287128911,0.0201248814589449,EPCI
248300394,CA Sud Sainte-Baume,1999_2010,2004.5,11,53531,59846,7758,6198,6315,-1560,7875,0.0101891660401112,-0.00251703864173769,0.0127062046818489,EPCI
248300410,CC de la Vallée du Gapeau,2010_2015,2012.5,5,29413,30281,1161,1444,868,283,585,0.00583369000829515,0.00190199800961697,0.00393169199867818,EPCI
248300410,CC de la Vallée du Gapeau,1968_1975,1971.5,7,9403,10665,782,837,1262,55,1207,0.0181540405403164,0.000791182432422666,0.0173628581078938,EPCI
248300410,CC de la Vallée du Gapeau,1975_1982,1978.5,7,10665,14239,936,874,3574,-62,3636,0.0421523997074869,-0.000731239166721932,0.0428836388742088,EPCI
248300410,CC de la Vallée du Gapeau,1982_1990,1986,8,14239,22792,1250,1877,8553,627,7926,0.0605664103527808,0.00443997887188046,0.0561264314809003,EPCI
248300410,CC de la Vallée du Gapeau,1990_1999,1994.5,9,22792,26065,1784,2303,3273,519,2754,0.0150210116851932,0.00238188361277583,0.0126391280724174,EPCI
248300410,CC de la Vallée du Gapeau,1999_2010,2004.5,11,26065,29413,2706,3232,3348,526,2822,0.0110463227689679,0.00173547364888803,0.00931084912007986,EPCI
248300493,CA Dracénoise,2010_2015,2012.5,5,100760,107910,4893,5950,7150,1057,6093,0.0138056488303975,0.00204091899492729,0.0117647298354702,EPCI
248300493,CA Dracénoise,1968_1975,1971.5,7,42580,49393,4004,4331,6813,327,6486,0.0214298264336781,0.00102855617845483,0.0204012702552233,EPCI
248300493,CA Dracénoise,1975_1982,1978.5,7,49393,61886,4727,4743,12493,16,12477,0.0327366094583237,4.19263388564139e-05,0.0326946831194673,EPCI
248300493,CA Dracénoise,1982_1990,1986,8,61886,75002,5848,6946,13116,1098,12018,0.0243185883070285,0.00203581960667256,0.0222827687003559,EPCI
248300493,CA Dracénoise,1990_1999,1994.5,9,75002,85279,7126,8353,10277,1227,9050,0.014370437671837,0.00171572706269767,0.0126547106091393,EPCI
248300493,CA Dracénoise,1999_2010,2004.5,11,85279,100760,10002,11724,15481,1722,13759,0.0152804075424207,0.0016996874741973,0.0135807200682234,EPCI
248300543,Métropole Toulon-Provence-Méditerranée,2010_2015,2012.5,5,423190,431038,22867,24091,7848,1224,6624,0.00368176159320233,0.000574219698022381,0.00310754189517995,EPCI
248300543,Métropole Toulon-Provence-Méditerranée,1968_1975,1971.5,7,317240,352007,25148,34997,34767,9849,24918,0.0149669679559383,0.00423993060655324,0.0107270373493851,EPCI
248300543,Métropole Toulon-Provence-Méditerranée,1975_1982,1978.5,7,352007,378927,27974,33136,26920,5162,21758,0.0105831109216572,0.00202934690109935,0.00855376402055785,EPCI
248300543,Métropole Toulon-Provence-Méditerranée,1982_1990,1986,8,378927,394042,33659,40919,15115,7260,7855,0.00490121286806633,0.0023541386319657,0.00254707423610063,EPCI
248300543,Métropole Toulon-Provence-Méditerranée,1990_1999,1994.5,9,394042,406845,39138,44857,12803,5719,7084,0.00355907127594723,0.00158980931243788,0.00196926196350935,EPCI
248300543,Métropole Toulon-Provence-Méditerranée,1999_2010,2004.5,11,406845,423190,48437,53063,16345,4626,11719,0.00358723452989818,0.00101526747845267,0.0025719670514455,EPCI
248300550,CC Coeur du Var,2010_2015,2012.5,5,39090,42592,2016,2411,3502,395,3107,0.0173080302560833,0.00195221928930694,0.0153558109667764,EPCI
248300550,CC Coeur du Var,1968_1975,1971.5,7,16320,17823,1877,1496,1503,-381,1884,0.0126650174633012,-0.00321049344878094,0.0158755109120821,EPCI
248300550,CC Coeur du Var,1975_1982,1978.5,7,17823,20296,2064,1298,2473,-766,3239,0.0187353541542856,-0.00580318693173586,0.0245385410860215,EPCI
248300550,CC Coeur du Var,1982_1990,1986,8,20296,25480,2494,2106,5184,-388,5572,0.0288418488854132,-0.00215868776380022,0.0310005366492134,EPCI
248300550,CC Coeur du Var,1990_1999,1994.5,9,25480,28916,2804,2843,3436,39,3397,0.0141549395344169,0.000160664331153161,0.0139942752032638,EPCI
248300550,CC Coeur du Var,1999_2010,2004.5,11,28916,39090,3958,4439,10174,481,9693,0.0277855224486476,0.00131362652818945,0.0264718959204582,EPCI
248400053,CA Ventoux-Comtat-Venaissin (Cove),2010_2015,2012.5,5,68362,69203,3348,4210,841,862,-21,0.00244841239613947,0.00250954992327256,-6.113752713309e-05,EPCI
248400053,CA Ventoux-Comtat-Venaissin (Cove),1968_1975,1971.5,7,42083,46987,3475,4918,4904,1443,3461,0.0158713629422731,0.00467014207294047,0.0112012208693326,EPCI
248400053,CA Ventoux-Comtat-Venaissin (Cove),1975_1982,1978.5,7,46987,51221,3894,3875,4234,-19,4253,0.0124017917582184,-5.56528208328177e-05,0.0124574445790512,EPCI
248400053,CA Ventoux-Comtat-Venaissin (Cove),1982_1990,1986,8,51221,54796,4807,5166,3575,359,3216,0.00846911101155023,0.000850464574306723,0.00761864643724351,EPCI
248400053,CA Ventoux-Comtat-Venaissin (Cove),1990_1999,1994.5,9,54796,60597,5853,6573,5801,720,5081,0.0112436497963646,0.00139552281561498,0.00984812698074962,EPCI
248400053,CA Ventoux-Comtat-Venaissin (Cove),1999_2010,2004.5,11,60597,68362,7257,8520,7765,1263,6502,0.0110213587378722,0.00179265628923795,0.0092287024486343,EPCI
248400160,CC Aygues-Ouvèze en Provence (Ccaop),2010_2015,2012.5,5,18130,18898,723,1037,768,314,454,0.00833213493395224,0.00340662808497526,0.00492550684897698,EPCI
248400160,CC Aygues-Ouvèze en Provence (Ccaop),1968_1975,1971.5,7,9186,10213,800,854,1027,54,973,0.0152553111640934,0.000802129311451844,0.0144531818526416,EPCI
248400160,CC Aygues-Ouvèze en Provence (Ccaop),1975_1982,1978.5,7,10213,12131,834,929,1918,95,1823,0.0248908364401039,0.00123286207602183,0.0236579743640821,EPCI
248400160,CC Aygues-Ouvèze en Provence (Ccaop),1982_1990,1986,8,12131,14531,1060,1374,2400,314,2086,0.0228215331162451,0.0029858172493754,0.0198357158668697,EPCI
248400160,CC Aygues-Ouvèze en Provence (Ccaop),1990_1999,1994.5,9,14531,16177,1199,1639,1646,440,1206,0.0119942703220193,0.00320624480053978,0.00878802552147949,EPCI
248400160,CC Aygues-Ouvèze en Provence (Ccaop),1999_2010,2004.5,11,16177,18130,1520,2166,1953,646,1307,0.0104154621614514,0.00344515543077194,0.00697030673067945,EPCI
248400236,CC du Pays Réuni d'Orange,2010_2015,2012.5,5,43973,45146,2233,3253,1173,1020,153,0.00527906002264666,0.00459048697621449,0.000688573046432174,EPCI
248400236,CC du Pays Réuni d'Orange,1968_1975,1971.5,7,35032,36912,2551,4566,1880,2015,-135,0.00749577830482417,0.00803403898096846,-0.000538260676144289,EPCI
248400236,CC du Pays Réuni d'Orange,1975_1982,1978.5,7,36912,38415,2583,3796,1503,1213,290,0.00571790041391607,0.00461464617570206,0.00110325423821401,EPCI
248400236,CC du Pays Réuni d'Orange,1982_1990,1986,8,38415,40232,2941,4861,1817,1920,-103,0.0057935544147496,0.00612197274425935,-0.000328418329509746,EPCI
248400236,CC du Pays Réuni d'Orange,1990_1999,1994.5,9,40232,41853,3622,5169,1621,1547,74,0.00439862122454859,0.00419782050239153,0.000200800722157061,EPCI
248400236,CC du Pays Réuni d'Orange,1999_2010,2004.5,11,41853,43973,4784,6836,2120,2052,68,0.00450213431339774,0.00435772623164725,0.000144408081750494,EPCI
248400251,CA du Grand Avignon (Coga),2010_2015,2012.5,5,187253,192582,7744,12937,5329,5193,136,0.00562805702405123,0.00548442486881179,0.000143632155239438,EPCI
248400251,CA du Grand Avignon (Coga),1968_1975,1971.5,7,125423,141088,8930,14480,15665,5550,10115,0.0169552479362349,0.00600712582483906,0.0109481221113959,EPCI
248400251,CA du Grand Avignon (Coga),1975_1982,1978.5,7,141088,152835,9495,14014,11747,4519,7228,0.0114905288697544,0.00442033710414747,0.00707019176560697,EPCI
248400251,CA du Grand Avignon (Coga),1982_1990,1986,8,152835,163682,10970,17352,10847,6382,4465,0.00860766131866986,0.00506445049651987,0.00354321082214999,EPCI
248400251,CA du Grand Avignon (Coga),1990_1999,1994.5,9,163682,171934,12674,19803,8252,7129,1123,0.00547997835665037,0.00473421785077078,0.000745760505879589,EPCI
248400251,CA du Grand Avignon (Coga),1999_2010,2004.5,11,171934,187253,15622,26059,15319,10437,4882,0.00778926712268557,0.00530691174094062,0.00248235538174495,EPCI
248400285,CC Territoriale Sud-Luberon,2010_2015,2012.5,5,23500,24557,1089,1285,1057,196,861,0.00883813265209432,0.00163885903482544,0.00719927361726889,EPCI
248400285,CC Territoriale Sud-Luberon,1968_1975,1971.5,7,10933,11429,981,943,496,-38,534,0.00635845058631346,-0.000487139359435305,0.00684558994574876,EPCI
248400285,CC Territoriale Sud-Luberon,1975_1982,1978.5,7,11429,13248,1055,811,1819,-244,2063,0.0213231011209589,-0.00286027304756129,0.0241833741685202,EPCI
248400285,CC Territoriale Sud-Luberon,1982_1990,1986,8,13248,17441,1329,1435,4193,106,4087,0.0349696936907955,0.000884041862920182,0.0340856518278753,EPCI
248400285,CC Territoriale Sud-Luberon,1990_1999,1994.5,9,17441,21179,1676,2101,3738,425,3313,0.0218107138775669,0.00247981631834295,0.019330897559224,EPCI
248400285,CC Territoriale Sud-Luberon,1999_2010,2004.5,11,21179,23500,2203,2742,2321,539,1782,0.00949849033667638,0.00220581055211916,0.00729267978455722,EPCI
248400293,CC des Sorgues du Comtat,2010_2015,2012.5,5,47271,48237,1878,2993,966,1115,-149,0.0040540679470793,0.00467938484574888,-0.000625316898669581,EPCI
248400293,CC des Sorgues du Comtat,1968_1975,1971.5,7,29210,32700,1984,3564,3490,1580,1910,0.0162541068697228,0.00735859279488885,0.00889551407483399,EPCI
248400293,CC des Sorgues du Comtat,1975_1982,1978.5,7,32700,37410,2216,3350,4710,1134,3576,0.0194092384257516,0.00467305230887523,0.0147361861168764,EPCI
248400293,CC des Sorgues du Comtat,1982_1990,1986,8,37410,40113,2475,4060,2703,1585,1118,0.0087584354706447,0.00513581954161001,0.00362261592903469,EPCI
248400293,CC des Sorgues du Comtat,1990_1999,1994.5,9,40113,44371,2978,4796,4258,1818,2440,0.0112725766410602,0.00481295075938173,0.00645962588167845,EPCI
248400293,CC des Sorgues du Comtat,1999_2010,2004.5,11,44371,47271,4081,6437,2900,2356,544,0.00577213098912988,0.00468935883116896,0.00108277215796091,EPCI
248400319,CC du Pays des Sorgues et des Monts de Vaucluse,2010_2015,2012.5,5,32112,33245,1578,1743,1133,165,968,0.00695901978430236,0.00101344948315083,0.00594557030115153,EPCI
248400319,CC du Pays des Sorgues et des Monts de Vaucluse,1968_1975,1971.5,7,15597,18164,1423,1701,2567,278,2289,0.0220047570846038,0.00238306290203345,0.0196216941825704,EPCI
248400319,CC du Pays des Sorgues et des Monts de Vaucluse,1975_1982,1978.5,7,18164,20957,1607,1638,2793,31,2762,0.0206431983439788,0.00022912250220671,0.0204140758417721,EPCI
248400319,CC du Pays des Sorgues et des Monts de Vaucluse,1982_1990,1986,8,20957,25348,2059,2328,4391,269,4122,0.024063349042313,0.00147416098665047,0.0225891880556625,EPCI
248400319,CC du Pays des Sorgues et des Monts de Vaucluse,1990_1999,1994.5,9,25348,27722,2457,2799,2374,342,2032,0.009997027535251,0.00144017835596287,0.00855684917928814,EPCI
248400319,CC du Pays des Sorgues et des Monts de Vaucluse,1999_2010,2004.5,11,27722,32112,3270,3594,4390,324,4066,0.013453648568692,0.000992934427393215,0.0124607141412988,EPCI
248400335,CC Vaison Ventoux,2010_2015,2012.5,5,16864,16873,949,848,9,-101,110,0.000106713464926411,-0.0011975622175075,0.00130427568243391,EPCI
248400335,CC Vaison Ventoux,1968_1975,1971.5,7,11745,12566,1098,1161,821,63,758,0.00969918310585016,0.000744273490461097,0.00895490961538907,EPCI
248400335,CC Vaison Ventoux,1975_1982,1978.5,7,12566,13878,1083,1015,1312,-68,1380,0.0142882722527284,-0.000740550696025559,0.015028822948754,EPCI
248400335,CC Vaison Ventoux,1982_1990,1986,8,13878,14639,1399,1310,761,-89,850,0.00669535782581443,-0.000783031335739138,0.00747838916155357,EPCI
248400335,CC Vaison Ventoux,1990_1999,1994.5,9,14639,15533,1593,1550,894,-43,937,0.00660813722795561,-0.000317841052351333,0.00692597828030695,EPCI
248400335,CC Vaison Ventoux,1999_2010,2004.5,11,15533,16864,2098,1826,1331,-272,1603,0.00750203479736622,-0.00153309802019806,0.00903513281756427,EPCI
248500191,CC de l'Ile de Noirmoutier,2010_2015,2012.5,5,9581,9463,642,297,-118,-345,227,-0.00247543367688019,-0.00723749676714971,0.00476206309026952,EPCI
248500191,CC de l'Ile de Noirmoutier,1968_1975,1971.5,7,7966,8094,788,926,128,138,-10,0.00227981794100018,0.00245792871764082,-0.000178110776640639,EPCI
248500191,CC de l'Ile de Noirmoutier,1975_1982,1978.5,7,8094,8482,896,762,388,-134,522,0.00671145362557368,-0.00231787315934761,0.00902932678492129,EPCI
248500191,CC de l'Ile de Noirmoutier,1982_1990,1986,8,8482,9170,870,836,688,-34,722,0.00979655200270657,-0.000484131930366313,0.0102806839330729,EPCI
248500191,CC de l'Ile de Noirmoutier,1990_1999,1994.5,9,9170,9592,1047,862,422,-185,607,0.00501164219485206,-0.00219704693376216,0.00720868912861422,EPCI
248500191,CC de l'Ile de Noirmoutier,1999_2010,2004.5,11,9592,9581,1457,1013,-11,-444,433,-0.000104307928320391,-0.0042102472885685,0.00410593936024811,EPCI
248500258,CC Océan Marais de Monts,2010_2015,2012.5,5,18172,19012,1276,711,840,-565,1405,0.00907864533144465,-0.00610646977650741,0.0151851151079521,EPCI
248500258,CC Océan Marais de Monts,1968_1975,1971.5,7,11486,12080,1041,1137,594,96,498,0.00722918962983887,0.00116835387956992,0.00606083575026895,EPCI
248500258,CC Océan Marais de Monts,1975_1982,1978.5,7,12080,12475,1126,1002,395,-124,519,0.00460707280991435,-0.00144627095804906,0.00605334376796341,EPCI
248500258,CC Océan Marais de Monts,1982_1990,1986,8,12475,13596,1379,1052,1121,-327,1448,0.010814178836299,-0.00315453744823351,0.0139687162845325,EPCI
248500258,CC Océan Marais de Monts,1990_1999,1994.5,9,13596,15155,1602,1261,1559,-341,1900,0.0121346882709033,-0.00265421982064016,0.0147889080915434,EPCI
248500258,CC Océan Marais de Monts,1999_2010,2004.5,11,15155,18172,2356,1791,3017,-565,3582,0.016641630719431,-0.00311651354208768,0.0197581442615187,EPCI
248500340,CC Pays de Chantonnay,2010_2015,2012.5,5,21420,22184,859,1437,764,578,186,0.00703387093642593,0.00532143638907617,0.00171243454734977,EPCI
248500340,CC Pays de Chantonnay,1968_1975,1971.5,7,15823,16622,1297,1958,799,661,138,0.00706232735100842,0.00584255116272412,0.00121977618828431,EPCI
248500340,CC Pays de Chantonnay,1975_1982,1978.5,7,16622,17593,1111,2109,971,998,-27,0.00814354783363469,0.00836999046134647,-0.000226442627711777,EPCI
248500340,CC Pays de Chantonnay,1982_1990,1986,8,17593,18478,1287,2188,885,901,-16,0.00615382490532568,0.00626508049683439,-0.000111255591508713,EPCI
248500340,CC Pays de Chantonnay,1990_1999,1994.5,9,18478,18793,1383,1953,315,570,-255,0.0018799454220273,0.00340180600176368,-0.00152186057973638,EPCI
248500340,CC Pays de Chantonnay,1999_2010,2004.5,11,18793,21420,1791,3014,2627,1223,1404,0.0119656225232077,0.00557059624890863,0.00639502627429903,EPCI
248500415,CC du Pays de la Châtaigneraie,2010_2015,2012.5,5,15553,15646,833,835,93,2,91,0.00119306057129776,2.56572165870485e-05,0.00116740335471071,EPCI
248500415,CC du Pays de la Châtaigneraie,1968_1975,1971.5,7,15557,15249,1146,1852,-308,706,-1014,-0.00285260513526875,0.00653876371915499,-0.00939136885442374,EPCI
248500415,CC du Pays de la Châtaigneraie,1975_1982,1978.5,7,15249,15438,1093,1683,189,590,-401,0.00176127428113837,0.00549815780884465,-0.00373688352770628,EPCI
248500415,CC du Pays de la Châtaigneraie,1982_1990,1986,8,15438,15342,1227,1605,-96,378,-474,-0.000779425713670956,0.00306898874757939,-0.00384841446125035,EPCI
248500415,CC du Pays de la Châtaigneraie,1990_1999,1994.5,9,15342,14966,1341,1400,-376,59,-435,-0.00275322555662216,0.000432022095321031,-0.00318524765194319,EPCI
248500415,CC du Pays de la Châtaigneraie,1999_2010,2004.5,11,14966,15553,1862,1968,587,106,481,0.00350363108989393,0.000632682956607763,0.00287094813328617,EPCI
248500464,CC du Pays de Pouzauges,2010_2015,2012.5,5,22644,23179,892,1406,535,514,21,0.00468127914468464,0.00449752800068767,0.000183751143996967,EPCI
248500464,CC du Pays de Pouzauges,1968_1975,1971.5,7,19694,20401,1173,2703,707,1530,-823,0.00505127179252551,0.0109313236811372,-0.00588005188861174,EPCI
248500464,CC du Pays de Pouzauges,1975_1982,1978.5,7,20401,20992,1206,2561,591,1355,-764,0.004087974996557,0.00937259918838364,-0.00528462419182664,EPCI
248500464,CC du Pays de Pouzauges,1982_1990,1986,8,20992,21274,1316,2449,282,1133,-851,0.00166942407289916,0.00670729600920124,-0.00503787193630208,EPCI
248500464,CC du Pays de Pouzauges,1990_1999,1994.5,9,21274,20892,1584,2174,-382,590,-972,-0.00201123688661964,0.00310636063640206,-0.0051175975230217,EPCI
248500464,CC du Pays de Pouzauges,1999_2010,2004.5,11,20892,22644,1861,3148,1752,1287,465,0.0073476447655918,0.00539749932266932,0.00195014544292248,EPCI
248500530,CC du Pays des Achards,2010_2015,2012.5,5,16341,18221,691,1310,1880,619,1261,0.0220184021117766,0.00724967601446263,0.014768726097314,EPCI
248500530,CC du Pays des Achards,1968_1975,1971.5,7,9390,9333,717,996,-57,279,-336,-0.000869448472815781,0.00425572147220356,-0.00512516994501934,EPCI
248500530,CC du Pays des Achards,1975_1982,1978.5,7,9333,10731,758,918,1398,160,1238,0.0201401651030477,0.00230502604898973,0.017835139054058,EPCI
248500530,CC du Pays des Achards,1982_1990,1986,8,10731,11433,950,1178,702,228,474,0.00795234848345827,0.00258281403736252,0.00536953444609576,EPCI
248500530,CC du Pays des Achards,1990_1999,1994.5,9,11433,12151,1017,1157,718,140,578,0.00679045802611134,0.00132404474046739,0.00546641328564394,EPCI
248500530,CC du Pays des Achards,1999_2010,2004.5,11,12151,16341,1331,2246,4190,915,3275,0.0272992344285212,0.00596152732746943,0.0213377071010518,EPCI
248500563,"CC Vendée, Sèvre, Autise",2010_2015,2012.5,5,15738,16322,939,893,584,-46,630,0.00731376003394435,-0.000576083838290137,0.00788984387223449,EPCI
248500563,"CC Vendée, Sèvre, Autise",1968_1975,1971.5,7,13802,13342,1184,1235,-460,51,-511,-0.00483065963944029,0.000535573133937946,-0.00536623277337824,EPCI
248500563,"CC Vendée, Sèvre, Autise",1975_1982,1978.5,7,13342,13949,1341,1147,607,-194,801,0.00637607931716722,-0.00203782436166465,0.00841390367883186,EPCI
248500563,"CC Vendée, Sèvre, Autise",1982_1990,1986,8,13949,14153,1394,1298,204,-96,300,0.00181649716595311,-0.000854822195742641,0.00267131936169575,EPCI
248500563,"CC Vendée, Sèvre, Autise",1990_1999,1994.5,9,14153,14149,1616,1348,-4,-268,264,-3.14067887838831e-05,-0.00210425484852017,0.00207284805973629,EPCI
248500563,"CC Vendée, Sèvre, Autise",1999_2010,2004.5,11,14149,15738,1917,1971,1589,54,1535,0.00972280043902662,0.000330416125681207,0.00939238431334542,EPCI
248500589,CA La Roche-sur-Yon Agglomération,2010_2015,2012.5,5,91168,94892,3309,5342,3724,2033,1691,0.00803923136515183,0.00438876406158799,0.00365046730356384,EPCI
248500589,CA La Roche-sur-Yon Agglomération,1968_1975,1971.5,7,53049,64290,3283,8288,11241,5005,6236,0.0278358142240371,0.0123937594690246,0.0154420547550125,EPCI
248500589,CA La Roche-sur-Yon Agglomération,1975_1982,1978.5,7,64290,70666,3362,8164,6376,4802,1574,0.0136002901314571,0.0102428784835723,0.00335741164788481,EPCI
248500589,CA La Roche-sur-Yon Agglomération,1982_1990,1986,8,70666,73740,4137,7968,3074,3831,-757,0.00533679532879372,0.00665102892147324,-0.00131423359267952,EPCI
248500589,CA La Roche-sur-Yon Agglomération,1990_1999,1994.5,9,73740,79665,4666,8100,5925,3434,2491,0.0086241925464392,0.00499839277712611,0.00362579976931309,EPCI
248500589,CA La Roche-sur-Yon Agglomération,1999_2010,2004.5,11,79665,91168,6650,11130,11503,4480,7023,0.012336714939319,0.00480470163680336,0.00753201330251562,EPCI
248500621,CC du Pays des Herbiers,2010_2015,2012.5,5,27573,29330,972,1925,1757,953,804,0.0124314054390469,0.00674281695128723,0.00568858848775963,EPCI
248500621,CC du Pays des Herbiers,1968_1975,1971.5,7,17296,18720,1079,2455,1424,1376,48,0.0113665726996852,0.0109834297996958,0.00038314289998939,EPCI
248500621,CC du Pays des Herbiers,1975_1982,1978.5,7,18720,20772,1063,2837,2052,1774,278,0.014970009727145,0.0129419089941302,0.00202810073301477,EPCI
248500621,CC du Pays des Herbiers,1982_1990,1986,8,20772,22805,1152,2790,2033,1638,395,0.0117401160084398,0.0094590801878133,0.00228103582062653,EPCI
248500621,CC du Pays des Herbiers,1990_1999,1994.5,9,22805,23684,1412,2591,879,1179,-300,0.00421105328349825,0.00564827283418024,-0.00143721955068199,EPCI
248500621,CC du Pays des Herbiers,1999_2010,2004.5,11,23684,27573,1849,4029,3889,2180,1709,0.0139175339514561,0.00780154898795946,0.00611598496349666,EPCI
248500662,CC du Pays de Mortagne,2010_2015,2012.5,5,26539,27537,1142,1790,998,648,350,0.00741036298346631,0.0048115382898659,0.00259882469360041,EPCI
248500662,CC du Pays de Mortagne,1968_1975,1971.5,7,18584,19998,1512,2612,1414,1100,314,0.0105309604699075,0.00819240206287008,0.00233855840703746,EPCI
248500662,CC du Pays de Mortagne,1975_1982,1978.5,7,19998,22198,1475,2784,2200,1309,891,0.015021697846298,0.00893791021854733,0.0060837876277507,EPCI
248500662,CC du Pays de Mortagne,1982_1990,1986,8,22198,23669,1657,2949,1471,1292,179,0.00805274789565447,0.00707284179550345,0.000979906100151019,EPCI
248500662,CC du Pays de Mortagne,1990_1999,1994.5,9,23669,24265,1786,2639,596,853,-257,0.00276702202430124,0.00396018420592106,-0.00119316218161983,EPCI
248500662,CC du Pays de Mortagne,1999_2010,2004.5,11,24265,26539,2166,3691,2274,1525,749,0.00817691954448319,0.00548364217473037,0.00269327736975282,EPCI
248600413,CA Grand Châtellerault,2010_2015,2012.5,5,84797,84770,4369,4824,-27,455,-482,-6.36896103825002e-05,0.00107328787866806,-0.00113697748905056,EPCI
248600413,CA Grand Châtellerault,1968_1975,1971.5,7,73448,76716,5684,8655,3268,2971,297,0.0062383233237806,0.00567137655904289,0.00056694676473771,EPCI
248600413,CA Grand Châtellerault,1975_1982,1978.5,7,76716,79599,5573,7439,2883,1866,1017,0.00528408872294928,0.00342008656157591,0.00186400216137337,EPCI
248600413,CA Grand Châtellerault,1982_1990,1986,8,79599,80747,6412,8043,1148,1631,-483,0.00179151281408263,0.00254525905903203,-0.000753746244949399,EPCI
248600413,CA Grand Châtellerault,1990_1999,1994.5,9,80747,81782,7323,8157,1035,834,201,0.0014161529972776,0.00114113198041499,0.000275021016862606,EPCI
248600413,CA Grand Châtellerault,1999_2010,2004.5,11,81782,84797,9257,11117,3015,1860,1155,0.00329660318540448,0.00203372534820973,0.00126287783719475,EPCI
248600447,CC du Pays Loudunais,2010_2015,2012.5,5,24431,24436,1564,1188,5,-376,381,4.09282529099109e-05,-0.0030778046188253,0.00311873287173521,EPCI
248600447,CC du Pays Loudunais,1968_1975,1971.5,7,27612,26228,2371,2885,-1384,514,-1898,-0.0073192143357973,0.00271826312760102,-0.0100374774633983,EPCI
248600447,CC du Pays Loudunais,1975_1982,1978.5,7,26228,25673,2280,2166,-555,-114,-441,-0.00305072083774594,-0.000626634550455922,-0.00242408628729001,EPCI
248600447,CC du Pays Loudunais,1982_1990,1986,8,25673,25125,2357,2313,-548,-44,-504,-0.00269342739984713,-0.000216260594148309,-0.00247716680569882,EPCI
248600447,CC du Pays Loudunais,1990_1999,1994.5,9,25125,24625,2631,2324,-500,-307,-193,-0.00223097204331801,-0.00136981683459726,-0.000861155208720753,EPCI
248600447,CC du Pays Loudunais,1999_2010,2004.5,11,24625,24431,3350,2823,-194,-527,333,-0.000718775134348926,-0.00195254894743239,0.00123377381308347,EPCI
248700189,CC du Pays de Saint-Yrieix,2010_2015,2012.5,5,12296,12125,896,379,-171,-517,346,-0.00279699498294816,-0.00845641173207135,0.00565941674912319,EPCI
248700189,CC du Pays de Saint-Yrieix,1968_1975,1971.5,7,13817,13339,1464,1052,-478,-412,-66,-0.00501703569702761,-0.00432430691877693,-0.000692728778250673,EPCI
248700189,CC du Pays de Saint-Yrieix,1975_1982,1978.5,7,13339,13026,1392,808,-313,-584,271,-0.00338635546893351,-0.00631831180146061,0.0029319563325271,EPCI
248700189,CC du Pays de Saint-Yrieix,1982_1990,1986,8,13026,12961,1609,825,-65,-784,719,-0.000625118492342036,-0.00753989073840241,0.00691477224606037,EPCI
248700189,CC du Pays de Saint-Yrieix,1990_1999,1994.5,9,12961,12497,1794,924,-464,-870,406,-0.00404249955971914,-0.00757968667447338,0.00353718711475425,EPCI
248700189,CC du Pays de Saint-Yrieix,1999_2010,2004.5,11,12497,12296,2127,1100,-201,-1027,826,-0.00147296950191533,-0.00752606805207486,0.00605309855015953,EPCI
248719262,CC Gartempe - Saint-Pardoux,2010_2015,2012.5,5,5340,5233,377,229,-107,-148,41,-0.00404000226066714,-0.00558804051008165,0.00154803824941451,EPCI
248719262,CC Gartempe - Saint-Pardoux,1968_1975,1971.5,7,7300,6595,788,483,-705,-305,-400,-0.014404189997031,-0.00623159992779354,-0.00817259006923743,EPCI
248719262,CC Gartempe - Saint-Pardoux,1975_1982,1978.5,7,6595,5961,783,282,-634,-501,-133,-0.0143353327346093,-0.0113280783912291,-0.00300725434338018,EPCI
248719262,CC Gartempe - Saint-Pardoux,1982_1990,1986,8,5961,5422,823,341,-539,-482,-57,-0.0117767919242769,-0.0105313797912829,-0.00124541213299404,EPCI
248719262,CC Gartempe - Saint-Pardoux,1990_1999,1994.5,9,5422,5153,876,353,-269,-523,254,-0.00563801105980077,-0.0109616348857837,0.00532362382598289,EPCI
248719262,CC Gartempe - Saint-Pardoux,1999_2010,2004.5,11,5153,5340,948,518,187,-430,617,0.00324585492725626,-0.00746373058139141,0.0107095855086477,EPCI
248719288,CC du Val de Vienne,2010_2015,2012.5,5,14949,15947,622,843,998,221,777,0.013009155427129,0.00288078491923398,0.010128370507895,EPCI
248719288,CC du Val de Vienne,1968_1975,1971.5,7,9473,10208,850,835,735,-15,750,0.0107323370003216,-0.000219027285720849,0.0109513642860425,EPCI
248719288,CC du Val de Vienne,1975_1982,1978.5,7,10208,12107,836,792,1899,-44,1943,0.0246726062352252,-0.000571666495181626,0.0252442727304068,EPCI
248719288,CC du Val de Vienne,1982_1990,1986,8,12107,13168,1078,1044,1061,-34,1095,0.0105560569350098,-0.000338271381517751,0.0108943283165276,EPCI
248719288,CC du Val de Vienne,1990_1999,1994.5,9,13168,13580,1134,1060,412,-74,486,0.00342902996189798,-0.000615893731020511,0.00404492369291849,EPCI
248719288,CC du Val de Vienne,1999_2010,2004.5,11,13580,14949,1307,1695,1369,388,981,0.00876971109555047,0.00248549883496975,0.00628421226058072,EPCI
248719312,CA Limoges Métropole,2010_2015,2012.5,5,210012,208390,8697,11618,-1622,2921,-4543,-0.00154946790495369,0.00279037962414904,-0.00433984752910273,EPCI
248719312,CA Limoges Métropole,1968_1975,1971.5,7,161116,180916,12344,17996,19800,5652,14148,0.016696167717392,0.00476599696660099,0.011930170750791,EPCI
248719312,CA Limoges Métropole,1975_1982,1978.5,7,180916,188801,12994,16943,7885,3949,3936,0.00611299644548113,0.00306153747155422,0.00305145897392692,EPCI
248719312,CA Limoges Métropole,1982_1990,1986,8,188801,190272,14244,17026,1471,2782,-1311,0.000970605366327204,0.00183563842904302,-0.000865033062715816,EPCI
248719312,CA Limoges Métropole,1990_1999,1994.5,9,190272,195529,15706,17509,5257,1803,3454,0.00303282068364896,0.00104017038094333,0.00199265030270563,EPCI
248719312,CA Limoges Métropole,1999_2010,2004.5,11,195529,210012,19006,24061,14483,5055,9428,0.00651714165045214,0.00227467727977875,0.0042424643706734,EPCI
248719338,CC Briance Combade,2010_2015,2012.5,5,5747,5561,524,189,-186,-335,149,-0.00655840542666741,-0.0118121818168472,0.00525377639017981,EPCI
248719338,CC Briance Combade,1968_1975,1971.5,7,8073,7424,858,440,-649,-418,-231,-0.011901067494732,-0.00766509431864093,-0.00423597317609104,EPCI
248719338,CC Briance Combade,1975_1982,1978.5,7,7424,6443,905,261,-981,-644,-337,-0.0200426674458071,-0.0131574697605502,-0.00688519768525686,EPCI
248719338,CC Briance Combade,1982_1990,1986,8,6443,5957,1020,361,-486,-659,173,-0.00975551217032,-0.013228153333829,0.00347264116350897,EPCI
248719338,CC Briance Combade,1990_1999,1994.5,9,5957,5664,991,373,-293,-618,325,-0.00558839784593623,-0.0117871326579815,0.00619873481204531,EPCI
248719338,CC Briance Combade,1999_2010,2004.5,11,5664,5747,1075,516,83,-559,642,0.00132338609759342,-0.00891292564523758,0.010236311742831,EPCI
248719353,CC des Portes de Vassivière,2010_2015,2012.5,5,5705,5587,507,162,-118,-345,227,-0.00417137809929236,-0.0121959783411514,0.00802460024185902,EPCI
248719353,CC des Portes de Vassivière,1968_1975,1971.5,7,8799,8087,1012,500,-712,-512,-200,-0.0119819583779803,-0.00861623973248024,-0.00336571864550009,EPCI
248719353,CC des Portes de Vassivière,1975_1982,1978.5,7,8087,7292,998,346,-795,-652,-143,-0.0146741239539132,-0.012034627443964,-0.00263949650994917,EPCI
248719353,CC des Portes de Vassivière,1982_1990,1986,8,7292,6632,1110,400,-660,-710,50,-0.011788889903818,-0.0126819876238042,0.000893097719986212,EPCI
248719353,CC des Portes de Vassivière,1990_1999,1994.5,9,6632,5992,1130,393,-640,-737,97,-0.0112123534527478,-0.0129117257729299,0.0016993723201821,EPCI
248719353,CC des Portes de Vassivière,1999_2010,2004.5,11,5992,5705,1287,394,-287,-893,606,-0.00445208386116358,-0.0138526511777668,0.00940056731660324,EPCI
248719361,CC de Noblat,2010_2015,2012.5,5,11856,12036,743,611,180,-132,312,0.003018163554666,-0.0022133199400884,0.0052314834947544,EPCI
248719361,CC de Noblat,1968_1975,1971.5,7,12750,11999,1394,906,-751,-488,-263,-0.00863506730133778,-0.00561106903202775,-0.00302399826931004,EPCI
248719361,CC de Noblat,1975_1982,1978.5,7,11999,11940,1365,668,-59,-697,638,-0.000703924274378931,-0.00831585117359517,0.00761192689921624,EPCI
248719361,CC de Noblat,1982_1990,1986,8,11940,11839,1492,906,-101,-586,485,-0.00106130410987293,-0.00615766542955977,0.00509636131968684,EPCI
248719361,CC de Noblat,1990_1999,1994.5,9,11839,11268,1625,876,-571,-749,178,-0.0054774235133187,-0.00718492156125343,0.00170749804793473,EPCI
248719361,CC de Noblat,1999_2010,2004.5,11,11268,11856,1714,1317,588,-397,985,0.00463500113562221,-0.00312941403204425,0.00776441516766645,EPCI
248900334,CA du Grand Sénonais,2010_2015,2012.5,5,56678,58567,2976,3623,1889,647,1242,0.006578598470657,0.00225323092139496,0.00432536754926204,EPCI
248900334,CA du Grand Sénonais,1968_1975,1971.5,7,41292,47066,4107,5475,5774,1368,4406,0.0188733339011609,0.00447154845458747,0.0144017854465734,EPCI
248900334,CA du Grand Sénonais,1975_1982,1978.5,7,47066,50775,4082,5230,3709,1148,2561,0.0108951005025637,0.00337222307278057,0.00752287742978314,EPCI
248900334,CA du Grand Sénonais,1982_1990,1986,8,50775,53979,4553,6014,3204,1461,1743,0.00767819916759449,0.00350120130582258,0.00417699786177191,EPCI
248900334,CA du Grand Sénonais,1990_1999,1994.5,9,53979,56294,5201,6362,2315,1161,1154,0.00467677719908854,0.00234545932101158,0.00233131787807697,EPCI
248900334,CA du Grand Sénonais,1999_2010,2004.5,11,56294,56678,6515,7703,384,1188,-804,0.000618206543166577,0.0019125764929216,-0.00129436994975502,EPCI
248900383,CC de l'Agglomération Migennoise,2010_2015,2012.5,5,15118,14938,754,963,-180,209,-389,-0.00239268993023922,0.00277817886344443,-0.00517086879368365,EPCI
248900383,CC de l'Agglomération Migennoise,1968_1975,1971.5,7,12822,15115,1034,1904,2293,870,1423,0.0237819838200213,0.00902325596311318,0.0147587278569081,EPCI
248900383,CC de l'Agglomération Migennoise,1975_1982,1978.5,7,15115,15554,1207,1681,439,474,-35,0.00409840588042276,0.00442515805767742,-0.000326752177254662,EPCI
248900383,CC de l'Agglomération Migennoise,1982_1990,1986,8,15554,15828,1406,1962,274,556,-282,0.00218521952590667,0.00443424108176682,-0.00224902155586015,EPCI
248900383,CC de l'Agglomération Migennoise,1990_1999,1994.5,9,15828,15916,1502,1946,88,444,-356,0.000616230796842476,0.00310916447497795,-0.00249293367813547,EPCI
248900383,CC de l'Agglomération Migennoise,1999_2010,2004.5,11,15916,15118,1760,2284,-798,524,-1322,-0.00466533840543415,0.00306345529379385,-0.007728793699228,EPCI
248900524,CC de l'Aillantais,2010_2015,2012.5,5,10249,10437,572,541,188,-31,219,0.00364202511198575,-0.00060054669399765,0.0042425718059834,EPCI
248900524,CC de l'Aillantais,1968_1975,1971.5,7,7609,7681,930,582,72,-348,420,0.00134633261056161,-0.0065072742843811,0.00785360689494271,EPCI
248900524,CC de l'Aillantais,1975_1982,1978.5,7,7681,8181,848,575,500,-273,773,0.00904994038127782,-0.00494126744817769,0.0139912078294555,EPCI
248900524,CC de l'Aillantais,1982_1990,1986,8,8181,8494,931,727,313,-204,517,0.00470423525527375,-0.00306601914401228,0.00777025439928603,EPCI
248900524,CC de l'Aillantais,1990_1999,1994.5,9,8494,8953,1052,818,459,-234,693,0.00586475738388526,-0.00298987631335327,0.00885463369723852,EPCI
248900524,CC de l'Aillantais,1999_2010,2004.5,11,8953,10249,1233,1279,1296,46,1250,0.012365967514602,0.000438915513635563,0.0119270520009664,EPCI
248900664,CC de la Vanne et du Pays d'Othe,2010_2015,2012.5,5,8741,8729,479,448,-12,-31,19,-0.000274719026843284,-0.000709690819345151,0.000434971792501867,EPCI
248900664,CC de la Vanne et du Pays d'Othe,1968_1975,1971.5,7,7770,7132,895,592,-638,-303,-335,-0.0121651791892441,-0.00577750673094194,-0.00638767245830215,EPCI
248900664,CC de la Vanne et du Pays d'Othe,1975_1982,1978.5,7,7132,7075,757,531,-57,-226,169,-0.00114566557659923,-0.00454246351423555,0.00339679793763632,EPCI
248900664,CC de la Vanne et du Pays d'Othe,1982_1990,1986,8,7075,7496,856,678,421,-178,599,0.00725142786504729,-0.00306592437049505,0.0103173522355423,EPCI
248900664,CC de la Vanne et du Pays d'Othe,1990_1999,1994.5,9,7496,8052,922,772,556,-150,706,0.00798179299630331,-0.002153361419866,0.0101351544161693,EPCI
248900664,CC de la Vanne et du Pays d'Othe,1999_2010,2004.5,11,8052,8741,1136,1054,689,-82,771,0.00749193349225208,-0.000891637948279638,0.00838357144053172,EPCI
248900748,CC du Gâtinais en Bourgogne,2010_2015,2012.5,5,16663,17431,907,984,768,77,691,0.00905263703217463,0.000907621160777925,0.0081450158713967,EPCI
248900748,CC du Gâtinais en Bourgogne,1968_1975,1971.5,7,9130,9112,987,818,-18,-169,151,-0.000281884329144333,-0.00264658064585513,0.00236469631671079,EPCI
248900748,CC du Gâtinais en Bourgogne,1975_1982,1978.5,7,9112,10337,977,668,1225,-309,1534,0.0181829711894119,-0.00458656171226799,0.0227695329016799,EPCI
248900748,CC du Gâtinais en Bourgogne,1982_1990,1986,8,10337,12568,1187,1098,2231,-89,2320,0.0247288347949097,-0.000986493185453593,0.0257153279803633,EPCI
248900748,CC du Gâtinais en Bourgogne,1990_1999,1994.5,9,12568,13981,1453,1262,1413,-191,1604,0.0119087246697887,-0.001609742683602,0.0135184673533907,EPCI
248900748,CC du Gâtinais en Bourgogne,1999_2010,2004.5,11,13981,16663,1946,1920,2682,-26,2708,0.0160817069417156,-0.000155900216437213,0.0162376071581528,EPCI
248900896,CC Yonne Nord,2010_2015,2012.5,5,23400,24483,1231,1369,1083,138,945,0.00908965765588277,0.00115823892568035,0.00793141873020241,EPCI
248900896,CC Yonne Nord,1968_1975,1971.5,7,13400,13952,1642,1148,552,-494,1046,0.00578354049350671,-0.0051758496445513,0.010959390138058,EPCI
248900896,CC Yonne Nord,1975_1982,1978.5,7,13952,15223,1655,1037,1271,-618,1889,0.0125328250473793,-0.00609385198999245,0.0186266770373717,EPCI
248900896,CC Yonne Nord,1982_1990,1986,8,15223,18400,1935,1436,3177,-499,3676,0.0239758095144464,-0.00376579444372325,0.0277416039581697,EPCI
248900896,CC Yonne Nord,1990_1999,1994.5,9,18400,20293,2367,1911,1893,-456,2349,0.0109400016303076,-0.0026353094260012,0.0135753110563088,EPCI
248900896,CC Yonne Nord,1999_2010,2004.5,11,20293,23400,2847,2829,3107,-18,3125,0.0130351374755207,-7.55173719212655e-05,0.0131106548474419,EPCI
248900938,CC du Jovinien,2010_2015,2012.5,5,22063,21389,1192,1243,-674,51,-725,-0.00618583369212766,0.000468067534567523,-0.00665390122669519,EPCI
248900938,CC du Jovinien,1968_1975,1971.5,7,18395,20290,1990,2320,1895,330,1565,0.014105596084397,0.00245638348699262,0.0116492125974044,EPCI
248900938,CC du Jovinien,1975_1982,1978.5,7,20290,19376,1973,1971,-914,-2,-912,-0.00656307788070565,-1.43612207455266e-05,-0.00654871665996012,EPCI
248900938,CC du Jovinien,1982_1990,1986,8,19376,20018,2312,1986,642,-326,968,0.00408289765677194,-0.00207324709674089,0.00615614475351284,EPCI
248900938,CC du Jovinien,1990_1999,1994.5,9,20018,21074,2266,2277,1056,11,1045,0.00572836518133468,5.96704706389029e-05,0.00566869471069578,EPCI
248900938,CC du Jovinien,1999_2010,2004.5,11,21074,22063,2872,2941,989,69,920,0.00417797113778784,0.000291486358450314,0.00388648477933753,EPCI
249000241,CC du Sud Territoire,2010_2015,2012.5,5,23646,23688,1136,1290,42,154,-112,0.000354987664887396,0.00130162143792045,-0.000946633773033057,EPCI
249000241,CC du Sud Territoire,1968_1975,1971.5,7,20453,22260,1383,2681,1807,1298,509,0.012167973958797,0.00874047050277725,0.00342750345601974,EPCI
249000241,CC du Sud Territoire,1975_1982,1978.5,7,22260,23438,1571,2488,1178,917,261,0.00739395715557767,0.00575573744623491,0.00163821970934276,EPCI
249000241,CC du Sud Territoire,1982_1990,1986,8,23438,23785,1739,2591,347,852,-505,0.0018387500624566,0.00451474078735741,-0.00267599072490081,EPCI
249000241,CC du Sud Territoire,1990_1999,1994.5,9,23785,23547,2003,2638,-238,635,-873,-0.00111678771363832,0.00297966469815267,-0.00409645241179099,EPCI
249000241,CC du Sud Territoire,1999_2010,2004.5,11,23547,23646,2515,3139,99,624,-525,0.000381485804311854,0.0024045165847535,-0.00202303078044165,EPCI
249100074,CC du Pays de Limours (Ccpl),2010_2015,2012.5,5,26047,26923,667,1350,876,683,193,0.00663760016249215,0.00517520651938601,0.00146239364310615,EPCI
249100074,CC du Pays de Limours (Ccpl),1968_1975,1971.5,7,8704,13144,654,1173,4440,519,3921,0.0606513934628576,0.00708965612775295,0.0535617373351047,EPCI
249100074,CC du Pays de Limours (Ccpl),1975_1982,1978.5,7,13144,15816,706,1305,2672,599,2073,0.0267892208611789,0.00600551770054122,0.0207837031606376,EPCI
249100074,CC du Pays de Limours (Ccpl),1982_1990,1986,8,15816,20889,824,1746,5073,922,4151,0.0353868006593165,0.00643142720439382,0.0289553734549227,EPCI
249100074,CC du Pays de Limours (Ccpl),1990_1999,1994.5,9,20889,23644,1110,2323,2755,1213,1542,0.0138603628664375,0.00610258444899773,0.00775777841743982,EPCI
249100074,CC du Pays de Limours (Ccpl),1999_2010,2004.5,11,23644,26047,1391,3054,2403,1663,740,0.0088382116010115,0.00611649849874412,0.00272171310226738,EPCI
249100157,CC des Deux Vallées,2010_2015,2012.5,5,18931,18768,842,860,-163,18,-181,-0.0017280049006887,0.000190822627069917,-0.00191882752775861,EPCI
249100157,CC des Deux Vallées,1968_1975,1971.5,7,9590,11263,867,940,1673,73,1600,0.0232376148670979,0.00101395450406344,0.0222236603630344,EPCI
249100157,CC des Deux Vallées,1975_1982,1978.5,7,11263,13378,1021,1036,2115,15,2100,0.0248887586133506,0.000176516018534401,0.0247122425948162,EPCI
249100157,CC des Deux Vallées,1982_1990,1986,8,13378,16389,1239,1325,3011,86,2925,0.0256995334009253,0.000734028519588037,0.0249655048813373,EPCI
249100157,CC des Deux Vallées,1990_1999,1994.5,9,16389,18143,1564,1686,1754,122,1632,0.0113612131416192,0.000790232613043068,0.0105709805285761,EPCI
249100157,CC des Deux Vallées,1999_2010,2004.5,11,18143,18931,1972,2158,788,186,602,0.00387256805628922,0.000914083322931211,0.00295848473335801,EPCI
249100546,CC du Val d'Essonne (Ccve),2010_2015,2012.5,5,57769,59405,1810,3158,1636,1348,288,0.00560084607597355,0.00461487806259924,0.000985968013374318,EPCI
249100546,CC du Val d'Essonne (Ccve),1968_1975,1971.5,7,21958,31857,1735,3120,9899,1385,8514,0.0545992110807996,0.00763914611040584,0.0469600649703937,EPCI
249100546,CC du Val d'Essonne (Ccve),1975_1982,1978.5,7,31857,38390,1987,3200,6533,1213,5320,0.0270068008602298,0.00501442667127793,0.0219923741889518,EPCI
249100546,CC du Val d'Essonne (Ccve),1982_1990,1986,8,38390,45314,2349,4000,6924,1651,5273,0.020943682305308,0.00499393695639276,0.0159497453489152,EPCI
249100546,CC du Val d'Essonne (Ccve),1990_1999,1994.5,9,45314,51041,3109,5125,5727,2016,3711,0.0133115080635282,0.00468587397521789,0.00862563408831032,EPCI
249100546,CC du Val d'Essonne (Ccve),1999_2010,2004.5,11,51041,57769,3699,7340,6728,3641,3087,0.0113202369695022,0.00612618650504721,0.00519405046445503,EPCI
249100553,CC Entre Juine et Renarde (Ccejr),2010_2015,2012.5,5,26634,27338,813,1417,704,604,100,0.00523145263996927,0.00448834857179182,0.000743104068177453,EPCI
249100553,CC Entre Juine et Renarde (Ccejr),1968_1975,1971.5,7,11504,16001,937,1270,4497,333,4164,0.0482652251671454,0.00357400933525893,0.0446912158318864,EPCI
249100553,CC Entre Juine et Renarde (Ccejr),1975_1982,1978.5,7,16001,18858,1022,1397,2857,375,2482,0.0237470038480194,0.00311695010255768,0.0206300537454617,EPCI
249100553,CC Entre Juine et Renarde (Ccejr),1982_1990,1986,8,18858,22234,1101,1689,3376,588,2788,0.0207990242306124,0.00362257886481046,0.017176445365802,EPCI
249100553,CC Entre Juine et Renarde (Ccejr),1990_1999,1994.5,9,22234,24411,1299,2400,2177,1101,1076,0.0104330712794343,0.00527644073433952,0.00515663054509475,EPCI
249100553,CC Entre Juine et Renarde (Ccejr),1999_2010,2004.5,11,24411,26634,1571,3286,2223,1715,508,0.00795462989243356,0.0061368377262814,0.00181779216615216,EPCI
249100595,CC Le Dourdannais en Hurepoix (Ccdh),2010_2015,2012.5,5,25051,26265,1057,1513,1214,456,758,0.00950963343359201,0.00357198751706586,0.00593764591652615,EPCI
249100595,CC Le Dourdannais en Hurepoix (Ccdh),1968_1975,1971.5,7,11471,15702,1078,1676,4231,598,3633,0.0458733552943589,0.00648363660270069,0.0393897186916582,EPCI
249100595,CC Le Dourdannais en Hurepoix (Ccdh),1975_1982,1978.5,7,15702,18176,1125,1624,2474,499,1975,0.0211219694518685,0.00426025172048601,0.0168617177313825,EPCI
249100595,CC Le Dourdannais en Hurepoix (Ccdh),1982_1990,1986,8,18176,21187,1381,1943,3011,562,2449,0.0193454625539129,0.0036108103471601,0.0157346522067528,EPCI
249100595,CC Le Dourdannais en Hurepoix (Ccdh),1990_1999,1994.5,9,21187,23122,1581,2530,1935,949,986,0.00975805335590163,0.00478573262777811,0.00497232072812352,EPCI
249100595,CC Le Dourdannais en Hurepoix (Ccdh),1999_2010,2004.5,11,23122,25051,2126,3234,1929,1108,821,0.00731106918978464,0.00419941143715986,0.00311165775262477,EPCI
249500109,CA de Cergy-Pontoise,2010_2015,2012.5,5,195313,204248,4142,17854,8935,13712,-4777,0.0089864461911493,0.0137909513344196,-0.00480450514327031,EPCI
249500109,CA de Cergy-Pontoise,1968_1975,1971.5,7,44292,72798,2998,7655,28506,4657,23849,0.0735634978854236,0.0120180035660008,0.0615454943194228,EPCI
249500109,CA de Cergy-Pontoise,1975_1982,1978.5,7,72798,106161,3315,12046,33363,8731,24632,0.0553742837583735,0.0144912888977118,0.0408829948606617,EPCI
249500109,CA de Cergy-Pontoise,1982_1990,1986,8,106161,163125,4337,22262,56964,17925,39039,0.0551627242656454,0.0173581881971367,0.0378045360685087,EPCI
249500109,CA de Cergy-Pontoise,1990_1999,1994.5,9,163125,182839,5697,26899,19714,21202,-1488,0.0127572668677387,0.0137201771395859,-0.000962910271847174,EPCI
249500109,CA de Cergy-Pontoise,1999_2010,2004.5,11,182839,195313,7894,34864,12474,26970,-14496,0.00601779970767802,0.0130110676700398,-0.00699326796236176,EPCI
249500430,CC Sausseron Impressionnistes,2010_2015,2012.5,5,18787,19411,655,958,624,303,321,0.00655635428772849,0.00318361434163739,0.0033727399460911,EPCI
249500430,CC Sausseron Impressionnistes,1968_1975,1971.5,7,12262,13925,961,1223,1663,262,1401,0.0183347311836872,0.00288857460620929,0.0154461565774779,EPCI
249500430,CC Sausseron Impressionnistes,1975_1982,1978.5,7,13925,14867,939,1125,942,186,756,0.00939503107485562,0.00185506983006703,0.00753996124478859,EPCI
249500430,CC Sausseron Impressionnistes,1982_1990,1986,8,14867,16887,1062,1384,2020,322,1698,0.0160524917600446,0.0025588625478883,0.0134936292121563,EPCI
249500430,CC Sausseron Impressionnistes,1990_1999,1994.5,9,16887,18486,1207,1822,1599,615,984,0.0101028699243917,0.00388571920168911,0.00621715072270258,EPCI
249500430,CC Sausseron Impressionnistes,1999_2010,2004.5,11,18486,18787,1337,2094,301,757,-456,0.0014693923590039,0.00369544855736196,-0.00222605619835806,EPCI
249500455,CC de la Vallée de l'Oise et des Trois Forêts,2010_2015,2012.5,5,36968,38491,1189,2139,1523,950,573,0.00810704034812626,0.0050569194554957,0.00305012089263056,EPCI
249500455,CC de la Vallée de l'Oise et des Trois Forêts,1968_1975,1971.5,7,18887,25574,1426,2409,6687,983,5704,0.0442514746176794,0.0065050395617136,0.0377464350559658,EPCI
249500455,CC de la Vallée de l'Oise et des Trois Forêts,1975_1982,1978.5,7,25574,28118,1637,2573,2544,936,1608,0.0136398613415669,0.00501843955019915,0.00862142179136777,EPCI
249500455,CC de la Vallée de l'Oise et des Trois Forêts,1982_1990,1986,8,28118,30980,1774,2840,2862,1066,1796,0.0121901887864067,0.00454044068704035,0.0076497480993663,EPCI
249500455,CC de la Vallée de l'Oise et des Trois Forêts,1990_1999,1994.5,9,30980,35410,2036,3619,4430,1583,2847,0.014961083242941,0.0053461387750735,0.00961494446786749,EPCI
249500455,CC de la Vallée de l'Oise et des Trois Forêts,1999_2010,2004.5,11,35410,36968,2572,4700,1558,2128,-570,0.00392207194928229,0.00535697632097093,-0.00143490437168864,EPCI
249500489,CC du Haut Val d'Oise,2010_2015,2012.5,5,33918,37957,1044,2847,4039,1803,2236,0.0227566896255078,0.0101585321601363,0.0125981574653715,EPCI
249500489,CC du Haut Val d'Oise,1968_1975,1971.5,7,19930,24871,1681,2879,4941,1198,3743,0.0321453250387807,0.00779398894888873,0.0243513360898919,EPCI
249500489,CC du Haut Val d'Oise,1975_1982,1978.5,7,24871,27093,1596,2875,2222,1279,943,0.0122997307983137,0.00707981804277373,0.00521991275553997,EPCI
249500489,CC du Haut Val d'Oise,1982_1990,1986,8,27093,31686,1784,3645,4593,1861,2732,0.0197677893487076,0.00800954843848135,0.0117582409102263,EPCI
249500489,CC du Haut Val d'Oise,1990_1999,1994.5,9,31686,31128,2082,4011,-558,1929,-2487,-0.0019721868200091,0.00681782863046158,-0.00879001545047068,EPCI
249500489,CC du Haut Val d'Oise,1999_2010,2004.5,11,31128,33918,2386,5228,2790,2842,-52,0.00783399104060867,0.00798000090946589,-0.000146009868857223,EPCI
249500513,CC du Vexin-Val de Seine,2010_2015,2012.5,5,16925,16682,784,1006,-243,222,-465,-0.00288812631133684,0.00263853514862871,-0.00552666145996555,EPCI
249500513,CC du Vexin-Val de Seine,1968_1975,1971.5,7,10472,11284,1095,1264,812,169,643,0.0107257939479808,0.00223233888818812,0.00849345505979267,EPCI
249500513,CC du Vexin-Val de Seine,1975_1982,1978.5,7,11284,12414,1026,1206,1130,180,950,0.0137275224746185,0.00218668499595693,0.0115408374786616,EPCI
249500513,CC du Vexin-Val de Seine,1982_1990,1986,8,12414,13982,1084,1289,1568,205,1363,0.0149793221419494,0.00195839351983395,0.0130209286221155,EPCI
249500513,CC du Vexin-Val de Seine,1990_1999,1994.5,9,13982,15679,1409,1742,1697,333,1364,0.0128092837745566,0.00251354831875506,0.0102957354558015,EPCI
249500513,CC du Vexin-Val de Seine,1999_2010,2004.5,11,15679,16925,1784,2246,1246,462,784,0.0069759998434229,0.00258660668351636,0.00438939315990654,EPCI
249710047,CC de Marie-Galante,2010_2015,2012.5,5,11561,10966,632,544,-595,-88,-507,-0.0105119170731577,-0.00155470370157626,-0.00895721337158142,EPCI
249710047,CC de Marie-Galante,1968_1975,1971.5,7,15867,15912,1073,3787,45,2714,-2669,0.000404661967818409,0.024405612903537,-0.0240009509357185,EPCI
249710047,CC de Marie-Galante,1975_1982,1978.5,7,15912,13757,932,2060,-2155,1128,-3283,-0.0205747840535423,0.0107695389384667,-0.031344322992009,EPCI
249710047,CC de Marie-Galante,1982_1990,1986,8,13757,13473,974,2037,-284,1063,-1347,-0.00260411622941792,0.00974709701363115,-0.0123512132430491,EPCI
249710047,CC de Marie-Galante,1990_1999,1994.5,9,13473,12488,971,1707,-985,736,-1721,-0.00840002095258108,0.00627656387928901,-0.0146765848318701,EPCI
249710047,CC de Marie-Galante,1999_2010,2004.5,11,12488,11561,1455,1757,-927,302,-1229,-0.00698736663180477,0.00227635892427728,-0.00926372555608205,EPCI
249710062,CA du Nord Basse-Terre,2010_2015,2012.5,5,78769,78087,2658,5093,-682,2435,-3117,-0.00173767423694693,0.00620415948235451,-0.00794183371930143,EPCI
249710062,CA du Nord Basse-Terre,1968_1975,1971.5,7,45424,47072,2798,7113,1648,4315,-2667,0.00510408808722662,0.013364162679844,-0.00826007459261735,EPCI
249710062,CA du Nord Basse-Terre,1975_1982,1978.5,7,47072,49364,2269,6687,2292,4418,-2126,0.00681498405970626,0.0131363872494687,-0.00632140318976244,EPCI
249710062,CA du Nord Basse-Terre,1982_1990,1986,8,49364,54861,2690,7855,5497,5165,332,0.0132851360357138,0.0124827592549503,0.000802376780763505,EPCI
249710062,CA du Nord Basse-Terre,1990_1999,1994.5,9,54861,68324,3192,9903,13463,6711,6752,0.0246839921253985,0.0123044099497548,0.0123795821756437,EPCI
249710062,CA du Nord Basse-Terre,1999_2010,2004.5,11,68324,78769,4848,12902,10445,8054,2391,0.0130165714100785,0.0100369043692458,0.00297966704083271,EPCI
249710070,CA Grand Sud Caraïbe,2010_2015,2012.5,5,83575,80697,3425,4843,-2878,1418,-4296,-0.00698410348342515,0.00344109059746243,-0.0104251940808876,EPCI
249710070,CA Grand Sud Caraïbe,1968_1975,1971.5,7,84544,82870,5479,20522,-1674,15043,-16717,-0.00285292181025676,0.0256370984418712,-0.028490020252128,EPCI
249710070,CA Grand Sud Caraïbe,1975_1982,1978.5,7,82870,78403,3878,8661,-4467,4783,-9250,-0.00788459832823596,0.00844236261561509,-0.016326960943851,EPCI
249710070,CA Grand Sud Caraïbe,1982_1990,1986,8,78403,83081,4351,11350,4678,6999,-2321,0.0072705333633718,0.0108778244998374,-0.00360729113646557,EPCI
249710070,CA Grand Sud Caraïbe,1990_1999,1994.5,9,83081,83978,4968,12578,897,7610,-6713,0.00119391484418196,0.0101289765487455,-0.00893506170456358,EPCI
249710070,CA Grand Sud Caraïbe,1999_2010,2004.5,11,83978,83575,6926,13940,-403,7014,-7417,-0.000437215981606731,0.00760951090568142,-0.00804672688728815,EPCI
249720053,CA de l'Espace Sud de la Martinique,2010_2015,2012.5,5,121511,118812,4152,6525,-2699,2373,-5072,-0.00448240026935165,0.00394099141873711,-0.00842339168808876,EPCI
249720053,CA de l'Espace Sud de la Martinique,1968_1975,1971.5,7,79627,76742,4682,14741,-2885,10059,-12944,-0.00525813944942533,0.0183333187943741,-0.0235914582437995,EPCI
249720053,CA de l'Espace Sud de la Martinique,1975_1982,1978.5,7,76742,78329,4562,10074,1587,5512,-3925,0.00292838770201787,0.0101709344760696,-0.00724254677405175,EPCI
249720053,CA de l'Espace Sud de la Martinique,1982_1990,1986,8,78329,93345,4571,11789,15016,7218,7798,0.0221651260794382,0.010654493875958,0.0115106322034802,EPCI
249720053,CA de l'Espace Sud de la Martinique,1990_1999,1994.5,9,93345,106818,5474,14482,13473,9008,4465,0.0150932300598232,0.0100912800696866,0.00500194999013662,EPCI
249720053,CA de l'Espace Sud de la Martinique,1999_2010,2004.5,11,106818,121511,8434,17440,14693,9006,5687,0.0117851165662843,0.00722362756387101,0.00456148900241333,EPCI
249720061,CA du Centre de la Martinique,2010_2015,2012.5,5,164107,158944,6053,9954,-5163,3901,-9064,-0.00637294910293063,0.00481519938999271,-0.0111881484929233,EPCI
249720061,CA du Centre de la Martinique,1968_1975,1971.5,7,139660,147651,6707,27626,7991,20919,-12928,0.00798031481309613,0.0208910281035112,-0.0129107132904151,EPCI
249720061,CA du Centre de la Martinique,1975_1982,1978.5,7,147651,155571,7030,21345,7920,14315,-6395,0.0074923335646504,0.0135420145174205,-0.00604968095277012,EPCI
249720061,CA du Centre de la Martinique,1982_1990,1986,8,155571,163969,7076,22170,8398,15094,-6696,0.0065935381058253,0.011850781634833,-0.00525724352900765,EPCI
249720061,CA du Centre de la Martinique,1990_1999,1994.5,9,163969,166139,8578,23847,2170,15269,-13099,0.00146188994373353,0.0102864504842706,-0.0088245605405371,EPCI
249720061,CA du Centre de la Martinique,1999_2010,2004.5,11,166139,164107,12361,26272,-2032,13911,-15943,-0.00111811383256566,0.00765456767953784,-0.0087726815121035,EPCI
249730037,CC de l'Ouest Guyanais,2010_2015,2012.5,5,73848,89892,914,13151,16044,12237,3807,0.0401032682450364,0.0305873655892864,0.00951590265575004,EPCI
249730037,CC de l'Ouest Guyanais,1968_1975,1971.5,7,8122,9233,518,1701,1111,1183,-72,0.0184841255984092,0.0196820167262989,-0.00119789112788971,EPCI
249730037,CC de l'Ouest Guyanais,1975_1982,1978.5,7,9233,11435,591,2158,2202,1567,635,0.0310280390802897,0.0220803529694886,0.00894768611080108,EPCI
249730037,CC de l'Ouest Guyanais,1982_1990,1986,8,11435,25989,750,5184,14554,4434,10120,0.108075047035265,0.0329259831355205,0.0751490638997445,EPCI
249730037,CC de l'Ouest Guyanais,1990_1999,1994.5,9,25989,37553,1043,11581,11564,10538,1026,0.0417455986195125,0.0380417777803894,0.00370382083912313,EPCI
249730037,CC de l'Ouest Guyanais,1999_2010,2004.5,11,37553,73848,1693,23011,36295,21318,14977,0.0634068749249304,0.0372422581526289,0.0261646167723015,EPCI
249730045,CA du Centre Littoral,2010_2015,2012.5,5,117600,131922,2373,13979,14322,11606,2716,0.0232505364744546,0.0188413438292501,0.0044091926452045,EPCI
249730045,CA du Centre Littoral,1968_1975,1971.5,7,28257,35812,1924,7252,7555,5328,2227,0.0344282216149641,0.0242797570833261,0.010148464531638,EPCI
249730045,CA du Centre Littoral,1975_1982,1978.5,7,35812,49118,1951,7709,13306,5758,7548,0.0461687145958578,0.0199789161763828,0.026189798419475,EPCI
249730045,CA du Centre Littoral,1982_1990,1986,8,49118,66803,2615,12455,17685,9840,7845,0.0391886899702028,0.0218047333506811,0.0173839566195217,EPCI
249730045,CA du Centre Littoral,1990_1999,1994.5,9,66803,92059,3373,19573,25256,16200,9056,0.036273700336598,0.0232671026866047,0.0130065976499933,EPCI
249730045,CA du Centre Littoral,1999_2010,2004.5,11,92059,117600,4728,28524,25541,23796,1745,0.0225095428820201,0.0209716566469813,0.00153788623503877,EPCI
249730052,CC de l'Est Guyanais,2010_2015,2012.5,5,6630,6900,122,1008,270,886,-616,0.00801527316227491,0.0263019704510206,-0.0182866972887457,EPCI
249730052,CC de l'Est Guyanais,1968_1975,1971.5,7,1680,1930,139,447,250,308,-58,0.0200157108062702,0.0246593557133249,-0.00464364490705468,EPCI
249730052,CC de l'Est Guyanais,1975_1982,1978.5,7,1930,2341,125,485,411,360,51,0.0279635824763971,0.0244936488844354,0.00346993359196168,EPCI
249730052,CC de l'Est Guyanais,1982_1990,1986,8,2341,2881,177,611,540,434,106,0.0262844073164277,0.0211248755098696,0.00515953180655802,EPCI
249730052,CC de l'Est Guyanais,1990_1999,1994.5,9,2881,4042,228,1159,1161,931,230,0.0383391469476313,0.0307439671044313,0.0075951798432,EPCI
249730052,CC de l'Est Guyanais,1999_2010,2004.5,11,4042,6630,308,1995,2588,1687,901,0.046015039985492,0.0299951207324285,0.0160199192530635,EPCI
249740077,CA Civis (Communauté Intercommunale des Villes Solidaires),2010_2015,2012.5,5,172686,180558,4670,14944,7872,10274,-2402,0.00895528867015072,0.0116878348319523,-0.00273254616180158,EPCI
249740077,CA Civis (Communauté Intercommunale des Villes Solidaires),1968_1975,1971.5,7,91612,101457,5525,20728,9845,15203,-5358,0.0146886614883459,0.0226827547595046,-0.0079940932711587,EPCI
249740077,CA Civis (Communauté Intercommunale des Villes Solidaires),1975_1982,1978.5,7,101457,108065,4273,18801,6608,14528,-7920,0.00905472458989443,0.0199072395341989,-0.0108525149443045,EPCI
249740077,CA Civis (Communauté Intercommunale des Villes Solidaires),1982_1990,1986,8,108065,125678,5705,21764,17613,16059,1554,0.0190530082976061,0.0173719559558995,0.00168105234170669,EPCI
249740077,CA Civis (Communauté Intercommunale des Villes Solidaires),1990_1999,1994.5,9,125678,147627,6730,25013,21949,18283,3666,0.0180459782981446,0.0150318748564845,0.00301410344166012,EPCI
249740077,CA Civis (Communauté Intercommunale des Villes Solidaires),1999_2010,2004.5,11,147627,172686,9655,32602,25059,22947,2112,0.0143553436330657,0.0131454595294289,0.00120988410363681,EPCI
249740085,CA du Sud,2010_2015,2012.5,5,120560,125814,3537,10457,5254,6920,-1666,0.00856791053220918,0.0112847241878355,-0.00271681365562628,EPCI
249740085,CA du Sud,1968_1975,1971.5,7,60798,66958,3089,12818,6160,9729,-3569,0.0138824302252345,0.0219256759190433,-0.00804324569380876,EPCI
249740085,CA du Sud,1975_1982,1978.5,7,66958,71033,2712,11926,4075,9214,-5139,0.00847557323739134,0.0191641550452328,-0.0106885818078415,EPCI
249740085,CA du Sud,1982_1990,1986,8,71033,81488,3623,13211,10455,9588,867,0.0173120476766051,0.0158764144546427,0.00143563322196237,EPCI
249740085,CA du Sud,1990_1999,1994.5,9,81488,100646,4466,15592,19158,11126,8032,0.0237389019058685,0.0137863567493837,0.00995254515648479,EPCI
249740085,CA du Sud,1999_2010,2004.5,11,100646,120560,6867,21636,19914,14769,5145,0.0165479845301031,0.0122726314916688,0.00427535303843429,EPCI
249740093,CA Intercommunale de la Réunion Est (Cirest),2010_2015,2012.5,5,120272,126567,3117,11164,6295,8047,-1752,0.0102554236239152,0.0131096733759564,-0.00285424975204121,EPCI
249740093,CA Intercommunale de la Réunion Est (Cirest),1968_1975,1971.5,7,61289,66204,3994,14260,4915,10266,-5351,0.0110810164554227,0.0231450081243885,-0.0120639916689658,EPCI
249740093,CA Intercommunale de la Réunion Est (Cirest),1975_1982,1978.5,7,66204,74313,3133,13261,8109,10128,-2019,0.016643415044747,0.020787335993735,-0.00414392094898806,EPCI
249740093,CA Intercommunale de la Réunion Est (Cirest),1982_1990,1986,8,74313,85132,3934,15612,10819,11678,-859,0.0171347809818663,0.0184952372960749,-0.00136045631420863,EPCI
249740093,CA Intercommunale de la Réunion Est (Cirest),1990_1999,1994.5,9,85132,101804,4555,18028,16672,13473,3199,0.020070581603632,0.0162194665274552,0.00385111507617674,EPCI
249740093,CA Intercommunale de la Réunion Est (Cirest),1999_2010,2004.5,11,101804,120272,6629,24935,18468,18306,162,0.0152705530151323,0.0151366007957013,0.000133952219430985,EPCI
249740101,CA Territoire de la Côte Ouest (Tco),2010_2015,2012.5,5,210224,214795,4877,17245,4571,12368,-7797,0.00431135847851949,0.0116654740018222,-0.00735411552330266,EPCI
249740101,CA Territoire de la Côte Ouest (Tco),1968_1975,1971.5,7,91864,109994,5717,24169,18130,18452,-322,0.026064840725063,0.0265277683981722,-0.000462927673109227,EPCI
249740101,CA Territoire de la Côte Ouest (Tco),1975_1982,1978.5,7,109994,122884,4493,23168,12890,18675,-5785,0.0159566842000649,0.0231180044558737,-0.0071613202558088,EPCI
249740101,CA Territoire de la Côte Ouest (Tco),1982_1990,1986,8,122884,148673,5866,26509,25789,20643,5146,0.0240993621900141,0.0192905166423072,0.00480884554770687,EPCI
249740101,CA Territoire de la Côte Ouest (Tco),1990_1999,1994.5,9,148673,179940,7083,32609,31267,25526,5741,0.0214347374473995,0.0174990599700106,0.00393567747738897,EPCI
249740101,CA Territoire de la Côte Ouest (Tco),1999_2010,2004.5,11,179940,210224,10282,41795,30284,31513,-1229,0.014241380088333,0.0148193306935556,-0.0005779506052226,EPCI
249740119,CA Intercommunale du Nord de la Réunion (Cinor),2010_2015,2012.5,5,197394,202993,4802,16846,5599,12044,-6445,0.00560962822734124,0.0120668623629394,-0.00645723413559819,EPCI
249740119,CA Intercommunale du Nord de la Réunion (Cinor),1968_1975,1971.5,7,110962,132062,6343,27892,21100,21549,-449,0.0251809168662378,0.0257167572298843,-0.00053584036364648,EPCI
249740119,CA Intercommunale du Nord de la Réunion (Cinor),1975_1982,1978.5,7,132062,139519,5102,24236,7457,19134,-11677,0.0078779092007546,0.0202140156426497,-0.0123361064418951,EPCI
249740119,CA Intercommunale du Nord de la Réunion (Cinor),1982_1990,1986,8,139519,156852,5887,26910,17333,21023,-3690,0.0147453929176842,0.0178845205855002,-0.00313912766781599,EPCI
249740119,CA Intercommunale du Nord de la Réunion (Cinor),1990_1999,1994.5,9,156852,176283,7270,30575,19431,23305,-3874,0.0130610007817453,0.015665000422962,-0.00260399964121669,EPCI
249740119,CA Intercommunale du Nord de la Réunion (Cinor),1999_2010,2004.5,11,176283,197394,10564,38717,21111,28153,-7042,0.0103358747573514,0.0137836143263566,-0.0034477395690052,EPCI
ZZZZZZZZZ,Sans objet,2010_2015,2012.5,5,6071,6232,404,210,161,-194,355,0.00524851996023923,-0.00632430355457398,0.0115728235148132,EPCI
ZZZZZZZZZ,Sans objet,1968_1975,1971.5,7,8088,7376,754,957,-712,203,-915,-0.0130780148424814,0.00372870366997714,-0.0168067185124585,EPCI
ZZZZZZZZZ,Sans objet,1975_1982,1978.5,7,7376,7116,720,656,-260,-64,-196,-0.0051134126884671,-0.00125868620023806,-0.00385472648822905,EPCI
ZZZZZZZZZ,Sans objet,1982_1990,1986,8,7116,6812,775,655,-304,-120,-184,-0.00544263577189008,-0.00214840885732503,-0.00329422691456505,EPCI
ZZZZZZZZZ,Sans objet,1990_1999,1994.5,9,6812,6383,762,657,-429,-105,-324,-0.00720145066736444,-0.0017625928206836,-0.00543885784668084,EPCI
ZZZZZZZZZ,Sans objet,1999_2010,2004.5,11,6383,6071,909,674,-312,-235,-77,-0.00454553492670051,-0.00342372021722635,-0.00112181470947416,EPCI
01,Ain,2010_2015,2012.5,5,597341,631877,22438,36439,34536,14001,20535,0.0113047441644374,0.00458297785054111,0.00672176631389627,DEP
01,Ain,1968_1975,1971.5,7,339262,376477,27981,40085,37215,12104,25111,0.014980280004,0.00487226411845804,0.0101080158855419,DEP
01,Ain,1975_1982,1978.5,7,376477,418516,27016,38623,42039,11607,30432,0.0152375199699542,0.00420709089871923,0.0110304290712349,DEP
01,Ain,1982_1990,1986,8,418516,471019,31484,48281,52503,16797,35706,0.0148825728127455,0.00476130079301538,0.0101212720197301,DEP
01,Ain,1990_1999,1994.5,9,471019,515270,35945,55645,44251,19700,24551,0.0100268915565782,0.0044638485834126,0.00556304297316562,DEP
01,Ain,1999_2010,2004.5,11,515270,597341,45724,75480,82071,29756,52315,0.013526770433109,0.00490432163623682,0.0086224487968722,DEP
02,Aisne,2010_2015,2012.5,5,540458,538659,27352,33768,-1799,6416,-8215,-0.000666619828946446,0.00237745015148438,-0.00304406998043083,DEP
02,Aisne,1968_1975,1971.5,7,525953,533807,42457,65861,7854,23404,-15550,0.00211974281020511,0.00631658527247775,-0.00419684246227265,DEP
02,Aisne,1975_1982,1978.5,7,533807,533927,41432,57586,120,16154,-16034,3.21112420373915e-05,0.00432270836560018,-0.00429059712356279,DEP
02,Aisne,1982_1990,1986,8,533927,537200,45322,63772,3273,18450,-15177,0.000764209253406367,0.00430787067685532,-0.00354366142344896,DEP
02,Aisne,1990_1999,1994.5,9,537200,535434,48292,63529,-1766,15237,-17003,-0.000365803261756947,0.00315614059988143,-0.00352194386163838,DEP
02,Aisne,1999_2010,2004.5,11,535434,540458,58977,76618,5024,17641,-12617,0.000849387365294607,0.00298249253804979,-0.00213310517275519,DEP
03,Allier,2010_2015,2012.5,5,342908,341613,21305,16236,-1295,-5069,3774,-0.000756448192175241,-0.0029609543522288,0.00220450616005356,DEP
03,Allier,1968_1975,1971.5,7,386533,378406,36773,36429,-8127,-344,-7783,-0.00303104746128846,-0.000128298305239723,-0.00290274915604874,DEP
03,Allier,1975_1982,1978.5,7,378406,369580,35808,29324,-8826,-6484,-2342,-0.00336581825420534,-0.00247269041018213,-0.000893127844023217,DEP
03,Allier,1982_1990,1986,8,369580,357710,38922,29716,-11870,-9206,-2664,-0.00407226369055513,-0.00315832009564032,-0.000913943594914817,DEP
03,Allier,1990_1999,1994.5,9,357710,344721,40374,30427,-12989,-9947,-3042,-0.00410125656528626,-0.00314074979250923,-0.000960506772777027,DEP
03,Allier,1999_2010,2004.5,11,344721,342908,47446,37249,-1813,-10197,8384,-0.000479267350576573,-0.00269558145274645,0.00221631410216988,DEP
04,Alpes-de-Haute-Provence,2010_2015,2012.5,5,160149,161799,8518,7853,1650,-665,2315,0.0020521412146961,-0.000827075095619944,0.00287921631031605,DEP
04,Alpes-de-Haute-Provence,1968_1975,1971.5,7,104813,112178,8759,9973,7365,1214,6151,0.00974850805309857,0.00160688238648495,0.00814162566661362,DEP
04,Alpes-de-Haute-Provence,1975_1982,1978.5,7,112178,119068,9465,8479,6890,-986,7876,0.0085517682334888,-0.00122380892281857,0.00977557715630737,DEP
04,Alpes-de-Haute-Provence,1982_1990,1986,8,119068,130883,11004,11924,11815,920,10895,0.0118963346320922,0.000926333293400321,0.0109700013386918,DEP
04,Alpes-de-Haute-Provence,1990_1999,1994.5,9,130883,139561,13186,13407,8678,221,8457,0.00715861092725989,0.000182306178258174,0.00697630474900172,DEP
04,Alpes-de-Haute-Provence,1999_2010,2004.5,11,139561,160149,17192,16823,20588,-369,20957,0.0125879192136471,-0.000225614056238381,0.0128135332698855,DEP
05,Hautes-Alpes,2010_2015,2012.5,5,136971,140916,6439,7099,3945,660,3285,0.00569510451384403,0.000952793150605085,0.00474231136323895,DEP
05,Hautes-Alpes,1968_1975,1971.5,7,91790,97358,7231,9511,5568,2280,3288,0.00844856752847445,0.0034595427379529,0.00498902479052155,DEP
05,Hautes-Alpes,1975_1982,1978.5,7,97358,105070,7660,8851,7712,1191,6521,0.0109497846288773,0.00169102612720343,0.00925875850167387,DEP
05,Hautes-Alpes,1982_1990,1986,8,105070,113300,8715,11378,8230,2663,5567,0.00947111649412635,0.00306459091419909,0.00640652557992727,DEP
05,Hautes-Alpes,1990_1999,1994.5,9,113300,121419,10099,12282,8119,2183,5936,0.00771944308961703,0.00207556894502204,0.00564387414459499,DEP
05,Hautes-Alpes,1999_2010,2004.5,11,121419,136971,13278,15836,15552,2558,12994,0.0110167745017435,0.00181204405706404,0.0092047304446795,DEP
06,Alpes-Maritimes,2010_2015,2012.5,5,1078729,1082440,55261,60662,3711,5401,-1690,0.000687087107535955,0.000999988538884854,-0.000312901431348899,DEP
06,Alpes-Maritimes,1968_1975,1971.5,7,722070,816681,67445,59036,94611,-8409,103020,0.0177451031554332,-0.00157717995195102,0.0193222831073842,DEP
06,Alpes-Maritimes,1975_1982,1978.5,7,816681,881198,76064,63231,64517,-12833,77350,0.010921173856004,-0.00217231774716895,0.0130934916031729,DEP
06,Alpes-Maritimes,1982_1990,1986,8,881198,971829,93206,85146,90631,-8060,98691,0.0123123704807753,-0.00109496426250454,0.0134073347432798,DEP
06,Alpes-Maritimes,1990_1999,1994.5,9,971829,1011326,103778,99741,39497,-4037,43534,0.00443622850105019,-0.000453428221351992,0.00488965672240218,DEP
06,Alpes-Maritimes,1999_2010,2004.5,11,1011326,1078729,123542,126734,67403,3192,64211,0.00588279563884164,0.000278591215215681,0.00560420442362596,DEP
07,Ardèche,2010_2015,2012.5,5,315090,324209,16956,16578,9119,-378,9497,0.00572232174182652,-0.000237201186359296,0.00595952292818582,DEP
07,Ardèche,1968_1975,1971.5,7,256927,257065,23038,26236,138,3198,-3060,7.67134210395426e-05,0.0017777501484381,-0.00170103672739855,DEP
07,Ardèche,1975_1982,1978.5,7,257065,267970,22719,21623,10905,-1096,12001,0.00595279973089635,-0.000598282302160697,0.00655108203305705,DEP
07,Ardèche,1982_1990,1986,8,267970,277581,24772,25560,9611,788,8823,0.00441443359904348,0.000361936705446495,0.00405249689359698,DEP
07,Ardèche,1990_1999,1994.5,9,277581,286023,27600,27691,8442,91,8351,0.00333437388490743,3.5942670401158e-05,0.00329843121450627,DEP
07,Ardèche,1999_2010,2004.5,11,286023,315090,34491,36664,29067,2173,26894,0.0088375576611357,0.000660680937064295,0.0081768767240714,DEP
08,Ardennes,2010_2015,2012.5,5,283250,277752,13922,15643,-5498,1721,-7219,-0.00391257997408989,0.00122472719814636,-0.00513730717223625,DEP
08,Ardennes,1968_1975,1971.5,7,309380,309306,23960,40001,-74,16041,-16115,-3.41732251607496e-05,0.00740773925410249,-0.00744191247926324,DEP
08,Ardennes,1975_1982,1978.5,7,309306,302338,23016,33058,-6968,10042,-17010,-0.00324977676652138,0.00468344694164864,-0.00793322370817003,DEP
08,Ardennes,1982_1990,1986,8,302338,296357,24230,35437,-5981,11207,-17188,-0.0024944821153573,0.00467407809175878,-0.00716856020711608,DEP
08,Ardennes,1990_1999,1994.5,9,296357,290130,25512,33885,-6227,8373,-14600,-0.00235674187691037,0.00316894166297905,-0.00552568353988943,DEP
08,Ardennes,1999_2010,2004.5,11,290130,283250,30619,38928,-6880,8309,-15189,-0.00217936704076738,0.00263202917757793,-0.0048113962183453,DEP
09,Ariège,2010_2015,2012.5,5,152038,152499,8862,7079,461,-1783,2244,0.000605693167557986,-0.00234262671964401,0.002948319887202,DEP
09,Ariège,1968_1975,1971.5,7,138478,137857,14169,11178,-621,-2991,2370,-0.000641872801628529,-0.00309153228610456,0.00244965948447603,DEP
09,Ariège,1975_1982,1978.5,7,137857,135725,13731,9231,-2132,-4500,2368,-0.0022241138741651,-0.00469442421845355,0.00247031034428844,DEP
09,Ariège,1982_1990,1986,8,135725,136455,15301,10736,730,-4565,5295,0.000670738613435695,-0.00419441338401911,0.0048651519974548,DEP
09,Ariège,1990_1999,1994.5,9,136455,137205,16403,11701,750,-4702,5452,0.0006092152556465,-0.00381937350939979,0.00442858876504629,DEP
09,Ariège,1999_2010,2004.5,11,137205,152038,19320,15390,14833,-3930,18763,0.00937589284831075,-0.00248414069263542,0.0118600335409462,DEP
10,Aube,2010_2015,2012.5,5,303327,309056,14823,17757,5729,2934,2795,0.00374922256640975,0.00192009408445561,0.00182912848195414,DEP
10,Aube,1968_1975,1971.5,7,270325,284823,22036,32668,14498,10632,3866,0.00749120485146171,0.00549361911855021,0.0019975857329115,DEP
10,Aube,1975_1982,1978.5,7,284823,289300,21862,28097,4477,6235,-1758,0.0022305235358282,0.00310639138840492,-0.00087586785257672,DEP
10,Aube,1982_1990,1986,8,289300,289207,24191,30909,-93,6718,-6811,-4.01888533789752e-05,0.00290310448387048,-0.00294329333724946,DEP
10,Aube,1990_1999,1994.5,9,289207,292131,26077,32204,2924,6127,-3203,0.00111836235759721,0.00234343576094327,-0.00122507340334606,DEP
10,Aube,1999_2010,2004.5,11,292131,303327,31629,39405,11196,7776,3420,0.00342486054225777,0.00237868127693787,0.0010461792653199,DEP
11,Aude,2010_2015,2012.5,5,356467,366957,19959,18362,10490,-1597,12087,0.00581745726871086,-0.000885651025560652,0.00670310829427151,DEP
11,Aude,1968_1975,1971.5,7,278323,272366,25660,22982,-5957,-2678,-3279,-0.00308602265649705,-0.00138733736345461,-0.00169868529304244,DEP
11,Aude,1975_1982,1978.5,7,272366,280686,25799,19853,8320,-5946,14266,0.00430780298987621,-0.00307862939637067,0.00738643238624687,DEP
11,Aude,1982_1990,1986,8,280686,298712,29506,24861,18026,-4645,22671,0.00781075751310434,-0.00201270213293962,0.00982345964604396,DEP
11,Aude,1990_1999,1994.5,9,298712,309770,32572,28094,11058,-4478,15536,0.00404707717958153,-0.00163888692441364,0.00568596410399517,DEP
11,Aude,1999_2010,2004.5,11,309770,356467,41009,38284,46697,-2725,49422,0.0128465056984293,-0.000749656895051497,0.0135961625934808,DEP
12,Aveyron,2010_2015,2012.5,5,276805,279169,16763,13022,2364,-3741,6105,0.00170225640452393,-0.00269379915792048,0.00439605556244441,DEP
12,Aveyron,1968_1975,1971.5,7,281568,278306,25497,25429,-3262,-68,-3194,-0.00166329428963419,-3.46732102069665e-05,-0.00162862107942722,DEP
12,Aveyron,1975_1982,1978.5,7,278306,278654,24797,22070,348,-2727,3075,0.000178536088585757,-0.00139904572865908,0.00157758181724483,DEP
12,Aveyron,1982_1990,1986,8,278654,270141,27326,22101,-8513,-5225,-3288,-0.00387084189340803,-0.00237579571162422,-0.00149504618178381,DEP
12,Aveyron,1990_1999,1994.5,9,270141,263808,29600,22355,-6333,-7245,912,-0.00263236025667513,-0.00301144008520627,0.000379079828531141,DEP
12,Aveyron,1999_2010,2004.5,11,263808,276805,35594,29342,12997,-6252,19249,0.00438154569118421,-0.00210767282151909,0.0064892185127033,DEP
13,Bouches-du-Rhône,2010_2015,2012.5,5,1972018,2016622,84022,131809,44604,47787,-3183,0.0044833101857078,0.00480324508663839,-0.000319934900930588,DEP
13,Bouches-du-Rhône,1968_1975,1971.5,7,1470271,1632974,110482,160167,162703,49685,113018,0.0151067063594958,0.00461317065740368,0.0104935357020922,DEP
13,Bouches-du-Rhône,1975_1982,1978.5,7,1632974,1724199,115725,153209,91225,37484,53741,0.00779590282895137,0.00320330634848357,0.00459259648046781,DEP
13,Bouches-du-Rhône,1982_1990,1986,8,1724199,1759371,133457,185407,35172,51950,-16778,0.0025274090261358,0.00373305182837924,-0.00120564280224344,DEP
13,Bouches-du-Rhône,1990_1999,1994.5,9,1759371,1835719,152875,204324,76348,51449,24899,0.0047311424085601,0.00318819806383937,0.00154294434472072,DEP
13,Bouches-du-Rhône,1999_2010,2004.5,11,1835719,1972018,181514,269034,136299,87520,48779,0.00653225668952429,0.0041944776224856,0.00233777906703868,DEP
14,Calvados,2010_2015,2012.5,5,682567,693042,30911,39050,10475,8139,2336,0.00305062625349284,0.00237031475677119,0.000680311496721649,DEP
14,Calvados,1968_1975,1971.5,7,518950,560354,36254,70633,41404,34379,7025,0.0110262296070531,0.00915541367164717,0.00187081593540596,DEP
14,Calvados,1975_1982,1978.5,7,560354,589025,36588,64221,28671,27633,1038,0.00715402588993341,0.00689502275527641,0.000259003134657001,DEP
14,Calvados,1982_1990,1986,8,589025,617991,42471,70919,28966,28448,518,0.00601869835019708,0.00591106575524431,0.000107632594952775,DEP
14,Calvados,1990_1999,1994.5,9,617991,647873,48492,72887,29882,24395,5487,0.00526054335048554,0.00429459055736211,0.000965952793123423,DEP
14,Calvados,1999_2010,2004.5,11,647873,682567,62757,91231,34694,28474,6220,0.0047536265539625,0.00390138820826449,0.00085223834569801,DEP
15,Cantal,2010_2015,2012.5,5,148162,146219,9860,6245,-1943,-3615,1672,-0.00263667223652098,-0.00490559451107737,0.00226892227455639,DEP
15,Cantal,1968_1975,1971.5,7,169330,166549,14893,17308,-2781,2415,-5196,-0.00236290582667154,0.00205193008680754,-0.00441483591347907,DEP
15,Cantal,1975_1982,1978.5,7,166549,162838,15003,13854,-3711,-1149,-2562,-0.00321392693760059,-0.00099509621430964,-0.00221883072329095,DEP
15,Cantal,1982_1990,1986,8,162838,158723,16197,13690,-4115,-2507,-1608,-0.00319429945963212,-0.00194607745936761,-0.00124822200026451,DEP
15,Cantal,1990_1999,1994.5,9,158723,150778,17225,12246,-7945,-4979,-2966,-0.00568952944283674,-0.00356553393277333,-0.00212399551006341,DEP
15,Cantal,1999_2010,2004.5,11,150778,148162,20669,15092,-2616,-5577,2961,-0.00158985180904669,-0.00338937444153418,0.00179952263248749,DEP
16,Charente,2010_2015,2012.5,5,351577,353613,19221,17363,2036,-1858,3894,0.00115553639166799,-0.00105451209023533,0.00221004848190331,DEP
16,Charente,1968_1975,1971.5,7,331016,337064,27727,35068,6048,7341,-1293,0.00258993534908902,0.00314363680516907,-0.000553701456080044,DEP
16,Charente,1975_1982,1978.5,7,337064,340770,27029,30208,3706,3179,527,0.00156335499735505,0.00134104304818988,0.000222311949165167,DEP
16,Charente,1982_1990,1986,8,340770,341993,30878,32686,1223,1808,-585,0.000447913546508083,0.000662164915851688,-0.000214251369343605,DEP
16,Charente,1990_1999,1994.5,9,341993,339628,33479,32305,-2365,-1174,-1191,-0.000770743717396938,-0.00038260174385793,-0.000388141973539008,DEP
16,Charente,1999_2010,2004.5,11,339628,351577,40988,39255,11949,-1733,13682,0.00314838646757765,-0.000456620114512684,0.00360500658209033,DEP
17,Charente-Maritime,2010_2015,2012.5,5,622323,639938,35344,29790,17615,-5554,23169,0.00559801990185749,-0.00176505265597028,0.00736307255782777,DEP
17,Charente-Maritime,1968_1975,1971.5,7,483622,497859,39670,53356,14237,13686,551,0.00415335774735715,0.00399261460492589,0.000160743142431256,DEP
17,Charente-Maritime,1975_1982,1978.5,7,497859,513220,40271,44812,15361,4541,10820,0.00435053604319879,0.00128610013489784,0.00306443590830095,DEP
17,Charente-Maritime,1982_1990,1986,8,513220,527146,46298,48198,13926,1900,12026,0.00335222453909778,0.000457362245029857,0.00289486229406792,DEP
17,Charente-Maritime,1990_1999,1994.5,9,527146,557024,53698,49994,29878,-3704,33582,0.00614444199546571,-0.000761731479724379,0.00690617347519009,DEP
17,Charente-Maritime,1999_2010,2004.5,11,557024,622323,71545,66116,65299,-5429,70728,0.0101283042437879,-0.00084207359591302,0.0109703778397009,DEP
18,Cher,2010_2015,2012.5,5,311257,308992,17873,15845,-2265,-2028,-237,-0.0014596438603256,-0.00130691291335113,-0.000152730946974467,DEP
18,Cher,1968_1975,1971.5,7,304601,316350,28487,32767,11749,4280,7469,0.00542128112612272,0.00197489856326541,0.00344638256285732,DEP
18,Cher,1975_1982,1978.5,7,316350,320174,28181,26659,3824,-1522,5346,0.00171796006579195,-0.000683769670537485,0.00240172973632943,DEP
18,Cher,1982_1990,1986,8,320174,321559,30699,30284,1385,-415,1800,0.00053970103623513,-0.00016171547295132,0.00070141650918645,DEP
18,Cher,1990_1999,1994.5,9,321559,314428,32792,30618,-7131,-2174,-4957,-0.00248866773032153,-0.000758710369614219,-0.00172995736070731,DEP
18,Cher,1999_2010,2004.5,11,314428,311257,40209,36650,-3171,-3559,388,-0.000921046269699688,-0.00103374445722523,0.000112698187525537,DEP
19,Corrèze,2010_2015,2012.5,5,243551,241871,15569,10755,-1680,-4814,3134,-0.00138341020417132,-0.00396412900171472,0.0025807187975434,DEP
19,Corrèze,1968_1975,1971.5,7,237858,240363,23562,20649,2505,-2913,5418,0.00149775247104933,-0.00174169778369928,0.00323945025474861,DEP
19,Corrèze,1975_1982,1978.5,7,240363,241448,23673,17883,1085,-5790,6875,0.000643613935030096,-0.00343458496205001,0.0040781988970801,DEP
19,Corrèze,1982_1990,1986,8,241448,237908,26022,18927,-3540,-7095,3555,-0.00184455729415844,-0.00369693050905485,0.0018523732148964,DEP
19,Corrèze,1990_1999,1994.5,9,237908,232576,27595,18661,-5332,-8934,3602,-0.00251538565621601,-0.00421463905713312,0.00169925340091711,DEP
19,Corrèze,1999_2010,2004.5,11,232576,243551,32787,24746,10975,-8041,19016,0.00420055340933123,-0.00307759908559749,0.00727815249492872,DEP
21,Côte-d'Or,2010_2015,2012.5,5,524358,533147,22714,29322,8789,6608,2181,0.00333003756971939,0.00250368509053427,0.000826352479185117,DEP
21,Côte-d'Or,1968_1975,1971.5,7,421192,456070,31581,53969,34878,22388,12490,0.0114301910486059,0.0073369779573424,0.00409321309126347,DEP
21,Côte-d'Or,1975_1982,1978.5,7,456070,473548,31090,47915,17478,16825,653,0.00538688217287242,0.00518562149894602,0.000201260673926404,DEP
21,Côte-d'Or,1982_1990,1986,8,473548,493866,34719,53677,20318,18958,1360,0.00526518073723503,0.00491275206302302,0.000352428674212011,DEP
21,Côte-d'Or,1990_1999,1994.5,9,493866,506755,39066,54764,12889,15698,-2809,0.00286670413259404,0.00349146725684392,-0.000624763124249877,DEP
21,Côte-d'Or,1999_2010,2004.5,11,506755,524358,48591,66002,17603,17411,192,0.00310909643354007,0.00307518479829382,3.39116352462473e-05,DEP
22,Côtes-d'Armor,2010_2015,2012.5,5,591641,598357,34348,30560,6716,-3788,10504,0.00226005684111819,-0.00127473128560984,0.00353478812672803,DEP
22,Côtes-d'Armor,1968_1975,1971.5,7,506102,525556,46340,57001,19454,10661,8793,0.00540290329498427,0.0029608487728913,0.00244205452209297,DEP
22,Côtes-d'Armor,1975_1982,1978.5,7,525556,538869,47104,49256,13313,2152,11161,0.00358007161394247,0.000578706085270352,0.00300136552867212,DEP
22,Côtes-d'Armor,1982_1990,1986,8,538869,538395,52552,51636,-474,-916,442,-0.000109994848368378,-0.000212563884188679,0.000102569035820302,DEP
22,Côtes-d'Armor,1990_1999,1994.5,9,538395,542373,57647,51100,3978,-6547,10525,0.000818275172871141,-0.00134671884283242,0.00216499401570356,DEP
22,Côtes-d'Armor,1999_2010,2004.5,11,542373,591641,71561,70318,49268,-1243,50511,0.00793550923817765,-0.000200207801880629,0.00813571704005828,DEP
23,Creuse,2010_2015,2012.5,5,123029,120365,9507,4660,-2664,-4847,2183,-0.00436869078633317,-0.00794859018068952,0.00357989939435635,DEP
23,Creuse,1968_1975,1971.5,7,156876,146214,18109,11918,-10662,-6191,-4471,-0.0100045301487708,-0.00580923336625773,-0.00419529678251305,DEP
23,Creuse,1975_1982,1978.5,7,146214,139968,17282,9075,-6246,-8207,1961,-0.00621737405789036,-0.0081693866303404,0.00195201257245005,DEP
23,Creuse,1982_1990,1986,8,139968,131349,18451,9506,-8619,-8945,326,-0.00791301621558793,-0.00821231349906417,0.000299297283476234,DEP
23,Creuse,1990_1999,1994.5,9,131349,124470,18704,9634,-6879,-9070,2191,-0.00595919313340687,-0.00785722949847366,0.00189803636506679,DEP
23,Creuse,1999_2010,2004.5,11,124470,123029,21439,11341,-1441,-10098,8657,-0.00105804197598192,-0.00741437048817862,0.0063563285121967,DEP
24,Dordogne,2010_2015,2012.5,5,414149,415417,25883,17822,1268,-8061,9329,0.000611591457349903,-0.0038880431685312,0.00449963462588111,DEP
24,Dordogne,1968_1975,1971.5,7,374073,373179,35994,32656,-894,-3338,2444,-0.000341765619144674,-0.00127607789340595,0.000934312274261278,DEP
24,Dordogne,1975_1982,1978.5,7,373179,377356,36295,27639,4177,-8656,12833,0.00159138514994006,-0.00329782855108479,0.00488921370102485,DEP
24,Dordogne,1982_1990,1986,8,377356,386365,40250,30902,9009,-9348,18357,0.00295353806968413,-0.00306467686484706,0.00601821493453119,DEP
24,Dordogne,1990_1999,1994.5,9,386365,388293,44556,31596,1928,-12960,14888,0.000553229725259952,-0.00371880562207934,0.0042720353473393,DEP
24,Dordogne,1999_2010,2004.5,11,388293,414149,54951,40566,25856,-14385,40241,0.00587771576145135,-0.00327007043736377,0.00914778619881512,DEP
25,Doubs,2010_2015,2012.5,5,527770,536959,20979,34100,9189,13121,-3932,0.00345819756701715,0.00493797042951704,-0.00147977286249988,DEP
25,Doubs,1968_1975,1971.5,7,426458,471082,26462,61333,44624,34871,9753,0.0143184393611093,0.0111890081337676,0.00312943122734177,DEP
25,Doubs,1975_1982,1978.5,7,471082,477163,26126,55675,6081,29549,-23468,0.00183396180687034,0.00891164897734119,-0.00707768717047085,DEP
25,Doubs,1982_1990,1986,8,477163,484770,29849,56789,7607,26940,-19333,0.00197900565933851,0.00700859898285518,-0.00502959332351668,DEP
25,Doubs,1990_1999,1994.5,9,484770,499062,34085,57653,14292,23568,-9276,0.00323363750427452,0.00533237956204464,-0.00209874205777012,DEP
25,Doubs,1999_2010,2004.5,11,499062,527770,43709,73796,28708,30087,-1379,0.00509751618874099,0.00534237737113872,-0.000244861182397724,DEP
26,Drôme,2010_2015,2012.5,5,484715,504637,21504,29796,19922,8292,11630,0.00808818799743438,0.00336649206278114,0.00472169593465324,DEP
26,Drôme,1968_1975,1971.5,7,342891,361847,26612,39705,18956,13093,5863,0.00771660041282951,0.0053298928679667,0.00238670754486281,DEP
26,Drôme,1975_1982,1978.5,7,361847,389781,26918,35783,27934,8865,19069,0.0106799958029205,0.00338935214408569,0.00729064365883476,DEP
26,Drôme,1982_1990,1986,8,389781,414072,30593,44129,24291,13536,10755,0.00758547867882786,0.00422695810780182,0.00335852057102604,DEP
26,Drôme,1990_1999,1994.5,9,414072,437778,34891,48122,23706,13231,10475,0.00620495601077753,0.00346316430349268,0.00274179170728485,DEP
26,Drôme,1999_2010,2004.5,11,437778,484715,44400,62440,46937,18040,28897,0.00930201152687626,0.00357518136959856,0.0057268301572777,DEP
27,Eure,2010_2015,2012.5,5,586543,601948,25540,37723,15405,12183,3222,0.0051984816897428,0.00411120431198549,0.0010872773777573,DEP
27,Eure,1968_1975,1971.5,7,383385,422952,29452,50655,39567,21203,18364,0.014130184956656,0.00757202496110336,0.00655815999555261,DEP
27,Eure,1975_1982,1978.5,7,422952,462254,29904,46658,39302,16754,22548,0.0127745962954569,0.00544566653946578,0.00732892975599107,DEP
27,Eure,1982_1990,1986,8,462254,513818,35320,58237,51564,22917,28647,0.0133070857550368,0.00591417431246952,0.00739291144256728,DEP
27,Eure,1990_1999,1994.5,9,513818,541054,40899,63849,27236,22950,4286,0.00575538471538795,0.00484968715002766,0.000905697565360286,DEP
27,Eure,1999_2010,2004.5,11,541054,586543,53407,81176,45489,27769,17720,0.00736580347554994,0.00449649358553818,0.00286930989001176,DEP
28,Eure-et-Loir,2010_2015,2012.5,5,428933,434035,18940,27411,5102,8471,-3369,0.00236768784335339,0.0039311414584568,-0.00156345361510341,DEP
28,Eure-et-Loir,1968_1975,1971.5,7,302064,335151,23851,38663,33087,14812,18275,0.0149596869768165,0.00669697716627696,0.00826270981053953,DEP
28,Eure-et-Loir,1975_1982,1978.5,7,335151,362813,24221,36773,27662,12552,15110,0.0113939035634687,0.00517013511418766,0.00622376844928104,DEP
28,Eure-et-Loir,1982_1990,1986,8,362813,396073,27738,43933,33260,16195,17065,0.011024196979631,0.00536791551669043,0.00565628146294055,DEP
28,Eure-et-Loir,1990_1999,1994.5,9,396073,407665,32474,46881,11592,14407,-2815,0.00321038907427429,0.00398999960257675,-0.000779610528302461,DEP
28,Eure-et-Loir,1999_2010,2004.5,11,407665,428933,40689,59748,21268,19059,2209,0.00463388255116248,0.004152584518648,0.000481298032514478,DEP
29,Finistère,2010_2015,2012.5,5,897628,907796,48915,47400,10168,-1515,11683,0.00225533047590432,-0.000336037143095499,0.00259136761899982,DEP
29,Finistère,1968_1975,1971.5,7,768929,804088,67079,88395,35159,21316,13843,0.00640759542041547,0.00388476077196667,0.0025228346484488,DEP
29,Finistère,1975_1982,1978.5,7,804088,828364,68939,77778,24276,8839,15437,0.00425817686397334,0.00155042121027601,0.00270775565369733,DEP
29,Finistère,1982_1990,1986,8,828364,838687,77802,85547,10323,7745,2578,0.00154931174289752,0.00116239653673751,0.000386915206160012,DEP
29,Finistère,1990_1999,1994.5,9,838687,852418,85570,87421,13731,1851,11880,0.00180601145075676,0.000243458393077763,0.001562553057679,DEP
29,Finistère,1999_2010,2004.5,11,852418,897628,104493,109893,45210,5400,39810,0.00470911791146378,0.000562469292676497,0.00414664861878728,DEP
2A,Corse-du-Sud,2010_2015,2012.5,5,143600,152730,7015,6916,9130,-99,9229,0.0124043030177383,-0.000134504490553789,0.0125388075082921,DEP
2A,Corse-du-Sud,1968_1975,1971.5,7,89566,100278,7994,8919,10712,925,9787,0.016269580726753,0.00140490684953758,0.0148646738772154,DEP
2A,Corse-du-Sud,1975_1982,1978.5,7,100278,108604,8649,8499,8326,-150,8476,0.011459723871762,-0.000206456711597922,0.0116661805833599,DEP
2A,Corse-du-Sud,1982_1990,1986,8,108604,118808,10413,11415,10204,1002,9202,0.0112883006017563,0.00110847483368874,0.0101798257680676,DEP
2A,Corse-du-Sud,1990_1999,1994.5,9,118808,118593,11722,12199,-215,477,-692,-0.000201233286455493,0.000446457105298932,-0.000647690391754425,DEP
2A,Corse-du-Sud,1999_2010,2004.5,11,118593,143600,14277,14545,25007,268,24739,0.0175461744608232,0.000188042338365282,0.0173581321224579,DEP
2B,Haute-Corse,2010_2015,2012.5,5,166093,174553,7928,8080,8460,152,8308,0.00998563663880647,0.00017941096561449,0.00980622567319198,DEP
2B,Haute-Corse,1968_1975,1971.5,7,115702,125284,9308,10496,9582,1188,8394,0.0114313065555978,0.00141728158923504,0.0100140249663627,DEP
2B,Haute-Corse,1975_1982,1978.5,7,125284,131574,9716,9753,6290,37,6253,0.0070225821728136,4.13093068989035e-05,0.00698127286591469,DEP
2B,Haute-Corse,1982_1990,1986,8,131574,131563,11455,12025,-11,570,-581,-1.04507751922389e-05,0.00054154016905238,-0.000551990944244619,DEP
2B,Haute-Corse,1990_1999,1994.5,9,131563,141603,12896,13212,10040,316,9724,0.00820475861819525,0.000258237422644392,0.00794652119555086,DEP
2B,Haute-Corse,1999_2010,2004.5,11,141603,166093,15978,16346,24490,368,24122,0.0146075262673642,0.000219500598872602,0.0143880256684916,DEP
30,Gard,2010_2015,2012.5,5,709700,738189,33689,41800,28489,8111,20378,0.00790257054128896,0.00224991223491154,0.00565265830637742,DEP
30,Gard,1968_1975,1971.5,7,478544,494575,39012,47143,16031,8131,7900,0.00471833175446945,0.0023931604700637,0.00232517128440576,DEP
30,Gard,1975_1982,1978.5,7,494575,530478,40196,42594,35903,2398,33505,0.0100616642575866,0.000672029381658709,0.00938963487592788,DEP
30,Gard,1982_1990,1986,8,530478,585049,47914,55927,54571,8013,46558,0.0123148506187964,0.00180826625878976,0.0105065843600067,DEP
30,Gard,1990_1999,1994.5,9,585049,623125,54456,63676,38076,9220,28856,0.00703032376424373,0.00170237380781403,0.00532794995642969,DEP
30,Gard,1999_2010,2004.5,11,623125,709700,69387,86352,86575,16965,69610,0.0118970503641389,0.00233131342105246,0.00956573694308645,DEP
31,Haute-Garonne,2010_2015,2012.5,5,1243641,1335103,43114,81079,91462,37965,53497,0.014294214038665,0.00593339130981083,0.00836082272885421,DEP
31,Haute-Garonne,1968_1975,1971.5,7,690712,777431,51602,77486,86719,25884,60835,0.0170395366502709,0.00508598307932071,0.0119535535709502,DEP
31,Haute-Garonne,1975_1982,1978.5,7,777431,824501,52914,69021,47070,16107,30963,0.00843299630969319,0.00288570791502503,0.00554728839466816,DEP
31,Haute-Garonne,1982_1990,1986,8,824501,925962,60653,84859,101461,24206,77255,0.0146125903799283,0.0034861903858285,0.0111263999940998,DEP
31,Haute-Garonne,1990_1999,1994.5,9,925962,1046338,70973,109844,120376,38871,81505,0.0136724615736201,0.00441501839094328,0.00925744318267684,DEP
31,Haute-Garonne,1999_2010,2004.5,11,1046338,1243641,90434,157344,197303,66910,130393,0.0158282253207376,0.00536771643720851,0.0104605088835291,DEP
32,Gers,2010_2015,2012.5,5,188159,190932,11204,8217,2773,-2987,5760,0.0029302836411631,-0.00315642165025394,0.00608670529141704,DEP
32,Gers,1968_1975,1971.5,7,181577,175366,16604,15198,-6211,-1406,-4805,-0.00495974360304663,-0.00112274988019378,-0.00383699372285285,DEP
32,Gers,1975_1982,1978.5,7,175366,174154,15696,11705,-1212,-3991,2779,-0.000990259833005269,-0.0032608308527426,0.00227057101973733,DEP
32,Gers,1982_1990,1986,8,174154,174587,17652,13278,433,-4374,4807,0.000310450614939839,-0.00313605309410359,0.00344650370904343,DEP
32,Gers,1990_1999,1994.5,9,174587,172335,19064,14003,-2252,-5061,2809,-0.00144150755743044,-0.0032395513979376,0.00179804384050716,DEP
32,Gers,1999_2010,2004.5,11,172335,188159,23378,18050,15824,-5328,21152,0.00801807332307458,-0.00269971528471571,0.0107177886077903,DEP
33,Gironde,2010_2015,2012.5,5,1449245,1548478,61487,86034,99233,24547,74686,0.013334072684166,0.00329841365451233,0.0100356590296536,DEP
33,Gironde,1968_1975,1971.5,7,1009390,1061480,84333,111764,52090,27431,24659,0.00721417953129921,0.00379904316995717,0.00341513636134205,DEP
33,Gironde,1975_1982,1978.5,7,1061480,1127546,83795,102696,66066,18901,47165,0.00866294068495499,0.00247840404877447,0.00618453663618052,DEP
33,Gironde,1982_1990,1986,8,1127546,1213499,93705,116422,85953,22717,63236,0.0092253350294127,0.0024382154882688,0.0067871195411439,DEP
33,Gironde,1990_1999,1994.5,9,1213499,1287334,105074,130729,73835,25655,48180,0.00658441491516038,0.00228784674813353,0.00429656816702684,DEP
33,Gironde,1999_2010,2004.5,11,1287334,1449245,129061,176534,161911,47473,114438,0.0108281425446755,0.00317485786032683,0.00765328468434862,DEP
34,Hérault,2010_2015,2012.5,5,1044558,1120190,47760,64467,75632,16707,58925,0.0140790866672913,0.00311004999141152,0.0109690366758798,DEP
34,Hérault,1968_1975,1971.5,7,591397,648202,48468,59710,56805,11242,45563,0.0131883290823878,0.0026100377703407,0.0105782913120471,DEP
34,Hérault,1975_1982,1978.5,7,648202,706499,51052,57332,58297,6280,52017,0.0123787633543069,0.00133349287038865,0.0110452704839182,DEP
34,Hérault,1982_1990,1986,8,706499,794603,61872,73828,88104,11956,76148,0.0147985338964836,0.00200820928977524,0.0127903246067083,DEP
34,Hérault,1990_1999,1994.5,9,794603,896441,72844,91318,101838,18474,83364,0.0134890405593524,0.00244698968256914,0.0110420508767833,DEP
34,Hérault,1999_2010,2004.5,11,896441,1044558,96696,128452,148117,31756,116361,0.013998587053458,0.00300127014771845,0.0109973169057396,DEP
35,Ille-et-Vilaine,2010_2015,2012.5,5,988140,1042884,38288,64085,54744,25797,28947,0.010842527353172,0.0051093211699872,0.00573320618318484,DEP
35,Ille-et-Vilaine,1968_1975,1971.5,7,652722,702199,49484,87186,49477,37702,11775,0.0104925978821968,0.00799547113516551,0.0024971267470313,DEP
35,Ille-et-Vilaine,1975_1982,1978.5,7,702199,749764,50429,79793,47565,29364,18201,0.0094070638405177,0.00580740087486517,0.00359966296565253,DEP
35,Ille-et-Vilaine,1982_1990,1986,8,749764,798718,55462,86403,48954,30941,18013,0.00793751787537911,0.0050168472562427,0.00292067061913641,DEP
35,Ille-et-Vilaine,1990_1999,1994.5,9,798718,867533,61103,95977,68815,34874,33941,0.00922513714023476,0.0046751061923788,0.00455003094785596,DEP
35,Ille-et-Vilaine,1999_2010,2004.5,11,867533,988140,78821,135014,120607,56193,64414,0.011904007810968,0.00554629425258671,0.0063577135583813,DEP
36,Indre,2010_2015,2012.5,5,231176,224200,14740,10530,-6976,-4210,-2766,-0.00610942401626069,-0.00368702338137292,-0.00242240063488777,DEP
36,Indre,1968_1975,1971.5,7,247178,248523,23072,24623,1345,1551,-206,0.000775539393331526,0.000894320891492339,-0.000118781498160814,DEP
36,Indre,1975_1982,1978.5,7,248523,243191,22975,19696,-5332,-3279,-2053,-0.00309352711911182,-0.00190241474560533,-0.00119111237350648,DEP
36,Indre,1982_1990,1986,8,243191,237510,25425,19743,-5681,-5682,1,-0.00295031611033514,-0.00295083544075414,5.19330418999493e-07,DEP
36,Indre,1990_1999,1994.5,9,237510,231139,26787,20663,-6371,-6124,-247,-0.00301660384580282,-0.0028996518524088,-0.000116951993394019,DEP
36,Indre,1999_2010,2004.5,11,231139,231176,32817,25872,37,-6945,6982,1.45513809568509e-05,-0.00273133353365756,0.00274588491461441,DEP
37,Indre-et-Loire,2010_2015,2012.5,5,590515,604966,26133,33690,14451,7557,6894,0.00484715374369471,0.00253476858633319,0.00231238515736152,DEP
37,Indre-et-Loire,1968_1975,1971.5,7,437866,478597,33220,55569,40731,22349,18382,0.0127876399831974,0.00701654675761654,0.00577109322558089,DEP
37,Indre-et-Loire,1975_1982,1978.5,7,478597,506093,33981,47299,27496,13318,14178,0.00801214678269391,0.00388077432542615,0.00413137245726776,DEP
37,Indre-et-Loire,1982_1990,1986,8,506093,529345,38574,53823,23252,15249,8003,0.00563078691293195,0.0036927520056468,0.00193803490728515,DEP
37,Indre-et-Loire,1990_1999,1994.5,9,529345,554003,44496,57340,24658,12844,11814,0.00507167414156373,0.00264176261960599,0.00242991152195774,DEP
37,Indre-et-Loire,1999_2010,2004.5,11,554003,590515,55328,73652,36512,18324,18188,0.00581913262919098,0.00292040387536414,0.00289872875382684,DEP
38,Isère,2010_2015,2012.5,5,1206374,1251060,42636,79211,44686,36575,8111,0.00730092788845727,0.00597572925570256,0.00132519863275471,DEP
38,Isère,1968_1975,1971.5,7,767678,860339,54161,97686,92661,43525,49136,0.0164126783594132,0.00770941200282167,0.00870326635659151,DEP
38,Isère,1975_1982,1978.5,7,860339,936771,54390,92085,76432,37695,38737,0.012233128279036,0.00603317681701724,0.00619995146201876,DEP
38,Isère,1982_1990,1986,8,936771,1016228,62380,111355,79457,48975,30482,0.0102287290619989,0.00630469317758531,0.00392403588441359,DEP
38,Isère,1990_1999,1994.5,9,1016228,1094006,71171,124743,77778,53572,24206,0.0082279377232084,0.0056672462612528,0.0025606914619556,DEP
38,Isère,1999_2010,2004.5,11,1094006,1206374,88719,168280,112368,79561,32807,0.00892807212645685,0.00632142911196278,0.00260664301449407,DEP
39,Jura,2010_2015,2012.5,5,261534,260587,13061,13676,-947,615,-1562,-0.000725240007898864,0.000470984799216263,-0.00119622480711513,DEP
39,Jura,1968_1975,1971.5,7,233441,238856,19302,26488,5415,7186,-1771,0.00328129905237051,0.00435446260209317,-0.00107316354972265,DEP
39,Jura,1975_1982,1978.5,7,238856,242925,18892,22725,4069,3833,236,0.00241604162699938,0.00227591240016923,0.000140129226830143,DEP
39,Jura,1982_1990,1986,8,242925,248759,20559,25167,5834,4608,1226,0.00297087966236154,0.00234655699077168,0.00062432267158986,DEP
39,Jura,1990_1999,1994.5,9,248759,250857,22580,26813,2098,4233,-2135,0.000933602132613398,0.0018836691264788,-0.000950066993865398,DEP
39,Jura,1999_2010,2004.5,11,250857,261534,27451,33222,10677,5771,4906,0.00379639160871115,0.00205197864323986,0.00174441296547128,DEP
40,Landes,2010_2015,2012.5,5,384320,403234,20199,19286,18914,-913,19827,0.00965460784991357,-0.00046603875261558,0.0101206466025291,DEP
40,Landes,1968_1975,1971.5,7,277381,288323,24798,27550,10942,2752,8190,0.00554235477461917,0.00139394629315957,0.00414840848145961,DEP
40,Landes,1975_1982,1978.5,7,288323,297424,25593,22894,9101,-2699,11800,0.00444949124783389,-0.00131954476188371,0.00576903600971761,DEP
40,Landes,1982_1990,1986,8,297424,311461,28936,26211,14037,-2725,16762,0.00578107121530658,-0.00112227819774243,0.006903349413049,DEP
40,Landes,1990_1999,1994.5,9,311461,327334,32801,28634,15873,-4167,20040,0.00553827168074794,-0.0014539140738157,0.00699218575456365,DEP
40,Landes,1999_2010,2004.5,11,327334,384320,41110,39993,56986,-1117,58103,0.0146973670612911,-0.000288087583046049,0.0149854546443371,DEP
41,Loir-et-Cher,2010_2015,2012.5,5,330079,333050,17696,18246,2971,550,2421,0.00179372863192029,0.000332060164105069,0.00146166846781522,DEP
41,Loir-et-Cher,1968_1975,1971.5,7,267900,283690,22927,30376,15790,7449,8341,0.00821474538948697,0.00387534125435645,0.00433940413513051,DEP
41,Loir-et-Cher,1975_1982,1978.5,7,283690,296224,23078,26380,12534,3302,9232,0.00619537417396865,0.00163213064643725,0.0045632435275314,DEP
41,Loir-et-Cher,1982_1990,1986,8,296224,305937,26842,28828,9713,1986,7727,0.00404105231115426,0.000826266847519032,0.00321478546363523,DEP
41,Loir-et-Cher,1990_1999,1994.5,9,305937,314968,30192,31444,9031,1252,7779,0.00323765747875582,0.00044884809693304,0.00278880938182278,DEP
41,Loir-et-Cher,1999_2010,2004.5,11,314968,330079,38542,40646,15111,2104,13007,0.00426917556594542,0.000594424286331094,0.00367475127961432,DEP
42,Loire,2010_2015,2012.5,5,748947,759411,36092,46502,10464,10410,54,0.00277883639080989,0.0027644960653986,1.43403254112898e-05,DEP
42,Loire,1968_1975,1971.5,7,722443,742396,58879,85024,19953,26145,-6192,0.00389962230108276,0.00510978925784638,-0.00121016695676362,DEP
42,Loire,1975_1982,1978.5,7,742396,739521,56264,74020,-2875,17756,-20631,-0.000554148433420165,0.00342242072480294,-0.00397656915822311,DEP
42,Loire,1982_1990,1986,8,739521,746288,60303,78158,6767,17855,-11088,0.00113926163729894,0.00300598737017475,-0.00186672573287581,DEP
42,Loire,1990_1999,1994.5,9,746288,728524,65263,78436,-17764,13173,-30937,-0.0026732000852393,0.00198232744443016,-0.00465552752966946,DEP
42,Loire,1999_2010,2004.5,11,728524,748947,77399,98958,20423,21559,-1136,0.0025165840677408,0.0026565654368322,-0.000139981369091395,DEP
43,Haute-Loire,2010_2015,2012.5,5,224006,227034,12214,11296,3028,-918,3946,0.00268899864690297,-0.000815224820956714,0.00350422346785969,DEP
43,Haute-Loire,1968_1975,1971.5,7,208337,205491,20051,19828,-2846,-223,-2623,-0.00196303123704322,-0.000153814464462628,-0.00180921677258059,DEP
43,Haute-Loire,1975_1982,1978.5,7,205491,205895,19385,17015,404,-2370,2774,0.000280624046029132,-0.00164623512150753,0.00192685916753666,DEP
43,Haute-Loire,1982_1990,1986,8,205895,206568,21041,18616,673,-2425,3098,0.000407998947591581,-0.00147012993745852,0.0018781288850501,DEP
43,Haute-Loire,1990_1999,1994.5,9,206568,209113,22041,19572,2545,-2469,5014,0.0013614948489058,-0.00132083724241588,0.00268233209132168,DEP
43,Haute-Loire,1999_2010,2004.5,11,209113,224006,26127,26377,14893,250,14643,0.00627396863369745,0.000105317408072542,0.00616865122562491,DEP
44,Loire-Atlantique,2010_2015,2012.5,5,1282219,1366358,51323,84254,84139,32931,51208,0.0127924593459221,0.00500681584901842,0.00778564349690368,DEP
44,Loire-Atlantique,1968_1975,1971.5,7,862082,934882,65444,116039,72800,50595,22205,0.011648742037826,0.00809571570609621,0.00355302633172974,DEP
44,Loire-Atlantique,1975_1982,1978.5,7,934882,995822,65356,109064,60940,43708,17232,0.009061986076631,0.00649952883881503,0.00256245723781597,DEP
44,Loire-Atlantique,1982_1990,1986,8,995822,1052466,73323,116626,56644,43303,13341,0.00693930796928788,0.00530493702764764,0.00163437094164024,DEP
44,Loire-Atlantique,1990_1999,1994.5,9,1052466,1134551,82379,125680,82085,43301,38784,0.00837946794718736,0.00442028801341487,0.00395917993377249,DEP
44,Loire-Atlantique,1999_2010,2004.5,11,1134551,1282219,105052,176954,147668,71902,75766,0.0111852921363915,0.00544630438003375,0.00573898775635778,DEP
45,Loiret,2010_2015,2012.5,5,656105,673349,28375,43013,17244,14638,2606,0.00520207035937403,0.00441590732547652,0.000786163033897514,DEP
45,Loiret,1968_1975,1971.5,7,430629,490189,34694,54274,59560,19580,39980,0.018678602893331,0.00614048093773373,0.0125381219555973,DEP
45,Loiret,1975_1982,1978.5,7,490189,535669,35796,52424,45480,16628,28852,0.0127557264340172,0.00466363718436321,0.00809208924965403,DEP
45,Loiret,1982_1990,1986,8,535669,580612,40994,62779,44943,21785,23158,0.0101216668552124,0.00490622594043128,0.00521544091478116,DEP
45,Loiret,1990_1999,1994.5,9,580612,618126,46463,69046,37514,22583,14931,0.00698087578500983,0.00420240757724788,0.00277846820776195,DEP
45,Loiret,1999_2010,2004.5,11,618126,656105,59665,91489,37979,31824,6155,0.00543549324816306,0.00455459957159328,0.000880893676569779,DEP
46,Lot,2010_2015,2012.5,5,174578,173400,10472,7177,-1178,-3295,2117,-0.00135319736746797,-0.00378504696588028,0.00243184959841231,DEP
46,Lot,1968_1975,1971.5,7,151198,150778,14564,12987,-420,-1577,1157,-0.000397303883587496,-0.00149178148670829,0.00109447760312079,DEP
46,Lot,1975_1982,1978.5,7,150778,154533,14676,11114,3755,-3562,7317,0.00352034038368321,-0.00333940145051387,0.00685974183419708,DEP
46,Lot,1982_1990,1986,8,154533,155816,16101,12409,1283,-3692,4975,0.00103405403614554,-0.00297562548826915,0.00400967952441469,DEP
46,Lot,1990_1999,1994.5,9,155816,160197,17725,12978,4381,-4747,9128,0.00308569364170208,-0.00334348041934713,0.00642917406104921,DEP
46,Lot,1999_2010,2004.5,11,160197,174578,21864,16670,14381,-5194,19575,0.00784582986753768,-0.00283368613670751,0.0106795160042452,DEP
47,Lot-et-Garonne,2010_2015,2012.5,5,331123,333417,18243,16796,2294,-1447,3741,0.00138176400939249,-0.000871583488051848,0.00225334749744434,DEP
47,Lot-et-Garonne,1968_1975,1971.5,7,290592,292616,24971,28275,2024,3304,-1280,0.000992055725433483,0.00161944274547047,-0.000627387020036985,DEP
47,Lot-et-Garonne,1975_1982,1978.5,7,292616,298522,24773,23904,5906,-869,6775,0.00285871588730569,-0.000420627176781009,0.00327934306408669,DEP
47,Lot-et-Garonne,1982_1990,1986,8,298522,305989,27627,27466,7467,-161,7628,0.00309296357610656,-6.6689049920069e-05,0.00315965262602662,DEP
47,Lot-et-Garonne,1990_1999,1994.5,9,305989,305380,30722,27611,-609,-3111,2502,-0.000221336705689912,-0.00113067075763763,0.000909334051947716,DEP
47,Lot-et-Garonne,1999_2010,2004.5,11,305380,331123,38153,36113,25743,-2040,27783,0.00738467913587759,-0.000585197740635912,0.00796987687651351,DEP
48,Lozère,2010_2015,2012.5,5,77082,76309,4712,3456,-773,-1256,483,-0.00201375037939089,-0.00327201872770369,0.00125826834831281,DEP
48,Lozère,1968_1975,1971.5,7,77258,74825,7397,7035,-2433,-362,-2071,-0.0045607703201439,-0.000678585637440235,-0.00388218468270367,DEP
48,Lozère,1975_1982,1978.5,7,74825,74294,7055,6392,-531,-663,132,-0.0010168910408147,-0.00126967751423757,0.000252786473422864,DEP
48,Lozère,1982_1990,1986,8,74294,72825,7522,6413,-1469,-1109,-360,-0.00249324817038332,-0.00188224113067059,-0.000611007039712727,DEP
48,Lozère,1990_1999,1994.5,9,72825,73509,8100,6439,684,-1661,2345,0.00103926687023415,-0.00252371677113877,0.00356298364137291,DEP
48,Lozère,1999_2010,2004.5,11,73509,77082,10090,8434,3573,-1656,5229,0.00432404386769636,-0.00200409086059479,0.00632813472829115,DEP
49,Maine-et-Loire,2010_2015,2012.5,5,784643,809055,32058,50485,24412,18427,5985,0.00614642475161142,0.00463952846542453,0.00150689628618689,DEP
49,Maine-et-Loire,1968_1975,1971.5,7,584933,629466,41876,83300,44533,41424,3109,0.0105372051464019,0.00980156706228082,0.000735638084121066,DEP
49,Maine-et-Loire,1975_1982,1978.5,7,629466,674997,42486,78931,45531,36445,9086,0.0100265618400699,0.00802569779406003,0.00200086404600986,DEP
49,Maine-et-Loire,1982_1990,1986,8,674997,705599,47201,83009,30602,35808,-5206,0.00555774239426277,0.00650322330742308,-0.000945480913160315,DEP
49,Maine-et-Loire,1990_1999,1994.5,9,705599,732657,53257,83069,27058,29812,-2754,0.00418992718494038,0.00461638366610402,-0.000426456481163641,DEP
49,Maine-et-Loire,1999_2010,2004.5,11,732657,784643,68820,111247,51986,42427,9559,0.00625138474887454,0.00510190244951526,0.00114948229935928,DEP
50,Manche,2010_2015,2012.5,5,499285,499824,26651,25650,539,-1001,1540,0.000215815576679601,-0.000400800356690688,0.000616615933370289,DEP
50,Manche,1968_1975,1971.5,7,452705,452275,33729,52619,-430,18890,-19320,-0.000135747544847131,0.00596342121433095,-0.00609916875917808,DEP
50,Manche,1975_1982,1978.5,7,452275,466482,33525,46670,14207,13145,1062,0.00442820887220408,0.00409719192124464,0.000331016950959437,DEP
50,Manche,1982_1990,1986,8,466482,480123,39144,53718,13641,14574,-933,0.003609358947398,0.00385622735132164,-0.000246868403923637,DEP
50,Manche,1990_1999,1994.5,9,480123,481983,42845,53252,1860,10407,-8547,0.000429705924212653,0.00240427395337693,-0.00197456802916427,DEP
50,Manche,1999_2010,2004.5,11,481983,499285,54463,60965,17302,6502,10800,0.00321134820929081,0.0012068076555779,0.00200454055371291,DEP
51,Marne,2010_2015,2012.5,5,565357,572293,24501,34903,6936,10402,-3466,0.00244171774474844,0.00366187254626201,-0.00122015480151357,DEP
51,Marne,1968_1975,1971.5,7,485302,530454,34896,67693,45152,32797,12355,0.0127899384932535,0.00929021112604613,0.00349972736720736,DEP
51,Marne,1975_1982,1978.5,7,530454,543670,34813,60442,13216,25629,-12413,0.00352178718458895,0.00682959168839515,-0.0033078045038062,DEP
51,Marne,1982_1990,1986,8,543670,558276,39056,66233,14606,27177,-12571,0.00331937428803863,0.00617627242407408,-0.00285689813603544,DEP
51,Marne,1990_1999,1994.5,9,558276,565284,42940,65762,7008,22822,-15814,0.00138704950610502,0.00451701538646244,-0.00312996588035742,DEP
51,Marne,1999_2010,2004.5,11,565284,565357,52772,78494,73,25722,-25649,1.17391861753635e-05,0.00413637461373562,-0.00412463542756026,DEP
52,Haute-Marne,2010_2015,2012.5,5,184039,179154,9956,9456,-4885,-500,-4385,-0.00536593575981914,-0.00054922576866112,-0.00481670999115802,DEP
52,Haute-Marne,1968_1975,1971.5,7,214340,212304,16226,26945,-2036,10719,-12755,-0.00136254653094725,0.00717344610276207,-0.00853599263370932,DEP
52,Haute-Marne,1975_1982,1978.5,7,212304,210670,15660,22317,-1634,6657,-8291,-0.00110314560927116,0.00449427192222651,-0.00559741753149767,DEP
52,Haute-Marne,1982_1990,1986,8,210670,204067,16992,23525,-6603,6533,-13136,-0.00397265763975685,0.00393054253529176,-0.00790320017504861,DEP
52,Haute-Marne,1990_1999,1994.5,9,204067,194873,18285,21579,-9194,3294,-12488,-0.00510915994436201,0.00183049519868702,-0.00693965514304903,DEP
52,Haute-Marne,1999_2010,2004.5,11,194873,184039,22284,23422,-10834,1138,-11972,-0.00518653710716333,0.00054479224921099,-0.00573132935637432,DEP
53,Mayenne,2010_2015,2012.5,5,306337,307940,13832,18557,1603,4725,-3122,0.00104437611206687,0.00307840120369055,-0.00203402509162368,DEP
53,Mayenne,1968_1975,1971.5,7,252762,261789,19521,32330,9027,12809,-3782,0.00502551450160871,0.0071310308243166,-0.00210551632270789,DEP
53,Mayenne,1975_1982,1978.5,7,261789,271784,19102,29740,9995,10638,-643,0.00536703655518944,0.00571230964223164,-0.000345273087042202,DEP
53,Mayenne,1982_1990,1986,8,271784,278037,20820,30538,6253,9718,-3465,0.00284736671865082,0.00442518947254897,-0.00157782275389815,DEP
53,Mayenne,1990_1999,1994.5,9,278037,285338,22746,31751,7301,9005,-1704,0.00288417838690247,0.0035573245273328,-0.000673146140430326,DEP
53,Mayenne,1999_2010,2004.5,11,285338,306337,28823,43362,20999,14539,6460,0.00647646039904637,0.00448408294403234,0.00199237745501403,DEP
54,Meurthe-et-Moselle,2010_2015,2012.5,5,732207,734403,31769,41754,2196,9985,-7789,0.000599112075065689,0.00272410476754595,-0.00212499269248026,DEP
54,Meurthe-et-Moselle,1968_1975,1971.5,7,705554,722693,48702,88960,17139,40258,-23119,0.00343462808089035,0.00806763856003755,-0.0046330104791472,DEP
54,Meurthe-et-Moselle,1975_1982,1978.5,7,722693,716964,48161,76524,-5729,28363,-34092,-0.0011363370520826,0.00562575105746533,-0.00676208810954793,DEP
54,Meurthe-et-Moselle,1982_1990,1986,8,716964,711943,52243,82031,-5021,29788,-34809,-0.00087808651952237,0.00520940873203194,-0.00608749525155431,DEP
54,Meurthe-et-Moselle,1990_1999,1994.5,9,711943,713779,56048,79766,1836,23718,-21882,0.000286211905274447,0.0036973714429735,-0.00341115953769905,DEP
54,Meurthe-et-Moselle,1999_2010,2004.5,11,713779,732207,68204,94453,18428,26249,-7821,0.00231994785616596,0.00330455346627416,-0.000984605610108203,DEP
55,Meuse,2010_2015,2012.5,5,193923,190626,9768,10445,-3297,677,-3974,-0.00342368175193375,0.000703012601170503,-0.00412669435310425,DEP
55,Meuse,1968_1975,1971.5,7,209372,203799,17226,24659.2028536997,-5573,7433.20285369969,-13006.2028536997,-0.00384663412045361,0.0051305960382728,-0.00897723015872641,DEP
55,Meuse,1975_1982,1978.5,7,203799,199983,16807,20475.4536245267,-3816,3668.45362452668,-7484.45362452668,-0.0026966220037894,0.00259235659428187,-0.00528897859807126,DEP
55,Meuse,1982_1990,1986,8,199983,196223,17107,22433.6537552888,-3760,5326.65375528876,-9086.65375528876,-0.00236976208935491,0.00335715482244768,-0.00572691691180259,DEP
55,Meuse,1990_1999,1994.5,9,196223,192198,18396,21216,-4025,2820,-6845,-0.00230020345992832,0.00161157111975102,-0.00391177457967934,DEP
55,Meuse,1999_2010,2004.5,11,192198,193923,21809,24974,1725,3165,-1440,0.000812610207421072,0.00149096307622475,-0.000678352868803677,DEP
56,Morbihan,2010_2015,2012.5,5,721657,744813,38166,39032,23156,866,22290,0.00633663675233165,0.000236980800981137,0.00609965595135051,DEP
56,Morbihan,1968_1975,1971.5,7,540474,563588,47518,66512,23114,18994,4120,0.0060003526812864,0.00493080811751986,0.00106954456376655,DEP
56,Morbihan,1975_1982,1978.5,7,563588,590889,47528,59171,27301,11643,15658,0.0067806990311281,0.00289175044208727,0.00388894858904083,DEP
56,Morbihan,1982_1990,1986,8,590889,619838,54138,65145,28949,11007,17942,0.00599665475961797,0.00228005039687433,0.00371660436274364,DEP
56,Morbihan,1990_1999,1994.5,9,619838,643873,59127,66199,24035,7072,16963,0.00423598520862711,0.00124638599523241,0.0029895992133947,DEP
56,Morbihan,1999_2010,2004.5,11,643873,721657,76742,87213,77784,10471,67313,0.0104219757478696,0.00140296858037569,0.00901900716749393,DEP
57,Moselle,2010_2015,2012.5,5,1045066,1044486,45895,57715,-580,11820,-12400,-0.000111022423523566,0.00226256042422163,-0.0023735828477452,DEP
57,Moselle,1968_1975,1971.5,7,971314,1006373,62371,123890,35059,61519,-26460,0.00507831735095743,0.00891106435190821,-0.00383274700095079,DEP
57,Moselle,1975_1982,1978.5,7,1006373,1007189,63104,104659,816,41555,-40739,0.000115792991624009,0.00589678647908784,-0.00578099348746383,DEP
57,Moselle,1982_1990,1986,8,1007189,1011302,69927,118573,4113,48646,-44533,0.000509545681113499,0.00602658867090865,-0.00551704298979515,DEP
57,Moselle,1990_1999,1994.5,9,1011302,1023447,76507,112967,12145,36460,-24315,0.00132729475531557,0.00398461644946938,-0.00265732169415381,DEP
57,Moselle,1999_2010,2004.5,11,1023447,1045066,96782,131742,21619,34960,-13341,0.00190214311394143,0.00307594815964626,-0.00117380504570483,DEP
58,Nièvre,2010_2015,2012.5,5,219584,211747,14751,9574,-7837,-5177,-2660,-0.00724218436633051,-0.00478407406718043,-0.00245811029915008,DEP
58,Nièvre,1968_1975,1971.5,7,247702,245212,24345,23293,-2490,-1052,-1438,-0.00144228294315552,-0.000609350062730764,-0.000832932880424751,DEP
58,Nièvre,1975_1982,1978.5,7,245212,239635,24410,19718,-5577,-4692,-885,-0.00328120648571162,-0.00276052014182516,-0.000520686343886459,DEP
58,Nièvre,1982_1990,1986,8,239635,233278,26617,20895,-6357,-5722,-635,-0.00335511609847849,-0.00301997393668302,-0.000335142161795477,DEP
58,Nièvre,1990_1999,1994.5,9,233278,225198,28152,20428,-8080,-7724,-356,-0.00390910173193759,-0.00373686903186707,-0.000172232700070518,DEP
58,Nièvre,1999_2010,2004.5,11,225198,219584,32392,23603,-5614,-8789,3175,-0.00229238373828478,-0.00358884230063856,0.00129645856235379,DEP
59,Nord,2010_2015,2012.5,5,2576770,2605238,110078,182171,28468,72093,-43625,0.00219988764506884,0.0055710446816056,-0.00337115703653675,DEP
59,Nord,1968_1975,1971.5,7,2418847,2511478,192646,333036,92631,140390,-47759,0.00538307181751829,0.00815849394329537,-0.00277542212577707,DEP
59,Nord,1975_1982,1978.5,7,2511478,2520526,189565,304918,9048,115353,-106305,0.000513872764067447,0.00655136659521134,-0.00603749383114389,DEP
59,Nord,1982_1990,1986,8,2520526,2531855,198022,336921,11329,138899,-127570,0.0005607353731516,0.00687488592068003,-0.00631415054752843,DEP
59,Nord,1990_1999,1994.5,9,2531855,2555020,203853,330885,23165,127032,-103867,0.00101249175229823,0.00555229234957688,-0.00453980059727866,DEP
59,Nord,1999_2010,2004.5,11,2555020,2576770,242147,402585,21750,160438,-138688,0.000770899281709925,0.00568650753834377,-0.00491560825663384,DEP
60,Oise,2010_2015,2012.5,5,803595,821552,31197,54549,17957,23352,-5395,0.00442974713070732,0.00576062009223575,-0.00133087296152843,DEP
60,Oise,1968_1975,1971.5,7,540988,606320,40232,74825,65332,34593,30739,0.016420617854398,0.00869464325961533,0.00772597459478264,DEP
60,Oise,1975_1982,1978.5,7,606320,661781,40184,69663,55461,29479,25982,0.0125823262506157,0.006687841826543,0.00589448442407273,DEP
60,Oise,1982_1990,1986,8,661781,725603,46170,84764,63822,38594,25228,0.0115750215393846,0.00699956725409748,0.00457545428528713,DEP
60,Oise,1990_1999,1994.5,9,725603,766441,51977,95381,40838,43404,-2566,0.00610239853963135,0.00648583442416766,-0.000383435884536315,DEP
60,Oise,1999_2010,2004.5,11,766441,803595,65593,120222,37154,54629,-17475,0.00431269929287281,0.0063411328435794,-0.00202843355070658,DEP
61,Orne,2010_2015,2012.5,5,291642,286618,16200,14874,-5024,-1326,-3698,-0.00346930878479534,-0.000915665495350045,-0.0025536432894453,DEP
61,Orne,1968_1975,1971.5,7,288503,293523,22450,34751,5020,12301,-7281,0.00246739849480715,0.00604610933956628,-0.00357871084475913,DEP
61,Orne,1975_1982,1978.5,7,293523,295472,21692,30190,1949,8498,-6549,0.00094588663173889,0.00412424042920323,-0.00317835379746434,DEP
61,Orne,1982_1990,1986,8,295472,293204,24336,31159,-2268,6823,-9091,-0.000962719440408932,0.00289622343117731,-0.00385894287158625,DEP
61,Orne,1990_1999,1994.5,9,293204,292337,26808,31071,-867,4263,-5130,-0.000328986549766319,0.00161761206649806,-0.00194659861626438,DEP
61,Orne,1999_2010,2004.5,11,292337,291642,33319,36555,-695,3236,-3931,-0.000216360563426887,0.00100739968812864,-0.00122376025155553,DEP
62,Pas-de-Calais,2010_2015,2012.5,5,1461387,1472648,71065,96384,11261,25319,-14058,0.00153641028572804,0.00345443317861187,-0.00191802289288383,DEP
62,Pas-de-Calais,1968_1975,1971.5,7,1397099,1402295,106622,181796,5196,75174,-69978,0.00053046011102853,0.00767452047468413,-0.0071440603636556,DEP
62,Pas-de-Calais,1975_1982,1978.5,7,1402295,1412413,108211,158902,10118,50691,-40573,0.00102758604054354,0.00514818778228825,-0.00412060174174471,DEP
62,Pas-de-Calais,1982_1990,1986,8,1412413,1433203,117408,181671,20790,64263,-43473,0.00182819542065271,0.00565104965451685,-0.00382285423386413,DEP
62,Pas-de-Calais,1990_1999,1994.5,9,1433203,1441568,124867,174680,8365,49813,-41448,0.000646832484059834,0.00385184298009235,-0.00320501049603252,DEP
62,Pas-de-Calais,1999_2010,2004.5,11,1441568,1461387,153916,215682,19819,61766,-41947,0.00124209573441703,0.0038709967774359,-0.00262890104301887,DEP
63,Puy-de-Dôme,2010_2015,2012.5,5,632311,647501,30334,34499,15190,4165,11025,0.00475908388928059,0.00130491009867371,0.00345417379060688,DEP
63,Puy-de-Dôme,1968_1975,1971.5,7,547743,580033,45732,62571,32290,16839,15451,0.00821625533498804,0.00428471736097441,0.00393153797401363,DEP
63,Puy-de-Dôme,1975_1982,1978.5,7,580033,594365,45153,54018,14332,8865,5467,0.00349303078971475,0.00216059991283988,0.00133243087687486,DEP
63,Puy-de-Dôme,1982_1990,1986,8,594365,598213,49405,56683,3848,7278,-3430,0.000806984068976391,0.00152630718659308,-0.000719323117616689,DEP
63,Puy-de-Dôme,1990_1999,1994.5,9,598213,604266,53724,55961,6053,2237,3816,0.00111925039567851,0.00041364003554152,0.000705610360136986,DEP
63,Puy-de-Dôme,1999_2010,2004.5,11,604266,632311,65180,73426,28045,8246,19799,0.00413277677275614,0.00121514984019066,0.00291762693256548,DEP
64,Pyrénées-Atlantiques,2010_2015,2012.5,5,653515,670032,33129,32284,16517,-845,17362,0.00500447803957704,-0.000256026151446546,0.00526050419102359,DEP
64,Pyrénées-Atlantiques,1968_1975,1971.5,7,508734,534748,41834,53156,26014,11322,14692,0.00714977003360984,0.00311177428771164,0.0040379957458982,DEP
64,Pyrénées-Atlantiques,1975_1982,1978.5,7,534748,555696,43231,45462,20948,2231,18717,0.00550449066315295,0.00058623824085804,0.00491825242229491,DEP
64,Pyrénées-Atlantiques,1982_1990,1986,8,555696,578516,51289,51172,22820,-117,22937,0.00504327745876165,-2.58572945957543e-05,0.00506913475335741,DEP
64,Pyrénées-Atlantiques,1990_1999,1994.5,9,578516,600018,57588,55194,21502,-2394,23896,0.00406305980148125,-0.000452374903020469,0.00451543470450172,DEP
64,Pyrénées-Atlantiques,1999_2010,2004.5,11,600018,653515,70538,71010,53497,472,53025,0.00779438578675706,6.87692784894356e-05,0.00772561650826763,DEP
65,Hautes-Pyrénées,2010_2015,2012.5,5,229458,228582,13425,10628,-876,-2797,1921,-0.000764707085160743,-0.00244165036209429,0.00167694327693355,DEP
65,Hautes-Pyrénées,1968_1975,1971.5,7,225730,227222,19522,21434,1492,1912,-420,0.000941574195725936,0.00120662859398659,-0.000265054398260652,DEP
65,Hautes-Pyrénées,1975_1982,1978.5,7,227222,227922,19184,16787,700,-2397,3097,0.000439518276270201,-0.00150503615459953,0.00194455443086973,DEP
65,Hautes-Pyrénées,1982_1990,1986,8,227922,224759,21193,18773,-3163,-2420,-743,-0.00174531867139405,-0.00133533708023193,-0.000409981591162117,DEP
65,Hautes-Pyrénées,1990_1999,1994.5,9,224759,222368,23573,19779,-2391,-3794,1403,-0.00118763308406045,-0.00188451690544765,0.000696883821387205,DEP
65,Hautes-Pyrénées,1999_2010,2004.5,11,222368,229458,28956,24127,7090,-4829,11919,0.00285737809814757,-0.00194616062566355,0.00480353872381112,DEP
66,Pyrénées-Orientales,2010_2015,2012.5,5,448543,471038,25518,24369,22495,-1149,23644,0.00983489139650273,-0.000502346753259908,0.0103372381497626,DEP
66,Pyrénées-Orientales,1968_1975,1971.5,7,281976,299506,25894,25964,17530,70,17460,0.00865329513854563,3.45539452195205e-05,0.0086187411933261,DEP
66,Pyrénées-Orientales,1975_1982,1978.5,7,299506,334557,28525,24256,35051,-4269,39320,0.0159360482673143,-0.00194091438341744,0.0178769626507318,DEP
66,Pyrénées-Orientales,1982_1990,1986,8,334557,363796,33604,31233,29239,-2371,31610,0.0105282867464653,-0.000853742189400092,0.0113820289358654,DEP
66,Pyrénées-Orientales,1990_1999,1994.5,9,363796,392803,40120,36013,29007,-4107,33114,0.0085603142770323,-0.00121202505380672,0.00977233933083902,DEP
66,Pyrénées-Orientales,1999_2010,2004.5,11,392803,448543,52620,49233,55740,-3387,59127,0.0121363585768541,-0.000737456880154377,0.0128738154570085,DEP
67,Bas-Rhin,2010_2015,2012.5,5,1095905,1116658,42779,65576,20753,22797,-2044,0.0037590054070904,0.00412923655690454,-0.000370231149814136,DEP
67,Bas-Rhin,1968_1975,1971.5,7,827367,882121,66361,100690,54754,34329,20425,0.00919643912403623,0.00576587205846221,0.00343056706557402,DEP
67,Bas-Rhin,1975_1982,1978.5,7,882121,915676,65178,88415,33555,23237,10318,0.00534758405786029,0.00370322785732378,0.00164435620053651,DEP
67,Bas-Rhin,1982_1990,1986,8,915676,953053,71090,103957,37377,32867,4510,0.00501351653155724,0.00440857339654578,0.000604943135011455,DEP
67,Bas-Rhin,1990_1999,1994.5,9,953053,1026120,75309,118023,73067,42714,30353,0.00824149366084948,0.00481786798732019,0.00342362567352928,DEP
67,Bas-Rhin,1999_2010,2004.5,11,1026120,1095905,89834,145337,69785,55503,14282,0.00599936151121994,0.00477154921483471,0.00122781229638523,DEP
68,Haut-Rhin,2010_2015,2012.5,5,749782,762607,30993,44461,12825,13468,-643,0.00339782534424504,0.00356818025234247,-0.000170354908097432,DEP
68,Haut-Rhin,1968_1975,1971.5,7,585018,635209,48663,70085,50191,21422,28769,0.0118281866080872,0.00504838344560664,0.00677980316248051,DEP
68,Haut-Rhin,1975_1982,1978.5,7,635209,650372,47433,64748,15163,17315,-2152,0.00337574622329173,0.0038548470524498,-0.000479100829158069,DEP
68,Haut-Rhin,1982_1990,1986,8,650372,671319,50934,76333,20947,25399,-4452,0.00397035191661321,0.00481419622523793,-0.000843844308624721,DEP
68,Haut-Rhin,1990_1999,1994.5,9,671319,708025,53991,81623,36706,27632,9074,0.00593252479850581,0.00446595993113694,0.00146656486736887,DEP
68,Haut-Rhin,1999_2010,2004.5,11,708025,749782,64066,99365,41757,35299,6458,0.00522296453578552,0.00441519805418716,0.000807766481598365,DEP
69,Rhône,2010_2015,2012.5,5,1725177,1821995,59777,130824,96818,71047,25771,0.0109803262305366,0.00805758472289174,0.00292274150764484,DEP
69,Rhône,1968_1975,1971.5,7,1326383,1429647,90874,169838,103264,78964,24300,0.0107678276516949,0.00823395125782885,0.00253387639386608,DEP
69,Rhône,1975_1982,1978.5,7,1429647,1445208,88267,155750,15561,67483,-51922,0.00154772437530393,0.00671197763759623,-0.0051642532622923,DEP
69,Rhône,1982_1990,1986,8,1445208,1508966,96229,177335,63758,81106,-17348,0.00541101094991214,0.00688330019924675,-0.00147228924933461,DEP
69,Rhône,1990_1999,1994.5,9,1508966,1578869,106651,200159,69903,93508,-23605,0.00504424847501661,0.00674760148208021,-0.0017033530070636,DEP
69,Rhône,1999_2010,2004.5,11,1578869,1725177,129550,262825,146308,133275,13033,0.00808898465495966,0.00736842435061479,0.000720560304344871,DEP
70,Haute-Saône,2010_2015,2012.5,5,239548,237706,11657,12981,-1842,1324,-3166,-0.00154264856406472,0.00110883099827453,-0.00265147956233925,DEP
70,Haute-Saône,1968_1975,1971.5,7,214396,222254,18611,25808,7858,7197,661,0.00515554427049381,0.00472186970154542,0.000433674568948384,DEP
70,Haute-Saône,1975_1982,1978.5,7,222254,231962,18019,22759,9708,4740,4968,0.00612621657009504,0.00299116878267929,0.00313504778741576,DEP
70,Haute-Saône,1982_1990,1986,8,231962,229650,19654,24657,-2312,5003,-7315,-0.00125136069136433,0.00270785360678882,-0.00395921429815316,DEP
70,Haute-Saône,1990_1999,1994.5,9,229650,229732,21164,23748,82,2584,-2502,3.96676052376588e-05,0.00125001331626964,-0.00121034571103198,DEP
70,Haute-Saône,1999_2010,2004.5,11,229732,239548,25217,30779,9816,5562,4254,0.00381091606885442,0.00215936381163084,0.00165155225722358,DEP
71,Saône-et-Loire,2010_2015,2012.5,5,555663,555408,30470,28494,-255,-1976,1721,-9.17991019160347e-05,-0.000711353040729743,0.000619553938813709,DEP
71,Saône-et-Loire,1968_1975,1971.5,7,550364,569810,47935,61597,19446,13662,5784,0.00497276542131675,0.00349367073876527,0.00147909468255148,DEP
71,Saône-et-Loire,1975_1982,1978.5,7,569810,571852,46918,52843,2042,5925,-3883,0.000511165559811566,0.00148318116644639,-0.000972015606634824,DEP
71,Saône-et-Loire,1982_1990,1986,8,571852,559413,51028,54980,-12439,3952,-16391,-0.00274524951178623,0.000872194394290472,-0.0036174439060767,DEP
71,Saône-et-Loire,1990_1999,1994.5,9,559413,544893,54281,53573,-14520,-708,-13812,-0.0029177987678457,-0.000142272832481733,-0.00277552593536397,DEP
71,Saône-et-Loire,1999_2010,2004.5,11,544893,555663,65616,63904,10770,-1712,12482,0.00178090668566266,-0.000283093059039413,0.00206399974470208,DEP
72,Sarthe,2010_2015,2012.5,5,563518,568445,26423,33764,4927,7341,-2414,0.0017425738215211,0.00259635364801834,-0.000853779826497246,DEP
72,Sarthe,1968_1975,1971.5,7,461839,490385,33391,60162,28546,26771,1775,0.00860458723227486,0.00806955106828383,0.000535036163991028,DEP
72,Sarthe,1975_1982,1978.5,7,490385,504768,33584,50981,14383,17397,-3014,0.00413827064875494,0.00500545744812554,-0.000867186799370603,DEP
72,Sarthe,1982_1990,1986,8,504768,513654,38133,54068,8886,15935,-7049,0.00218375207851018,0.00391605777302045,-0.00173230569451027,DEP
72,Sarthe,1990_1999,1994.5,9,513654,529851,43574,58114,16197,14540,1657,0.00345550631172253,0.00310199801027633,0.000353508301446208,DEP
72,Sarthe,1999_2010,2004.5,11,529851,563518,55472,75389,33667,19917,13750,0.00561602390686367,0.0033223734859953,0.00229365042086837,DEP
73,Savoie,2010_2015,2012.5,5,414959,428204,16894,24337,13245,7443,5802,0.00630378522188302,0.00354239889818613,0.00276138632369689,DEP
73,Savoie,1968_1975,1971.5,7,288921,305118,22042,33266,16197,11224,4973,0.00782262274933321,0.00542082593927986,0.00240179681005335,DEP
73,Savoie,1975_1982,1978.5,7,305118,323675,21726,30136,18557,8410,10147,0.00847014740505947,0.00383865601533384,0.00463149138972563,DEP
73,Savoie,1982_1990,1986,8,323675,348261,24758,35455,24586,10697,13889,0.00919353741197382,0.00399997029593606,0.00519356711603776,DEP
73,Savoie,1990_1999,1994.5,9,348261,373258,27827,40226,24997,12399,12598,0.00773169984538669,0.00383507406420569,0.003896625781181,DEP
73,Savoie,1999_2010,2004.5,11,373258,414959,35311,52690,41701,17379,24322,0.00967466816693485,0.00403194307266398,0.00564272509427087,DEP
74,Haute-Savoie,2010_2015,2012.5,5,738088,793938,24931,48701,55850,23770,32080,0.0146953937508367,0.00625442272976525,0.00844097102107148,DEP
74,Haute-Savoie,1968_1975,1971.5,7,378550,447795,26407,49781,69245,23374,45871,0.0242884703438493,0.00819869601873252,0.0160897743251168,DEP
74,Haute-Savoie,1975_1982,1978.5,7,447795,494505,27711,48574,46710,20863,25847,0.0142754669926883,0.00637613076147413,0.0078993362312142,DEP
74,Haute-Savoie,1982_1990,1986,8,494505,568286,32738,60436,73781,27698,46083,0.017535415239492,0.0065829404765922,0.0109524747628998,DEP
74,Haute-Savoie,1990_1999,1994.5,9,568286,631679,38204,74340,63393,36136,27257,0.0118200377415756,0.00673779256115936,0.00508224518041622,DEP
74,Haute-Savoie,1999_2010,2004.5,11,631679,738088,49938,97632,106409,47694,58715,0.0142535084638775,0.00638862157031994,0.00786488689355758,DEP
75,Paris,2010_2015,2012.5,5,2243833,2206488,69505,148914,-37345,79409,-116754,-0.00335106320800627,0.00712557446203159,-0.0104766376700379,DEP
75,Paris,1968_1975,1971.5,7,2590771,2299830,195077,262006,-290941,66929,-357870,-0.0168732123208307,0.00388156783478739,-0.0207547801556181,DEP
75,Paris,1975_1982,1978.5,7,2299830,2176243,174171,220479,-123587,46308,-169895,-0.00785969431419942,0.00294502434966418,-0.0108047186638636,DEP
75,Paris,1982_1990,1986,8,2176243,2152423,177141,254976,-23820,77835,-101655,-0.00137478052607354,0.00449227717241536,-0.0058670576984889,DEP
75,Paris,1990_1999,1994.5,9,2152423,2125246,168412,274423,-27177,106011,-133188,-0.0014108509172126,0.00550339318484841,-0.00691424410206101,DEP
75,Paris,1999_2010,2004.5,11,2125246,2243833,166231,346283,118587,180052,-61465,0.00494838518421803,0.00751318988749884,-0.00256480470328081,DEP
76,Seine-Maritime,2010_2015,2012.5,5,1250411,1257699,56603,79271,7288,22668,-15380,0.00116298848666663,0.00361726440940712,-0.0024542759227405,DEP
76,Seine-Maritime,1968_1975,1971.5,7,1113977,1172743,77327,147809,58766,70482,-11716,0.00737117064705894,0.0088407386847158,-0.00146956803765685,DEP
76,Seine-Maritime,1975_1982,1978.5,7,1172743,1193108,78408,131084,20365,52676,-32311,0.00246248663297721,0.00636945474484202,-0.0039069681118648,DEP
76,Seine-Maritime,1982_1990,1986,8,1193108,1223429,89036,152135,30321,63099,-32778,0.00314191360586458,0.00653842573188381,-0.00339651212601923,DEP
76,Seine-Maritime,1990_1999,1994.5,9,1223429,1239138,97560,150181,15709,52621,-36912,0.00141860578327679,0.00475195460702834,-0.00333334882375155,DEP
76,Seine-Maritime,1999_2010,2004.5,11,1239138,1250411,120259,176143,11273,55884,-44611,0.000823640886144839,0.00408306105573655,-0.00325942016959171,DEP
77,Seine-et-Marne,2010_2015,2012.5,5,1324865,1390121,42308,98253,65256,55945,9311,0.00966242796844186,0.0082837521866875,0.00137867578175436,DEP
77,Seine-et-Marne,1968_1975,1971.5,7,604340,755762,48073,82037,151422,33964,117458,0.0324569659079284,0.00728010718453645,0.0251768587233919,DEP
77,Seine-et-Marne,1975_1982,1978.5,7,755762,887112,50607,86119,131350,35512,95838,0.0231561395544615,0.0062605316167342,0.0168956079377273,DEP
77,Seine-et-Marne,1982_1990,1986,8,887112,1078166,60492,117975,191054,57483,133571,0.0246803248262419,0.00742564464490074,0.0172546801813412,DEP
77,Seine-et-Marne,1990_1999,1994.5,9,1078166,1193767,70493,148647,115601,78154,37447,0.0113812125289461,0.00769446011701674,0.00368675241192934,DEP
77,Seine-et-Marne,1999_2010,2004.5,11,1193767,1324865,89872,200240,131098,110368,20730,0.00951743397945592,0.00801248038448025,0.00150495359497568,DEP
78,Yvelines,2010_2015,2012.5,5,1408765,1427291,42545,99436,18526,56891,-38365,0.00261637835328954,0.00803456660352991,-0.00541818825024038,DEP
78,Yvelines,1968_1975,1971.5,7,854382,1082255,49627,124610,227873,74983,152890,0.0343516601329803,0.0113036232100831,0.0230480369228972,DEP
78,Yvelines,1975_1982,1978.5,7,1082255,1196111,53143,130983,113856,77840,36016,0.014392392078785,0.00983965534897257,0.00455273672981238,DEP
78,Yvelines,1982_1990,1986,8,1196111,1307150,62144,156777,111039,94633,16406,0.0111585136949011,0.0095098445275045,0.00164866916739656,DEP
78,Yvelines,1990_1999,1994.5,9,1307150,1354304,73447,178259,47154,104812,-57658,0.00394537084613633,0.00876961040686349,-0.00482423956072716,DEP
78,Yvelines,1999_2010,2004.5,11,1354304,1408765,91222,218428,54461,127206,-72745,0.00359059122211103,0.00838663900772765,-0.00479604778561662,DEP
79,Deux-Sèvres,2010_2015,2012.5,5,369270,374435,18747,19799,5165,1052,4113,0.00278189016508645,0.000566611510875305,0.00221527865421115,DEP
79,Deux-Sèvres,1968_1975,1971.5,7,325608,335829,25466,38858,10221,13392,-3171,0.00442517630224293,0.00579805900006235,-0.00137288269781942,DEP
79,Deux-Sèvres,1975_1982,1978.5,7,335829,342812,24943,32899,6983,7956,-973,0.00294433894802948,0.003354598406204,-0.000410259458174522,DEP
79,Deux-Sèvres,1982_1990,1986,8,342812,345965,27986,33637,3153,5651,-2498,0.0011450828481232,0.00205228771796518,-0.000907204869841979,DEP
79,Deux-Sèvres,1990_1999,1994.5,9,345965,344392,31668,33780,-1573,2112,-3685,-0.000506212985581289,0.000679670582039213,-0.0011858835676205,DEP
79,Deux-Sèvres,1999_2010,2004.5,11,344392,369270,38894,44748,24878,5854,19024,0.00636083018350919,0.00149675616585991,0.00486407401764928,DEP
80,Somme,2010_2015,2012.5,5,570741,571879,27441,34184,1138,6743,-5605,0.000398462161090407,0.00236101085433446,-0.00196254869324405,DEP
80,Somme,1968_1975,1971.5,7,511491,538462,42851,68052,26971,25201,1770,0.00736800224373946,0.00688446941323933,0.000483532830500124,DEP
80,Somme,1975_1982,1978.5,7,538462,544570,42539,58277,6108,15738,-9630,0.00161266533442617,0.00415522708467567,-0.00254256175024951,DEP
80,Somme,1982_1990,1986,8,544570,547825,46320,63115,3255,16795,-13540,0.000745202583201765,0.00384506217661249,-0.00309985959341072,DEP
80,Somme,1990_1999,1994.5,9,547825,555551,48723,63480,7726,14757,-7031,0.00155726919351551,0.00297445269074662,-0.00141718349723111,DEP
80,Somme,1999_2010,2004.5,11,555551,570741,59621,78172,15190,18551,-3361,0.0024552913497129,0.00299855890905358,-0.000543267559340688,DEP
81,Tarn,2010_2015,2012.5,5,375379,386543,20127,19530,11164,-597,11761,0.00587859842610961,-0.000314360736329939,0.00619295916243954,DEP
81,Tarn,1968_1975,1971.5,7,332011,338024,28499,31232,6013,2733,3280,0.00256740414917989,0.00116692425406763,0.00140047989511226,DEP
81,Tarn,1975_1982,1978.5,7,338024,339345,27852,27649,1321,-203,1524,0.000557353851319498,-8.56493806342604e-05,0.000643003231953758,DEP
81,Tarn,1982_1990,1986,8,339345,342723,31155,29886,3378,-1269,4647,0.00123892329862652,-0.000465421452325947,0.00170434475095246,DEP
81,Tarn,1990_1999,1994.5,9,342723,343402,34351,30990,679,-3361,4040,0.000219938831417243,-0.00108868101972512,0.00130861985114236,DEP
81,Tarn,1999_2010,2004.5,11,343402,375379,42467,41097,31977,-1370,33347,0.00812688252200045,-0.000348182414083266,0.00847506493608371,DEP
82,Tarn-et-Garonne,2010_2015,2012.5,5,241698,255274,12044,14500,13576,2456,11120,0.0109896403247027,0.00198810817895329,0.00900153214574944,DEP
82,Tarn-et-Garonne,1968_1975,1971.5,7,183572,183314,16222,17700,-258,1478,-1736,-0.000200898625367651,0.00115088437323019,-0.00135178299859784,DEP
82,Tarn-et-Garonne,1975_1982,1978.5,7,183314,190485,15938,14891,7171,-1047,8218,0.00549689879038584,-0.000802573285948121,0.00629947207633396,DEP
82,Tarn-et-Garonne,1982_1990,1986,8,190485,200220,17697,17289,9735,-408,10143,0.00624986323518106,-0.000261935716482165,0.00651179895166323,DEP
82,Tarn-et-Garonne,1990_1999,1994.5,9,200220,206034,19821,20049,5814,228,5586,0.00318555666063336,0.000124923790613073,0.00306063287002029,DEP
82,Tarn-et-Garonne,1999_2010,2004.5,11,206034,241698,24859,28592,35664,3733,31931,0.0146192685055442,0.00153021896958267,0.0130890495359615,DEP
83,Var,2010_2015,2012.5,5,1008183,1048652,53510,55585,40469,2075,38394,0.00790222487563974,0.000405177212606006,0.00749704766303374,DEP
83,Var,1968_1975,1971.5,7,555926,626093,47013,57841,70167,10828,59339,0.0171255216771049,0.00264276866218724,0.0144827530149177,DEP
83,Var,1975_1982,1978.5,7,626093,708331,53118,56112,82238,2994,79244,0.0177867003478818,0.000647551993501277,0.0171391483543805,DEP
83,Var,1982_1990,1986,8,708331,815449,66352,76946,107118,10594,96524,0.017759276325982,0.00175639736923256,0.0160028789567494,DEP
83,Var,1990_1999,1994.5,9,815449,898441,81740,90939,82992,9199,73793,0.0108273243708259,0.00120012238393131,0.00962720198689459,DEP
83,Var,1999_2010,2004.5,11,898441,1008183,109425,117360,109742,7935,101807,0.0105317948928925,0.000761511476691711,0.00977028341620075,DEP
84,Vaucluse,2010_2015,2012.5,5,543105,557548,24934,35311,14443,10377,4066,0.00526298648650747,0.00378134811122952,0.00148163837527795,DEP
84,Vaucluse,1968_1975,1971.5,7,353966,390446,27273,40652,36480,13379,23101,0.0141113253426255,0.00517531309646344,0.00893601224616205,DEP
84,Vaucluse,1975_1982,1978.5,7,390446,427343,29389,37163,36897,7774,29123,0.0129831723471572,0.00273548477726644,0.0102476875698907,DEP
84,Vaucluse,1982_1990,1986,8,427343,467075,34610,48377,39732,13767,25965,0.0111748365506343,0.00387204205156003,0.00730279449907431,DEP
84,Vaucluse,1990_1999,1994.5,9,467075,499685,41198,55822,32610,14624,17986,0.00752685829238731,0.00337543010327728,0.00415142818911003,DEP
84,Vaucluse,1999_2010,2004.5,11,499685,543105,52188,72522,43420,20334,23086,0.00760374196384084,0.00356090486164762,0.00404283710219322,DEP
85,Vendée,2010_2015,2012.5,5,634778,666714,30982,36713,31936,5731,26205,0.00986551384392276,0.00177039265529563,0.00809512118862713,DEP
85,Vendée,1968_1975,1971.5,7,421250,450641,32662,52834,29391,20172,9219,0.00968149854018185,0.0066447275884641,0.00303677095171775,DEP
85,Vendée,1975_1982,1978.5,7,450641,483027,33957,51008,32386,17051,15335,0.00996381712239303,0.00524587926122162,0.0047179378611714,DEP
85,Vendée,1982_1990,1986,8,483027,509356,39555,52521,26329,12966,13363,0.00665638465419227,0.00327800840997596,0.00337837624421631,DEP
85,Vendée,1990_1999,1994.5,9,509356,539664,45388,52762,30308,7374,22934,0.00644283757993747,0.00156755590320902,0.00487528167672845,DEP
85,Vendée,1999_2010,2004.5,11,539664,634778,61428,78127,95114,16699,78415,0.014866570445083,0.00261009798623169,0.0122564724588513,DEP
86,Vienne,2010_2015,2012.5,5,427193,434887,20435,24165,7694,3730,3964,0.00357644536953994,0.00173383691556849,0.00184260845397145,DEP
86,Vienne,1968_1975,1971.5,7,340256,357366,26964,38372,17110,11408,5702,0.00703350417686077,0.00468955088542535,0.00234395329143542,DEP
86,Vienne,1975_1982,1978.5,7,357366,371428,26549,33731,14062,7182,6880,0.00552873733962711,0.00282373713363689,0.00270500020599022,DEP
86,Vienne,1982_1990,1986,8,371428,380005,30019,35813,8577,5794,2783,0.00285774735175814,0.00193048713490576,0.000927260216852386,DEP
86,Vienne,1990_1999,1994.5,9,380005,399024,33721,37411,19019,3690,15329,0.00544109985394869,0.00105566320316897,0.00438543665077972,DEP
86,Vienne,1999_2010,2004.5,11,399024,427193,43106,51636,28169,8530,19639,0.00622057118821418,0.00188368320620068,0.0043368879820135,DEP
87,Haute-Vienne,2010_2015,2012.5,5,376191,375795,19755,19027,-396,-728,332,-0.000210620055355548,-0.000387200505805149,0.000176580450449601,DEP
87,Haute-Vienne,1968_1975,1971.5,7,341589,352149,30692,30899,10560,207,10353,0.00435891849666681,8.54447091676164e-05,0.00427347378749919,DEP
87,Haute-Vienne,1975_1982,1978.5,7,352149,355737,31430,26947,3588,-4483,8071,0.00144923660101171,-0.00181073792707232,0.00325997452808402,DEP
87,Haute-Vienne,1982_1990,1986,8,355737,353593,35032,28449,-2144,-6583,4439,-0.000755359522129573,-0.00231927786109094,0.00156391833896137,DEP
87,Haute-Vienne,1990_1999,1994.5,9,353593,353893,37570,29377,300,-8193,8493,9.42348142205507e-05,-0.00257355277636324,0.00266778759058379,DEP
87,Haute-Vienne,1999_2010,2004.5,11,353893,376191,44093,40664,22298,-3429,25727,0.00557021862301999,-0.000856591607244395,0.00642681023026438,DEP
88,Vosges,2010_2015,2012.5,5,379724,372016,20111,19130,-7708,-981,-6727,-0.00409316187062814,-0.000520938219393643,-0.00357222365123449,DEP
88,Vosges,1968_1975,1971.5,7,388201,397957,30859,47356,9756,16497,-6741,0.00355210991731547,0.0060064736885971,-0.00245436377128163,DEP
88,Vosges,1975_1982,1978.5,7,397957,395769,31070,41038,-2188,9968,-12156,-0.000787297280249844,0.00358673642117479,-0.00437403370142463,DEP
88,Vosges,1982_1990,1986,8,395769,386258,33759,42869,-9511,9110,-18621,-0.00303602788594626,0.00290802376626752,-0.00594405165221378,DEP
88,Vosges,1990_1999,1994.5,9,386258,380952,35787,42158,-5306,6371,-11677,-0.00153572590133111,0.00184397092298916,-0.00337969682432027,DEP
88,Vosges,1999_2010,2004.5,11,380952,379724,43051,47915,-1228,4864,-6092,-0.000293476009506133,0.00116243266306012,-0.00145590867256626,DEP
89,Yonne,2010_2015,2012.5,5,342510,340903,19642,18671,-1607,-971,-636,-0.000940132801291238,-0.000568057840730425,-0.000372074960560814,DEP
89,Yonne,1968_1975,1971.5,7,283376,299851,29272,31164,16475,1892,14583,0.0081056812861442,0.000930861850888305,0.00717481943525589,DEP
89,Yonne,1975_1982,1978.5,7,299851,311019,29015,28513,11168,-502,11670,0.00523771468277912,-0.000235434524601998,0.00547314920738111,DEP
89,Yonne,1982_1990,1986,8,311019,323096,32712,32450,12077,-262,12339,0.00477329217694944,-0.000103552417848866,0.00487684459479831,DEP
89,Yonne,1990_1999,1994.5,9,323096,333221,36065,34335,10125,-1730,11855,0.00343437743175956,-0.000586812143895708,0.00402118957565527,DEP
89,Yonne,1999_2010,2004.5,11,333221,342510,43751,42962,9289,-789,10078,0.00250266470824667,-0.00021257427654286,0.00271523898478953,DEP
90,Territoire de Belfort,2010_2015,2012.5,5,142911,144483,6179,8741,1572,2562,-990,0.00219035426730518,0.00356977584785997,-0.00137942158055479,DEP
90,Territoire de Belfort,1968_1975,1971.5,7,118450,128125,8745,15156,9675,6411,3264,0.0112796291278237,0.00747428447942919,0.00380534464839446,DEP
90,Territoire de Belfort,1975_1982,1978.5,7,128125,131999,8924,14128,3874,5204,-1330,0.00426449532094697,0.00572855798921219,-0.00146406266826522,DEP
90,Territoire de Belfort,1982_1990,1986,8,131999,134097,9652,15455,2098,5803,-3705,0.00197307794573121,0.00545746964684375,-0.00348439170111254,DEP
90,Territoire de Belfort,1990_1999,1994.5,9,134097,137408,10373,16168,3311,5795,-2484,0.00271380723550241,0.00474977738741663,-0.00203597015191422,DEP
90,Territoire de Belfort,1999_2010,2004.5,11,137408,142911,13114,20176,5503,7062,-1559,0.00357614799708639,0.00458927078964639,-0.00101312279256,DEP
91,Essonne,2010_2015,2012.5,5,1215340,1276233,36870,92921,60893,56051,4842,0.00982573808688669,0.00904442949941842,0.00078130858746827,DEP
91,Essonne,1968_1975,1971.5,7,673325,923063,39244,103801,249738,64557,185181,0.0460980002884395,0.0119162826827347,0.0341817176057048,DEP
91,Essonne,1975_1982,1978.5,7,923063,988000,43823,103957,64937,60134,4803,0.00975948904855906,0.0090376382408496,0.000721850807709458,DEP
91,Essonne,1982_1990,1986,8,988000,1084824,52076,124574,96824,72498,24326,0.0117548443839941,0.00880156477888545,0.00295327960510866,DEP
91,Essonne,1990_1999,1994.5,9,1084824,1134238,61979,149514,49414,87535,-38121,0.00496152312515164,0.00878914734205181,-0.00382762421690018,DEP
91,Essonne,1999_2010,2004.5,11,1134238,1215340,77282,192709,81102,115427,-34325,0.00629818826646722,0.00896378605994318,-0.00266559779347596,DEP
92,Hauts-de-Seine,2010_2015,2012.5,5,1572490,1601569,48647,124357,29079,75710,-46631,0.00367140786228704,0.00955886685421615,-0.00588745899192912,DEP
92,Hauts-de-Seine,1968_1975,1971.5,7,1461619,1438930,88158,162753,-22689,74595,-97284,-0.00223249621088883,0.00733981466134482,-0.00957231087223365,DEP
92,Hauts-de-Seine,1975_1982,1978.5,7,1438930,1387039,86126,147548,-51891,61422,-113313,-0.00523319070405082,0.00619438899663158,-0.0114275797006824,DEP
92,Hauts-de-Seine,1982_1990,1986,8,1387039,1391658,93170,172040,4619,78870,-74251,0.000415659223891529,0.00709743299162695,-0.00668177376773543,DEP
92,Hauts-de-Seine,1990_1999,1994.5,9,1391658,1428881,96100,201947,37223,105847,-68624,0.00293716931989296,0.00835210920674611,-0.00541493988685315,DEP
92,Hauts-de-Seine,1999_2010,2004.5,11,1428881,1572490,107903,271986,143609,164083,-20474,0.00874425776995547,0.00999090619437224,-0.00124664842441677,DEP
93,Seine-Saint-Denis,2010_2015,2012.5,5,1522048,1592663,42043,143708,70615,101665,-31050,0.00911139061953548,0.0131177444924602,-0.00400635387292468,DEP
93,Seine-Saint-Denis,1968_1975,1971.5,7,1249606,1322127,72222,159001,72521,86779,-14258,0.00809163341082408,0.00968248997887375,-0.00159085656804967,DEP
93,Seine-Saint-Denis,1975_1982,1978.5,7,1322127,1324301,72713,153562,2174,80849,-78675,0.000234737501565219,0.00872966525485113,-0.00849492775328591,DEP
93,Seine-Saint-Denis,1982_1990,1986,8,1324301,1381197,78508,188629,56896,110121,-53225,0.00527206636916233,0.0102039725224713,-0.00493190615330894,DEP
93,Seine-Saint-Denis,1990_1999,1994.5,9,1381197,1382861,82871,209605,1664,126734,-125070,0.00013378972443201,0.0101897277260615,-0.0100559380016295,DEP
93,Seine-Saint-Denis,1999_2010,2004.5,11,1382861,1522048,93539,290958,139187,197419,-58232,0.0087565026330223,0.0124199817030946,-0.00366347907007231,DEP
94,Val-de-Marne,2010_2015,2012.5,5,1327732,1372389,40752,105663,44657,64911,-20254,0.00663809379744129,0.00964877413363441,-0.00301068033619312,DEP
94,Val-de-Marne,1968_1975,1971.5,7,1121319,1215713,70440,140172,94394,69732,24662,0.0116133552740458,0.00857917335815586,0.00303418191588998,DEP
94,Val-de-Marne,1975_1982,1978.5,7,1215713,1193655,70354,128181,-22058,57827,-79885,-0.00261239708702887,0.00684863026346988,-0.00946102735049875,DEP
94,Val-de-Marne,1982_1990,1986,8,1193655,1215538,77351,145834,21883,68483,-46600,0.0022734238988229,0.00711469583069455,-0.00484127193187165,DEP
94,Val-de-Marne,1990_1999,1994.5,9,1215538,1227250,81857,169029,11712,87172,-75460,0.00106602522538424,0.00793438788825092,-0.00686836266286668,DEP
94,Val-de-Marne,1999_2010,2004.5,11,1227250,1327732,91745,220169,100482,128424,-27942,0.00717986428410078,0.00917643847476521,-0.00199657419066444,DEP
95,Val-d'Oise,2010_2015,2012.5,5,1171161,1215390,34612,97839,44229,63227,-18998,0.00744144061482155,0.0106378160427168,-0.00319637542789527,DEP
95,Val-d'Oise,1968_1975,1971.5,7,693269,840885,42367,93866,147616,51499,96117,0.0279604445190396,0.00975459931366531,0.0182058452053743,DEP
95,Val-d'Oise,1975_1982,1978.5,7,840885,920598,44272,97452,79713,53180,26533,0.0130224271087556,0.00868782599630701,0.00433460111244855,DEP
95,Val-d'Oise,1982_1990,1986,8,920598,1049598,52408,128858,129000,76450,52550,0.0165274739680363,0.00979477042524324,0.0067327035427931,DEP
95,Val-d'Oise,1990_1999,1994.5,9,1049598,1105464,60006,149455,55866,89449,-33583,0.0057786236038242,0.00925235568572066,-0.00347373208189647,DEP
95,Val-d'Oise,1999_2010,2004.5,11,1105464,1171161,73333,196778,65697,123445,-57748,0.00526201494845435,0.00988735308023117,-0.00462533813177682,DEP
971,Guadeloupe,2010_2015,2012.5,5,403355,397990,14914,26032,-5365,11118,-16483,-0.00267445488567886,0.00554232794389143,-0.00821678282957029,DEP
971,Guadeloupe,1968_1975,1971.5,7,305312,315848,19202,75711,10536,56509,-45973,0.00485846146890379,0.0260579725841196,-0.0211995111152158,DEP
971,Guadeloupe,1975_1982,1978.5,7,315848,317269,14706,41890,1421,27184,-25763,0.000641478412632068,0.0122716039190641,-0.0116301255064321,DEP
971,Guadeloupe,1982_1990,1986,8,317269,353431,17036,50657,36162,33621,2541,0.0135837167304549,0.0126292279241918,0.000954488806263089,DEP
971,Guadeloupe,1990_1999,1994.5,9,353431,386566,20049,58091,33135,38042,-4907,0.0100068863935667,0.011488817630423,-0.00148193123685625,DEP
971,Guadeloupe,1999_2010,2004.5,11,386566,403355,29016,68469,16789,39453,-22664,0.00387242862198245,0.0090999420110235,-0.00522751338904105,DEP
972,Martinique,2010_2015,2012.5,5,394173,380877,14624,22317,-13296,7693,-20989,-0.00683918774504289,0.00395712028599691,-0.0107963080310398,DEP
972,Martinique,1968_1975,1971.5,7,320030,324832,16566,60888,4802,44322,-39520,0.00212989131758601,0.0196586928317466,-0.0175288015141606,DEP
972,Martinique,1975_1982,1978.5,7,324832,328566,16967,44559,3734,27592,-23858,0.00163413451417482,0.012075265001369,-0.0104411304871941,DEP
972,Martinique,1982_1990,1986,8,328566,359572,16786,47536,31006,30750,256,0.0113358573994697,0.0112422632727116,9.35941267581845e-05,DEP
972,Martinique,1990_1999,1994.5,9,359572,381427,20361,53254,21855,32893,-11038,0.00657765473092931,0.00989973905579765,-0.00332208432486834,DEP
972,Martinique,1999_2010,2004.5,11,381427,394173,29581,59732,12746,30151,-17405,0.00299268888282578,0.00707928467802291,-0.00408659579519713,DEP
973,Guyane,2010_2015,2012.5,5,229040,259865,3829,32017,30825,28188,2637,0.0255746820818106,0.0233868333664907,0.00218784871531985,DEP
973,Guyane,1968_1975,1971.5,7,44392,55125,2909,10846,10733,7937,2796,0.0314183211125187,0.0232336918541006,0.00818462925841819,DEP
973,Guyane,1975_1982,1978.5,7,55125,73022,2984,11640,17897,8656,9241,0.0409828837825261,0.0198216372588448,0.0211612465236813,DEP
973,Guyane,1982_1990,1986,8,73022,114678,3933,20756,41656,16823,24833,0.0580429514309646,0.0234409586115594,0.0346019928194052,DEP
973,Guyane,1990_1999,1994.5,9,114678,157213,5285,37793,42535,32508,10027,0.0356741806927794,0.0272645178314534,0.00840966286132594,DEP
973,Guyane,1999_2010,2004.5,11,157213,229040,7619,62415,71827,54796,17031,0.0348004894027414,0.0265488968954936,0.00825159250724781,DEP
974,La Réunion,2010_2015,2012.5,5,821136,850727,21003,70656,29591,49653,-20062,0.00710563218393978,0.0119230831952,-0.00481745101126018,DEP
974,La Réunion,1968_1975,1971.5,7,416525,476675,24668,99867,60150,75199,-15049,0.0194566366220896,0.0243245156665755,-0.0048678790444859,DEP
974,La Réunion,1975_1982,1978.5,7,476675,515814,19713,91392,39139,71679,-32540,0.0113368257079916,0.0207622149243242,-0.00942538921633269,DEP
974,La Réunion,1982_1990,1986,8,515814,597823,25015,104006,82009,78991,3018,0.0186146939695355,0.0179296576149884,0.000685036354547162,DEP
974,La Réunion,1990_1999,1994.5,9,597823,706300,30104,121817,108477,91713,16764,0.0186999560118617,0.0158100709432956,0.00288988506856614,DEP
974,La Réunion,1999_2010,2004.5,11,706300,821136,43997,159685,114836,115688,-852,0.0137895443977445,0.013891852836099,-0.000102308438354508,DEP
01,Guadeloupe,2010_2015,2012.5,5,403355,397990,14914,26032,-5365,11118,-16483,-0.00267445488567886,0.00554232794389143,-0.00821678282957029,REG
01,Guadeloupe,1968_1975,1971.5,7,305312,315848,19202,75711,10536,56509,-45973,0.00485846146890379,0.0260579725841196,-0.0211995111152158,REG
01,Guadeloupe,1975_1982,1978.5,7,315848,317269,14706,41890,1421,27184,-25763,0.000641478412632068,0.0122716039190641,-0.0116301255064321,REG
01,Guadeloupe,1982_1990,1986,8,317269,353431,17036,50657,36162,33621,2541,0.0135837167304549,0.0126292279241918,0.000954488806263089,REG
01,Guadeloupe,1990_1999,1994.5,9,353431,386566,20049,58091,33135,38042,-4907,0.0100068863935667,0.011488817630423,-0.00148193123685625,REG
01,Guadeloupe,1999_2010,2004.5,11,386566,403355,29016,68469,16789,39453,-22664,0.00387242862198245,0.0090999420110235,-0.00522751338904105,REG
02,Martinique,2010_2015,2012.5,5,394173,380877,14624,22317,-13296,7693,-20989,-0.00683918774504289,0.00395712028599691,-0.0107963080310398,REG
02,Martinique,1968_1975,1971.5,7,320030,324832,16566,60888,4802,44322,-39520,0.00212989131758601,0.0196586928317466,-0.0175288015141606,REG
02,Martinique,1975_1982,1978.5,7,324832,328566,16967,44559,3734,27592,-23858,0.00163413451417482,0.012075265001369,-0.0104411304871941,REG
02,Martinique,1982_1990,1986,8,328566,359572,16786,47536,31006,30750,256,0.0113358573994697,0.0112422632727116,9.35941267581845e-05,REG
02,Martinique,1990_1999,1994.5,9,359572,381427,20361,53254,21855,32893,-11038,0.00657765473092931,0.00989973905579765,-0.00332208432486834,REG
02,Martinique,1999_2010,2004.5,11,381427,394173,29581,59732,12746,30151,-17405,0.00299268888282578,0.00707928467802291,-0.00408659579519713,REG
03,Guyane,2010_2015,2012.5,5,229040,259865,3829,32017,30825,28188,2637,0.0255746820818106,0.0233868333664907,0.00218784871531985,REG
03,Guyane,1968_1975,1971.5,7,44392,55125,2909,10846,10733,7937,2796,0.0314183211125187,0.0232336918541006,0.00818462925841819,REG
03,Guyane,1975_1982,1978.5,7,55125,73022,2984,11640,17897,8656,9241,0.0409828837825261,0.0198216372588448,0.0211612465236813,REG
03,Guyane,1982_1990,1986,8,73022,114678,3933,20756,41656,16823,24833,0.0580429514309646,0.0234409586115594,0.0346019928194052,REG
03,Guyane,1990_1999,1994.5,9,114678,157213,5285,37793,42535,32508,10027,0.0356741806927794,0.0272645178314534,0.00840966286132594,REG
03,Guyane,1999_2010,2004.5,11,157213,229040,7619,62415,71827,54796,17031,0.0348004894027414,0.0265488968954936,0.00825159250724781,REG
04,La Réunion,2010_2015,2012.5,5,821136,850727,21003,70656,29591,49653,-20062,0.00710563218393978,0.0119230831952,-0.00481745101126018,REG
04,La Réunion,1968_1975,1971.5,7,416525,476675,24668,99867,60150,75199,-15049,0.0194566366220896,0.0243245156665755,-0.0048678790444859,REG
04,La Réunion,1975_1982,1978.5,7,476675,515814,19713,91392,39139,71679,-32540,0.0113368257079916,0.0207622149243242,-0.00942538921633269,REG
04,La Réunion,1982_1990,1986,8,515814,597823,25015,104006,82009,78991,3018,0.0186146939695355,0.0179296576149884,0.000685036354547162,REG
04,La Réunion,1990_1999,1994.5,9,597823,706300,30104,121817,108477,91713,16764,0.0186999560118617,0.0158100709432956,0.00288988506856614,REG
04,La Réunion,1999_2010,2004.5,11,706300,821136,43997,159685,114836,115688,-852,0.0137895443977445,0.013891852836099,-0.000102308438354508,REG
11,Île-de-France,2010_2015,2012.5,5,11786234,12082144,357282,911091,295910,553809,-257899,0.00497160158641696,0.0093045780912169,-0.00433297650479993,REG
11,Île-de-France,1968_1975,1971.5,7,9248631,9878565,605208,1128246,629934,523038,106896,0.0094575451198402,0.00785265676148768,0.00160488835835252,REG
11,Île-de-France,1975_1982,1978.5,7,9878565,10073059,595209,1068281,194494,473072,-278578,0.00278919342349449,0.00678421602331888,-0.0039950225998244,REG
11,Île-de-France,1982_1990,1986,8,10073059,10660554,653290,1289663,587495,636373,-48878,0.00711090743136089,0.00770251575727015,-0.000591608325909254,REG
11,Île-de-France,1990_1999,1994.5,9,10660554,10952011,695165,1480879,291457,785714,-494257,0.00300146261820178,0.00809138637808593,-0.00508992375988415,REG
11,Île-de-France,1999_2010,2004.5,11,10952011,11786234,791127,1937551,834223,1146424,-312201,0.00669587671430216,0.00920175272836776,-0.0025058760140656,REG
24,Centre-Val de Loire,2010_2015,2012.5,5,2548065,2578592,123757,148735,30527,24978,5549,0.00238469205427294,0.00195121820459362,0.000433473849679318,REG
24,Centre-Val de Loire,1968_1975,1971.5,7,1990238,2152500,166251,236272,162262,70021,92241,0.0112594482989008,0.00485879521599224,0.00640065308290856,REG
24,Centre-Val de Loire,1975_1982,1978.5,7,2152500,2264164,168232,209231,111664,40999,70665,0.00725125516881864,0.00266239979461953,0.00458885537419911,REG
24,Centre-Val de Loire,1982_1990,1986,8,2264164,2371036,190272,239390,106872,49118,57754,0.00578182491932422,0.00265730665082872,0.0031245182684955,REG
24,Centre-Val de Loire,1990_1999,1994.5,9,2371036,2440329,213204,255992,69293,42788,26505,0.0032057804302581,0.00197954963776837,0.00122623079248973,REG
24,Centre-Val de Loire,1999_2010,2004.5,11,2440329,2548065,267250,328057,107736,60807,46929,0.00393512063564017,0.00222101136566581,0.00171410926997436,REG
27,Bourgogne-Franche-Comté,2010_2015,2012.5,5,2813878,2820940,139453,155559,7062,16106,-9044,0.000501437606441391,0.00114360720608114,-0.000642169599639753,REG
27,Bourgogne-Franche-Comté,1968_1975,1971.5,7,2495379,2631260,206253,298808,135881,92555,43326,0.0076033594832341,0.00517900911069783,0.00242435037253627,REG
27,Bourgogne-Franche-Comté,1975_1982,1978.5,7,2631260,2680103,203394,264276,48843,60882,-12039,0.00263094168350264,0.00327942574319775,-0.000648484059695111,REG
27,Bourgogne-Franche-Comté,1982_1990,1986,8,2680103,2706929,224790,284070,26826,59280,-32454,0.00124571968638398,0.00275278696074117,-0.00150706727435718,REG
27,Bourgogne-Franche-Comté,1990_1999,1994.5,9,2706929,2727126,245766,287482,20197,41716,-21519,0.000826288457854485,0.00170666184620774,-0.000880373388353254,REG
27,Bourgogne-Franche-Comté,1999_2010,2004.5,11,2727126,2813878,299841,354444,86752,54603,32149,0.00285090117339837,0.00179439963079896,0.00105650154259941,REG
28,Normandie,2010_2015,2012.5,5,3310448,3339131,155905,196568,28683,40663,-11980,0.00172690254836172,0.00244817621322848,-0.000721273664866764,REG
28,Normandie,1968_1975,1971.5,7,2757520,2901847,199212,356467,144327,157255,-12928,0.00731457976289351,0.00796977863195258,-0.000655198869059064,REG
28,Normandie,1975_1982,1978.5,7,2901847,3006341,200117,318823,104494,118706,-14212,0.00506654803344264,0.00575563813097252,-0.000689090097529876,REG
28,Normandie,1982_1990,1986,8,3006341,3128565,230307,366168,122224,135861,-13637,0.00499376602922452,0.00555093963948548,-0.000557173610260953,REG
28,Normandie,1990_1999,1994.5,9,3128565,3202385,256604,371240,73820,114636,-40816,0.00259462820639178,0.00402923054819735,-0.00143460234180557,REG
28,Normandie,1999_2010,2004.5,11,3202385,3310448,324205,446070,108063,121865,-13802,0.00302161800013834,0.00340754446560672,-0.000385926465468378,REG
32,Hauts-de-France,2010_2015,2012.5,5,5952951,6009976,267133,401056,57025,133923,-76898,0.00190855742192375,0.00448223999327128,-0.00257368257134752,REG
32,Hauts-de-France,1968_1975,1971.5,7,5394378,5592362,424808,723570,197984,298762,-100778,0.00516248537737796,0.00779029849036383,-0.00262781311298588,REG
32,Hauts-de-France,1975_1982,1978.5,7,5592362,5673217,421931,649346,80855,227415,-146560,0.00205275986213871,0.00577364892768876,-0.00372088906555005,REG
32,Hauts-de-France,1982_1990,1986,8,5673217,5775686,453242,730243,102469,277001,-174532,0.00224009380107471,0.00605557020163654,-0.00381547640056183,REG
32,Hauts-de-France,1990_1999,1994.5,9,5775686,5854014,477712,727955,78328,250243,-171915,0.00149784760615979,0.00478533702517929,-0.0032874894190195,REG
32,Hauts-de-France,1999_2010,2004.5,11,5854014,5952951,580254,893279,98937,313025,-214088,0.00152475063374991,0.0048241311858007,-0.0032993805520508,REG
44,Grand Est,2010_2015,2012.5,5,5532580,5559051,244517,316840,26471,72323,-45852,0.00095508728438376,0.00260945100934935,-0.00165436372496559,REG
44,Grand Est,1968_1975,1971.5,7,4966173,5185039,371300,622947.2028537,218866,251647.2028537,-32781.2028536997,0.0061801387358531,0.00710578448057365,-0.000925645744720549,REG
44,Grand Est,1975_1982,1978.5,7,5185039,5231931,367104,539773.453624527,46892,172669.453624527,-125777.453624527,0.00128697925424248,0.00473901741568178,-0.0034520381614393,REG
44,Grand Est,1982_1990,1986,8,5231931,5278005,399529,602300.653755289,46074,202771.653755289,-156697.653755289,0.00109657072133906,0.00482600726278491,-0.00372943654144584,REG
44,Grand Est,1990_1999,1994.5,9,5278005,5386939,428852,609183,108934,180331,-71397,0.00227248203416131,0.00376190131366095,-0.00148941927949965,REG
44,Grand Est,1999_2010,2004.5,11,5386939,5532580,521050,724035,145641,202985,-57344,0.00242811882367699,0.00338415487001651,-0.000956036046339517,REG
52,Pays de la Loire,2010_2015,2012.5,5,3571495,3718512,154618,223773,147017,69155,77862,0.00810049542784475,0.00381037404730476,0.00429012138053999,REG
52,Pays de la Loire,1968_1975,1971.5,7,2582866,2767163,192894,344665,184297,151771,32526,0.00989477164235186,0.00814847440235807,0.0017462972399938,REG
52,Pays de la Loire,1975_1982,1978.5,7,2767163,2930398,194485,319724,163235,125239,37996,0.00822156183799239,0.00630783951375825,0.00191372232423413,REG
52,Pays de la Loire,1982_1990,1986,8,2930398,3059112,219032,336762,128714,117730,10984,0.00538776556022658,0.00492799259913821,0.000459772961088372,REG
52,Pays de la Loire,1990_1999,1994.5,9,3059112,3222061,247344,351376,162949,104032,58917,0.00578293913293759,0.00369201850810845,0.00209092062482914,REG
52,Pays de la Loire,1999_2010,2004.5,11,3222061,3571495,319595,485079,349434,165484,183950,0.00940422247217421,0.00445362601116456,0.00495059646100965,REG
53,Bretagne,2010_2015,2012.5,5,3199066,3293850,159717,181077,94784,21360,73424,0.00585672417275029,0.00131983909024673,0.00453688508250356,REG
53,Bretagne,1968_1975,1971.5,7,2468227,2595431,210421,299094,127204,88673,38531,0.00720476062832365,0.00502238718275638,0.00218237344556727,REG
53,Bretagne,1975_1982,1978.5,7,2595431,2707886,214000,265998,112455,51998,60457,0.00607777592840275,0.00281029916611166,0.0032674767622911,REG
53,Bretagne,1982_1990,1986,8,2707886,2795638,239954,288731,87752,48777,38975,0.00399446778521484,0.00222032723082578,0.00177414055438906,REG
53,Bretagne,1990_1999,1994.5,9,2795638,2906197,263447,300697,110559,37250,73309,0.00431874438063984,0.00145508939280234,0.0028636549878375,REG
53,Bretagne,1999_2010,2004.5,11,2906197,3199066,331617,402438,292869,70821,222048,0.00876670796846768,0.00211994791198403,0.00664676005648366,REG
75,Nouvelle-Aquitaine,2010_2015,2012.5,5,5745486,5911482,297519,297781,165996,262,165734,0.0057126670803469,9.01659543031692e-06,0.00570365048491658,REG
75,Nouvelle-Aquitaine,1968_1975,1971.5,7,4676995,4817190,404120,482521,140195,78401,61794,0.00422819381233541,0.00236452529035207,0.00186366852198334,REG
75,Nouvelle-Aquitaine,1975_1982,1978.5,7,4817190,4961927,404864,418150,144737,13286,131451,0.00423801263246881,0.000389024477742254,0.00384898815472656,REG
75,Nouvelle-Aquitaine,1982_1990,1986,8,4961927,5113789,456493,459389,151862,2896,148966,0.00377541441193063,7.19969454962473e-05,0.00370341746643439,REG
75,Nouvelle-Aquitaine,1990_1999,1994.5,9,5113789,5259366,507176,484926,145577,-22250,167827,0.00312374324230191,-0.00047743316005425,0.00360117640235616,REG
75,Nouvelle-Aquitaine,1999_2010,2004.5,11,5259366,5745486,626665,642722,486120,16057,470063,0.00806910990667942,0.000266530276005002,0.00780257963067442,REG
76,Occitanie,2010_2015,2012.5,5,5518106,5774185,267649,313686,256079,46037,210042,0.00911376684088605,0.00163844159050087,0.00747532525038519,REG
76,Occitanie,1968_1975,1971.5,7,3892344,4057772,333110,375478,165428,42368,123060,0.0059637855023158,0.00152739357401477,0.00443639192830103,REG
76,Occitanie,1975_1982,1978.5,7,4057772,4251833,337415,332895,194061,-4520,198581,0.00669605177183397,-0.000155962063519664,0.00685201383535363,REG
76,Occitanie,1982_1990,1986,8,4251833,4545648,387496,401593,293815,14097,279718,0.00838749301812203,0.000402424958141913,0.00798506805998011,REG
76,Occitanie,1990_1999,1994.5,9,4545648,4847335,439602,467239,301687,27637,274050,0.00716541378623692,0.000656410587165605,0.00650900319907131,REG
76,Occitanie,1999_2010,2004.5,11,4847335,5518106,556674,641367,670771,84693,586078,0.0118520137846809,0.00149646094340092,0.01035555284128,REG
84,Auvergne-Rhône-Alpes,2010_2015,2012.5,5,7578078,7877698,314941,480664,299620,165723,133897,0.00778537438700155,0.00430617315111494,0.00347920123588661,REG
84,Auvergne-Rhône-Alpes,1968_1975,1971.5,7,5734998,6111163,447443,677757,376165,230314,145851,0.00911697976478765,0.00558204000251832,0.00353493976226933,REG
84,Auvergne-Rhône-Alpes,1975_1982,1978.5,7,6111163,6348625,440360,610805,237462,170445,67017,0.00546073507825473,0.00391959551596941,0.00154113956228532,REG
84,Auvergne-Rhône-Alpes,1982_1990,1986,8,6348625,6671915,488822,699414,323290,210592,112698,0.00622789709835736,0.00405686939199255,0.00217102770636481,REG
84,Auvergne-Rhône-Alpes,1990_1999,1994.5,9,6671915,6954285,540916,767568,282370,226652,55718,0.00461629922931706,0.00370539877792672,0.000910900451390331,REG
84,Auvergne-Rhône-Alpes,1999_2010,2004.5,11,6954285,7578078,664954,1007113,623793,342159,281634,0.0078398069838157,0.00430024145473802,0.00353956552907768,REG
93,Provence-Alpes-Côte d'Azur,2010_2015,2012.5,5,4899155,5007977,232684,298319,108822,65635,43187,0.00440352713016767,0.00265594735612794,0.00174757977403973,REG
93,Provence-Alpes-Côte d'Azur,1968_1975,1971.5,7,3298836,3675730,268203,337180,376894,68977,307917,0.0155746215581676,0.00285037881000421,0.0127242427481634,REG
93,Provence-Alpes-Côte d'Azur,1975_1982,1978.5,7,3675730,3965209,291421,327045,289479,35624,253855,0.0108883964193662,0.00133995292937831,0.00954844348998792,REG
93,Provence-Alpes-Côte d'Azur,1982_1990,1986,8,3965209,4257907,347344,419178,292698,71834,220864,0.00894213917932518,0.00219458153389379,0.00674755764543139,REG
93,Provence-Alpes-Côte d'Azur,1990_1999,1994.5,9,4257907,4506151,402876,476515,248244,73639,174605,0.00631604342520808,0.00187358857329441,0.00444245485191367,REG
93,Provence-Alpes-Côte d'Azur,1999_2010,2004.5,11,4506151,4899155,497139,618309,393004,121170,271834,0.00763072938166443,0.00235268719701652,0.00527804218464791,REG
94,Corse,2010_2015,2012.5,5,309693,327283,14943,14996,17590,53,17537,0.0111100140367422,3.34753123335608e-05,0.0110765387244086,REG
94,Corse,1968_1975,1971.5,7,205268,225562,17302,19415,20294,2113,18181,0.0135594818790663,0.00141180571649094,0.0121476761625754,REG
94,Corse,1975_1982,1978.5,7,225562,240178,18365,18252,14616,-113,14729,0.00900966623596133,-6.96560129080207e-05,0.00907932224886935,REG
94,Corse,1982_1990,1986,8,240178,250371,21868,23440,10193,1572,8621,0.00520895752967121,0.000803343592332301,0.00440561393733891,REG
94,Corse,1990_1999,1994.5,9,250371,260196,24618,25411,9825,793,9032,0.00428597812748732,0.000345931873292361,0.00394004625419496,REG
94,Corse,1999_2010,2004.5,11,260196,309693,30255,30891,49497,636,48861,0.0159574628469306,0.000205041646375494,0.0157524212005551,REG
